alfaiatar-vos	alfaiatar+V.vós.AD.2.PL+INF+3+SG
alfaiatar-vos	alfaiatar+V.vós.AD.2.PL+SBJF+1+SG
alfaiatar-vos	alfaiatar+V.vós.AD.2.PL+SBJF+3+SG
alfaiatar-vos-ão	alfaiatar+V.vós.AD.2.PL+FUT+3+PL
alfaiatar-vos-ás	alfaiatar+V.vós.AD.2.PL+FUT+2+SG
alfaiatar-vos-ei	alfaiatar+V.vós.AD.2.PL+FUT+1+SG
alfaiatar-vos-eis	alfaiatar+V.vós.AD.2.PL+FUT+2+PL
alfaiatar-vos-emos	alfaiatar+V.vós.AD.2.PL+FUT+1+PL
alfaiatar-vos-ia	alfaiatar+V.vós.AD.2.PL+COND+1+SG
alfaiatar-vos-ia	alfaiatar+V.vós.AD.2.PL+COND+3+SG
alfaiatar-vos-iam	alfaiatar+V.vós.AD.2.PL+COND+3+PL
alfaiatar-vos-íamos	alfaiatar+V.vós.AD.2.PL+COND+1+PL
alfaiatar-vos-ias	alfaiatar+V.vós.AD.2.PL+COND+2+SG
alfaiatar-vos-íeis	alfaiatar+V.vós.AD.2.PL+COND+2+PL
alfaiata-se	alfaiatar+V.ele.REFL+PRS+3+SG
alfaiatas-lhe	alfaiatar+V.ele.DAT.3.SG+PRS+2+SG
alfaiatas-lhes	alfaiatar+V.ele.DAT.3.PL+PRS+2+SG
alfaiatas-me	alfaiatar+V.eu.AD.1.SG+PRS+2+SG
alfaiataste-a	alfaiatar+V.ele.ACC.3.F.SG+PRF+2+SG
alfaiatas-te	alfaiatar+V.tu.AD.2.SG+PRS+2+SG
alfaiataste-as	alfaiatar+V.ele.ACC.3.F.PL+PRF+2+SG
alfaiataste-la	alfaiatar+V.ele.ACC.3.F.SG+PRF+2+PL
alfaiataste-las	alfaiatar+V.ele.ACC.3.F.PL+PRF+2+PL
alfaiataste-lhe	alfaiatar+V.ele.DAT.3.SG+PRF+2+SG
alfaiataste-lhes	alfaiatar+V.ele.DAT.3.PL+PRF+2+SG
alfaiataste-lo	alfaiatar+V.ele.ACC.3.M.SG+PRF+2+PL
alfaiataste-los	alfaiatar+V.ele.ACC.3.M.PL+PRF+2+PL
alfaiataste-me	alfaiatar+V.eu.AD.1.SG+PRF+2+SG
alfaiataste-nos	alfaiatar+nós.AD.1.PL+PRF+2+PL
alfaiataste-nos	alfaiatar+nós.AD.1.PL+PRF+2+SG
alfaiataste-o	alfaiatar+V.ele.ACC.3.M.SG+PRF+2+SG
alfaiataste-os	alfaiatar+V.ele.ACC.3.M.PL+PRF+2+SG
alfaiatastes-lhe	alfaiatar+V.ele.DAT.3.SG+PRF+2+PL
alfaiatastes-lhes	alfaiatar+V.ele.DAT.3.PL+PRF+2+PL
alfaiatastes-me	alfaiatar+V.eu.AD.1.SG+PRF+2+PL
alfaiatastes-te	alfaiatar+V.tu.AD.2.SG+PRF+2+PL
alfaiatastes-vos	alfaiatar+V.vós.AD.2.PL+PRF+2+PL
alfaiataste-te	alfaiatar+V.tu.AD.2.SG+PRF+2+SG
alfaiataste-vos	alfaiatar+V.vós.AD.2.PL+PRF+2+SG
alfaiatas-vos	alfaiatar+V.vós.AD.2.PL+PRS+2+SG
alfaiata-te	alfaiatar+V.tu.AD.2.SG+PRS+3+SG
alfaiatava-a	alfaiatar+V.ele.ACC.3.F.SG+IMPF+1+SG
alfaiatava-a	alfaiatar+V.ele.ACC.3.F.SG+IMPF+3+SG
alfaiatava-as	alfaiatar+V.ele.ACC.3.F.PL+IMPF+1+SG
alfaiatava-as	alfaiatar+V.ele.ACC.3.F.PL+IMPF+3+SG
alfaiatava-la	alfaiatar+V.ele.ACC.3.F.SG+IMPF+2+SG
alfaiatava-las	alfaiatar+V.ele.ACC.3.F.PL+IMPF+2+SG
alfaiatava-lhe	alfaiatar+V.ele.DAT.3.SG+IMPF+1+SG
alfaiatava-lhe	alfaiatar+V.ele.DAT.3.SG+IMPF+3+SG
alfaiatava-lhes	alfaiatar+V.ele.DAT.3.PL+IMPF+1+SG
alfaiatava-lhes	alfaiatar+V.ele.DAT.3.PL+IMPF+3+SG
alfaiatava-lo	alfaiatar+V.ele.ACC.3.M.SG+IMPF+2+SG
alfaiatava-los	alfaiatar+V.ele.ACC.3.M.PL+IMPF+2+SG
alfaiatava-me	alfaiatar+V.eu.AD.1.SG+IMPF+1+SG
alfaiatava-me	alfaiatar+V.eu.AD.1.SG+IMPF+3+SG
alfaiatavam-lhe	alfaiatar+V.ele.DAT.3.SG+IMPF+3+PL
alfaiatavam-lhes	alfaiatar+V.ele.DAT.3.PL+IMPF+3+PL
alfaiatavam-me	alfaiatar+V.eu.AD.1.SG+IMPF+3+PL
alfaiatavam-na	alfaiatar+V.ele.ACC.3.F.SG+IMPF+3+PL
alfaiatavam-nas	alfaiatar+V.ele.ACC.3.F.PL+IMPF+3+PL
alfaiatavam-no	alfaiatar+V.ele.ACC.3.M.SG+IMPF+3+PL
alfaiatavam-nos	alfaiatar+V.ele.ACC.3.M.PL+IMPF+3+PL
alfaiatavam-nos	alfaiatar+V.nós.AD.1.PL+IMPF+3+PL
alfaiatávamo-la	alfaiatar+V.ele.ACC.3.F.SG+IMPF+1+PL
alfaiatávamo-las	alfaiatar+V.ele.ACC.3.F.PL+IMPF+1+PL
alfaiatávamo-lo	alfaiatar+V.ele.ACC.3.M.SG+IMPF+1+PL
alfaiatávamo-los	alfaiatar+V.ele.ACC.3.M.PL+IMPF+1+PL
alfaiatávamo-nos	alfaiatar+nós.AD.1.PL+IMPF+1+PL
alfaiatávamos-lhe	alfaiatar+V.ele.DAT.3.SG+IMPF+1+PL
alfaiatávamos-lhes	alfaiatar+V.ele.DAT.3.PL+IMPF+1+PL
alfaiatávamos-me	alfaiatar+V.eu.AD.1.SG+IMPF+1+PL
alfaiatávamos-te	alfaiatar+V.tu.AD.2.SG+IMPF+1+PL
alfaiatávamos-vos	alfaiatar+V.vós.AD.2.PL+IMPF+1+PL
alfaiatavam-se	alfaiatar+V.ele.REFL+IMPF+3+PL
alfaiatavam-te	alfaiatar+V.tu.AD.2.SG+IMPF+3+PL
alfaiatavam-vos	alfaiatar+V.vós.AD.2.PL+IMPF+3+PL
alfaiatava-nos	alfaiatar+nós.AD.1.PL+IMPF+1+SG
alfaiatava-nos	alfaiatar+nós.AD.1.PL+IMPF+2+SG
alfaiatava-nos	alfaiatar+nós.AD.1.PL+IMPF+3+SG
alfaiatava-o	alfaiatar+V.ele.ACC.3.M.SG+IMPF+1+SG
alfaiatava-o	alfaiatar+V.ele.ACC.3.M.SG+IMPF+3+SG
alfaiatava-os	alfaiatar+V.ele.ACC.3.M.PL+IMPF+1+SG
alfaiatava-os	alfaiatar+V.ele.ACC.3.M.PL+IMPF+3+SG
alfaiatava-se	alfaiatar+V.ele.REFL+IMPF+1+SG
alfaiatava-se	alfaiatar+V.ele.REFL+IMPF+3+SG
alfaiatavas-lhe	alfaiatar+V.ele.DAT.3.SG+IMPF+2+SG
alfaiatavas-lhes	alfaiatar+V.ele.DAT.3.PL+IMPF+2+SG
alfaiatavas-me	alfaiatar+V.eu.AD.1.SG+IMPF+2+SG
alfaiatavas-te	alfaiatar+V.tu.AD.2.SG+IMPF+2+SG
alfaiatavas-vos	alfaiatar+V.vós.AD.2.PL+IMPF+2+SG
alfaiatava-te	alfaiatar+V.tu.AD.2.SG+IMPF+1+SG
alfaiatava-te	alfaiatar+V.tu.AD.2.SG+IMPF+3+SG
alfaiatava-vos	alfaiatar+V.vós.AD.2.PL+IMPF+1+SG
alfaiatava-vos	alfaiatar+V.vós.AD.2.PL+IMPF+3+SG
alfaiatávei-la	alfaiatar+V.ele.ACC.3.F.SG+IMPF+2+PL
alfaiatávei-las	alfaiatar+V.ele.ACC.3.F.PL+IMPF+2+PL
alfaiatávei-lo	alfaiatar+V.ele.ACC.3.M.SG+IMPF+2+PL
alfaiatávei-los	alfaiatar+V.ele.ACC.3.M.PL+IMPF+2+PL
alfaiatávei-nos	alfaiatar+nós.AD.1.PL+IMPF+2+PL
alfaiatáveis-lhe	alfaiatar+V.ele.DAT.3.SG+IMPF+2+PL
alfaiatáveis-lhes	alfaiatar+V.ele.DAT.3.PL+IMPF+2+PL
alfaiatáveis-me	alfaiatar+V.eu.AD.1.SG+IMPF+2+PL
alfaiatáveis-te	alfaiatar+V.tu.AD.2.SG+IMPF+2+PL
alfaiatáveis-vos	alfaiatar+V.vós.AD.2.PL+IMPF+2+PL
alfaiata-vos	alfaiatar+V.vós.AD.2.PL+PRS+3+SG
alfaiate-a	alfaiatar+V.ele.ACC.3.F.SG+IMP+3+SG
alfaia-te	alfaiar+V.tu.AD.2.SG+PRS+3+SG
alfaiate-as	alfaiatar+V.ele.ACC.3.F.PL+IMP+3+SG
alfaiatei-a	alfaiatar+V.ele.ACC.3.F.SG+PRF+1+SG
alfaiatei-as	alfaiatar+V.ele.ACC.3.F.PL+PRF+1+SG
alfaiatei-lhe	alfaiatar+V.ele.DAT.3.SG+PRF+1+SG
alfaiatei-lhes	alfaiatar+V.ele.DAT.3.PL+PRF+1+SG
alfaiatei-me	alfaiatar+V.eu.AD.1.SG+PRF+1+SG
alfaiatei-nos	alfaiatar+nós.AD.1.PL+PRF+1+SG
alfaiatei-o	alfaiatar+V.ele.ACC.3.M.SG+PRF+1+SG
alfaiatei-os	alfaiatar+V.ele.ACC.3.M.PL+PRF+1+SG
alfaiatei-te	alfaiatar+V.tu.AD.2.SG+PRF+1+SG
alfaiatei-vos	alfaiatar+V.vós.AD.2.PL+PRF+1+SG
alfaiate-lhe	alfaiatar+V.ele.DAT.3.SG+IMP+3+SG
alfaiate-lhes	alfaiatar+V.ele.DAT.3.PL+IMP+3+SG
alfaiate-me	alfaiatar+V.eu.AD.1.SG+IMP+3+SG
alfaiatem-lhe	alfaiatar+V.ele.DAT.3.SG+IMP+3+PL
alfaiatem-lhes	alfaiatar+V.ele.DAT.3.PL+IMP+3+PL
alfaiatem-me	alfaiatar+V.eu.AD.1.SG+IMP+3+PL
alfaiatem-na	alfaiatar+V.ele.ACC.3.F.SG+IMP+3+PL
alfaiatem-nas	alfaiatar+V.ele.ACC.3.F.PL+IMP+3+PL
alfaiatem-no	alfaiatar+V.ele.ACC.3.M.SG+IMP+3+PL
alfaiatem-nos	alfaiatar+V.ele.ACC.3.M.PL+IMP+3+PL
alfaiatem-nos	alfaiatar+V.nós.AD.1.PL+IMP+3+PL
alfaiatemo-la	alfaiatar+V.ele.ACC.3.F.SG+IMP+1+PL
alfaiatemo-las	alfaiatar+V.ele.ACC.3.F.PL+IMP+1+PL
alfaiatemo-lo	alfaiatar+V.ele.ACC.3.M.SG+IMP+1+PL
alfaiatemo-los	alfaiatar+V.ele.ACC.3.M.PL+IMP+1+PL
alfaiatemo-nos	alfaiatar+nós.AD.1.PL+IMP+1+PL
alfaiatemos-lhe	alfaiatar+V.ele.DAT.3.SG+IMP+1+PL
alfaiatemos-lhes	alfaiatar+V.ele.DAT.3.PL+IMP+1+PL
alfaiatemos-me	alfaiatar+V.eu.AD.1.SG+IMP+1+PL
alfaiatemos-te	alfaiatar+V.tu.AD.2.SG+IMP+1+PL
alfaiatemos-vos	alfaiatar+V.vós.AD.2.PL+IMP+1+PL
alfaiatem-se	alfaiatar+V.ele.REFL+IMP+3+PL
alfaiatem-te	alfaiatar+V.tu.AD.2.SG+IMP+3+PL
alfaiatem-vos	alfaiatar+V.vós.AD.2.PL+IMP+3+PL
alfaiate-nos	alfaiatar+nós.AD.1.PL+IMP+3+SG
alfaiate-o	alfaiatar+V.ele.ACC.3.M.SG+IMP+3+SG
alfaiate-os	alfaiatar+V.ele.ACC.3.M.PL+IMP+3+SG
alfaiate-se	alfaiatar+V.ele.REFL+IMP+3+SG
alfaiate-te	alfaiatar+V.tu.AD.2.SG+IMP+3+SG
alfaiate-vos	alfaiatar+V.vós.AD.2.PL+IMP+3+SG
alfaiato-a	alfaiatar+V.ele.ACC.3.F.SG+PRS+1+SG
alfaiato-as	alfaiatar+V.ele.ACC.3.F.PL+PRS+1+SG
alfaiato-lhe	alfaiatar+V.ele.DAT.3.SG+PRS+1+SG
alfaiato-lhes	alfaiatar+V.ele.DAT.3.PL+PRS+1+SG
alfaiato-me	alfaiatar+V.eu.AD.1.SG+PRS+1+SG
alfaiato-nos	alfaiatar+nós.AD.1.PL+PRS+1+SG
alfaiato-o	alfaiatar+V.ele.ACC.3.M.SG+PRS+1+SG
alfaiato-os	alfaiatar+V.ele.ACC.3.M.PL+PRS+1+SG
alfaiato-te	alfaiatar+V.tu.AD.2.SG+PRS+1+SG
alfaiatou-a	alfaiatar+V.ele.ACC.3.F.SG+PRF+3+SG
alfaiatou-as	alfaiatar+V.ele.ACC.3.F.PL+PRF+3+SG
alfaiatou-lhe	alfaiatar+V.ele.DAT.3.SG+PRF+3+SG
alfaiatou-lhes	alfaiatar+V.ele.DAT.3.PL+PRF+3+SG
alfaiatou-me	alfaiatar+V.eu.AD.1.SG+PRF+3+SG
alfaiatou-nos	alfaiatar+nós.AD.1.PL+PRF+3+SG
alfaiatou-o	alfaiatar+V.ele.ACC.3.M.SG+PRF+3+SG
alfaiatou-os	alfaiatar+V.ele.ACC.3.M.PL+PRF+3+SG
alfaiatou-se	alfaiatar+V.ele.REFL+PRF+3+SG
alfaiatou-te	alfaiatar+V.tu.AD.2.SG+PRF+3+SG
alfaiatou-vos	alfaiatar+V.vós.AD.2.PL+PRF+3+SG
alfaiato-vos	alfaiatar+V.vós.AD.2.PL+PRS+1+SG
alfaiava-a	alfaiar+V.ele.ACC.3.F.SG+IMPF+1+SG
alfaiava-a	alfaiar+V.ele.ACC.3.F.SG+IMPF+3+SG
alfaiava-as	alfaiar+V.ele.ACC.3.F.PL+IMPF+1+SG
alfaiava-as	alfaiar+V.ele.ACC.3.F.PL+IMPF+3+SG
alfaiava-la	alfaiar+V.ele.ACC.3.F.SG+IMPF+2+SG
alfaiava-las	alfaiar+V.ele.ACC.3.F.PL+IMPF+2+SG
alfaiava-lhe	alfaiar+V.ele.DAT.3.SG+IMPF+1+SG
alfaiava-lhe	alfaiar+V.ele.DAT.3.SG+IMPF+3+SG
alfaiava-lhes	alfaiar+V.ele.DAT.3.PL+IMPF+1+SG
alfaiava-lhes	alfaiar+V.ele.DAT.3.PL+IMPF+3+SG
alfaiava-lo	alfaiar+V.ele.ACC.3.M.SG+IMPF+2+SG
alfaiava-los	alfaiar+V.ele.ACC.3.M.PL+IMPF+2+SG
alfaiava-me	alfaiar+V.eu.AD.1.SG+IMPF+1+SG
alfaiava-me	alfaiar+V.eu.AD.1.SG+IMPF+3+SG
alfaiavam-lhe	alfaiar+V.ele.DAT.3.SG+IMPF+3+PL
alfaiavam-lhes	alfaiar+V.ele.DAT.3.PL+IMPF+3+PL
alfaiavam-me	alfaiar+V.eu.AD.1.SG+IMPF+3+PL
alfaiavam-na	alfaiar+V.ele.ACC.3.F.SG+IMPF+3+PL
alfaiavam-nas	alfaiar+V.ele.ACC.3.F.PL+IMPF+3+PL
alfaiavam-no	alfaiar+V.ele.ACC.3.M.SG+IMPF+3+PL
alfaiavam-nos	alfaiar+V.ele.ACC.3.M.PL+IMPF+3+PL
alfaiavam-nos	alfaiar+V.nós.AD.1.PL+IMPF+3+PL
alfaiávamo-la	alfaiar+V.ele.ACC.3.F.SG+IMPF+1+PL
alfaiávamo-las	alfaiar+V.ele.ACC.3.F.PL+IMPF+1+PL
alfaiávamo-lo	alfaiar+V.ele.ACC.3.M.SG+IMPF+1+PL
alfaiávamo-los	alfaiar+V.ele.ACC.3.M.PL+IMPF+1+PL
alfaiávamo-nos	alfaiar+nós.AD.1.PL+IMPF+1+PL
alfaiávamos-lhe	alfaiar+V.ele.DAT.3.SG+IMPF+1+PL
alfaiávamos-lhes	alfaiar+V.ele.DAT.3.PL+IMPF+1+PL
alfaiávamos-me	alfaiar+V.eu.AD.1.SG+IMPF+1+PL
alfaiávamos-te	alfaiar+V.tu.AD.2.SG+IMPF+1+PL
alfaiávamos-vos	alfaiar+V.vós.AD.2.PL+IMPF+1+PL
alfaiavam-se	alfaiar+V.ele.REFL+IMPF+3+PL
alfaiavam-te	alfaiar+V.tu.AD.2.SG+IMPF+3+PL
alfaiavam-vos	alfaiar+V.vós.AD.2.PL+IMPF+3+PL
alfaiava-nos	alfaiar+nós.AD.1.PL+IMPF+1+SG
alfaiava-nos	alfaiar+nós.AD.1.PL+IMPF+2+SG
alfaiava-nos	alfaiar+nós.AD.1.PL+IMPF+3+SG
alfaiava-o	alfaiar+V.ele.ACC.3.M.SG+IMPF+1+SG
alfaiava-o	alfaiar+V.ele.ACC.3.M.SG+IMPF+3+SG
alfaiava-os	alfaiar+V.ele.ACC.3.M.PL+IMPF+1+SG
alfaiava-os	alfaiar+V.ele.ACC.3.M.PL+IMPF+3+SG
alfaiava-se	alfaiar+V.ele.REFL+IMPF+1+SG
alfaiava-se	alfaiar+V.ele.REFL+IMPF+3+SG
alfaiavas-lhe	alfaiar+V.ele.DAT.3.SG+IMPF+2+SG
alfaiavas-lhes	alfaiar+V.ele.DAT.3.PL+IMPF+2+SG
alfaiavas-me	alfaiar+V.eu.AD.1.SG+IMPF+2+SG
alfaiavas-te	alfaiar+V.tu.AD.2.SG+IMPF+2+SG
alfaiavas-vos	alfaiar+V.vós.AD.2.PL+IMPF+2+SG
alfaiava-te	alfaiar+V.tu.AD.2.SG+IMPF+1+SG
alfaiava-te	alfaiar+V.tu.AD.2.SG+IMPF+3+SG
alfaiava-vos	alfaiar+V.vós.AD.2.PL+IMPF+1+SG
alfaiava-vos	alfaiar+V.vós.AD.2.PL+IMPF+3+SG
alfaiávei-la	alfaiar+V.ele.ACC.3.F.SG+IMPF+2+PL
alfaiávei-las	alfaiar+V.ele.ACC.3.F.PL+IMPF+2+PL
alfaiávei-lo	alfaiar+V.ele.ACC.3.M.SG+IMPF+2+PL
alfaiávei-los	alfaiar+V.ele.ACC.3.M.PL+IMPF+2+PL
alfaiávei-nos	alfaiar+nós.AD.1.PL+IMPF+2+PL
alfaiáveis-lhe	alfaiar+V.ele.DAT.3.SG+IMPF+2+PL
alfaiáveis-lhes	alfaiar+V.ele.DAT.3.PL+IMPF+2+PL
alfaiáveis-me	alfaiar+V.eu.AD.1.SG+IMPF+2+PL
alfaiáveis-te	alfaiar+V.tu.AD.2.SG+IMPF+2+PL
alfaiáveis-vos	alfaiar+V.vós.AD.2.PL+IMPF+2+PL
alfaia-vos	alfaiar+V.vós.AD.2.PL+PRS+3+SG
alfaie-a	alfaiar+V.ele.ACC.3.F.SG+IMP+3+SG
alfaie-as	alfaiar+V.ele.ACC.3.F.PL+IMP+3+SG
alfaiei-a	alfaiar+V.ele.ACC.3.F.SG+PRF+1+SG
alfaiei-as	alfaiar+V.ele.ACC.3.F.PL+PRF+1+SG
alfaiei-lhe	alfaiar+V.ele.DAT.3.SG+PRF+1+SG
alfaiei-lhes	alfaiar+V.ele.DAT.3.PL+PRF+1+SG
alfaiei-me	alfaiar+V.eu.AD.1.SG+PRF+1+SG
alfaiei-nos	alfaiar+nós.AD.1.PL+PRF+1+SG
alfaiei-o	alfaiar+V.ele.ACC.3.M.SG+PRF+1+SG
alfaiei-os	alfaiar+V.ele.ACC.3.M.PL+PRF+1+SG
alfaiei-te	alfaiar+V.tu.AD.2.SG+PRF+1+SG
alfaiei-vos	alfaiar+V.vós.AD.2.PL+PRF+1+SG
alfaie-lhe	alfaiar+V.ele.DAT.3.SG+IMP+3+SG
alfaie-lhes	alfaiar+V.ele.DAT.3.PL+IMP+3+SG
alfaie-me	alfaiar+V.eu.AD.1.SG+IMP+3+SG
alfaiem-lhe	alfaiar+V.ele.DAT.3.SG+IMP+3+PL
alfaiem-lhes	alfaiar+V.ele.DAT.3.PL+IMP+3+PL
alfaiem-me	alfaiar+V.eu.AD.1.SG+IMP+3+PL
alfaiem-na	alfaiar+V.ele.ACC.3.F.SG+IMP+3+PL
alfaiem-nas	alfaiar+V.ele.ACC.3.F.PL+IMP+3+PL
alfaiem-no	alfaiar+V.ele.ACC.3.M.SG+IMP+3+PL
alfaiem-nos	alfaiar+V.ele.ACC.3.M.PL+IMP+3+PL
alfaiem-nos	alfaiar+V.nós.AD.1.PL+IMP+3+PL
alfaiemo-la	alfaiar+V.ele.ACC.3.F.SG+IMP+1+PL
alfaiemo-las	alfaiar+V.ele.ACC.3.F.PL+IMP+1+PL
alfaiemo-lo	alfaiar+V.ele.ACC.3.M.SG+IMP+1+PL
alfaiemo-los	alfaiar+V.ele.ACC.3.M.PL+IMP+1+PL
alfaiemo-nos	alfaiar+nós.AD.1.PL+IMP+1+PL
alfaiemos-lhe	alfaiar+V.ele.DAT.3.SG+IMP+1+PL
alfaiemos-lhes	alfaiar+V.ele.DAT.3.PL+IMP+1+PL
alfaiemos-me	alfaiar+V.eu.AD.1.SG+IMP+1+PL
alfaiemos-te	alfaiar+V.tu.AD.2.SG+IMP+1+PL
alfaiemos-vos	alfaiar+V.vós.AD.2.PL+IMP+1+PL
alfaiem-se	alfaiar+V.ele.REFL+IMP+3+PL
alfaiem-te	alfaiar+V.tu.AD.2.SG+IMP+3+PL
alfaiem-vos	alfaiar+V.vós.AD.2.PL+IMP+3+PL
alfaie-nos	alfaiar+nós.AD.1.PL+IMP+3+SG
alfaie-o	alfaiar+V.ele.ACC.3.M.SG+IMP+3+SG
alfaie-os	alfaiar+V.ele.ACC.3.M.PL+IMP+3+SG
alfaie-se	alfaiar+V.ele.REFL+IMP+3+SG
alfaie-te	alfaiar+V.tu.AD.2.SG+IMP+3+SG
alfaie-vos	alfaiar+V.vós.AD.2.PL+IMP+3+SG
alfai-la	alfar+V.ele.ACC.3.F.SG+PRS+2+PL
alfai-las	alfar+V.ele.ACC.3.F.PL+PRS+2+PL
alfai-lo	alfar+V.ele.ACC.3.M.SG+PRS+2+PL
alfai-los	alfar+V.ele.ACC.3.M.PL+PRS+2+PL
alfai-nos	alfar+nós.AD.1.PL+PRS+2+PL
alfaio-a	alfaiar+V.ele.ACC.3.F.SG+PRS+1+SG
alfaio-as	alfaiar+V.ele.ACC.3.F.PL+PRS+1+SG
alfaio-lhe	alfaiar+V.ele.DAT.3.SG+PRS+1+SG
alfaio-lhes	alfaiar+V.ele.DAT.3.PL+PRS+1+SG
alfaio-me	alfaiar+V.eu.AD.1.SG+PRS+1+SG
alfaio-nos	alfaiar+nós.AD.1.PL+PRS+1+SG
alfaio-o	alfaiar+V.ele.ACC.3.M.SG+PRS+1+SG
alfaio-os	alfaiar+V.ele.ACC.3.M.PL+PRS+1+SG
alfaio-te	alfaiar+V.tu.AD.2.SG+PRS+1+SG
alfaiou-a	alfaiar+V.ele.ACC.3.F.SG+PRF+3+SG
alfaiou-as	alfaiar+V.ele.ACC.3.F.PL+PRF+3+SG
alfaiou-lhe	alfaiar+V.ele.DAT.3.SG+PRF+3+SG
alfaiou-lhes	alfaiar+V.ele.DAT.3.PL+PRF+3+SG
alfaiou-me	alfaiar+V.eu.AD.1.SG+PRF+3+SG
alfaiou-nos	alfaiar+nós.AD.1.PL+PRF+3+SG
alfaiou-o	alfaiar+V.ele.ACC.3.M.SG+PRF+3+SG
alfaiou-os	alfaiar+V.ele.ACC.3.M.PL+PRF+3+SG
alfaiou-se	alfaiar+V.ele.REFL+PRF+3+SG
alfaiou-te	alfaiar+V.tu.AD.2.SG+PRF+3+SG
alfaiou-vos	alfaiar+V.vós.AD.2.PL+PRF+3+SG
alfaio-vos	alfaiar+V.vós.AD.2.PL+PRS+1+SG
alfais-lhe	alfar+V.ele.DAT.3.SG+PRS+2+PL
alfais-lhes	alfar+V.ele.DAT.3.PL+PRS+2+PL
alfais-me	alfar+V.eu.AD.1.SG+PRS+2+PL
alfais-te	alfar+V.tu.AD.2.SG+PRS+2+PL
alfais-vos	alfar+V.vós.AD.2.PL+PRS+2+PL
alfá-la-á	alfar+V.ele.ACC.3.F.SG+FUT+3+SG
alfá-la	alfar+V.ele.ACC.3.F.SG+INF+1+SG
alfá-la	alfar+V.ele.ACC.3.F.SG+INF+3+SG
alfa-la	alfar+V.ele.ACC.3.F.SG+PRS+2+SG
alfá-la	alfar+V.ele.ACC.3.F.SG+SBJF+1+SG
alfá-la	alfar+V.ele.ACC.3.F.SG+SBJF+3+SG
alfá-la-ão	alfar+V.ele.ACC.3.F.SG+FUT+3+PL
alfá-la-ás	alfar+V.ele.ACC.3.F.SG+FUT+2+SG
alfá-la-ei	alfar+V.ele.ACC.3.F.SG+FUT+1+SG
alfá-la-eis	alfar+V.ele.ACC.3.F.SG+FUT+2+PL
alfá-la-emos	alfar+V.ele.ACC.3.F.SG+FUT+1+PL
alfá-la-ia	alfar+V.ele.ACC.3.F.SG+COND+1+SG
alfá-la-ia	alfar+V.ele.ACC.3.F.SG+COND+3+SG
alfá-la-iam	alfar+V.ele.ACC.3.F.SG+COND+3+PL
alfá-la-íamos	alfar+V.ele.ACC.3.F.SG+COND+1+PL
alfá-la-ias	alfar+V.ele.ACC.3.F.SG+COND+2+SG
alfá-la-íeis	alfar+V.ele.ACC.3.F.SG+COND+2+PL
alfá-las-á	alfar+V.ele.ACC.3.F.PL+FUT+3+SG
alfá-las	alfar+V.ele.ACC.3.F.PL+INF+1+SG
alfá-las	alfar+V.ele.ACC.3.F.PL+INF+3+SG
alfa-las	alfar+V.ele.ACC.3.F.PL+PRS+2+SG
alfá-las	alfar+V.ele.ACC.3.F.PL+SBJF+1+SG
alfá-las	alfar+V.ele.ACC.3.F.PL+SBJF+3+SG
alfá-las-ão	alfar+V.ele.ACC.3.F.PL+FUT+3+PL
alfá-las-ás	alfar+V.ele.ACC.3.F.PL+FUT+2+SG
alfá-las-ei	alfar+V.ele.ACC.3.F.PL+FUT+1+SG
alfá-las-eis	alfar+V.ele.ACC.3.F.PL+FUT+2+PL
alfá-las-emos	alfar+V.ele.ACC.3.F.PL+FUT+1+PL
alfá-las-ia	alfar+V.ele.ACC.3.F.PL+COND+1+SG
alfá-las-ia	alfar+V.ele.ACC.3.F.PL+COND+3+SG
alfá-las-iam	alfar+V.ele.ACC.3.F.PL+COND+3+PL
alfá-las-íamos	alfar+V.ele.ACC.3.F.PL+COND+1+PL
alfá-las-ias	alfar+V.ele.ACC.3.F.PL+COND+2+SG
alfá-las-íeis	alfar+V.ele.ACC.3.F.PL+COND+2+PL
alfa-lhe	alfar+V.ele.DAT.3.SG+PRS+3+SG
alfa-lhes	alfar+V.ele.DAT.3.PL+PRS+3+SG
alfá-lo-á	alfar+V.ele.ACC.3.M.SG+FUT+3+SG
alfá-lo	alfar+V.ele.ACC.3.M.SG+INF+1+SG
alfá-lo	alfar+V.ele.ACC.3.M.SG+INF+3+SG
alfa-lo	alfar+V.ele.ACC.3.M.SG+PRS+2+SG
alfá-lo	alfar+V.ele.ACC.3.M.SG+SBJF+1+SG
alfá-lo	alfar+V.ele.ACC.3.M.SG+SBJF+3+SG
alfá-lo-ão	alfar+V.ele.ACC.3.M.SG+FUT+3+PL
alfá-lo-ás	alfar+V.ele.ACC.3.M.SG+FUT+2+SG
alfá-lo-ei	alfar+V.ele.ACC.3.M.SG+FUT+1+SG
alfá-lo-eis	alfar+V.ele.ACC.3.M.SG+FUT+2+PL
alfá-lo-emos	alfar+V.ele.ACC.3.M.SG+FUT+1+PL
alfá-lo-ia	alfar+V.ele.ACC.3.M.SG+COND+1+SG
alfá-lo-ia	alfar+V.ele.ACC.3.M.SG+COND+3+SG
alfá-lo-iam	alfar+V.ele.ACC.3.M.SG+COND+3+PL
alfá-lo-íamos	alfar+V.ele.ACC.3.M.SG+COND+1+PL
alfá-lo-ias	alfar+V.ele.ACC.3.M.SG+COND+2+SG
alfá-lo-íeis	alfar+V.ele.ACC.3.M.SG+COND+2+PL
alfá-los-á	alfar+V.ele.ACC.3.M.PL+FUT+3+SG
alfá-los	alfar+V.ele.ACC.3.M.PL+INF+1+SG
alfá-los	alfar+V.ele.ACC.3.M.PL+INF+3+SG
alfa-los	alfar+V.ele.ACC.3.M.PL+PRS+2+SG
alfá-los	alfar+V.ele.ACC.3.M.PL+SBJF+1+SG
alfá-los	alfar+V.ele.ACC.3.M.PL+SBJF+3+SG
alfá-los-ão	alfar+V.ele.ACC.3.M.PL+FUT+3+PL
alfá-los-ás	alfar+V.ele.ACC.3.M.PL+FUT+2+SG
alfá-los-ei	alfar+V.ele.ACC.3.M.PL+FUT+1+SG
alfá-los-eis	alfar+V.ele.ACC.3.M.PL+FUT+2+PL
alfá-los-emos	alfar+V.ele.ACC.3.M.PL+FUT+1+PL
alfá-los-ia	alfar+V.ele.ACC.3.M.PL+COND+1+SG
alfá-los-ia	alfar+V.ele.ACC.3.M.PL+COND+3+SG
alfá-los-iam	alfar+V.ele.ACC.3.M.PL+COND+3+PL
alfá-los-íamos	alfar+V.ele.ACC.3.M.PL+COND+1+PL
alfá-los-ias	alfar+V.ele.ACC.3.M.PL+COND+2+SG
alfá-los-íeis	alfar+V.ele.ACC.3.M.PL+COND+2+PL
alfa-me	alfar+V.eu.AD.1.SG+PRS+3+SG
alfam-lhe	alfar+V.ele.DAT.3.SG+PRS+3+PL
alfam-lhes	alfar+V.ele.DAT.3.PL+PRS+3+PL
alfam-me	alfar+V.eu.AD.1.SG+PRS+3+PL
alfam-na	alfar+V.ele.ACC.3.F.SG+PRS+3+PL
alfam-nas	alfar+V.ele.ACC.3.F.PL+PRS+3+PL
alfam-no	alfar+V.ele.ACC.3.M.SG+PRS+3+PL
alfam-nos	alfar+V.ele.ACC.3.M.PL+PRS+3+PL
alfam-nos	alfar+V.nós.AD.1.PL+PRS+3+PL
alfamo-la	alfar+V.ele.ACC.3.F.SG+PRF+1+PL
alfamo-la	alfar+V.ele.ACC.3.F.SG+PRS+1+PL
alfamo-las	alfar+V.ele.ACC.3.F.PL+PRF+1+PL
alfamo-las	alfar+V.ele.ACC.3.F.PL+PRS+1+PL
alfamo-lo	alfar+V.ele.ACC.3.M.SG+PRF+1+PL
alfamo-lo	alfar+V.ele.ACC.3.M.SG+PRS+1+PL
alfamo-los	alfar+V.ele.ACC.3.M.PL+PRF+1+PL
alfamo-los	alfar+V.ele.ACC.3.M.PL+PRS+1+PL
alfamo-nos	alfar+nós.AD.1.PL+PRF+1+PL
alfamo-nos	alfar+nós.AD.1.PL+PRS+1+PL
alfamos-lhe	alfar+V.ele.DAT.3.SG+PRF+1+PL
alfamos-lhe	alfar+V.ele.DAT.3.SG+PRS+1+PL
alfamos-lhes	alfar+V.ele.DAT.3.PL+PRF+1+PL
alfamos-lhes	alfar+V.ele.DAT.3.PL+PRS+1+PL
alfamos-me	alfar+V.eu.AD.1.SG+PRF+1+PL
alfamos-me	alfar+V.eu.AD.1.SG+PRS+1+PL
alfamos-te	alfar+V.tu.AD.2.SG+PRF+1+PL
alfamos-te	alfar+V.tu.AD.2.SG+PRS+1+PL
alfamos-vos	alfar+V.vós.AD.2.PL+PRF+1+PL
alfamos-vos	alfar+V.vós.AD.2.PL+PRS+1+PL
alfam-se	alfar+V.ele.REFL+PRS+3+PL
alfam-te	alfar+V.tu.AD.2.SG+PRS+3+PL
alfam-vos	alfar+V.vós.AD.2.PL+PRS+3+PL
alfandega-a	alfandegar+V.ele.ACC.3.F.SG+PRS+3+SG
alfandega-as	alfandegar+V.ele.ACC.3.F.PL+PRS+3+SG
alfandegai-la	alfandegar+V.ele.ACC.3.F.SG+PRS+2+PL
alfandegai-las	alfandegar+V.ele.ACC.3.F.PL+PRS+2+PL
alfandegai-lo	alfandegar+V.ele.ACC.3.M.SG+PRS+2+PL
alfandegai-los	alfandegar+V.ele.ACC.3.M.PL+PRS+2+PL
alfandegai-nos	alfandegar+nós.AD.1.PL+PRS+2+PL
alfandegais-lhe	alfandegar+V.ele.DAT.3.SG+PRS+2+PL
alfandegais-lhes	alfandegar+V.ele.DAT.3.PL+PRS+2+PL
alfandegais-me	alfandegar+V.eu.AD.1.SG+PRS+2+PL
alfandegais-te	alfandegar+V.tu.AD.2.SG+PRS+2+PL
alfandegais-vos	alfandegar+V.vós.AD.2.PL+PRS+2+PL
alfandegá-la-á	alfandegar+V.ele.ACC.3.F.SG+FUT+3+SG
alfandegá-la	alfandegar+V.ele.ACC.3.F.SG+INF+1+SG
alfandegá-la	alfandegar+V.ele.ACC.3.F.SG+INF+3+SG
alfandega-la	alfandegar+V.ele.ACC.3.F.SG+PRS+2+SG
alfandegá-la	alfandegar+V.ele.ACC.3.F.SG+SBJF+1+SG
alfandegá-la	alfandegar+V.ele.ACC.3.F.SG+SBJF+3+SG
alfandegá-la-ão	alfandegar+V.ele.ACC.3.F.SG+FUT+3+PL
alfandegá-la-ás	alfandegar+V.ele.ACC.3.F.SG+FUT+2+SG
alfandegá-la-ei	alfandegar+V.ele.ACC.3.F.SG+FUT+1+SG
alfandegá-la-eis	alfandegar+V.ele.ACC.3.F.SG+FUT+2+PL
alfandegá-la-emos	alfandegar+V.ele.ACC.3.F.SG+FUT+1+PL
alfandegá-la-ia	alfandegar+V.ele.ACC.3.F.SG+COND+1+SG
alfandegá-la-ia	alfandegar+V.ele.ACC.3.F.SG+COND+3+SG
alfandegá-la-iam	alfandegar+V.ele.ACC.3.F.SG+COND+3+PL
alfandegá-la-íamos	alfandegar+V.ele.ACC.3.F.SG+COND+1+PL
alfandegá-la-ias	alfandegar+V.ele.ACC.3.F.SG+COND+2+SG
alfandegá-la-íeis	alfandegar+V.ele.ACC.3.F.SG+COND+2+PL
alfandegá-las-á	alfandegar+V.ele.ACC.3.F.PL+FUT+3+SG
alfandegá-las	alfandegar+V.ele.ACC.3.F.PL+INF+1+SG
alfandegá-las	alfandegar+V.ele.ACC.3.F.PL+INF+3+SG
alfandega-las	alfandegar+V.ele.ACC.3.F.PL+PRS+2+SG
alfandegá-las	alfandegar+V.ele.ACC.3.F.PL+SBJF+1+SG
alfandegá-las	alfandegar+V.ele.ACC.3.F.PL+SBJF+3+SG
alfandegá-las-ão	alfandegar+V.ele.ACC.3.F.PL+FUT+3+PL
alfandegá-las-ás	alfandegar+V.ele.ACC.3.F.PL+FUT+2+SG
alfandegá-las-ei	alfandegar+V.ele.ACC.3.F.PL+FUT+1+SG
alfandegá-las-eis	alfandegar+V.ele.ACC.3.F.PL+FUT+2+PL
alfandegá-las-emos	alfandegar+V.ele.ACC.3.F.PL+FUT+1+PL
alfandegá-las-ia	alfandegar+V.ele.ACC.3.F.PL+COND+1+SG
alfandegá-las-ia	alfandegar+V.ele.ACC.3.F.PL+COND+3+SG
alfandegá-las-iam	alfandegar+V.ele.ACC.3.F.PL+COND+3+PL
alfandegá-las-íamos	alfandegar+V.ele.ACC.3.F.PL+COND+1+PL
alfandegá-las-ias	alfandegar+V.ele.ACC.3.F.PL+COND+2+SG
alfandegá-las-íeis	alfandegar+V.ele.ACC.3.F.PL+COND+2+PL
alfandega-lhe	alfandegar+V.ele.DAT.3.SG+PRS+3+SG
alfandega-lhes	alfandegar+V.ele.DAT.3.PL+PRS+3+SG
alfandegá-lo-á	alfandegar+V.ele.ACC.3.M.SG+FUT+3+SG
alfandegá-lo	alfandegar+V.ele.ACC.3.M.SG+INF+1+SG
alfandegá-lo	alfandegar+V.ele.ACC.3.M.SG+INF+3+SG
alfandega-lo	alfandegar+V.ele.ACC.3.M.SG+PRS+2+SG
alfandegá-lo	alfandegar+V.ele.ACC.3.M.SG+SBJF+1+SG
alfandegá-lo	alfandegar+V.ele.ACC.3.M.SG+SBJF+3+SG
alfandegá-lo-ão	alfandegar+V.ele.ACC.3.M.SG+FUT+3+PL
alfandegá-lo-ás	alfandegar+V.ele.ACC.3.M.SG+FUT+2+SG
alfandegá-lo-ei	alfandegar+V.ele.ACC.3.M.SG+FUT+1+SG
alfandegá-lo-eis	alfandegar+V.ele.ACC.3.M.SG+FUT+2+PL
alfandegá-lo-emos	alfandegar+V.ele.ACC.3.M.SG+FUT+1+PL
alfandegá-lo-ia	alfandegar+V.ele.ACC.3.M.SG+COND+1+SG
alfandegá-lo-ia	alfandegar+V.ele.ACC.3.M.SG+COND+3+SG
alfandegá-lo-iam	alfandegar+V.ele.ACC.3.M.SG+COND+3+PL
alfandegá-lo-íamos	alfandegar+V.ele.ACC.3.M.SG+COND+1+PL
alfandegá-lo-ias	alfandegar+V.ele.ACC.3.M.SG+COND+2+SG
alfandegá-lo-íeis	alfandegar+V.ele.ACC.3.M.SG+COND+2+PL
alfandegá-los-á	alfandegar+V.ele.ACC.3.M.PL+FUT+3+SG
alfandegá-los	alfandegar+V.ele.ACC.3.M.PL+INF+1+SG
alfandegá-los	alfandegar+V.ele.ACC.3.M.PL+INF+3+SG
alfandega-los	alfandegar+V.ele.ACC.3.M.PL+PRS+2+SG
alfandegá-los	alfandegar+V.ele.ACC.3.M.PL+SBJF+1+SG
alfandegá-los	alfandegar+V.ele.ACC.3.M.PL+SBJF+3+SG
alfandegá-los-ão	alfandegar+V.ele.ACC.3.M.PL+FUT+3+PL
alfandegá-los-ás	alfandegar+V.ele.ACC.3.M.PL+FUT+2+SG
alfandegá-los-ei	alfandegar+V.ele.ACC.3.M.PL+FUT+1+SG
alfandegá-los-eis	alfandegar+V.ele.ACC.3.M.PL+FUT+2+PL
alfandegá-los-emos	alfandegar+V.ele.ACC.3.M.PL+FUT+1+PL
alfandegá-los-ia	alfandegar+V.ele.ACC.3.M.PL+COND+1+SG
alfandegá-los-ia	alfandegar+V.ele.ACC.3.M.PL+COND+3+SG
alfandegá-los-iam	alfandegar+V.ele.ACC.3.M.PL+COND+3+PL
alfandegá-los-íamos	alfandegar+V.ele.ACC.3.M.PL+COND+1+PL
alfandegá-los-ias	alfandegar+V.ele.ACC.3.M.PL+COND+2+SG
alfandegá-los-íeis	alfandegar+V.ele.ACC.3.M.PL+COND+2+PL
alfandega-me	alfandegar+V.eu.AD.1.SG+PRS+3+SG
alfandegam-lhe	alfandegar+V.ele.DAT.3.SG+PRS+3+PL
alfandegam-lhes	alfandegar+V.ele.DAT.3.PL+PRS+3+PL
alfandegam-me	alfandegar+V.eu.AD.1.SG+PRS+3+PL
alfandegam-na	alfandegar+V.ele.ACC.3.F.SG+PRS+3+PL
alfandegam-nas	alfandegar+V.ele.ACC.3.F.PL+PRS+3+PL
alfandegam-no	alfandegar+V.ele.ACC.3.M.SG+PRS+3+PL
alfandegam-nos	alfandegar+V.ele.ACC.3.M.PL+PRS+3+PL
alfandegam-nos	alfandegar+V.nós.AD.1.PL+PRS+3+PL
alfandegamo-la	alfandegar+V.ele.ACC.3.F.SG+PRF+1+PL
alfandegamo-la	alfandegar+V.ele.ACC.3.F.SG+PRS+1+PL
alfandegamo-las	alfandegar+V.ele.ACC.3.F.PL+PRF+1+PL
alfandegamo-las	alfandegar+V.ele.ACC.3.F.PL+PRS+1+PL
alfandegamo-lo	alfandegar+V.ele.ACC.3.M.SG+PRF+1+PL
alfandegamo-lo	alfandegar+V.ele.ACC.3.M.SG+PRS+1+PL
alfandegamo-los	alfandegar+V.ele.ACC.3.M.PL+PRF+1+PL
alfandegamo-los	alfandegar+V.ele.ACC.3.M.PL+PRS+1+PL
alfandegamo-nos	alfandegar+nós.AD.1.PL+PRF+1+PL
alfandegamo-nos	alfandegar+nós.AD.1.PL+PRS+1+PL
alfandegamos-lhe	alfandegar+V.ele.DAT.3.SG+PRF+1+PL
alfandegamos-lhe	alfandegar+V.ele.DAT.3.SG+PRS+1+PL
alfandegamos-lhes	alfandegar+V.ele.DAT.3.PL+PRF+1+PL
alfandegamos-lhes	alfandegar+V.ele.DAT.3.PL+PRS+1+PL
alfandegamos-me	alfandegar+V.eu.AD.1.SG+PRF+1+PL
alfandegamos-me	alfandegar+V.eu.AD.1.SG+PRS+1+PL
alfandegamos-te	alfandegar+V.tu.AD.2.SG+PRF+1+PL
alfandegamos-te	alfandegar+V.tu.AD.2.SG+PRS+1+PL
alfandegamos-vos	alfandegar+V.vós.AD.2.PL+PRF+1+PL
alfandegamos-vos	alfandegar+V.vós.AD.2.PL+PRS+1+PL
alfandegam-se	alfandegar+V.ele.REFL+PRS+3+PL
alfandegam-te	alfandegar+V.tu.AD.2.SG+PRS+3+PL
alfandegam-vos	alfandegar+V.vós.AD.2.PL+PRS+3+PL
alfandegando-a	alfandegar+V.ele.ACC.3.F.SG+GRD
alfandegando-as	alfandegar+V.ele.ACC.3.F.PL+GRD
alfandegando-lhe	alfandegar+V.ele.DAT.3.SG+GRD
alfandegando-lhes	alfandegar+V.ele.DAT.3.PL+GRD
alfandegando-me	alfandegar+V.eu.AD.1.SG+GRD
alfandegando-nos	alfandegar+nós.AD.1.PL+GRD
alfandegando-o	alfandegar+V.ele.ACC.3.M.SG+GRD
alfandegando-os	alfandegar+V.ele.ACC.3.M.PL+GRD
alfandegando-se	alfandegar+V.ele.REFL+GRD
alfandegando-te	alfandegar+V.tu.AD.2.SG+GRD
alfandegando-vos	alfandegar+V.vós.AD.2.PL+GRD
alfandega-nos	alfandegar+nós.AD.1.PL+PRS+2+SG
alfandega-nos	alfandegar+nós.AD.1.PL+PRS+3+SG
alfandega-o	alfandegar+V.ele.ACC.3.M.SG+PRS+3+SG
alfandega-os	alfandegar+V.ele.ACC.3.M.PL+PRS+3+SG
alfandegara-a	alfandegar+V.ele.ACC.3.F.SG+PQP+1+SG
alfandegara-a	alfandegar+V.ele.ACC.3.F.SG+PQP+3+SG
alfandegara-as	alfandegar+V.ele.ACC.3.F.PL+PQP+1+SG
alfandegara-as	alfandegar+V.ele.ACC.3.F.PL+PQP+3+SG
alfandegara-la	alfandegar+V.ele.ACC.3.F.SG+PQP+2+SG
alfandegara-las	alfandegar+V.ele.ACC.3.F.PL+PQP+2+SG
alfandegara-lhe	alfandegar+V.ele.DAT.3.SG+PQP+1+SG
alfandegara-lhe	alfandegar+V.ele.DAT.3.SG+PQP+3+SG
alfandegara-lhes	alfandegar+V.ele.DAT.3.PL+PQP+1+SG
alfandegara-lhes	alfandegar+V.ele.DAT.3.PL+PQP+3+SG
alfandegara-lo	alfandegar+V.ele.ACC.3.M.SG+PQP+2+SG
alfandegara-los	alfandegar+V.ele.ACC.3.M.PL+PQP+2+SG
alfandegara-me	alfandegar+V.eu.AD.1.SG+PQP+1+SG
alfandegara-me	alfandegar+V.eu.AD.1.SG+PQP+3+SG
alfandegaram-lhe	alfandegar+V.ele.DAT.3.SG+PQP+3+PL
alfandegaram-lhe	alfandegar+V.ele.DAT.3.SG+PRF+3+PL
alfandegaram-lhes	alfandegar+V.ele.DAT.3.PL+PQP+3+PL
alfandegaram-lhes	alfandegar+V.ele.DAT.3.PL+PRF+3+PL
alfandegaram-me	alfandegar+V.eu.AD.1.SG+PQP+3+PL
alfandegaram-me	alfandegar+V.eu.AD.1.SG+PRF+3+PL
alfandegaram-na	alfandegar+V.ele.ACC.3.F.SG+PQP+3+PL
alfandegaram-na	alfandegar+V.ele.ACC.3.F.SG+PRF+3+PL
alfandegaram-nas	alfandegar+V.ele.ACC.3.F.PL+PQP+3+PL
alfandegaram-nas	alfandegar+V.ele.ACC.3.F.PL+PRF+3+PL
alfandegaram-no	alfandegar+V.ele.ACC.3.M.SG+PQP+3+PL
alfandegaram-no	alfandegar+V.ele.ACC.3.M.SG+PRF+3+PL
alfandegaram-nos	alfandegar+V.ele.ACC.3.M.PL+PQP+3+PL
alfandegaram-nos	alfandegar+V.ele.ACC.3.M.PL+PRF+3+PL
alfandegaram-nos	alfandegar+V.nós.AD.1.PL+PQP+3+PL
alfandegaram-nos	alfandegar+V.nós.AD.1.PL+PRF+3+PL
alfandegáramo-la	alfandegar+V.ele.ACC.3.F.SG+PQP+1+PL
alfandegáramo-las	alfandegar+V.ele.ACC.3.F.PL+PQP+1+PL
alfandegáramo-lo	alfandegar+V.ele.ACC.3.M.SG+PQP+1+PL
alfandegáramo-los	alfandegar+V.ele.ACC.3.M.PL+PQP+1+PL
alfandegáramo-nos	alfandegar+nós.AD.1.PL+PQP+1+PL
alfandegáramos-lhe	alfandegar+V.ele.DAT.3.SG+PQP+1+PL
alfandegáramos-lhes	alfandegar+V.ele.DAT.3.PL+PQP+1+PL
alfandegáramos-me	alfandegar+V.eu.AD.1.SG+PQP+1+PL
alfandegáramos-te	alfandegar+V.tu.AD.2.SG+PQP+1+PL
alfandegáramos-vos	alfandegar+V.vós.AD.2.PL+PQP+1+PL
alfandegaram-se	alfandegar+V.ele.REFL+PQP+3+PL
alfandegaram-se	alfandegar+V.ele.REFL+PRF+3+PL
alfandegaram-te	alfandegar+V.tu.AD.2.SG+PQP+3+PL
alfandegaram-te	alfandegar+V.tu.AD.2.SG+PRF+3+PL
alfandegaram-vos	alfandegar+V.vós.AD.2.PL+PQP+3+PL
alfandegaram-vos	alfandegar+V.vós.AD.2.PL+PRF+3+PL
alfandegara-nos	alfandegar+nós.AD.1.PL+PQP+1+SG
alfandegara-nos	alfandegar+nós.AD.1.PL+PQP+2+SG
alfandegara-nos	alfandegar+nós.AD.1.PL+PQP+3+SG
alfandegara-o	alfandegar+V.ele.ACC.3.M.SG+PQP+1+SG
alfandegara-o	alfandegar+V.ele.ACC.3.M.SG+PQP+3+SG
alfandegara-os	alfandegar+V.ele.ACC.3.M.PL+PQP+1+SG
alfandegara-os	alfandegar+V.ele.ACC.3.M.PL+PQP+3+SG
alfandegara-se	alfandegar+V.ele.REFL+PQP+1+SG
alfandegara-se	alfandegar+V.ele.REFL+PQP+3+SG
alfandegaras-lhe	alfandegar+V.ele.DAT.3.SG+PQP+2+SG
alfandegaras-lhes	alfandegar+V.ele.DAT.3.PL+PQP+2+SG
alfandegaras-me	alfandegar+V.eu.AD.1.SG+PQP+2+SG
alfandegaras-te	alfandegar+V.tu.AD.2.SG+PQP+2+SG
alfandegaras-vos	alfandegar+V.vós.AD.2.PL+PQP+2+SG
alfandegara-te	alfandegar+V.tu.AD.2.SG+PQP+1+SG
alfandegara-te	alfandegar+V.tu.AD.2.SG+PQP+3+SG
alfandegara-vos	alfandegar+V.vós.AD.2.PL+PQP+1+SG
alfandegara-vos	alfandegar+V.vós.AD.2.PL+PQP+3+SG
alfandegarde-la	alfandegar+V.ele.ACC.3.F.SG+INF+2+PL
alfandegarde-la	alfandegar+V.ele.ACC.3.F.SG+SBJF+2+PL
alfandegarde-las	alfandegar+V.ele.ACC.3.F.PL+INF+2+PL
alfandegarde-las	alfandegar+V.ele.ACC.3.F.PL+SBJF+2+PL
alfandegarde-lo	alfandegar+V.ele.ACC.3.M.SG+INF+2+PL
alfandegarde-lo	alfandegar+V.ele.ACC.3.M.SG+SBJF+2+PL
alfandegarde-los	alfandegar+V.ele.ACC.3.M.PL+INF+2+PL
alfandegarde-los	alfandegar+V.ele.ACC.3.M.PL+SBJF+2+PL
alfandegarde-nos	alfandegar+nós.AD.1.PL+INF+2+PL
alfandegarde-nos	alfandegar+nós.AD.1.PL+SBJF+2+PL
alfandegardes-lhe	alfandegar+V.ele.DAT.3.SG+INF+2+PL
alfandegardes-lhe	alfandegar+V.ele.DAT.3.SG+SBJF+2+PL
alfandegardes-lhes	alfandegar+V.ele.DAT.3.PL+INF+2+PL
alfandegardes-lhes	alfandegar+V.ele.DAT.3.PL+SBJF+2+PL
alfandegardes-me	alfandegar+V.eu.AD.1.SG+INF+2+PL
alfandegardes-me	alfandegar+V.eu.AD.1.SG+SBJF+2+PL
alfandegardes-te	alfandegar+V.tu.AD.2.SG+INF+2+PL
alfandegardes-te	alfandegar+V.tu.AD.2.SG+SBJF+2+PL
alfandegardes-vos	alfandegar+V.vós.AD.2.PL+INF+2+PL
alfandegardes-vos	alfandegar+V.vós.AD.2.PL+SBJF+2+PL
alfandegárei-la	alfandegar+V.ele.ACC.3.F.SG+PQP+2+PL
alfandegárei-las	alfandegar+V.ele.ACC.3.F.PL+PQP+2+PL
alfandegárei-lo	alfandegar+V.ele.ACC.3.M.SG+PQP+2+PL
alfandegárei-los	alfandegar+V.ele.ACC.3.M.PL+PQP+2+PL
alfandegárei-nos	alfandegar+nós.AD.1.PL+PQP+2+PL
alfandegáreis-lhe	alfandegar+V.ele.DAT.3.SG+PQP+2+PL
alfandegáreis-lhes	alfandegar+V.ele.DAT.3.PL+PQP+2+PL
alfandegáreis-me	alfandegar+V.eu.AD.1.SG+PQP+2+PL
alfandegáreis-te	alfandegar+V.tu.AD.2.SG+PQP+2+PL
alfandegáreis-vos	alfandegar+V.vós.AD.2.PL+PQP+2+PL
alfandegare-la	alfandegar+V.ele.ACC.3.F.SG+INF+2+SG
alfandegare-la	alfandegar+V.ele.ACC.3.F.SG+SBJF+2+SG
alfandegare-las	alfandegar+V.ele.ACC.3.F.PL+INF+2+SG
alfandegare-las	alfandegar+V.ele.ACC.3.F.PL+SBJF+2+SG
alfandegare-lo	alfandegar+V.ele.ACC.3.M.SG+INF+2+SG
alfandegare-lo	alfandegar+V.ele.ACC.3.M.SG+SBJF+2+SG
alfandegare-los	alfandegar+V.ele.ACC.3.M.PL+INF+2+SG
alfandegare-los	alfandegar+V.ele.ACC.3.M.PL+SBJF+2+SG
alfandegarem-lhe	alfandegar+V.ele.DAT.3.SG+INF+3+PL
alfandegarem-lhe	alfandegar+V.ele.DAT.3.SG+SBJF+3+PL
alfandegarem-lhes	alfandegar+V.ele.DAT.3.PL+INF+3+PL
alfandegarem-lhes	alfandegar+V.ele.DAT.3.PL+SBJF+3+PL
alfandegarem-me	alfandegar+V.eu.AD.1.SG+INF+3+PL
alfandegarem-me	alfandegar+V.eu.AD.1.SG+SBJF+3+PL
alfandegarem-na	alfandegar+V.ele.ACC.3.F.SG+INF+3+PL
alfandegarem-na	alfandegar+V.ele.ACC.3.F.SG+SBJF+3+PL
alfandegarem-nas	alfandegar+V.ele.ACC.3.F.PL+INF+3+PL
alfandegarem-nas	alfandegar+V.ele.ACC.3.F.PL+SBJF+3+PL
alfandegarem-no	alfandegar+V.ele.ACC.3.M.SG+INF+3+PL
alfandegarem-no	alfandegar+V.ele.ACC.3.M.SG+SBJF+3+PL
alfandegarem-nos	alfandegar+V.ele.ACC.3.M.PL+INF+3+PL
alfandegarem-nos	alfandegar+V.ele.ACC.3.M.PL+SBJF+3+PL
alfandegarem-nos	alfandegar+V.nós.AD.1.PL+INF+3+PL
alfandegarem-nos	alfandegar+V.nós.AD.1.PL+SBJF+3+PL
alfandegarem-se	alfandegar+V.ele.REFL+INF+3+PL
alfandegarem-se	alfandegar+V.ele.REFL+SBJF+3+PL
alfandegarem-te	alfandegar+V.tu.AD.2.SG+INF+3+PL
alfandegarem-te	alfandegar+V.tu.AD.2.SG+SBJF+3+PL
alfandegarem-vos	alfandegar+V.vós.AD.2.PL+INF+3+PL
alfandegarem-vos	alfandegar+V.vós.AD.2.PL+SBJF+3+PL
alfandegare-nos	alfandegar+nós.AD.1.PL+INF+2+SG
alfandegare-nos	alfandegar+nós.AD.1.PL+SBJF+2+SG
alfandegares-lhe	alfandegar+V.ele.DAT.3.SG+INF+2+SG
alfandegares-lhe	alfandegar+V.ele.DAT.3.SG+SBJF+2+SG
alfandegares-lhes	alfandegar+V.ele.DAT.3.PL+INF+2+SG
alfandegares-lhes	alfandegar+V.ele.DAT.3.PL+SBJF+2+SG
alfandegares-me	alfandegar+V.eu.AD.1.SG+INF+2+SG
alfandegares-me	alfandegar+V.eu.AD.1.SG+SBJF+2+SG
alfandegares-te	alfandegar+V.tu.AD.2.SG+INF+2+SG
alfandegares-te	alfandegar+V.tu.AD.2.SG+SBJF+2+SG
alfandegares-vos	alfandegar+V.vós.AD.2.PL+INF+2+SG
alfandegares-vos	alfandegar+V.vós.AD.2.PL+SBJF+2+SG
alfandegar-lhe-á	alfandegar+V.ele.DAT.3.SG+FUT+3+SG
alfandegar-lhe	alfandegar+V.ele.DAT.3.SG+INF
alfandegar-lhe	alfandegar+V.ele.DAT.3.SG+INF+1+SG
alfandegar-lhe	alfandegar+V.ele.DAT.3.SG+INF+3+SG
alfandegar-lhe	alfandegar+V.ele.DAT.3.SG+SBJF+1+SG
alfandegar-lhe	alfandegar+V.ele.DAT.3.SG+SBJF+3+SG
alfandegar-lhe-ão	alfandegar+V.ele.DAT.3.SG+FUT+3+PL
alfandegar-lhe-ás	alfandegar+V.ele.DAT.3.SG+FUT+2+SG
alfandegar-lhe-ei	alfandegar+V.ele.DAT.3.SG+FUT+1+SG
alfandegar-lhe-eis	alfandegar+V.ele.DAT.3.SG+FUT+2+PL
alfandegar-lhe-emos	alfandegar+V.ele.DAT.3.SG+FUT+1+PL
alfandegar-lhe-ia	alfandegar+V.ele.DAT.3.SG+COND+1+SG
alfandegar-lhe-ia	alfandegar+V.ele.DAT.3.SG+COND+3+SG
alfandegar-lhe-iam	alfandegar+V.ele.DAT.3.SG+COND+3+PL
alfandegar-lhe-íamos	alfandegar+V.ele.DAT.3.SG+COND+1+PL
alfandegar-lhe-ias	alfandegar+V.ele.DAT.3.SG+COND+2+SG
alfandegar-lhe-íeis	alfandegar+V.ele.DAT.3.SG+COND+2+PL
alfandegar-lhes-á	alfandegar+V.ele.DAT.3.PL+FUT+3+SG
alfandegar-lhes	alfandegar+V.ele.DAT.3.PL+INF
alfandegar-lhes	alfandegar+V.ele.DAT.3.PL+INF+1+SG
alfandegar-lhes	alfandegar+V.ele.DAT.3.PL+INF+3+SG
alfandegar-lhes	alfandegar+V.ele.DAT.3.PL+SBJF+1+SG
alfandegar-lhes	alfandegar+V.ele.DAT.3.PL+SBJF+3+SG
alfandegar-lhes-ão	alfandegar+V.ele.DAT.3.PL+FUT+3+PL
alfandegar-lhes-ás	alfandegar+V.ele.DAT.3.PL+FUT+2+SG
alfandegar-lhes-ei	alfandegar+V.ele.DAT.3.PL+FUT+1+SG
alfandegar-lhes-eis	alfandegar+V.ele.DAT.3.PL+FUT+2+PL
alfandegar-lhes-emos	alfandegar+V.ele.DAT.3.PL+FUT+1+PL
alfandegar-lhes-ia	alfandegar+V.ele.DAT.3.PL+COND+1+SG
alfandegar-lhes-ia	alfandegar+V.ele.DAT.3.PL+COND+3+SG
alfandegar-lhes-iam	alfandegar+V.ele.DAT.3.PL+COND+3+PL
alfandegar-lhes-íamos	alfandegar+V.ele.DAT.3.PL+COND+1+PL
alfandegar-lhes-ias	alfandegar+V.ele.DAT.3.PL+COND+2+SG
alfandegar-lhes-íeis	alfandegar+V.ele.DAT.3.PL+COND+2+PL
alfandegar-me-á	alfandegar+V.eu.AD.1.SG+FUT+3+SG
alfandegar-me	alfandegar+V.eu.AD.1.SG+INF
alfandegar-me	alfandegar+V.eu.AD.1.SG+INF+1+SG
alfandegar-me	alfandegar+V.eu.AD.1.SG+INF+3+SG
alfandegar-me	alfandegar+V.eu.AD.1.SG+SBJF+1+SG
alfandegar-me	alfandegar+V.eu.AD.1.SG+SBJF+3+SG
alfandegar-me-ão	alfandegar+V.eu.AD.1.SG+FUT+3+PL
alfandegar-me-ás	alfandegar+V.eu.AD.1.SG+FUT+2+SG
alfandegar-me-ei	alfandegar+V.eu.AD.1.SG+FUT+1+SG
alfandegar-me-eis	alfandegar+V.eu.AD.1.SG+FUT+2+PL
alfandegar-me-emos	alfandegar+V.eu.AD.1.SG+FUT+1+PL
alfandegar-me-ia	alfandegar+V.eu.AD.1.SG+COND+1+SG
alfandegar-me-ia	alfandegar+V.eu.AD.1.SG+COND+3+SG
alfandegar-me-iam	alfandegar+V.eu.AD.1.SG+COND+3+PL
alfandegar-me-íamos	alfandegar+V.eu.AD.1.SG+COND+1+PL
alfandegar-me-ias	alfandegar+V.eu.AD.1.SG+COND+2+SG
alfandegar-me-íeis	alfandegar+V.eu.AD.1.SG+COND+2+PL
alfandegarmo-la	alfandegar+V.ele.ACC.3.F.SG+INF+1+PL
alfandegarmo-la	alfandegar+V.ele.ACC.3.F.SG+SBJF+1+PL
alfandegarmo-las	alfandegar+V.ele.ACC.3.F.PL+INF+1+PL
alfandegarmo-las	alfandegar+V.ele.ACC.3.F.PL+SBJF+1+PL
alfandegarmo-lo	alfandegar+V.ele.ACC.3.M.SG+INF+1+PL
alfandegarmo-lo	alfandegar+V.ele.ACC.3.M.SG+SBJF+1+PL
alfandegarmo-los	alfandegar+V.ele.ACC.3.M.PL+INF+1+PL
alfandegarmo-los	alfandegar+V.ele.ACC.3.M.PL+SBJF+1+PL
alfandegarmo-nos	alfandegar+nós.AD.1.PL+INF+1+PL
alfandegarmo-nos	alfandegar+nós.AD.1.PL+SBJF+1+PL
alfandegarmos-lhe	alfandegar+V.ele.DAT.3.SG+INF+1+PL
alfandegarmos-lhe	alfandegar+V.ele.DAT.3.SG+SBJF+1+PL
alfandegarmos-lhes	alfandegar+V.ele.DAT.3.PL+INF+1+PL
alfandegarmos-lhes	alfandegar+V.ele.DAT.3.PL+SBJF+1+PL
alfandegarmos-me	alfandegar+V.eu.AD.1.SG+INF+1+PL
alfandegarmos-me	alfandegar+V.eu.AD.1.SG+SBJF+1+PL
alfandegarmos-te	alfandegar+V.tu.AD.2.SG+INF+1+PL
alfandegarmos-te	alfandegar+V.tu.AD.2.SG+SBJF+1+PL
alfandegarmos-vos	alfandegar+V.vós.AD.2.PL+INF+1+PL
alfandegarmos-vos	alfandegar+V.vós.AD.2.PL+SBJF+1+PL
alfandegar-nos-á	alfandegar+nós.AD.1.PL+FUT+3+SG
alfandegar-nos	alfandegar+nós.AD.1.PL+INF
alfandegar-nos	alfandegar+nós.AD.1.PL+INF+1+SG
alfandegar-nos	alfandegar+nós.AD.1.PL+INF+3+SG
alfandegar-nos	alfandegar+nós.AD.1.PL+SBJF+1+SG
alfandegar-nos	alfandegar+nós.AD.1.PL+SBJF+3+SG
alfandegar-nos-ão	alfandegar+nós.AD.1.PL+FUT+3+PL
alfandegar-nos-ás	alfandegar+nós.AD.1.PL+FUT+2+SG
alfandegar-nos-ei	alfandegar+nós.AD.1.PL+FUT+1+SG
alfandegar-nos-eis	alfandegar+nós.AD.1.PL+FUT+2+PL
alfandegar-nos-emos	alfandegar+nós.AD.1.PL+FUT+1+PL
alfandegar-nos-ia	alfandegar+nós.AD.1.PL+COND+1+SG
alfandegar-nos-ia	alfandegar+nós.AD.1.PL+COND+3+SG
alfandegar-nos-iam	alfandegar+nós.AD.1.PL+COND+3+PL
alfandegar-nos-íamos	alfandegar+nós.AD.1.PL+COND+1+PL
alfandegar-nos-ias	alfandegar+nós.AD.1.PL+COND+2+SG
alfandegar-nos-íeis	alfandegar+nós.AD.1.PL+COND+2+PL
alfandegar-se-á	alfandegar+V.ele.REFL+FUT+3+SG
alfandegar-se	alfandegar+V.ele.REFL+INF
alfandegar-se	alfandegar+V.ele.REFL+INF+3+SG
alfandegar-se	alfandegar+V.ele.REFL+SBJF+3+SG
alfandegar-se-ão	alfandegar+V.ele.REFL+FUT+3+PL
alfandegar-se-ia	alfandegar+V.ele.REFL+COND+3+SG
alfandegar-se-iam	alfandegar+V.ele.REFL+COND+3+PL
alfandegar-te-á	alfandegar+V.tu.AD.2.SG+FUT+3+SG
alfandegar-te	alfandegar+V.tu.AD.2.SG+INF
alfandegar-te	alfandegar+V.tu.AD.2.SG+INF+1+SG
alfandegar-te	alfandegar+V.tu.AD.2.SG+INF+3+SG
alfandegar-te	alfandegar+V.tu.AD.2.SG+SBJF+1+SG
alfandegar-te	alfandegar+V.tu.AD.2.SG+SBJF+3+SG
alfandegar-te-ão	alfandegar+V.tu.AD.2.SG+FUT+3+PL
alfandegar-te-ás	alfandegar+V.tu.AD.2.SG+FUT+2+SG
alfandegar-te-ei	alfandegar+V.tu.AD.2.SG+FUT+1+SG
alfandegar-te-eis	alfandegar+V.tu.AD.2.SG+FUT+2+PL
alfandegar-te-emos	alfandegar+V.tu.AD.2.SG+FUT+1+PL
alfandegar-te-ia	alfandegar+V.tu.AD.2.SG+COND+1+SG
alfandegar-te-ia	alfandegar+V.tu.AD.2.SG+COND+3+SG
alfandegar-te-iam	alfandegar+V.tu.AD.2.SG+COND+3+PL
alfandegar-te-íamos	alfandegar+V.tu.AD.2.SG+COND+1+PL
alfandegar-te-ias	alfandegar+V.tu.AD.2.SG+COND+2+SG
alfandegar-te-íeis	alfandegar+V.tu.AD.2.SG+COND+2+PL
alfandegar-vos-á	alfandegar+V.vós.AD.2.PL+FUT+3+SG
alfandegar-vos	alfandegar+V.vós.AD.2.PL+INF
alfandegar-vos	alfandegar+V.vós.AD.2.PL+INF+1+SG
alfandegar-vos	alfandegar+V.vós.AD.2.PL+INF+3+SG
alfandegar-vos	alfandegar+V.vós.AD.2.PL+SBJF+1+SG
alfandegar-vos	alfandegar+V.vós.AD.2.PL+SBJF+3+SG
alfandegar-vos-ão	alfandegar+V.vós.AD.2.PL+FUT+3+PL
alfandegar-vos-ás	alfandegar+V.vós.AD.2.PL+FUT+2+SG
alfandegar-vos-ei	alfandegar+V.vós.AD.2.PL+FUT+1+SG
alfandegar-vos-eis	alfandegar+V.vós.AD.2.PL+FUT+2+PL
alfandegar-vos-emos	alfandegar+V.vós.AD.2.PL+FUT+1+PL
alfandegar-vos-ia	alfandegar+V.vós.AD.2.PL+COND+1+SG
alfandegar-vos-ia	alfandegar+V.vós.AD.2.PL+COND+3+SG
alfandegar-vos-iam	alfandegar+V.vós.AD.2.PL+COND+3+PL
alfandegar-vos-íamos	alfandegar+V.vós.AD.2.PL+COND+1+PL
alfandegar-vos-ias	alfandegar+V.vós.AD.2.PL+COND+2+SG
alfandegar-vos-íeis	alfandegar+V.vós.AD.2.PL+COND+2+PL
alfandega-se	alfandegar+V.ele.REFL+PRS+3+SG
alfandegas-lhe	alfandegar+V.ele.DAT.3.SG+PRS+2+SG
alfandegas-lhes	alfandegar+V.ele.DAT.3.PL+PRS+2+SG
alfandegas-me	alfandegar+V.eu.AD.1.SG+PRS+2+SG
alfandegaste-a	alfandegar+V.ele.ACC.3.F.SG+PRF+2+SG
alfandegas-te	alfandegar+V.tu.AD.2.SG+PRS+2+SG
alfandegaste-as	alfandegar+V.ele.ACC.3.F.PL+PRF+2+SG
alfandegaste-la	alfandegar+V.ele.ACC.3.F.SG+PRF+2+PL
alfandegaste-las	alfandegar+V.ele.ACC.3.F.PL+PRF+2+PL
alfandegaste-lhe	alfandegar+V.ele.DAT.3.SG+PRF+2+SG
alfandegaste-lhes	alfandegar+V.ele.DAT.3.PL+PRF+2+SG
alfandegaste-lo	alfandegar+V.ele.ACC.3.M.SG+PRF+2+PL
alfandegaste-los	alfandegar+V.ele.ACC.3.M.PL+PRF+2+PL
alfandegaste-me	alfandegar+V.eu.AD.1.SG+PRF+2+SG
alfandegaste-nos	alfandegar+nós.AD.1.PL+PRF+2+PL
alfandegaste-nos	alfandegar+nós.AD.1.PL+PRF+2+SG
alfandegaste-o	alfandegar+V.ele.ACC.3.M.SG+PRF+2+SG
alfandegaste-os	alfandegar+V.ele.ACC.3.M.PL+PRF+2+SG
alfandegastes-lhe	alfandegar+V.ele.DAT.3.SG+PRF+2+PL
alfandegastes-lhes	alfandegar+V.ele.DAT.3.PL+PRF+2+PL
alfandegastes-me	alfandegar+V.eu.AD.1.SG+PRF+2+PL
alfandegastes-te	alfandegar+V.tu.AD.2.SG+PRF+2+PL
alfandegastes-vos	alfandegar+V.vós.AD.2.PL+PRF+2+PL
alfandegaste-te	alfandegar+V.tu.AD.2.SG+PRF+2+SG
alfandegaste-vos	alfandegar+V.vós.AD.2.PL+PRF+2+SG
alfandegas-vos	alfandegar+V.vós.AD.2.PL+PRS+2+SG
alfandega-te	alfandegar+V.tu.AD.2.SG+PRS+3+SG
alfandegava-a	alfandegar+V.ele.ACC.3.F.SG+IMPF+1+SG
alfandegava-a	alfandegar+V.ele.ACC.3.F.SG+IMPF+3+SG
alfandegava-as	alfandegar+V.ele.ACC.3.F.PL+IMPF+1+SG
alfandegava-as	alfandegar+V.ele.ACC.3.F.PL+IMPF+3+SG
alfandegava-la	alfandegar+V.ele.ACC.3.F.SG+IMPF+2+SG
alfandegava-las	alfandegar+V.ele.ACC.3.F.PL+IMPF+2+SG
alfandegava-lhe	alfandegar+V.ele.DAT.3.SG+IMPF+1+SG
alfandegava-lhe	alfandegar+V.ele.DAT.3.SG+IMPF+3+SG
alfandegava-lhes	alfandegar+V.ele.DAT.3.PL+IMPF+1+SG
alfandegava-lhes	alfandegar+V.ele.DAT.3.PL+IMPF+3+SG
alfandegava-lo	alfandegar+V.ele.ACC.3.M.SG+IMPF+2+SG
alfandegava-los	alfandegar+V.ele.ACC.3.M.PL+IMPF+2+SG
alfandegava-me	alfandegar+V.eu.AD.1.SG+IMPF+1+SG
alfandegava-me	alfandegar+V.eu.AD.1.SG+IMPF+3+SG
alfandegavam-lhe	alfandegar+V.ele.DAT.3.SG+IMPF+3+PL
alfandegavam-lhes	alfandegar+V.ele.DAT.3.PL+IMPF+3+PL
alfandegavam-me	alfandegar+V.eu.AD.1.SG+IMPF+3+PL
alfandegavam-na	alfandegar+V.ele.ACC.3.F.SG+IMPF+3+PL
alfandegavam-nas	alfandegar+V.ele.ACC.3.F.PL+IMPF+3+PL
alfandegavam-no	alfandegar+V.ele.ACC.3.M.SG+IMPF+3+PL
alfandegavam-nos	alfandegar+V.ele.ACC.3.M.PL+IMPF+3+PL
alfandegavam-nos	alfandegar+V.nós.AD.1.PL+IMPF+3+PL
alfandegávamo-la	alfandegar+V.ele.ACC.3.F.SG+IMPF+1+PL
alfandegávamo-las	alfandegar+V.ele.ACC.3.F.PL+IMPF+1+PL
alfandegávamo-lo	alfandegar+V.ele.ACC.3.M.SG+IMPF+1+PL
alfandegávamo-los	alfandegar+V.ele.ACC.3.M.PL+IMPF+1+PL
alfandegávamo-nos	alfandegar+nós.AD.1.PL+IMPF+1+PL
alfandegávamos-lhe	alfandegar+V.ele.DAT.3.SG+IMPF+1+PL
alfandegávamos-lhes	alfandegar+V.ele.DAT.3.PL+IMPF+1+PL
alfandegávamos-me	alfandegar+V.eu.AD.1.SG+IMPF+1+PL
alfandegávamos-te	alfandegar+V.tu.AD.2.SG+IMPF+1+PL
alfandegávamos-vos	alfandegar+V.vós.AD.2.PL+IMPF+1+PL
alfandegavam-se	alfandegar+V.ele.REFL+IMPF+3+PL
alfandegavam-te	alfandegar+V.tu.AD.2.SG+IMPF+3+PL
alfandegavam-vos	alfandegar+V.vós.AD.2.PL+IMPF+3+PL
alfandegava-nos	alfandegar+nós.AD.1.PL+IMPF+1+SG
alfandegava-nos	alfandegar+nós.AD.1.PL+IMPF+2+SG
alfandegava-nos	alfandegar+nós.AD.1.PL+IMPF+3+SG
alfandegava-o	alfandegar+V.ele.ACC.3.M.SG+IMPF+1+SG
alfandegava-o	alfandegar+V.ele.ACC.3.M.SG+IMPF+3+SG
alfandegava-os	alfandegar+V.ele.ACC.3.M.PL+IMPF+1+SG
alfandegava-os	alfandegar+V.ele.ACC.3.M.PL+IMPF+3+SG
alfandegava-se	alfandegar+V.ele.REFL+IMPF+1+SG
alfandegava-se	alfandegar+V.ele.REFL+IMPF+3+SG
alfandegavas-lhe	alfandegar+V.ele.DAT.3.SG+IMPF+2+SG
alfandegavas-lhes	alfandegar+V.ele.DAT.3.PL+IMPF+2+SG
alfandegavas-me	alfandegar+V.eu.AD.1.SG+IMPF+2+SG
alfandegavas-te	alfandegar+V.tu.AD.2.SG+IMPF+2+SG
alfandegavas-vos	alfandegar+V.vós.AD.2.PL+IMPF+2+SG
alfandegava-te	alfandegar+V.tu.AD.2.SG+IMPF+1+SG
alfandegava-te	alfandegar+V.tu.AD.2.SG+IMPF+3+SG
alfandegava-vos	alfandegar+V.vós.AD.2.PL+IMPF+1+SG
alfandegava-vos	alfandegar+V.vós.AD.2.PL+IMPF+3+SG
alfandegávei-la	alfandegar+V.ele.ACC.3.F.SG+IMPF+2+PL
alfandegávei-las	alfandegar+V.ele.ACC.3.F.PL+IMPF+2+PL
alfandegávei-lo	alfandegar+V.ele.ACC.3.M.SG+IMPF+2+PL
alfandegávei-los	alfandegar+V.ele.ACC.3.M.PL+IMPF+2+PL
alfandegávei-nos	alfandegar+nós.AD.1.PL+IMPF+2+PL
alfandegáveis-lhe	alfandegar+V.ele.DAT.3.SG+IMPF+2+PL
alfandegáveis-lhes	alfandegar+V.ele.DAT.3.PL+IMPF+2+PL
alfandegáveis-me	alfandegar+V.eu.AD.1.SG+IMPF+2+PL
alfandegáveis-te	alfandegar+V.tu.AD.2.SG+IMPF+2+PL
alfandegáveis-vos	alfandegar+V.vós.AD.2.PL+IMPF+2+PL
alfandega-vos	alfandegar+V.vós.AD.2.PL+PRS+3+SG
alfandego-a	alfandegar+V.ele.ACC.3.F.SG+PRS+1+SG
alfandego-as	alfandegar+V.ele.ACC.3.F.PL+PRS+1+SG
alfandego-lhe	alfandegar+V.ele.DAT.3.SG+PRS+1+SG
alfandego-lhes	alfandegar+V.ele.DAT.3.PL+PRS+1+SG
alfandego-me	alfandegar+V.eu.AD.1.SG+PRS+1+SG
alfandego-nos	alfandegar+nós.AD.1.PL+PRS+1+SG
alfandego-o	alfandegar+V.ele.ACC.3.M.SG+PRS+1+SG
alfandego-os	alfandegar+V.ele.ACC.3.M.PL+PRS+1+SG
alfandego-te	alfandegar+V.tu.AD.2.SG+PRS+1+SG
alfandegou-a	alfandegar+V.ele.ACC.3.F.SG+PRF+3+SG
alfandegou-as	alfandegar+V.ele.ACC.3.F.PL+PRF+3+SG
alfandegou-lhe	alfandegar+V.ele.DAT.3.SG+PRF+3+SG
alfandegou-lhes	alfandegar+V.ele.DAT.3.PL+PRF+3+SG
alfandegou-me	alfandegar+V.eu.AD.1.SG+PRF+3+SG
alfandegou-nos	alfandegar+nós.AD.1.PL+PRF+3+SG
alfandegou-o	alfandegar+V.ele.ACC.3.M.SG+PRF+3+SG
alfandegou-os	alfandegar+V.ele.ACC.3.M.PL+PRF+3+SG
alfandegou-se	alfandegar+V.ele.REFL+PRF+3+SG
alfandegou-te	alfandegar+V.tu.AD.2.SG+PRF+3+SG
alfandegou-vos	alfandegar+V.vós.AD.2.PL+PRF+3+SG
alfandego-vos	alfandegar+V.vós.AD.2.PL+PRS+1+SG
alfandegue-a	alfandegar+V.ele.ACC.3.F.SG+IMP+3+SG
alfandegue-as	alfandegar+V.ele.ACC.3.F.PL+IMP+3+SG
alfandeguei-a	alfandegar+V.ele.ACC.3.F.SG+PRF+1+SG
alfandeguei-as	alfandegar+V.ele.ACC.3.F.PL+PRF+1+SG
alfandeguei-lhe	alfandegar+V.ele.DAT.3.SG+PRF+1+SG
alfandeguei-lhes	alfandegar+V.ele.DAT.3.PL+PRF+1+SG
alfandeguei-me	alfandegar+V.eu.AD.1.SG+PRF+1+SG
alfandeguei-nos	alfandegar+nós.AD.1.PL+PRF+1+SG
alfandeguei-o	alfandegar+V.ele.ACC.3.M.SG+PRF+1+SG
alfandeguei-os	alfandegar+V.ele.ACC.3.M.PL+PRF+1+SG
alfandeguei-te	alfandegar+V.tu.AD.2.SG+PRF+1+SG
alfandeguei-vos	alfandegar+V.vós.AD.2.PL+PRF+1+SG
alfandegue-lhe	alfandegar+V.ele.DAT.3.SG+IMP+3+SG
alfandegue-lhes	alfandegar+V.ele.DAT.3.PL+IMP+3+SG
alfandegue-me	alfandegar+V.eu.AD.1.SG+IMP+3+SG
alfandeguem-lhe	alfandegar+V.ele.DAT.3.SG+IMP+3+PL
alfandeguem-lhes	alfandegar+V.ele.DAT.3.PL+IMP+3+PL
alfandeguem-me	alfandegar+V.eu.AD.1.SG+IMP+3+PL
alfandeguem-na	alfandegar+V.ele.ACC.3.F.SG+IMP+3+PL
alfandeguem-nas	alfandegar+V.ele.ACC.3.F.PL+IMP+3+PL
alfandeguem-no	alfandegar+V.ele.ACC.3.M.SG+IMP+3+PL
alfandeguem-nos	alfandegar+V.ele.ACC.3.M.PL+IMP+3+PL
alfandeguem-nos	alfandegar+V.nós.AD.1.PL+IMP+3+PL
alfandeguemo-la	alfandegar+V.ele.ACC.3.F.SG+IMP+1+PL
alfandeguemo-las	alfandegar+V.ele.ACC.3.F.PL+IMP+1+PL
alfandeguemo-lo	alfandegar+V.ele.ACC.3.M.SG+IMP+1+PL
alfandeguemo-los	alfandegar+V.ele.ACC.3.M.PL+IMP+1+PL
alfandeguemo-nos	alfandegar+nós.AD.1.PL+IMP+1+PL
alfandeguemos-lhe	alfandegar+V.ele.DAT.3.SG+IMP+1+PL
alfandeguemos-lhes	alfandegar+V.ele.DAT.3.PL+IMP+1+PL
alfandeguemos-me	alfandegar+V.eu.AD.1.SG+IMP+1+PL
alfandeguemos-te	alfandegar+V.tu.AD.2.SG+IMP+1+PL
alfandeguemos-vos	alfandegar+V.vós.AD.2.PL+IMP+1+PL
alfandeguem-se	alfandegar+V.ele.REFL+IMP+3+PL
alfandeguem-te	alfandegar+V.tu.AD.2.SG+IMP+3+PL
alfandeguem-vos	alfandegar+V.vós.AD.2.PL+IMP+3+PL
alfandegue-nos	alfandegar+nós.AD.1.PL+IMP+3+SG
alfandegue-o	alfandegar+V.ele.ACC.3.M.SG+IMP+3+SG
alfandegue-os	alfandegar+V.ele.ACC.3.M.PL+IMP+3+SG
alfandegue-se	alfandegar+V.ele.REFL+IMP+3+SG
alfandegue-te	alfandegar+V.tu.AD.2.SG+IMP+3+SG
alfandegue-vos	alfandegar+V.vós.AD.2.PL+IMP+3+SG
alfando-a	alfar+V.ele.ACC.3.F.SG+GRD
alfando-as	alfar+V.ele.ACC.3.F.PL+GRD
alfando-lhe	alfar+V.ele.DAT.3.SG+GRD
alfando-lhes	alfar+V.ele.DAT.3.PL+GRD
alfando-me	alfar+V.eu.AD.1.SG+GRD
alfando-nos	alfar+nós.AD.1.PL+GRD
alfando-o	alfar+V.ele.ACC.3.M.SG+GRD
alfando-os	alfar+V.ele.ACC.3.M.PL+GRD
alfando-se	alfar+V.ele.REFL+GRD
alfando-te	alfar+V.tu.AD.2.SG+GRD
alfando-vos	alfar+V.vós.AD.2.PL+GRD
alfa-nos	alfar+nós.AD.1.PL+PRS+2+SG
alfa-nos	alfar+nós.AD.1.PL+PRS+3+SG
alfa-o	alfar+V.ele.ACC.3.M.SG+PRS+3+SG
alfa-os	alfar+V.ele.ACC.3.M.PL+PRS+3+SG
alfara-a	alfar+V.ele.ACC.3.F.SG+PQP+1+SG
alfara-a	alfar+V.ele.ACC.3.F.SG+PQP+3+SG
alfara-as	alfar+V.ele.ACC.3.F.PL+PQP+1+SG
alfara-as	alfar+V.ele.ACC.3.F.PL+PQP+3+SG
alfara-la	alfar+V.ele.ACC.3.F.SG+PQP+2+SG
alfara-las	alfar+V.ele.ACC.3.F.PL+PQP+2+SG
alfara-lhe	alfar+V.ele.DAT.3.SG+PQP+1+SG
alfara-lhe	alfar+V.ele.DAT.3.SG+PQP+3+SG
alfara-lhes	alfar+V.ele.DAT.3.PL+PQP+1+SG
alfara-lhes	alfar+V.ele.DAT.3.PL+PQP+3+SG
alfara-lo	alfar+V.ele.ACC.3.M.SG+PQP+2+SG
alfara-los	alfar+V.ele.ACC.3.M.PL+PQP+2+SG
alfara-me	alfar+V.eu.AD.1.SG+PQP+1+SG
alfara-me	alfar+V.eu.AD.1.SG+PQP+3+SG
alfaram-lhe	alfar+V.ele.DAT.3.SG+PQP+3+PL
alfaram-lhe	alfar+V.ele.DAT.3.SG+PRF+3+PL
alfaram-lhes	alfar+V.ele.DAT.3.PL+PQP+3+PL
alfaram-lhes	alfar+V.ele.DAT.3.PL+PRF+3+PL
alfaram-me	alfar+V.eu.AD.1.SG+PQP+3+PL
alfaram-me	alfar+V.eu.AD.1.SG+PRF+3+PL
alfaram-na	alfar+V.ele.ACC.3.F.SG+PQP+3+PL
alfaram-na	alfar+V.ele.ACC.3.F.SG+PRF+3+PL
alfaram-nas	alfar+V.ele.ACC.3.F.PL+PQP+3+PL
alfaram-nas	alfar+V.ele.ACC.3.F.PL+PRF+3+PL
alfaram-no	alfar+V.ele.ACC.3.M.SG+PQP+3+PL
alfaram-no	alfar+V.ele.ACC.3.M.SG+PRF+3+PL
alfaram-nos	alfar+V.ele.ACC.3.M.PL+PQP+3+PL
alfaram-nos	alfar+V.ele.ACC.3.M.PL+PRF+3+PL
alfaram-nos	alfar+V.nós.AD.1.PL+PQP+3+PL
