amatilhar-vos-emos	amatilhar+V.vós.AD.2.PL+FUT+1+PL
amatilhar-vos-ia	amatilhar+V.vós.AD.2.PL+COND+1+SG
amatilhar-vos-ia	amatilhar+V.vós.AD.2.PL+COND+3+SG
amatilhar-vos-iam	amatilhar+V.vós.AD.2.PL+COND+3+PL
amatilhar-vos-íamos	amatilhar+V.vós.AD.2.PL+COND+1+PL
amatilhar-vos-ias	amatilhar+V.vós.AD.2.PL+COND+2+SG
amatilhar-vos-íeis	amatilhar+V.vós.AD.2.PL+COND+2+PL
amatilha-se	amatilhar+V.ele.REFL+PRS+3+SG
amatilhas-lhe	amatilhar+V.ele.DAT.3.SG+PRS+2+SG
amatilhas-lhes	amatilhar+V.ele.DAT.3.PL+PRS+2+SG
amatilhas-me	amatilhar+V.eu.AD.1.SG+PRS+2+SG
amatilhaste-a	amatilhar+V.ele.ACC.3.F.SG+PRF+2+SG
amatilhas-te	amatilhar+V.tu.AD.2.SG+PRS+2+SG
amatilhaste-as	amatilhar+V.ele.ACC.3.F.PL+PRF+2+SG
amatilhaste-la	amatilhar+V.ele.ACC.3.F.SG+PRF+2+PL
amatilhaste-las	amatilhar+V.ele.ACC.3.F.PL+PRF+2+PL
amatilhaste-lhe	amatilhar+V.ele.DAT.3.SG+PRF+2+SG
amatilhaste-lhes	amatilhar+V.ele.DAT.3.PL+PRF+2+SG
amatilhaste-lo	amatilhar+V.ele.ACC.3.M.SG+PRF+2+PL
amatilhaste-los	amatilhar+V.ele.ACC.3.M.PL+PRF+2+PL
amatilhaste-me	amatilhar+V.eu.AD.1.SG+PRF+2+SG
amatilhaste-nos	amatilhar+nós.AD.1.PL+PRF+2+PL
amatilhaste-nos	amatilhar+nós.AD.1.PL+PRF+2+SG
amatilhaste-o	amatilhar+V.ele.ACC.3.M.SG+PRF+2+SG
amatilhaste-os	amatilhar+V.ele.ACC.3.M.PL+PRF+2+SG
amatilhastes-lhe	amatilhar+V.ele.DAT.3.SG+PRF+2+PL
amatilhastes-lhes	amatilhar+V.ele.DAT.3.PL+PRF+2+PL
amatilhastes-me	amatilhar+V.eu.AD.1.SG+PRF+2+PL
amatilhastes-te	amatilhar+V.tu.AD.2.SG+PRF+2+PL
amatilhastes-vos	amatilhar+V.vós.AD.2.PL+PRF+2+PL
amatilhaste-te	amatilhar+V.tu.AD.2.SG+PRF+2+SG
amatilhaste-vos	amatilhar+V.vós.AD.2.PL+PRF+2+SG
amatilhas-vos	amatilhar+V.vós.AD.2.PL+PRS+2+SG
amatilha-te	amatilhar+V.tu.AD.2.SG+PRS+3+SG
amatilhava-a	amatilhar+V.ele.ACC.3.F.SG+IMPF+1+SG
amatilhava-a	amatilhar+V.ele.ACC.3.F.SG+IMPF+3+SG
amatilhava-as	amatilhar+V.ele.ACC.3.F.PL+IMPF+1+SG
amatilhava-as	amatilhar+V.ele.ACC.3.F.PL+IMPF+3+SG
amatilhava-la	amatilhar+V.ele.ACC.3.F.SG+IMPF+2+SG
amatilhava-las	amatilhar+V.ele.ACC.3.F.PL+IMPF+2+SG
amatilhava-lhe	amatilhar+V.ele.DAT.3.SG+IMPF+1+SG
amatilhava-lhe	amatilhar+V.ele.DAT.3.SG+IMPF+3+SG
amatilhava-lhes	amatilhar+V.ele.DAT.3.PL+IMPF+1+SG
amatilhava-lhes	amatilhar+V.ele.DAT.3.PL+IMPF+3+SG
amatilhava-lo	amatilhar+V.ele.ACC.3.M.SG+IMPF+2+SG
amatilhava-los	amatilhar+V.ele.ACC.3.M.PL+IMPF+2+SG
amatilhava-me	amatilhar+V.eu.AD.1.SG+IMPF+1+SG
amatilhava-me	amatilhar+V.eu.AD.1.SG+IMPF+3+SG
amatilhavam-lhe	amatilhar+V.ele.DAT.3.SG+IMPF+3+PL
amatilhavam-lhes	amatilhar+V.ele.DAT.3.PL+IMPF+3+PL
amatilhavam-me	amatilhar+V.eu.AD.1.SG+IMPF+3+PL
amatilhavam-na	amatilhar+V.ele.ACC.3.F.SG+IMPF+3+PL
amatilhavam-nas	amatilhar+V.ele.ACC.3.F.PL+IMPF+3+PL
amatilhavam-no	amatilhar+V.ele.ACC.3.M.SG+IMPF+3+PL
amatilhavam-nos	amatilhar+V.ele.ACC.3.M.PL+IMPF+3+PL
amatilhavam-nos	amatilhar+V.nós.AD.1.PL+IMPF+3+PL
amatilhávamo-la	amatilhar+V.ele.ACC.3.F.SG+IMPF+1+PL
amatilhávamo-las	amatilhar+V.ele.ACC.3.F.PL+IMPF+1+PL
amatilhávamo-lo	amatilhar+V.ele.ACC.3.M.SG+IMPF+1+PL
amatilhávamo-los	amatilhar+V.ele.ACC.3.M.PL+IMPF+1+PL
amatilhávamo-nos	amatilhar+nós.AD.1.PL+IMPF+1+PL
amatilhávamos-lhe	amatilhar+V.ele.DAT.3.SG+IMPF+1+PL
amatilhávamos-lhes	amatilhar+V.ele.DAT.3.PL+IMPF+1+PL
amatilhávamos-me	amatilhar+V.eu.AD.1.SG+IMPF+1+PL
amatilhávamos-te	amatilhar+V.tu.AD.2.SG+IMPF+1+PL
amatilhávamos-vos	amatilhar+V.vós.AD.2.PL+IMPF+1+PL
amatilhavam-se	amatilhar+V.ele.REFL+IMPF+3+PL
amatilhavam-te	amatilhar+V.tu.AD.2.SG+IMPF+3+PL
amatilhavam-vos	amatilhar+V.vós.AD.2.PL+IMPF+3+PL
amatilhava-nos	amatilhar+nós.AD.1.PL+IMPF+1+SG
amatilhava-nos	amatilhar+nós.AD.1.PL+IMPF+2+SG
amatilhava-nos	amatilhar+nós.AD.1.PL+IMPF+3+SG
amatilhava-o	amatilhar+V.ele.ACC.3.M.SG+IMPF+1+SG
amatilhava-o	amatilhar+V.ele.ACC.3.M.SG+IMPF+3+SG
amatilhava-os	amatilhar+V.ele.ACC.3.M.PL+IMPF+1+SG
amatilhava-os	amatilhar+V.ele.ACC.3.M.PL+IMPF+3+SG
amatilhava-se	amatilhar+V.ele.REFL+IMPF+1+SG
amatilhava-se	amatilhar+V.ele.REFL+IMPF+3+SG
amatilhavas-lhe	amatilhar+V.ele.DAT.3.SG+IMPF+2+SG
amatilhavas-lhes	amatilhar+V.ele.DAT.3.PL+IMPF+2+SG
amatilhavas-me	amatilhar+V.eu.AD.1.SG+IMPF+2+SG
amatilhavas-te	amatilhar+V.tu.AD.2.SG+IMPF+2+SG
amatilhavas-vos	amatilhar+V.vós.AD.2.PL+IMPF+2+SG
amatilhava-te	amatilhar+V.tu.AD.2.SG+IMPF+1+SG
amatilhava-te	amatilhar+V.tu.AD.2.SG+IMPF+3+SG
amatilhava-vos	amatilhar+V.vós.AD.2.PL+IMPF+1+SG
amatilhava-vos	amatilhar+V.vós.AD.2.PL+IMPF+3+SG
amatilhávei-la	amatilhar+V.ele.ACC.3.F.SG+IMPF+2+PL
amatilhávei-las	amatilhar+V.ele.ACC.3.F.PL+IMPF+2+PL
amatilhávei-lo	amatilhar+V.ele.ACC.3.M.SG+IMPF+2+PL
amatilhávei-los	amatilhar+V.ele.ACC.3.M.PL+IMPF+2+PL
amatilhávei-nos	amatilhar+nós.AD.1.PL+IMPF+2+PL
amatilháveis-lhe	amatilhar+V.ele.DAT.3.SG+IMPF+2+PL
amatilháveis-lhes	amatilhar+V.ele.DAT.3.PL+IMPF+2+PL
amatilháveis-me	amatilhar+V.eu.AD.1.SG+IMPF+2+PL
amatilháveis-te	amatilhar+V.tu.AD.2.SG+IMPF+2+PL
amatilháveis-vos	amatilhar+V.vós.AD.2.PL+IMPF+2+PL
amatilha-vos	amatilhar+V.vós.AD.2.PL+PRS+3+SG
amatilhe-a	amatilhar+V.ele.ACC.3.F.SG+IMP+3+SG
amatilhe-as	amatilhar+V.ele.ACC.3.F.PL+IMP+3+SG
amatilhei-a	amatilhar+V.ele.ACC.3.F.SG+PRF+1+SG
amatilhei-as	amatilhar+V.ele.ACC.3.F.PL+PRF+1+SG
amatilhei-lhe	amatilhar+V.ele.DAT.3.SG+PRF+1+SG
amatilhei-lhes	amatilhar+V.ele.DAT.3.PL+PRF+1+SG
amatilhei-me	amatilhar+V.eu.AD.1.SG+PRF+1+SG
amatilhei-nos	amatilhar+nós.AD.1.PL+PRF+1+SG
amatilhei-o	amatilhar+V.ele.ACC.3.M.SG+PRF+1+SG
amatilhei-os	amatilhar+V.ele.ACC.3.M.PL+PRF+1+SG
amatilhei-te	amatilhar+V.tu.AD.2.SG+PRF+1+SG
amatilhei-vos	amatilhar+V.vós.AD.2.PL+PRF+1+SG
amatilhe-lhe	amatilhar+V.ele.DAT.3.SG+IMP+3+SG
amatilhe-lhes	amatilhar+V.ele.DAT.3.PL+IMP+3+SG
amatilhe-me	amatilhar+V.eu.AD.1.SG+IMP+3+SG
amatilhem-lhe	amatilhar+V.ele.DAT.3.SG+IMP+3+PL
amatilhem-lhes	amatilhar+V.ele.DAT.3.PL+IMP+3+PL
amatilhem-me	amatilhar+V.eu.AD.1.SG+IMP+3+PL
amatilhem-na	amatilhar+V.ele.ACC.3.F.SG+IMP+3+PL
amatilhem-nas	amatilhar+V.ele.ACC.3.F.PL+IMP+3+PL
amatilhem-no	amatilhar+V.ele.ACC.3.M.SG+IMP+3+PL
amatilhem-nos	amatilhar+V.ele.ACC.3.M.PL+IMP+3+PL
amatilhem-nos	amatilhar+V.nós.AD.1.PL+IMP+3+PL
amatilhemo-la	amatilhar+V.ele.ACC.3.F.SG+IMP+1+PL
amatilhemo-las	amatilhar+V.ele.ACC.3.F.PL+IMP+1+PL
amatilhemo-lo	amatilhar+V.ele.ACC.3.M.SG+IMP+1+PL
amatilhemo-los	amatilhar+V.ele.ACC.3.M.PL+IMP+1+PL
amatilhemo-nos	amatilhar+nós.AD.1.PL+IMP+1+PL
amatilhemos-lhe	amatilhar+V.ele.DAT.3.SG+IMP+1+PL
amatilhemos-lhes	amatilhar+V.ele.DAT.3.PL+IMP+1+PL
amatilhemos-me	amatilhar+V.eu.AD.1.SG+IMP+1+PL
amatilhemos-te	amatilhar+V.tu.AD.2.SG+IMP+1+PL
amatilhemos-vos	amatilhar+V.vós.AD.2.PL+IMP+1+PL
amatilhem-se	amatilhar+V.ele.REFL+IMP+3+PL
amatilhem-te	amatilhar+V.tu.AD.2.SG+IMP+3+PL
amatilhem-vos	amatilhar+V.vós.AD.2.PL+IMP+3+PL
amatilhe-nos	amatilhar+nós.AD.1.PL+IMP+3+SG
amatilhe-o	amatilhar+V.ele.ACC.3.M.SG+IMP+3+SG
amatilhe-os	amatilhar+V.ele.ACC.3.M.PL+IMP+3+SG
amatilhe-se	amatilhar+V.ele.REFL+IMP+3+SG
amatilhe-te	amatilhar+V.tu.AD.2.SG+IMP+3+SG
amatilhe-vos	amatilhar+V.vós.AD.2.PL+IMP+3+SG
amatilho-a	amatilhar+V.ele.ACC.3.F.SG+PRS+1+SG
amatilho-as	amatilhar+V.ele.ACC.3.F.PL+PRS+1+SG
amatilho-lhe	amatilhar+V.ele.DAT.3.SG+PRS+1+SG
amatilho-lhes	amatilhar+V.ele.DAT.3.PL+PRS+1+SG
amatilho-me	amatilhar+V.eu.AD.1.SG+PRS+1+SG
amatilho-nos	amatilhar+nós.AD.1.PL+PRS+1+SG
amatilho-o	amatilhar+V.ele.ACC.3.M.SG+PRS+1+SG
amatilho-os	amatilhar+V.ele.ACC.3.M.PL+PRS+1+SG
amatilho-te	amatilhar+V.tu.AD.2.SG+PRS+1+SG
amatilhou-a	amatilhar+V.ele.ACC.3.F.SG+PRF+3+SG
amatilhou-as	amatilhar+V.ele.ACC.3.F.PL+PRF+3+SG
amatilhou-lhe	amatilhar+V.ele.DAT.3.SG+PRF+3+SG
amatilhou-lhes	amatilhar+V.ele.DAT.3.PL+PRF+3+SG
amatilhou-me	amatilhar+V.eu.AD.1.SG+PRF+3+SG
amatilhou-nos	amatilhar+nós.AD.1.PL+PRF+3+SG
amatilhou-o	amatilhar+V.ele.ACC.3.M.SG+PRF+3+SG
amatilhou-os	amatilhar+V.ele.ACC.3.M.PL+PRF+3+SG
amatilhou-se	amatilhar+V.ele.REFL+PRF+3+SG
amatilhou-te	amatilhar+V.tu.AD.2.SG+PRF+3+SG
amatilhou-vos	amatilhar+V.vós.AD.2.PL+PRF+3+SG
amatilho-vos	amatilhar+V.vós.AD.2.PL+PRS+1+SG
amato-a	amatar+V.ele.ACC.3.F.SG+PRS+1+SG
amato-as	amatar+V.ele.ACC.3.F.PL+PRS+1+SG
amato-lhe	amatar+V.ele.DAT.3.SG+PRS+1+SG
amato-lhes	amatar+V.ele.DAT.3.PL+PRS+1+SG
amato-me	amatar+V.eu.AD.1.SG+PRS+1+SG
amato-nos	amatar+nós.AD.1.PL+PRS+1+SG
amato-o	amatar+V.ele.ACC.3.M.SG+PRS+1+SG
amato-os	amatar+V.ele.ACC.3.M.PL+PRS+1+SG
amato-te	amatar+V.tu.AD.2.SG+PRS+1+SG
amatou-a	amatar+V.ele.ACC.3.F.SG+PRF+3+SG
amatou-as	amatar+V.ele.ACC.3.F.PL+PRF+3+SG
amatou-lhe	amatar+V.ele.DAT.3.SG+PRF+3+SG
amatou-lhes	amatar+V.ele.DAT.3.PL+PRF+3+SG
amatou-me	amatar+V.eu.AD.1.SG+PRF+3+SG
amatou-nos	amatar+nós.AD.1.PL+PRF+3+SG
amatou-o	amatar+V.ele.ACC.3.M.SG+PRF+3+SG
amatou-os	amatar+V.ele.ACC.3.M.PL+PRF+3+SG
amatou-se	amatar+V.ele.REFL+PRF+3+SG
amatou-te	amatar+V.tu.AD.2.SG+PRF+3+SG
amatou-vos	amatar+V.vós.AD.2.PL+PRF+3+SG
amato-vos	amatar+V.vós.AD.2.PL+PRS+1+SG
amatrona-a	amatronar+V.ele.ACC.3.F.SG+PRS+3+SG
amatrona-as	amatronar+V.ele.ACC.3.F.PL+PRS+3+SG
amatronai-la	amatronar+V.ele.ACC.3.F.SG+PRS+2+PL
amatronai-las	amatronar+V.ele.ACC.3.F.PL+PRS+2+PL
amatronai-lo	amatronar+V.ele.ACC.3.M.SG+PRS+2+PL
amatronai-los	amatronar+V.ele.ACC.3.M.PL+PRS+2+PL
amatronai-nos	amatronar+nós.AD.1.PL+PRS+2+PL
amatronais-lhe	amatronar+V.ele.DAT.3.SG+PRS+2+PL
amatronais-lhes	amatronar+V.ele.DAT.3.PL+PRS+2+PL
amatronais-me	amatronar+V.eu.AD.1.SG+PRS+2+PL
amatronais-te	amatronar+V.tu.AD.2.SG+PRS+2+PL
amatronais-vos	amatronar+V.vós.AD.2.PL+PRS+2+PL
amatroná-la-á	amatronar+V.ele.ACC.3.F.SG+FUT+3+SG
amatroná-la	amatronar+V.ele.ACC.3.F.SG+INF+1+SG
amatroná-la	amatronar+V.ele.ACC.3.F.SG+INF+3+SG
amatrona-la	amatronar+V.ele.ACC.3.F.SG+PRS+2+SG
amatroná-la	amatronar+V.ele.ACC.3.F.SG+SBJF+1+SG
amatroná-la	amatronar+V.ele.ACC.3.F.SG+SBJF+3+SG
amatroná-la-ão	amatronar+V.ele.ACC.3.F.SG+FUT+3+PL
amatroná-la-ás	amatronar+V.ele.ACC.3.F.SG+FUT+2+SG
amatroná-la-ei	amatronar+V.ele.ACC.3.F.SG+FUT+1+SG
amatroná-la-eis	amatronar+V.ele.ACC.3.F.SG+FUT+2+PL
amatroná-la-emos	amatronar+V.ele.ACC.3.F.SG+FUT+1+PL
amatroná-la-ia	amatronar+V.ele.ACC.3.F.SG+COND+1+SG
amatroná-la-ia	amatronar+V.ele.ACC.3.F.SG+COND+3+SG
amatroná-la-iam	amatronar+V.ele.ACC.3.F.SG+COND+3+PL
amatroná-la-íamos	amatronar+V.ele.ACC.3.F.SG+COND+1+PL
amatroná-la-ias	amatronar+V.ele.ACC.3.F.SG+COND+2+SG
amatroná-la-íeis	amatronar+V.ele.ACC.3.F.SG+COND+2+PL
amatroná-las-á	amatronar+V.ele.ACC.3.F.PL+FUT+3+SG
amatroná-las	amatronar+V.ele.ACC.3.F.PL+INF+1+SG
amatroná-las	amatronar+V.ele.ACC.3.F.PL+INF+3+SG
amatrona-las	amatronar+V.ele.ACC.3.F.PL+PRS+2+SG
amatroná-las	amatronar+V.ele.ACC.3.F.PL+SBJF+1+SG
amatroná-las	amatronar+V.ele.ACC.3.F.PL+SBJF+3+SG
amatroná-las-ão	amatronar+V.ele.ACC.3.F.PL+FUT+3+PL
amatroná-las-ás	amatronar+V.ele.ACC.3.F.PL+FUT+2+SG
amatroná-las-ei	amatronar+V.ele.ACC.3.F.PL+FUT+1+SG
amatroná-las-eis	amatronar+V.ele.ACC.3.F.PL+FUT+2+PL
amatroná-las-emos	amatronar+V.ele.ACC.3.F.PL+FUT+1+PL
amatroná-las-ia	amatronar+V.ele.ACC.3.F.PL+COND+1+SG
amatroná-las-ia	amatronar+V.ele.ACC.3.F.PL+COND+3+SG
amatroná-las-iam	amatronar+V.ele.ACC.3.F.PL+COND+3+PL
amatroná-las-íamos	amatronar+V.ele.ACC.3.F.PL+COND+1+PL
amatroná-las-ias	amatronar+V.ele.ACC.3.F.PL+COND+2+SG
amatroná-las-íeis	amatronar+V.ele.ACC.3.F.PL+COND+2+PL
amatrona-lhe	amatronar+V.ele.DAT.3.SG+PRS+3+SG
amatrona-lhes	amatronar+V.ele.DAT.3.PL+PRS+3+SG
amatroná-lo-á	amatronar+V.ele.ACC.3.M.SG+FUT+3+SG
amatroná-lo	amatronar+V.ele.ACC.3.M.SG+INF+1+SG
amatroná-lo	amatronar+V.ele.ACC.3.M.SG+INF+3+SG
amatrona-lo	amatronar+V.ele.ACC.3.M.SG+PRS+2+SG
amatroná-lo	amatronar+V.ele.ACC.3.M.SG+SBJF+1+SG
amatroná-lo	amatronar+V.ele.ACC.3.M.SG+SBJF+3+SG
amatroná-lo-ão	amatronar+V.ele.ACC.3.M.SG+FUT+3+PL
amatroná-lo-ás	amatronar+V.ele.ACC.3.M.SG+FUT+2+SG
amatroná-lo-ei	amatronar+V.ele.ACC.3.M.SG+FUT+1+SG
amatroná-lo-eis	amatronar+V.ele.ACC.3.M.SG+FUT+2+PL
amatroná-lo-emos	amatronar+V.ele.ACC.3.M.SG+FUT+1+PL
amatroná-lo-ia	amatronar+V.ele.ACC.3.M.SG+COND+1+SG
amatroná-lo-ia	amatronar+V.ele.ACC.3.M.SG+COND+3+SG
amatroná-lo-iam	amatronar+V.ele.ACC.3.M.SG+COND+3+PL
amatroná-lo-íamos	amatronar+V.ele.ACC.3.M.SG+COND+1+PL
amatroná-lo-ias	amatronar+V.ele.ACC.3.M.SG+COND+2+SG
amatroná-lo-íeis	amatronar+V.ele.ACC.3.M.SG+COND+2+PL
amatroná-los-á	amatronar+V.ele.ACC.3.M.PL+FUT+3+SG
amatroná-los	amatronar+V.ele.ACC.3.M.PL+INF+1+SG
amatroná-los	amatronar+V.ele.ACC.3.M.PL+INF+3+SG
amatrona-los	amatronar+V.ele.ACC.3.M.PL+PRS+2+SG
amatroná-los	amatronar+V.ele.ACC.3.M.PL+SBJF+1+SG
amatroná-los	amatronar+V.ele.ACC.3.M.PL+SBJF+3+SG
amatroná-los-ão	amatronar+V.ele.ACC.3.M.PL+FUT+3+PL
amatroná-los-ás	amatronar+V.ele.ACC.3.M.PL+FUT+2+SG
amatroná-los-ei	amatronar+V.ele.ACC.3.M.PL+FUT+1+SG
amatroná-los-eis	amatronar+V.ele.ACC.3.M.PL+FUT+2+PL
amatroná-los-emos	amatronar+V.ele.ACC.3.M.PL+FUT+1+PL
amatroná-los-ia	amatronar+V.ele.ACC.3.M.PL+COND+1+SG
amatroná-los-ia	amatronar+V.ele.ACC.3.M.PL+COND+3+SG
amatroná-los-iam	amatronar+V.ele.ACC.3.M.PL+COND+3+PL
amatroná-los-íamos	amatronar+V.ele.ACC.3.M.PL+COND+1+PL
amatroná-los-ias	amatronar+V.ele.ACC.3.M.PL+COND+2+SG
amatroná-los-íeis	amatronar+V.ele.ACC.3.M.PL+COND+2+PL
amatrona-me	amatronar+V.eu.AD.1.SG+PRS+3+SG
amatronam-lhe	amatronar+V.ele.DAT.3.SG+PRS+3+PL
amatronam-lhes	amatronar+V.ele.DAT.3.PL+PRS+3+PL
amatronam-me	amatronar+V.eu.AD.1.SG+PRS+3+PL
amatronam-na	amatronar+V.ele.ACC.3.F.SG+PRS+3+PL
amatronam-nas	amatronar+V.ele.ACC.3.F.PL+PRS+3+PL
amatronam-no	amatronar+V.ele.ACC.3.M.SG+PRS+3+PL
amatronam-nos	amatronar+V.ele.ACC.3.M.PL+PRS+3+PL
amatronam-nos	amatronar+V.nós.AD.1.PL+PRS+3+PL
amatronamo-la	amatronar+V.ele.ACC.3.F.SG+PRF+1+PL
amatronamo-la	amatronar+V.ele.ACC.3.F.SG+PRS+1+PL
amatronamo-las	amatronar+V.ele.ACC.3.F.PL+PRF+1+PL
amatronamo-las	amatronar+V.ele.ACC.3.F.PL+PRS+1+PL
amatronamo-lo	amatronar+V.ele.ACC.3.M.SG+PRF+1+PL
amatronamo-lo	amatronar+V.ele.ACC.3.M.SG+PRS+1+PL
amatronamo-los	amatronar+V.ele.ACC.3.M.PL+PRF+1+PL
amatronamo-los	amatronar+V.ele.ACC.3.M.PL+PRS+1+PL
amatronamo-nos	amatronar+nós.AD.1.PL+PRF+1+PL
amatronamo-nos	amatronar+nós.AD.1.PL+PRS+1+PL
amatronamos-lhe	amatronar+V.ele.DAT.3.SG+PRF+1+PL
amatronamos-lhe	amatronar+V.ele.DAT.3.SG+PRS+1+PL
amatronamos-lhes	amatronar+V.ele.DAT.3.PL+PRF+1+PL
amatronamos-lhes	amatronar+V.ele.DAT.3.PL+PRS+1+PL
amatronamos-me	amatronar+V.eu.AD.1.SG+PRF+1+PL
amatronamos-me	amatronar+V.eu.AD.1.SG+PRS+1+PL
amatronamos-te	amatronar+V.tu.AD.2.SG+PRF+1+PL
amatronamos-te	amatronar+V.tu.AD.2.SG+PRS+1+PL
amatronamos-vos	amatronar+V.vós.AD.2.PL+PRF+1+PL
amatronamos-vos	amatronar+V.vós.AD.2.PL+PRS+1+PL
amatronam-se	amatronar+V.ele.REFL+PRS+3+PL
amatronam-te	amatronar+V.tu.AD.2.SG+PRS+3+PL
amatronam-vos	amatronar+V.vós.AD.2.PL+PRS+3+PL
amatronando-a	amatronar+V.ele.ACC.3.F.SG+GRD
amatronando-as	amatronar+V.ele.ACC.3.F.PL+GRD
amatronando-lhe	amatronar+V.ele.DAT.3.SG+GRD
amatronando-lhes	amatronar+V.ele.DAT.3.PL+GRD
amatronando-me	amatronar+V.eu.AD.1.SG+GRD
amatronando-nos	amatronar+nós.AD.1.PL+GRD
amatronando-o	amatronar+V.ele.ACC.3.M.SG+GRD
amatronando-os	amatronar+V.ele.ACC.3.M.PL+GRD
amatronando-se	amatronar+V.ele.REFL+GRD
amatronando-te	amatronar+V.tu.AD.2.SG+GRD
amatronando-vos	amatronar+V.vós.AD.2.PL+GRD
amatrona-nos	amatronar+nós.AD.1.PL+PRS+2+SG
amatrona-nos	amatronar+nós.AD.1.PL+PRS+3+SG
amatrona-o	amatronar+V.ele.ACC.3.M.SG+PRS+3+SG
amatrona-os	amatronar+V.ele.ACC.3.M.PL+PRS+3+SG
amatronara-a	amatronar+V.ele.ACC.3.F.SG+PQP+1+SG
amatronara-a	amatronar+V.ele.ACC.3.F.SG+PQP+3+SG
amatronara-as	amatronar+V.ele.ACC.3.F.PL+PQP+1+SG
amatronara-as	amatronar+V.ele.ACC.3.F.PL+PQP+3+SG
amatronara-la	amatronar+V.ele.ACC.3.F.SG+PQP+2+SG
amatronara-las	amatronar+V.ele.ACC.3.F.PL+PQP+2+SG
amatronara-lhe	amatronar+V.ele.DAT.3.SG+PQP+1+SG
amatronara-lhe	amatronar+V.ele.DAT.3.SG+PQP+3+SG
amatronara-lhes	amatronar+V.ele.DAT.3.PL+PQP+1+SG
amatronara-lhes	amatronar+V.ele.DAT.3.PL+PQP+3+SG
amatronara-lo	amatronar+V.ele.ACC.3.M.SG+PQP+2+SG
amatronara-los	amatronar+V.ele.ACC.3.M.PL+PQP+2+SG
amatronara-me	amatronar+V.eu.AD.1.SG+PQP+1+SG
amatronara-me	amatronar+V.eu.AD.1.SG+PQP+3+SG
amatronaram-lhe	amatronar+V.ele.DAT.3.SG+PQP+3+PL
amatronaram-lhe	amatronar+V.ele.DAT.3.SG+PRF+3+PL
amatronaram-lhes	amatronar+V.ele.DAT.3.PL+PQP+3+PL
amatronaram-lhes	amatronar+V.ele.DAT.3.PL+PRF+3+PL
amatronaram-me	amatronar+V.eu.AD.1.SG+PQP+3+PL
amatronaram-me	amatronar+V.eu.AD.1.SG+PRF+3+PL
amatronaram-na	amatronar+V.ele.ACC.3.F.SG+PQP+3+PL
amatronaram-na	amatronar+V.ele.ACC.3.F.SG+PRF+3+PL
amatronaram-nas	amatronar+V.ele.ACC.3.F.PL+PQP+3+PL
amatronaram-nas	amatronar+V.ele.ACC.3.F.PL+PRF+3+PL
amatronaram-no	amatronar+V.ele.ACC.3.M.SG+PQP+3+PL
amatronaram-no	amatronar+V.ele.ACC.3.M.SG+PRF+3+PL
amatronaram-nos	amatronar+V.ele.ACC.3.M.PL+PQP+3+PL
amatronaram-nos	amatronar+V.ele.ACC.3.M.PL+PRF+3+PL
amatronaram-nos	amatronar+V.nós.AD.1.PL+PQP+3+PL
amatronaram-nos	amatronar+V.nós.AD.1.PL+PRF+3+PL
amatronáramo-la	amatronar+V.ele.ACC.3.F.SG+PQP+1+PL
amatronáramo-las	amatronar+V.ele.ACC.3.F.PL+PQP+1+PL
amatronáramo-lo	amatronar+V.ele.ACC.3.M.SG+PQP+1+PL
amatronáramo-los	amatronar+V.ele.ACC.3.M.PL+PQP+1+PL
amatronáramo-nos	amatronar+nós.AD.1.PL+PQP+1+PL
amatronáramos-lhe	amatronar+V.ele.DAT.3.SG+PQP+1+PL
amatronáramos-lhes	amatronar+V.ele.DAT.3.PL+PQP+1+PL
amatronáramos-me	amatronar+V.eu.AD.1.SG+PQP+1+PL
amatronáramos-te	amatronar+V.tu.AD.2.SG+PQP+1+PL
amatronáramos-vos	amatronar+V.vós.AD.2.PL+PQP+1+PL
amatronaram-se	amatronar+V.ele.REFL+PQP+3+PL
amatronaram-se	amatronar+V.ele.REFL+PRF+3+PL
amatronaram-te	amatronar+V.tu.AD.2.SG+PQP+3+PL
amatronaram-te	amatronar+V.tu.AD.2.SG+PRF+3+PL
amatronaram-vos	amatronar+V.vós.AD.2.PL+PQP+3+PL
amatronaram-vos	amatronar+V.vós.AD.2.PL+PRF+3+PL
amatronara-nos	amatronar+nós.AD.1.PL+PQP+1+SG
amatronara-nos	amatronar+nós.AD.1.PL+PQP+2+SG
amatronara-nos	amatronar+nós.AD.1.PL+PQP+3+SG
amatronara-o	amatronar+V.ele.ACC.3.M.SG+PQP+1+SG
amatronara-o	amatronar+V.ele.ACC.3.M.SG+PQP+3+SG
amatronara-os	amatronar+V.ele.ACC.3.M.PL+PQP+1+SG
amatronara-os	amatronar+V.ele.ACC.3.M.PL+PQP+3+SG
amatronara-se	amatronar+V.ele.REFL+PQP+1+SG
amatronara-se	amatronar+V.ele.REFL+PQP+3+SG
amatronaras-lhe	amatronar+V.ele.DAT.3.SG+PQP+2+SG
amatronaras-lhes	amatronar+V.ele.DAT.3.PL+PQP+2+SG
amatronaras-me	amatronar+V.eu.AD.1.SG+PQP+2+SG
amatronaras-te	amatronar+V.tu.AD.2.SG+PQP+2+SG
amatronaras-vos	amatronar+V.vós.AD.2.PL+PQP+2+SG
amatronara-te	amatronar+V.tu.AD.2.SG+PQP+1+SG
amatronara-te	amatronar+V.tu.AD.2.SG+PQP+3+SG
amatronara-vos	amatronar+V.vós.AD.2.PL+PQP+1+SG
amatronara-vos	amatronar+V.vós.AD.2.PL+PQP+3+SG
amatronarde-la	amatronar+V.ele.ACC.3.F.SG+INF+2+PL
amatronarde-la	amatronar+V.ele.ACC.3.F.SG+SBJF+2+PL
amatronarde-las	amatronar+V.ele.ACC.3.F.PL+INF+2+PL
amatronarde-las	amatronar+V.ele.ACC.3.F.PL+SBJF+2+PL
amatronarde-lo	amatronar+V.ele.ACC.3.M.SG+INF+2+PL
amatronarde-lo	amatronar+V.ele.ACC.3.M.SG+SBJF+2+PL
amatronarde-los	amatronar+V.ele.ACC.3.M.PL+INF+2+PL
amatronarde-los	amatronar+V.ele.ACC.3.M.PL+SBJF+2+PL
amatronarde-nos	amatronar+nós.AD.1.PL+INF+2+PL
amatronarde-nos	amatronar+nós.AD.1.PL+SBJF+2+PL
amatronardes-lhe	amatronar+V.ele.DAT.3.SG+INF+2+PL
amatronardes-lhe	amatronar+V.ele.DAT.3.SG+SBJF+2+PL
amatronardes-lhes	amatronar+V.ele.DAT.3.PL+INF+2+PL
amatronardes-lhes	amatronar+V.ele.DAT.3.PL+SBJF+2+PL
amatronardes-me	amatronar+V.eu.AD.1.SG+INF+2+PL
amatronardes-me	amatronar+V.eu.AD.1.SG+SBJF+2+PL
amatronardes-te	amatronar+V.tu.AD.2.SG+INF+2+PL
amatronardes-te	amatronar+V.tu.AD.2.SG+SBJF+2+PL
amatronardes-vos	amatronar+V.vós.AD.2.PL+INF+2+PL
amatronardes-vos	amatronar+V.vós.AD.2.PL+SBJF+2+PL
amatronárei-la	amatronar+V.ele.ACC.3.F.SG+PQP+2+PL
amatronárei-las	amatronar+V.ele.ACC.3.F.PL+PQP+2+PL
amatronárei-lo	amatronar+V.ele.ACC.3.M.SG+PQP+2+PL
amatronárei-los	amatronar+V.ele.ACC.3.M.PL+PQP+2+PL
amatronárei-nos	amatronar+nós.AD.1.PL+PQP+2+PL
amatronáreis-lhe	amatronar+V.ele.DAT.3.SG+PQP+2+PL
amatronáreis-lhes	amatronar+V.ele.DAT.3.PL+PQP+2+PL
amatronáreis-me	amatronar+V.eu.AD.1.SG+PQP+2+PL
amatronáreis-te	amatronar+V.tu.AD.2.SG+PQP+2+PL
amatronáreis-vos	amatronar+V.vós.AD.2.PL+PQP+2+PL
amatronare-la	amatronar+V.ele.ACC.3.F.SG+INF+2+SG
amatronare-la	amatronar+V.ele.ACC.3.F.SG+SBJF+2+SG
amatronare-las	amatronar+V.ele.ACC.3.F.PL+INF+2+SG
amatronare-las	amatronar+V.ele.ACC.3.F.PL+SBJF+2+SG
amatronare-lo	amatronar+V.ele.ACC.3.M.SG+INF+2+SG
amatronare-lo	amatronar+V.ele.ACC.3.M.SG+SBJF+2+SG
amatronare-los	amatronar+V.ele.ACC.3.M.PL+INF+2+SG
amatronare-los	amatronar+V.ele.ACC.3.M.PL+SBJF+2+SG
amatronarem-lhe	amatronar+V.ele.DAT.3.SG+INF+3+PL
amatronarem-lhe	amatronar+V.ele.DAT.3.SG+SBJF+3+PL
amatronarem-lhes	amatronar+V.ele.DAT.3.PL+INF+3+PL
amatronarem-lhes	amatronar+V.ele.DAT.3.PL+SBJF+3+PL
amatronarem-me	amatronar+V.eu.AD.1.SG+INF+3+PL
amatronarem-me	amatronar+V.eu.AD.1.SG+SBJF+3+PL
amatronarem-na	amatronar+V.ele.ACC.3.F.SG+INF+3+PL
amatronarem-na	amatronar+V.ele.ACC.3.F.SG+SBJF+3+PL
amatronarem-nas	amatronar+V.ele.ACC.3.F.PL+INF+3+PL
amatronarem-nas	amatronar+V.ele.ACC.3.F.PL+SBJF+3+PL
amatronarem-no	amatronar+V.ele.ACC.3.M.SG+INF+3+PL
amatronarem-no	amatronar+V.ele.ACC.3.M.SG+SBJF+3+PL
amatronarem-nos	amatronar+V.ele.ACC.3.M.PL+INF+3+PL
amatronarem-nos	amatronar+V.ele.ACC.3.M.PL+SBJF+3+PL
amatronarem-nos	amatronar+V.nós.AD.1.PL+INF+3+PL
amatronarem-nos	amatronar+V.nós.AD.1.PL+SBJF+3+PL
amatronarem-se	amatronar+V.ele.REFL+INF+3+PL
amatronarem-se	amatronar+V.ele.REFL+SBJF+3+PL
amatronarem-te	amatronar+V.tu.AD.2.SG+INF+3+PL
amatronarem-te	amatronar+V.tu.AD.2.SG+SBJF+3+PL
amatronarem-vos	amatronar+V.vós.AD.2.PL+INF+3+PL
amatronarem-vos	amatronar+V.vós.AD.2.PL+SBJF+3+PL
amatronare-nos	amatronar+nós.AD.1.PL+INF+2+SG
amatronare-nos	amatronar+nós.AD.1.PL+SBJF+2+SG
amatronares-lhe	amatronar+V.ele.DAT.3.SG+INF+2+SG
amatronares-lhe	amatronar+V.ele.DAT.3.SG+SBJF+2+SG
amatronares-lhes	amatronar+V.ele.DAT.3.PL+INF+2+SG
amatronares-lhes	amatronar+V.ele.DAT.3.PL+SBJF+2+SG
amatronares-me	amatronar+V.eu.AD.1.SG+INF+2+SG
amatronares-me	amatronar+V.eu.AD.1.SG+SBJF+2+SG
amatronares-te	amatronar+V.tu.AD.2.SG+INF+2+SG
amatronares-te	amatronar+V.tu.AD.2.SG+SBJF+2+SG
amatronares-vos	amatronar+V.vós.AD.2.PL+INF+2+SG
amatronares-vos	amatronar+V.vós.AD.2.PL+SBJF+2+SG
amatronar-lhe-á	amatronar+V.ele.DAT.3.SG+FUT+3+SG
amatronar-lhe	amatronar+V.ele.DAT.3.SG+INF
amatronar-lhe	amatronar+V.ele.DAT.3.SG+INF+1+SG
amatronar-lhe	amatronar+V.ele.DAT.3.SG+INF+3+SG
amatronar-lhe	amatronar+V.ele.DAT.3.SG+SBJF+1+SG
amatronar-lhe	amatronar+V.ele.DAT.3.SG+SBJF+3+SG
amatronar-lhe-ão	amatronar+V.ele.DAT.3.SG+FUT+3+PL
amatronar-lhe-ás	amatronar+V.ele.DAT.3.SG+FUT+2+SG
amatronar-lhe-ei	amatronar+V.ele.DAT.3.SG+FUT+1+SG
amatronar-lhe-eis	amatronar+V.ele.DAT.3.SG+FUT+2+PL
amatronar-lhe-emos	amatronar+V.ele.DAT.3.SG+FUT+1+PL
amatronar-lhe-ia	amatronar+V.ele.DAT.3.SG+COND+1+SG
amatronar-lhe-ia	amatronar+V.ele.DAT.3.SG+COND+3+SG
amatronar-lhe-iam	amatronar+V.ele.DAT.3.SG+COND+3+PL
amatronar-lhe-íamos	amatronar+V.ele.DAT.3.SG+COND+1+PL
amatronar-lhe-ias	amatronar+V.ele.DAT.3.SG+COND+2+SG
amatronar-lhe-íeis	amatronar+V.ele.DAT.3.SG+COND+2+PL
amatronar-lhes-á	amatronar+V.ele.DAT.3.PL+FUT+3+SG
amatronar-lhes	amatronar+V.ele.DAT.3.PL+INF
amatronar-lhes	amatronar+V.ele.DAT.3.PL+INF+1+SG
amatronar-lhes	amatronar+V.ele.DAT.3.PL+INF+3+SG
amatronar-lhes	amatronar+V.ele.DAT.3.PL+SBJF+1+SG
amatronar-lhes	amatronar+V.ele.DAT.3.PL+SBJF+3+SG
amatronar-lhes-ão	amatronar+V.ele.DAT.3.PL+FUT+3+PL
amatronar-lhes-ás	amatronar+V.ele.DAT.3.PL+FUT+2+SG
amatronar-lhes-ei	amatronar+V.ele.DAT.3.PL+FUT+1+SG
amatronar-lhes-eis	amatronar+V.ele.DAT.3.PL+FUT+2+PL
amatronar-lhes-emos	amatronar+V.ele.DAT.3.PL+FUT+1+PL
amatronar-lhes-ia	amatronar+V.ele.DAT.3.PL+COND+1+SG
amatronar-lhes-ia	amatronar+V.ele.DAT.3.PL+COND+3+SG
amatronar-lhes-iam	amatronar+V.ele.DAT.3.PL+COND+3+PL
amatronar-lhes-íamos	amatronar+V.ele.DAT.3.PL+COND+1+PL
amatronar-lhes-ias	amatronar+V.ele.DAT.3.PL+COND+2+SG
amatronar-lhes-íeis	amatronar+V.ele.DAT.3.PL+COND+2+PL
amatronar-me-á	amatronar+V.eu.AD.1.SG+FUT+3+SG
amatronar-me	amatronar+V.eu.AD.1.SG+INF
amatronar-me	amatronar+V.eu.AD.1.SG+INF+1+SG
amatronar-me	amatronar+V.eu.AD.1.SG+INF+3+SG
amatronar-me	amatronar+V.eu.AD.1.SG+SBJF+1+SG
amatronar-me	amatronar+V.eu.AD.1.SG+SBJF+3+SG
amatronar-me-ão	amatronar+V.eu.AD.1.SG+FUT+3+PL
amatronar-me-ás	amatronar+V.eu.AD.1.SG+FUT+2+SG
amatronar-me-ei	amatronar+V.eu.AD.1.SG+FUT+1+SG
amatronar-me-eis	amatronar+V.eu.AD.1.SG+FUT+2+PL
amatronar-me-emos	amatronar+V.eu.AD.1.SG+FUT+1+PL
amatronar-me-ia	amatronar+V.eu.AD.1.SG+COND+1+SG
amatronar-me-ia	amatronar+V.eu.AD.1.SG+COND+3+SG
amatronar-me-iam	amatronar+V.eu.AD.1.SG+COND+3+PL
amatronar-me-íamos	amatronar+V.eu.AD.1.SG+COND+1+PL
amatronar-me-ias	amatronar+V.eu.AD.1.SG+COND+2+SG
amatronar-me-íeis	amatronar+V.eu.AD.1.SG+COND+2+PL
amatronarmo-la	amatronar+V.ele.ACC.3.F.SG+INF+1+PL
amatronarmo-la	amatronar+V.ele.ACC.3.F.SG+SBJF+1+PL
amatronarmo-las	amatronar+V.ele.ACC.3.F.PL+INF+1+PL
amatronarmo-las	amatronar+V.ele.ACC.3.F.PL+SBJF+1+PL
amatronarmo-lo	amatronar+V.ele.ACC.3.M.SG+INF+1+PL
amatronarmo-lo	amatronar+V.ele.ACC.3.M.SG+SBJF+1+PL
amatronarmo-los	amatronar+V.ele.ACC.3.M.PL+INF+1+PL
amatronarmo-los	amatronar+V.ele.ACC.3.M.PL+SBJF+1+PL
amatronarmo-nos	amatronar+nós.AD.1.PL+INF+1+PL
amatronarmo-nos	amatronar+nós.AD.1.PL+SBJF+1+PL
amatronarmos-lhe	amatronar+V.ele.DAT.3.SG+INF+1+PL
amatronarmos-lhe	amatronar+V.ele.DAT.3.SG+SBJF+1+PL
amatronarmos-lhes	amatronar+V.ele.DAT.3.PL+INF+1+PL
amatronarmos-lhes	amatronar+V.ele.DAT.3.PL+SBJF+1+PL
amatronarmos-me	amatronar+V.eu.AD.1.SG+INF+1+PL
amatronarmos-me	amatronar+V.eu.AD.1.SG+SBJF+1+PL
amatronarmos-te	amatronar+V.tu.AD.2.SG+INF+1+PL
amatronarmos-te	amatronar+V.tu.AD.2.SG+SBJF+1+PL
amatronarmos-vos	amatronar+V.vós.AD.2.PL+INF+1+PL
amatronarmos-vos	amatronar+V.vós.AD.2.PL+SBJF+1+PL
amatronar-nos-á	amatronar+nós.AD.1.PL+FUT+3+SG
amatronar-nos	amatronar+nós.AD.1.PL+INF
amatronar-nos	amatronar+nós.AD.1.PL+INF+1+SG
amatronar-nos	amatronar+nós.AD.1.PL+INF+3+SG
amatronar-nos	amatronar+nós.AD.1.PL+SBJF+1+SG
amatronar-nos	amatronar+nós.AD.1.PL+SBJF+3+SG
amatronar-nos-ão	amatronar+nós.AD.1.PL+FUT+3+PL
amatronar-nos-ás	amatronar+nós.AD.1.PL+FUT+2+SG
amatronar-nos-ei	amatronar+nós.AD.1.PL+FUT+1+SG
amatronar-nos-eis	amatronar+nós.AD.1.PL+FUT+2+PL
amatronar-nos-emos	amatronar+nós.AD.1.PL+FUT+1+PL
amatronar-nos-ia	amatronar+nós.AD.1.PL+COND+1+SG
amatronar-nos-ia	amatronar+nós.AD.1.PL+COND+3+SG
amatronar-nos-iam	amatronar+nós.AD.1.PL+COND+3+PL
amatronar-nos-íamos	amatronar+nós.AD.1.PL+COND+1+PL
amatronar-nos-ias	amatronar+nós.AD.1.PL+COND+2+SG
amatronar-nos-íeis	amatronar+nós.AD.1.PL+COND+2+PL
amatronar-se-á	amatronar+V.ele.REFL+FUT+3+SG
amatronar-se	amatronar+V.ele.REFL+INF
amatronar-se	amatronar+V.ele.REFL+INF+3+SG
amatronar-se	amatronar+V.ele.REFL+SBJF+3+SG
amatronar-se-ão	amatronar+V.ele.REFL+FUT+3+PL
amatronar-se-ia	amatronar+V.ele.REFL+COND+3+SG
amatronar-se-iam	amatronar+V.ele.REFL+COND+3+PL
amatronar-te-á	amatronar+V.tu.AD.2.SG+FUT+3+SG
amatronar-te	amatronar+V.tu.AD.2.SG+INF
amatronar-te	amatronar+V.tu.AD.2.SG+INF+1+SG
amatronar-te	amatronar+V.tu.AD.2.SG+INF+3+SG
amatronar-te	amatronar+V.tu.AD.2.SG+SBJF+1+SG
amatronar-te	amatronar+V.tu.AD.2.SG+SBJF+3+SG
amatronar-te-ão	amatronar+V.tu.AD.2.SG+FUT+3+PL
amatronar-te-ás	amatronar+V.tu.AD.2.SG+FUT+2+SG
amatronar-te-ei	amatronar+V.tu.AD.2.SG+FUT+1+SG
amatronar-te-eis	amatronar+V.tu.AD.2.SG+FUT+2+PL
amatronar-te-emos	amatronar+V.tu.AD.2.SG+FUT+1+PL
amatronar-te-ia	amatronar+V.tu.AD.2.SG+COND+1+SG
amatronar-te-ia	amatronar+V.tu.AD.2.SG+COND+3+SG
amatronar-te-iam	amatronar+V.tu.AD.2.SG+COND+3+PL
amatronar-te-íamos	amatronar+V.tu.AD.2.SG+COND+1+PL
amatronar-te-ias	amatronar+V.tu.AD.2.SG+COND+2+SG
amatronar-te-íeis	amatronar+V.tu.AD.2.SG+COND+2+PL
amatronar-vos-á	amatronar+V.vós.AD.2.PL+FUT+3+SG
amatronar-vos	amatronar+V.vós.AD.2.PL+INF
amatronar-vos	amatronar+V.vós.AD.2.PL+INF+1+SG
amatronar-vos	amatronar+V.vós.AD.2.PL+INF+3+SG
amatronar-vos	amatronar+V.vós.AD.2.PL+SBJF+1+SG
amatronar-vos	amatronar+V.vós.AD.2.PL+SBJF+3+SG
amatronar-vos-ão	amatronar+V.vós.AD.2.PL+FUT+3+PL
amatronar-vos-ás	amatronar+V.vós.AD.2.PL+FUT+2+SG
amatronar-vos-ei	amatronar+V.vós.AD.2.PL+FUT+1+SG
amatronar-vos-eis	amatronar+V.vós.AD.2.PL+FUT+2+PL
amatronar-vos-emos	amatronar+V.vós.AD.2.PL+FUT+1+PL
amatronar-vos-ia	amatronar+V.vós.AD.2.PL+COND+1+SG
amatronar-vos-ia	amatronar+V.vós.AD.2.PL+COND+3+SG
amatronar-vos-iam	amatronar+V.vós.AD.2.PL+COND+3+PL
amatronar-vos-íamos	amatronar+V.vós.AD.2.PL+COND+1+PL
amatronar-vos-ias	amatronar+V.vós.AD.2.PL+COND+2+SG
amatronar-vos-íeis	amatronar+V.vós.AD.2.PL+COND+2+PL
amatrona-se	amatronar+V.ele.REFL+PRS+3+SG
amatronas-lhe	amatronar+V.ele.DAT.3.SG+PRS+2+SG
amatronas-lhes	amatronar+V.ele.DAT.3.PL+PRS+2+SG
amatronas-me	amatronar+V.eu.AD.1.SG+PRS+2+SG
amatronaste-a	amatronar+V.ele.ACC.3.F.SG+PRF+2+SG
amatronas-te	amatronar+V.tu.AD.2.SG+PRS+2+SG
amatronaste-as	amatronar+V.ele.ACC.3.F.PL+PRF+2+SG
amatronaste-la	amatronar+V.ele.ACC.3.F.SG+PRF+2+PL
amatronaste-las	amatronar+V.ele.ACC.3.F.PL+PRF+2+PL
amatronaste-lhe	amatronar+V.ele.DAT.3.SG+PRF+2+SG
amatronaste-lhes	amatronar+V.ele.DAT.3.PL+PRF+2+SG
amatronaste-lo	amatronar+V.ele.ACC.3.M.SG+PRF+2+PL
amatronaste-los	amatronar+V.ele.ACC.3.M.PL+PRF+2+PL
amatronaste-me	amatronar+V.eu.AD.1.SG+PRF+2+SG
amatronaste-nos	amatronar+nós.AD.1.PL+PRF+2+PL
amatronaste-nos	amatronar+nós.AD.1.PL+PRF+2+SG
amatronaste-o	amatronar+V.ele.ACC.3.M.SG+PRF+2+SG
amatronaste-os	amatronar+V.ele.ACC.3.M.PL+PRF+2+SG
amatronastes-lhe	amatronar+V.ele.DAT.3.SG+PRF+2+PL
amatronastes-lhes	amatronar+V.ele.DAT.3.PL+PRF+2+PL
amatronastes-me	amatronar+V.eu.AD.1.SG+PRF+2+PL
amatronastes-te	amatronar+V.tu.AD.2.SG+PRF+2+PL
amatronastes-vos	amatronar+V.vós.AD.2.PL+PRF+2+PL
amatronaste-te	amatronar+V.tu.AD.2.SG+PRF+2+SG
amatronaste-vos	amatronar+V.vós.AD.2.PL+PRF+2+SG
amatronas-vos	amatronar+V.vós.AD.2.PL+PRS+2+SG
amatrona-te	amatronar+V.tu.AD.2.SG+PRS+3+SG
amatronava-a	amatronar+V.ele.ACC.3.F.SG+IMPF+1+SG
amatronava-a	amatronar+V.ele.ACC.3.F.SG+IMPF+3+SG
amatronava-as	amatronar+V.ele.ACC.3.F.PL+IMPF+1+SG
amatronava-as	amatronar+V.ele.ACC.3.F.PL+IMPF+3+SG
amatronava-la	amatronar+V.ele.ACC.3.F.SG+IMPF+2+SG
amatronava-las	amatronar+V.ele.ACC.3.F.PL+IMPF+2+SG
amatronava-lhe	amatronar+V.ele.DAT.3.SG+IMPF+1+SG
amatronava-lhe	amatronar+V.ele.DAT.3.SG+IMPF+3+SG
amatronava-lhes	amatronar+V.ele.DAT.3.PL+IMPF+1+SG
amatronava-lhes	amatronar+V.ele.DAT.3.PL+IMPF+3+SG
amatronava-lo	amatronar+V.ele.ACC.3.M.SG+IMPF+2+SG
amatronava-los	amatronar+V.ele.ACC.3.M.PL+IMPF+2+SG
amatronava-me	amatronar+V.eu.AD.1.SG+IMPF+1+SG
amatronava-me	amatronar+V.eu.AD.1.SG+IMPF+3+SG
amatronavam-lhe	amatronar+V.ele.DAT.3.SG+IMPF+3+PL
amatronavam-lhes	amatronar+V.ele.DAT.3.PL+IMPF+3+PL
amatronavam-me	amatronar+V.eu.AD.1.SG+IMPF+3+PL
amatronavam-na	amatronar+V.ele.ACC.3.F.SG+IMPF+3+PL
amatronavam-nas	amatronar+V.ele.ACC.3.F.PL+IMPF+3+PL
amatronavam-no	amatronar+V.ele.ACC.3.M.SG+IMPF+3+PL
amatronavam-nos	amatronar+V.ele.ACC.3.M.PL+IMPF+3+PL
amatronavam-nos	amatronar+V.nós.AD.1.PL+IMPF+3+PL
amatronávamo-la	amatronar+V.ele.ACC.3.F.SG+IMPF+1+PL
amatronávamo-las	amatronar+V.ele.ACC.3.F.PL+IMPF+1+PL
amatronávamo-lo	amatronar+V.ele.ACC.3.M.SG+IMPF+1+PL
amatronávamo-los	amatronar+V.ele.ACC.3.M.PL+IMPF+1+PL
amatronávamo-nos	amatronar+nós.AD.1.PL+IMPF+1+PL
amatronávamos-lhe	amatronar+V.ele.DAT.3.SG+IMPF+1+PL
amatronávamos-lhes	amatronar+V.ele.DAT.3.PL+IMPF+1+PL
amatronávamos-me	amatronar+V.eu.AD.1.SG+IMPF+1+PL
amatronávamos-te	amatronar+V.tu.AD.2.SG+IMPF+1+PL
amatronávamos-vos	amatronar+V.vós.AD.2.PL+IMPF+1+PL
amatronavam-se	amatronar+V.ele.REFL+IMPF+3+PL
amatronavam-te	amatronar+V.tu.AD.2.SG+IMPF+3+PL
amatronavam-vos	amatronar+V.vós.AD.2.PL+IMPF+3+PL
amatronava-nos	amatronar+nós.AD.1.PL+IMPF+1+SG
amatronava-nos	amatronar+nós.AD.1.PL+IMPF+2+SG
amatronava-nos	amatronar+nós.AD.1.PL+IMPF+3+SG
amatronava-o	amatronar+V.ele.ACC.3.M.SG+IMPF+1+SG
amatronava-o	amatronar+V.ele.ACC.3.M.SG+IMPF+3+SG
amatronava-os	amatronar+V.ele.ACC.3.M.PL+IMPF+1+SG
amatronava-os	amatronar+V.ele.ACC.3.M.PL+IMPF+3+SG
amatronava-se	amatronar+V.ele.REFL+IMPF+1+SG
amatronava-se	amatronar+V.ele.REFL+IMPF+3+SG
amatronavas-lhe	amatronar+V.ele.DAT.3.SG+IMPF+2+SG
amatronavas-lhes	amatronar+V.ele.DAT.3.PL+IMPF+2+SG
amatronavas-me	amatronar+V.eu.AD.1.SG+IMPF+2+SG
amatronavas-te	amatronar+V.tu.AD.2.SG+IMPF+2+SG
amatronavas-vos	amatronar+V.vós.AD.2.PL+IMPF+2+SG
amatronava-te	amatronar+V.tu.AD.2.SG+IMPF+1+SG
amatronava-te	amatronar+V.tu.AD.2.SG+IMPF+3+SG
amatronava-vos	amatronar+V.vós.AD.2.PL+IMPF+1+SG
amatronava-vos	amatronar+V.vós.AD.2.PL+IMPF+3+SG
amatronávei-la	amatronar+V.ele.ACC.3.F.SG+IMPF+2+PL
amatronávei-las	amatronar+V.ele.ACC.3.F.PL+IMPF+2+PL
amatronávei-lo	amatronar+V.ele.ACC.3.M.SG+IMPF+2+PL
amatronávei-los	amatronar+V.ele.ACC.3.M.PL+IMPF+2+PL
amatronávei-nos	amatronar+nós.AD.1.PL+IMPF+2+PL
amatronáveis-lhe	amatronar+V.ele.DAT.3.SG+IMPF+2+PL
amatronáveis-lhes	amatronar+V.ele.DAT.3.PL+IMPF+2+PL
amatronáveis-me	amatronar+V.eu.AD.1.SG+IMPF+2+PL
amatronáveis-te	amatronar+V.tu.AD.2.SG+IMPF+2+PL
amatronáveis-vos	amatronar+V.vós.AD.2.PL+IMPF+2+PL
amatrona-vos	amatronar+V.vós.AD.2.PL+PRS+3+SG
amatrone-a	amatronar+V.ele.ACC.3.F.SG+IMP+3+SG
amatrone-as	amatronar+V.ele.ACC.3.F.PL+IMP+3+SG
amatronei-a	amatronar+V.ele.ACC.3.F.SG+PRF+1+SG
amatronei-as	amatronar+V.ele.ACC.3.F.PL+PRF+1+SG
amatronei-lhe	amatronar+V.ele.DAT.3.SG+PRF+1+SG
amatronei-lhes	amatronar+V.ele.DAT.3.PL+PRF+1+SG
amatronei-me	amatronar+V.eu.AD.1.SG+PRF+1+SG
amatronei-nos	amatronar+nós.AD.1.PL+PRF+1+SG
amatronei-o	amatronar+V.ele.ACC.3.M.SG+PRF+1+SG
amatronei-os	amatronar+V.ele.ACC.3.M.PL+PRF+1+SG
amatronei-te	amatronar+V.tu.AD.2.SG+PRF+1+SG
amatronei-vos	amatronar+V.vós.AD.2.PL+PRF+1+SG
amatrone-lhe	amatronar+V.ele.DAT.3.SG+IMP+3+SG
amatrone-lhes	amatronar+V.ele.DAT.3.PL+IMP+3+SG
amatrone-me	amatronar+V.eu.AD.1.SG+IMP+3+SG
amatronem-lhe	amatronar+V.ele.DAT.3.SG+IMP+3+PL
amatronem-lhes	amatronar+V.ele.DAT.3.PL+IMP+3+PL
amatronem-me	amatronar+V.eu.AD.1.SG+IMP+3+PL
amatronem-na	amatronar+V.ele.ACC.3.F.SG+IMP+3+PL
amatronem-nas	amatronar+V.ele.ACC.3.F.PL+IMP+3+PL
amatronem-no	amatronar+V.ele.ACC.3.M.SG+IMP+3+PL
amatronem-nos	amatronar+V.ele.ACC.3.M.PL+IMP+3+PL
amatronem-nos	amatronar+V.nós.AD.1.PL+IMP+3+PL
amatronemo-la	amatronar+V.ele.ACC.3.F.SG+IMP+1+PL
amatronemo-las	amatronar+V.ele.ACC.3.F.PL+IMP+1+PL
amatronemo-lo	amatronar+V.ele.ACC.3.M.SG+IMP+1+PL
amatronemo-los	amatronar+V.ele.ACC.3.M.PL+IMP+1+PL
amatronemo-nos	amatronar+nós.AD.1.PL+IMP+1+PL
amatronemos-lhe	amatronar+V.ele.DAT.3.SG+IMP+1+PL
amatronemos-lhes	amatronar+V.ele.DAT.3.PL+IMP+1+PL
amatronemos-me	amatronar+V.eu.AD.1.SG+IMP+1+PL
amatronemos-te	amatronar+V.tu.AD.2.SG+IMP+1+PL
amatronemos-vos	amatronar+V.vós.AD.2.PL+IMP+1+PL
amatronem-se	amatronar+V.ele.REFL+IMP+3+PL
amatronem-te	amatronar+V.tu.AD.2.SG+IMP+3+PL
amatronem-vos	amatronar+V.vós.AD.2.PL+IMP+3+PL
amatrone-nos	amatronar+nós.AD.1.PL+IMP+3+SG
amatrone-o	amatronar+V.ele.ACC.3.M.SG+IMP+3+SG
amatrone-os	amatronar+V.ele.ACC.3.M.PL+IMP+3+SG
amatrone-se	amatronar+V.ele.REFL+IMP+3+SG
amatrone-te	amatronar+V.tu.AD.2.SG+IMP+3+SG
amatrone-vos	amatronar+V.vós.AD.2.PL+IMP+3+SG
amatrono-a	amatronar+V.ele.ACC.3.F.SG+PRS+1+SG
amatrono-as	amatronar+V.ele.ACC.3.F.PL+PRS+1+SG
amatrono-lhe	amatronar+V.ele.DAT.3.SG+PRS+1+SG
amatrono-lhes	amatronar+V.ele.DAT.3.PL+PRS+1+SG
amatrono-me	amatronar+V.eu.AD.1.SG+PRS+1+SG
amatrono-nos	amatronar+nós.AD.1.PL+PRS+1+SG
amatrono-o	amatronar+V.ele.ACC.3.M.SG+PRS+1+SG
amatrono-os	amatronar+V.ele.ACC.3.M.PL+PRS+1+SG
amatrono-te	amatronar+V.tu.AD.2.SG+PRS+1+SG
amatronou-a	amatronar+V.ele.ACC.3.F.SG+PRF+3+SG
amatronou-as	amatronar+V.ele.ACC.3.F.PL+PRF+3+SG
amatronou-lhe	amatronar+V.ele.DAT.3.SG+PRF+3+SG
amatronou-lhes	amatronar+V.ele.DAT.3.PL+PRF+3+SG
amatronou-me	amatronar+V.eu.AD.1.SG+PRF+3+SG
amatronou-nos	amatronar+nós.AD.1.PL+PRF+3+SG
amatronou-o	amatronar+V.ele.ACC.3.M.SG+PRF+3+SG
amatronou-os	amatronar+V.ele.ACC.3.M.PL+PRF+3+SG
amatronou-se	amatronar+V.ele.REFL+PRF+3+SG
amatronou-te	amatronar+V.tu.AD.2.SG+PRF+3+SG
amatronou-vos	amatronar+V.vós.AD.2.PL+PRF+3+SG
amatrono-vos	amatronar+V.vós.AD.2.PL+PRS+1+SG
amatula-a	amatular+V.ele.ACC.3.F.SG+PRS+3+SG
amatula-as	amatular+V.ele.ACC.3.F.PL+PRS+3+SG
amatulai-la	amatular+V.ele.ACC.3.F.SG+PRS+2+PL
amatulai-las	amatular+V.ele.ACC.3.F.PL+PRS+2+PL
amatulai-lo	amatular+V.ele.ACC.3.M.SG+PRS+2+PL
amatulai-los	amatular+V.ele.ACC.3.M.PL+PRS+2+PL
amatulai-nos	amatular+nós.AD.1.PL+PRS+2+PL
amatulais-lhe	amatular+V.ele.DAT.3.SG+PRS+2+PL
amatulais-lhes	amatular+V.ele.DAT.3.PL+PRS+2+PL
amatulais-me	amatular+V.eu.AD.1.SG+PRS+2+PL
amatulais-te	amatular+V.tu.AD.2.SG+PRS+2+PL
amatulais-vos	amatular+V.vós.AD.2.PL+PRS+2+PL
amatulá-la-á	amatular+V.ele.ACC.3.F.SG+FUT+3+SG
amatulá-la	amatular+V.ele.ACC.3.F.SG+INF+1+SG
amatulá-la	amatular+V.ele.ACC.3.F.SG+INF+3+SG
amatula-la	amatular+V.ele.ACC.3.F.SG+PRS+2+SG
amatulá-la	amatular+V.ele.ACC.3.F.SG+SBJF+1+SG
amatulá-la	amatular+V.ele.ACC.3.F.SG+SBJF+3+SG
amatulá-la-ão	amatular+V.ele.ACC.3.F.SG+FUT+3+PL
amatulá-la-ás	amatular+V.ele.ACC.3.F.SG+FUT+2+SG
amatulá-la-ei	amatular+V.ele.ACC.3.F.SG+FUT+1+SG
amatulá-la-eis	amatular+V.ele.ACC.3.F.SG+FUT+2+PL
amatulá-la-emos	amatular+V.ele.ACC.3.F.SG+FUT+1+PL
amatulá-la-ia	amatular+V.ele.ACC.3.F.SG+COND+1+SG
amatulá-la-ia	amatular+V.ele.ACC.3.F.SG+COND+3+SG
amatulá-la-iam	amatular+V.ele.ACC.3.F.SG+COND+3+PL
amatulá-la-íamos	amatular+V.ele.ACC.3.F.SG+COND+1+PL
amatulá-la-ias	amatular+V.ele.ACC.3.F.SG+COND+2+SG
amatulá-la-íeis	amatular+V.ele.ACC.3.F.SG+COND+2+PL
amatulá-las-á	amatular+V.ele.ACC.3.F.PL+FUT+3+SG
amatulá-las	amatular+V.ele.ACC.3.F.PL+INF+1+SG
amatulá-las	amatular+V.ele.ACC.3.F.PL+INF+3+SG
amatula-las	amatular+V.ele.ACC.3.F.PL+PRS+2+SG
amatulá-las	amatular+V.ele.ACC.3.F.PL+SBJF+1+SG
amatulá-las	amatular+V.ele.ACC.3.F.PL+SBJF+3+SG
amatulá-las-ão	amatular+V.ele.ACC.3.F.PL+FUT+3+PL
amatulá-las-ás	amatular+V.ele.ACC.3.F.PL+FUT+2+SG
amatulá-las-ei	amatular+V.ele.ACC.3.F.PL+FUT+1+SG
amatulá-las-eis	amatular+V.ele.ACC.3.F.PL+FUT+2+PL
amatulá-las-emos	amatular+V.ele.ACC.3.F.PL+FUT+1+PL
amatulá-las-ia	amatular+V.ele.ACC.3.F.PL+COND+1+SG
amatulá-las-ia	amatular+V.ele.ACC.3.F.PL+COND+3+SG
amatulá-las-iam	amatular+V.ele.ACC.3.F.PL+COND+3+PL
amatulá-las-íamos	amatular+V.ele.ACC.3.F.PL+COND+1+PL
amatulá-las-ias	amatular+V.ele.ACC.3.F.PL+COND+2+SG
amatulá-las-íeis	amatular+V.ele.ACC.3.F.PL+COND+2+PL
amatula-lhe	amatular+V.ele.DAT.3.SG+PRS+3+SG
amatula-lhes	amatular+V.ele.DAT.3.PL+PRS+3+SG
amatulá-lo-á	amatular+V.ele.ACC.3.M.SG+FUT+3+SG
amatulá-lo	amatular+V.ele.ACC.3.M.SG+INF+1+SG
amatulá-lo	amatular+V.ele.ACC.3.M.SG+INF+3+SG
amatula-lo	amatular+V.ele.ACC.3.M.SG+PRS+2+SG
amatulá-lo	amatular+V.ele.ACC.3.M.SG+SBJF+1+SG
amatulá-lo	amatular+V.ele.ACC.3.M.SG+SBJF+3+SG
amatulá-lo-ão	amatular+V.ele.ACC.3.M.SG+FUT+3+PL
amatulá-lo-ás	amatular+V.ele.ACC.3.M.SG+FUT+2+SG
amatulá-lo-ei	amatular+V.ele.ACC.3.M.SG+FUT+1+SG
amatulá-lo-eis	amatular+V.ele.ACC.3.M.SG+FUT+2+PL
amatulá-lo-emos	amatular+V.ele.ACC.3.M.SG+FUT+1+PL
amatulá-lo-ia	amatular+V.ele.ACC.3.M.SG+COND+1+SG
amatulá-lo-ia	amatular+V.ele.ACC.3.M.SG+COND+3+SG
amatulá-lo-iam	amatular+V.ele.ACC.3.M.SG+COND+3+PL
amatulá-lo-íamos	amatular+V.ele.ACC.3.M.SG+COND+1+PL
amatulá-lo-ias	amatular+V.ele.ACC.3.M.SG+COND+2+SG
amatulá-lo-íeis	amatular+V.ele.ACC.3.M.SG+COND+2+PL
amatulá-los-á	amatular+V.ele.ACC.3.M.PL+FUT+3+SG
amatulá-los	amatular+V.ele.ACC.3.M.PL+INF+1+SG
amatulá-los	amatular+V.ele.ACC.3.M.PL+INF+3+SG
amatula-los	amatular+V.ele.ACC.3.M.PL+PRS+2+SG
amatulá-los	amatular+V.ele.ACC.3.M.PL+SBJF+1+SG
amatulá-los	amatular+V.ele.ACC.3.M.PL+SBJF+3+SG
amatulá-los-ão	amatular+V.ele.ACC.3.M.PL+FUT+3+PL
amatulá-los-ás	amatular+V.ele.ACC.3.M.PL+FUT+2+SG
amatulá-los-ei	amatular+V.ele.ACC.3.M.PL+FUT+1+SG
amatulá-los-eis	amatular+V.ele.ACC.3.M.PL+FUT+2+PL
amatulá-los-emos	amatular+V.ele.ACC.3.M.PL+FUT+1+PL
amatulá-los-ia	amatular+V.ele.ACC.3.M.PL+COND+1+SG
amatulá-los-ia	amatular+V.ele.ACC.3.M.PL+COND+3+SG
amatulá-los-iam	amatular+V.ele.ACC.3.M.PL+COND+3+PL
amatulá-los-íamos	amatular+V.ele.ACC.3.M.PL+COND+1+PL
amatulá-los-ias	amatular+V.ele.ACC.3.M.PL+COND+2+SG
amatulá-los-íeis	amatular+V.ele.ACC.3.M.PL+COND+2+PL
amatula-me	amatular+V.eu.AD.1.SG+PRS+3+SG
amatulam-lhe	amatular+V.ele.DAT.3.SG+PRS+3+PL
amatulam-lhes	amatular+V.ele.DAT.3.PL+PRS+3+PL
amatulam-me	amatular+V.eu.AD.1.SG+PRS+3+PL
amatulam-na	amatular+V.ele.ACC.3.F.SG+PRS+3+PL
amatulam-nas	amatular+V.ele.ACC.3.F.PL+PRS+3+PL
amatulam-no	amatular+V.ele.ACC.3.M.SG+PRS+3+PL
amatulam-nos	amatular+V.ele.ACC.3.M.PL+PRS+3+PL
amatulam-nos	amatular+V.nós.AD.1.PL+PRS+3+PL
amatulamo-la	amatular+V.ele.ACC.3.F.SG+PRF+1+PL
amatulamo-la	amatular+V.ele.ACC.3.F.SG+PRS+1+PL
amatulamo-las	amatular+V.ele.ACC.3.F.PL+PRF+1+PL
amatulamo-las	amatular+V.ele.ACC.3.F.PL+PRS+1+PL
amatulamo-lo	amatular+V.ele.ACC.3.M.SG+PRF+1+PL
amatulamo-lo	amatular+V.ele.ACC.3.M.SG+PRS+1+PL
amatulamo-los	amatular+V.ele.ACC.3.M.PL+PRF+1+PL
amatulamo-los	amatular+V.ele.ACC.3.M.PL+PRS+1+PL
amatulamo-nos	amatular+nós.AD.1.PL+PRF+1+PL
amatulamo-nos	amatular+nós.AD.1.PL+PRS+1+PL
amatulamos-lhe	amatular+V.ele.DAT.3.SG+PRF+1+PL
amatulamos-lhe	amatular+V.ele.DAT.3.SG+PRS+1+PL
amatulamos-lhes	amatular+V.ele.DAT.3.PL+PRF+1+PL
amatulamos-lhes	amatular+V.ele.DAT.3.PL+PRS+1+PL
amatulamos-me	amatular+V.eu.AD.1.SG+PRF+1+PL
amatulamos-me	amatular+V.eu.AD.1.SG+PRS+1+PL
amatulamos-te	amatular+V.tu.AD.2.SG+PRF+1+PL
amatulamos-te	amatular+V.tu.AD.2.SG+PRS+1+PL
amatulamos-vos	amatular+V.vós.AD.2.PL+PRF+1+PL
amatulamos-vos	amatular+V.vós.AD.2.PL+PRS+1+PL
amatulam-se	amatular+V.ele.REFL+PRS+3+PL
amatulam-te	amatular+V.tu.AD.2.SG+PRS+3+PL
amatulam-vos	amatular+V.vós.AD.2.PL+PRS+3+PL
amatulando-a	amatular+V.ele.ACC.3.F.SG+GRD
amatulando-as	amatular+V.ele.ACC.3.F.PL+GRD
amatulando-lhe	amatular+V.ele.DAT.3.SG+GRD
amatulando-lhes	amatular+V.ele.DAT.3.PL+GRD
amatulando-me	amatular+V.eu.AD.1.SG+GRD
amatulando-nos	amatular+nós.AD.1.PL+GRD
amatulando-o	amatular+V.ele.ACC.3.M.SG+GRD
amatulando-os	amatular+V.ele.ACC.3.M.PL+GRD
amatulando-se	amatular+V.ele.REFL+GRD
amatulando-te	amatular+V.tu.AD.2.SG+GRD
amatulando-vos	amatular+V.vós.AD.2.PL+GRD
amatula-nos	amatular+nós.AD.1.PL+PRS+2+SG
amatula-nos	amatular+nós.AD.1.PL+PRS+3+SG
amatula-o	amatular+V.ele.ACC.3.M.SG+PRS+3+SG
amatula-os	amatular+V.ele.ACC.3.M.PL+PRS+3+SG
amatulara-a	amatular+V.ele.ACC.3.F.SG+PQP+1+SG
amatulara-a	amatular+V.ele.ACC.3.F.SG+PQP+3+SG
amatulara-as	amatular+V.ele.ACC.3.F.PL+PQP+1+SG
amatulara-as	amatular+V.ele.ACC.3.F.PL+PQP+3+SG
amatulara-la	amatular+V.ele.ACC.3.F.SG+PQP+2+SG
amatulara-las	amatular+V.ele.ACC.3.F.PL+PQP+2+SG
amatulara-lhe	amatular+V.ele.DAT.3.SG+PQP+1+SG
amatulara-lhe	amatular+V.ele.DAT.3.SG+PQP+3+SG
amatulara-lhes	amatular+V.ele.DAT.3.PL+PQP+1+SG
amatulara-lhes	amatular+V.ele.DAT.3.PL+PQP+3+SG
amatulara-lo	amatular+V.ele.ACC.3.M.SG+PQP+2+SG
amatulara-los	amatular+V.ele.ACC.3.M.PL+PQP+2+SG
amatulara-me	amatular+V.eu.AD.1.SG+PQP+1+SG
amatulara-me	amatular+V.eu.AD.1.SG+PQP+3+SG
amatularam-lhe	amatular+V.ele.DAT.3.SG+PQP+3+PL
amatularam-lhe	amatular+V.ele.DAT.3.SG+PRF+3+PL
amatularam-lhes	amatular+V.ele.DAT.3.PL+PQP+3+PL
amatularam-lhes	amatular+V.ele.DAT.3.PL+PRF+3+PL
amatularam-me	amatular+V.eu.AD.1.SG+PQP+3+PL
amatularam-me	amatular+V.eu.AD.1.SG+PRF+3+PL
amatularam-na	amatular+V.ele.ACC.3.F.SG+PQP+3+PL
amatularam-na	amatular+V.ele.ACC.3.F.SG+PRF+3+PL
amatularam-nas	amatular+V.ele.ACC.3.F.PL+PQP+3+PL
amatularam-nas	amatular+V.ele.ACC.3.F.PL+PRF+3+PL
amatularam-no	amatular+V.ele.ACC.3.M.SG+PQP+3+PL
amatularam-no	amatular+V.ele.ACC.3.M.SG+PRF+3+PL
amatularam-nos	amatular+V.ele.ACC.3.M.PL+PQP+3+PL
amatularam-nos	amatular+V.ele.ACC.3.M.PL+PRF+3+PL
amatularam-nos	amatular+V.nós.AD.1.PL+PQP+3+PL
amatularam-nos	amatular+V.nós.AD.1.PL+PRF+3+PL
amatuláramo-la	amatular+V.ele.ACC.3.F.SG+PQP+1+PL
amatuláramo-las	amatular+V.ele.ACC.3.F.PL+PQP+1+PL
amatuláramo-lo	amatular+V.ele.ACC.3.M.SG+PQP+1+PL
amatuláramo-los	amatular+V.ele.ACC.3.M.PL+PQP+1+PL
amatuláramo-nos	amatular+nós.AD.1.PL+PQP+1+PL
amatuláramos-lhe	amatular+V.ele.DAT.3.SG+PQP+1+PL
amatuláramos-lhes	amatular+V.ele.DAT.3.PL+PQP+1+PL
amatuláramos-me	amatular+V.eu.AD.1.SG+PQP+1+PL
amatuláramos-te	amatular+V.tu.AD.2.SG+PQP+1+PL
amatuláramos-vos	amatular+V.vós.AD.2.PL+PQP+1+PL
amatularam-se	amatular+V.ele.REFL+PQP+3+PL
amatularam-se	amatular+V.ele.REFL+PRF+3+PL
amatularam-te	amatular+V.tu.AD.2.SG+PQP+3+PL
amatularam-te	amatular+V.tu.AD.2.SG+PRF+3+PL
amatularam-vos	amatular+V.vós.AD.2.PL+PQP+3+PL
amatularam-vos	amatular+V.vós.AD.2.PL+PRF+3+PL
amatulara-nos	amatular+nós.AD.1.PL+PQP+1+SG
amatulara-nos	amatular+nós.AD.1.PL+PQP+2+SG
amatulara-nos	amatular+nós.AD.1.PL+PQP+3+SG
amatulara-o	amatular+V.ele.ACC.3.M.SG+PQP+1+SG
amatulara-o	amatular+V.ele.ACC.3.M.SG+PQP+3+SG
amatulara-os	amatular+V.ele.ACC.3.M.PL+PQP+1+SG
amatulara-os	amatular+V.ele.ACC.3.M.PL+PQP+3+SG
amatulara-se	amatular+V.ele.REFL+PQP+1+SG
amatulara-se	amatular+V.ele.REFL+PQP+3+SG
amatularas-lhe	amatular+V.ele.DAT.3.SG+PQP+2+SG
amatularas-lhes	amatular+V.ele.DAT.3.PL+PQP+2+SG
amatularas-me	amatular+V.eu.AD.1.SG+PQP+2+SG
amatularas-te	amatular+V.tu.AD.2.SG+PQP+2+SG
amatularas-vos	amatular+V.vós.AD.2.PL+PQP+2+SG
amatulara-te	amatular+V.tu.AD.2.SG+PQP+1+SG
amatulara-te	amatular+V.tu.AD.2.SG+PQP+3+SG
amatulara-vos	amatular+V.vós.AD.2.PL+PQP+1+SG
amatulara-vos	amatular+V.vós.AD.2.PL+PQP+3+SG
amatularde-la	amatular+V.ele.ACC.3.F.SG+INF+2+PL
amatularde-la	amatular+V.ele.ACC.3.F.SG+SBJF+2+PL
amatularde-las	amatular+V.ele.ACC.3.F.PL+INF+2+PL
amatularde-las	amatular+V.ele.ACC.3.F.PL+SBJF+2+PL
amatularde-lo	amatular+V.ele.ACC.3.M.SG+INF+2+PL
amatularde-lo	amatular+V.ele.ACC.3.M.SG+SBJF+2+PL
amatularde-los	amatular+V.ele.ACC.3.M.PL+INF+2+PL
amatularde-los	amatular+V.ele.ACC.3.M.PL+SBJF+2+PL
amatularde-nos	amatular+nós.AD.1.PL+INF+2+PL
amatularde-nos	amatular+nós.AD.1.PL+SBJF+2+PL
amatulardes-lhe	amatular+V.ele.DAT.3.SG+INF+2+PL
amatulardes-lhe	amatular+V.ele.DAT.3.SG+SBJF+2+PL
amatulardes-lhes	amatular+V.ele.DAT.3.PL+INF+2+PL
amatulardes-lhes	amatular+V.ele.DAT.3.PL+SBJF+2+PL
amatulardes-me	amatular+V.eu.AD.1.SG+INF+2+PL
amatulardes-me	amatular+V.eu.AD.1.SG+SBJF+2+PL
amatulardes-te	amatular+V.tu.AD.2.SG+INF+2+PL
amatulardes-te	amatular+V.tu.AD.2.SG+SBJF+2+PL
amatulardes-vos	amatular+V.vós.AD.2.PL+INF+2+PL
amatulardes-vos	amatular+V.vós.AD.2.PL+SBJF+2+PL
amatulárei-la	amatular+V.ele.ACC.3.F.SG+PQP+2+PL
amatulárei-las	amatular+V.ele.ACC.3.F.PL+PQP+2+PL
amatulárei-lo	amatular+V.ele.ACC.3.M.SG+PQP+2+PL
amatulárei-los	amatular+V.ele.ACC.3.M.PL+PQP+2+PL
amatulárei-nos	amatular+nós.AD.1.PL+PQP+2+PL
amatuláreis-lhe	amatular+V.ele.DAT.3.SG+PQP+2+PL
amatuláreis-lhes	amatular+V.ele.DAT.3.PL+PQP+2+PL
amatuláreis-me	amatular+V.eu.AD.1.SG+PQP+2+PL
amatuláreis-te	amatular+V.tu.AD.2.SG+PQP+2+PL
amatuláreis-vos	amatular+V.vós.AD.2.PL+PQP+2+PL
amatulare-la	amatular+V.ele.ACC.3.F.SG+INF+2+SG
amatulare-la	amatular+V.ele.ACC.3.F.SG+SBJF+2+SG
amatulare-las	amatular+V.ele.ACC.3.F.PL+INF+2+SG
amatulare-las	amatular+V.ele.ACC.3.F.PL+SBJF+2+SG
amatulare-lo	amatular+V.ele.ACC.3.M.SG+INF+2+SG
amatulare-lo	amatular+V.ele.ACC.3.M.SG+SBJF+2+SG
amatulare-los	amatular+V.ele.ACC.3.M.PL+INF+2+SG
amatulare-los	amatular+V.ele.ACC.3.M.PL+SBJF+2+SG
amatularem-lhe	amatular+V.ele.DAT.3.SG+INF+3+PL
amatularem-lhe	amatular+V.ele.DAT.3.SG+SBJF+3+PL
amatularem-lhes	amatular+V.ele.DAT.3.PL+INF+3+PL
amatularem-lhes	amatular+V.ele.DAT.3.PL+SBJF+3+PL
amatularem-me	amatular+V.eu.AD.1.SG+INF+3+PL
amatularem-me	amatular+V.eu.AD.1.SG+SBJF+3+PL
amatularem-na	amatular+V.ele.ACC.3.F.SG+INF+3+PL
amatularem-na	amatular+V.ele.ACC.3.F.SG+SBJF+3+PL
amatularem-nas	amatular+V.ele.ACC.3.F.PL+INF+3+PL
amatularem-nas	amatular+V.ele.ACC.3.F.PL+SBJF+3+PL
amatularem-no	amatular+V.ele.ACC.3.M.SG+INF+3+PL
amatularem-no	amatular+V.ele.ACC.3.M.SG+SBJF+3+PL
amatularem-nos	amatular+V.ele.ACC.3.M.PL+INF+3+PL
amatularem-nos	amatular+V.ele.ACC.3.M.PL+SBJF+3+PL
amatularem-nos	amatular+V.nós.AD.1.PL+INF+3+PL
amatularem-nos	amatular+V.nós.AD.1.PL+SBJF+3+PL
amatularem-se	amatular+V.ele.REFL+INF+3+PL
amatularem-se	amatular+V.ele.REFL+SBJF+3+PL
amatularem-te	amatular+V.tu.AD.2.SG+INF+3+PL
amatularem-te	amatular+V.tu.AD.2.SG+SBJF+3+PL
amatularem-vos	amatular+V.vós.AD.2.PL+INF+3+PL
amatularem-vos	amatular+V.vós.AD.2.PL+SBJF+3+PL
amatulare-nos	amatular+nós.AD.1.PL+INF+2+SG
amatulare-nos	amatular+nós.AD.1.PL+SBJF+2+SG
amatulares-lhe	amatular+V.ele.DAT.3.SG+INF+2+SG
amatulares-lhe	amatular+V.ele.DAT.3.SG+SBJF+2+SG
amatulares-lhes	amatular+V.ele.DAT.3.PL+INF+2+SG
amatulares-lhes	amatular+V.ele.DAT.3.PL+SBJF+2+SG
amatulares-me	amatular+V.eu.AD.1.SG+INF+2+SG
amatulares-me	amatular+V.eu.AD.1.SG+SBJF+2+SG
amatulares-te	amatular+V.tu.AD.2.SG+INF+2+SG
amatulares-te	amatular+V.tu.AD.2.SG+SBJF+2+SG
amatulares-vos	amatular+V.vós.AD.2.PL+INF+2+SG
amatulares-vos	amatular+V.vós.AD.2.PL+SBJF+2+SG
amatular-lhe-á	amatular+V.ele.DAT.3.SG+FUT+3+SG
amatular-lhe	amatular+V.ele.DAT.3.SG+INF
amatular-lhe	amatular+V.ele.DAT.3.SG+INF+1+SG
amatular-lhe	amatular+V.ele.DAT.3.SG+INF+3+SG
amatular-lhe	amatular+V.ele.DAT.3.SG+SBJF+1+SG
