anteverteste-los	anteverter+V.ele.ACC.3.M.PL+PRF+2+PL
anteverteste-me	anteverter+V.eu.AD.1.SG+PRF+2+SG
anteverteste-nos	anteverter+nós.AD.1.PL+PRF+2+PL
anteverteste-nos	anteverter+nós.AD.1.PL+PRF+2+SG
anteverteste-o	anteverter+V.ele.ACC.3.M.SG+PRF+2+SG
anteverteste-os	anteverter+V.ele.ACC.3.M.PL+PRF+2+SG
antevertestes-lhe	anteverter+V.ele.DAT.3.SG+PRF+2+PL
antevertestes-lhes	anteverter+V.ele.DAT.3.PL+PRF+2+PL
antevertestes-me	anteverter+V.eu.AD.1.SG+PRF+2+PL
antevertestes-te	anteverter+V.tu.AD.2.SG+PRF+2+PL
antevertestes-vos	anteverter+V.vós.AD.2.PL+PRF+2+PL
anteverteste-te	anteverter+V.tu.AD.2.SG+PRF+2+SG
anteverteste-vos	anteverter+V.vós.AD.2.PL+PRF+2+SG
antevertes-vos	anteverter+V.vós.AD.2.PL+PRS+2+SG
anteverte-te	anteverter+V.tu.AD.2.SG+PRS+3+SG
anteverteu-a	anteverter+V.ele.ACC.3.F.SG+PRF+3+SG
anteverteu-as	anteverter+V.ele.ACC.3.F.PL+PRF+3+SG
anteverteu-lhe	anteverter+V.ele.DAT.3.SG+PRF+3+SG
anteverteu-lhes	anteverter+V.ele.DAT.3.PL+PRF+3+SG
anteverteu-me	anteverter+V.eu.AD.1.SG+PRF+3+SG
anteverteu-nos	anteverter+nós.AD.1.PL+PRF+3+SG
anteverteu-o	anteverter+V.ele.ACC.3.M.SG+PRF+3+SG
anteverteu-os	anteverter+V.ele.ACC.3.M.PL+PRF+3+SG
anteverteu-se	anteverter+V.ele.REFL+PRF+3+SG
anteverteu-te	anteverter+V.tu.AD.2.SG+PRF+3+SG
anteverteu-vos	anteverter+V.vós.AD.2.PL+PRF+3+SG
anteverte-vos	anteverter+V.vós.AD.2.PL+PRS+3+SG
antevertia-a	anteverter+V.ele.ACC.3.F.SG+IMPF+1+SG
antevertia-a	anteverter+V.ele.ACC.3.F.SG+IMPF+3+SG
anteverti-a	anteverter+V.ele.ACC.3.F.SG+PRF+1+SG
antevertia-as	anteverter+V.ele.ACC.3.F.PL+IMPF+1+SG
antevertia-as	anteverter+V.ele.ACC.3.F.PL+IMPF+3+SG
antevertia-la	anteverter+V.ele.ACC.3.F.SG+IMPF+2+SG
antevertia-las	anteverter+V.ele.ACC.3.F.PL+IMPF+2+SG
antevertia-lhe	anteverter+V.ele.DAT.3.SG+IMPF+1+SG
antevertia-lhe	anteverter+V.ele.DAT.3.SG+IMPF+3+SG
antevertia-lhes	anteverter+V.ele.DAT.3.PL+IMPF+1+SG
antevertia-lhes	anteverter+V.ele.DAT.3.PL+IMPF+3+SG
antevertia-lo	anteverter+V.ele.ACC.3.M.SG+IMPF+2+SG
antevertia-los	anteverter+V.ele.ACC.3.M.PL+IMPF+2+SG
antevertia-me	anteverter+V.eu.AD.1.SG+IMPF+1+SG
antevertia-me	anteverter+V.eu.AD.1.SG+IMPF+3+SG
antevertiam-lhe	anteverter+V.ele.DAT.3.SG+IMPF+3+PL
antevertiam-lhes	anteverter+V.ele.DAT.3.PL+IMPF+3+PL
antevertiam-me	anteverter+V.eu.AD.1.SG+IMPF+3+PL
antevertiam-na	anteverter+V.ele.ACC.3.F.SG+IMPF+3+PL
antevertiam-nas	anteverter+V.ele.ACC.3.F.PL+IMPF+3+PL
antevertiam-no	anteverter+V.ele.ACC.3.M.SG+IMPF+3+PL
antevertiam-nos	anteverter+V.ele.ACC.3.M.PL+IMPF+3+PL
antevertiam-nos	anteverter+V.nós.AD.1.PL+IMPF+3+PL
antevertíamo-la	anteverter+V.ele.ACC.3.F.SG+IMPF+1+PL
antevertíamo-las	anteverter+V.ele.ACC.3.F.PL+IMPF+1+PL
antevertíamo-lo	anteverter+V.ele.ACC.3.M.SG+IMPF+1+PL
antevertíamo-los	anteverter+V.ele.ACC.3.M.PL+IMPF+1+PL
antevertíamo-nos	anteverter+nós.AD.1.PL+IMPF+1+PL
antevertíamos-lhe	anteverter+V.ele.DAT.3.SG+IMPF+1+PL
antevertíamos-lhes	anteverter+V.ele.DAT.3.PL+IMPF+1+PL
antevertíamos-me	anteverter+V.eu.AD.1.SG+IMPF+1+PL
antevertíamos-te	anteverter+V.tu.AD.2.SG+IMPF+1+PL
antevertíamos-vos	anteverter+V.vós.AD.2.PL+IMPF+1+PL
antevertiam-se	anteverter+V.ele.REFL+IMPF+3+PL
antevertiam-te	anteverter+V.tu.AD.2.SG+IMPF+3+PL
antevertiam-vos	anteverter+V.vós.AD.2.PL+IMPF+3+PL
antevertia-nos	anteverter+nós.AD.1.PL+IMPF+1+SG
antevertia-nos	anteverter+nós.AD.1.PL+IMPF+2+SG
antevertia-nos	anteverter+nós.AD.1.PL+IMPF+3+SG
antevertia-o	anteverter+V.ele.ACC.3.M.SG+IMPF+1+SG
antevertia-o	anteverter+V.ele.ACC.3.M.SG+IMPF+3+SG
antevertia-os	anteverter+V.ele.ACC.3.M.PL+IMPF+1+SG
antevertia-os	anteverter+V.ele.ACC.3.M.PL+IMPF+3+SG
anteverti-as	anteverter+V.ele.ACC.3.F.PL+PRF+1+SG
antevertia-se	anteverter+V.ele.REFL+IMPF+3+SG
antevertias-lhe	anteverter+V.ele.DAT.3.SG+IMPF+2+SG
antevertias-lhes	anteverter+V.ele.DAT.3.PL+IMPF+2+SG
antevertias-me	anteverter+V.eu.AD.1.SG+IMPF+2+SG
antevertias-te	anteverter+V.tu.AD.2.SG+IMPF+2+SG
antevertias-vos	anteverter+V.vós.AD.2.PL+IMPF+2+SG
antevertia-te	anteverter+V.tu.AD.2.SG+IMPF+1+SG
antevertia-te	anteverter+V.tu.AD.2.SG+IMPF+3+SG
antevertia-vos	anteverter+V.vós.AD.2.PL+IMPF+1+SG
antevertia-vos	anteverter+V.vós.AD.2.PL+IMPF+3+SG
antevertíei-la	anteverter+V.ele.ACC.3.F.SG+IMPF+2+PL
antevertíei-las	anteverter+V.ele.ACC.3.F.PL+IMPF+2+PL
antevertíei-lo	anteverter+V.ele.ACC.3.M.SG+IMPF+2+PL
antevertíei-los	anteverter+V.ele.ACC.3.M.PL+IMPF+2+PL
antevertíei-nos	anteverter+nós.AD.1.PL+IMPF+2+PL
antevertíeis-lhe	anteverter+V.ele.DAT.3.SG+IMPF+2+PL
antevertíeis-lhes	anteverter+V.ele.DAT.3.PL+IMPF+2+PL
antevertíeis-me	anteverter+V.eu.AD.1.SG+IMPF+2+PL
antevertíeis-te	anteverter+V.tu.AD.2.SG+IMPF+2+PL
antevertíeis-vos	anteverter+V.vós.AD.2.PL+IMPF+2+PL
anteverti-lhe	anteverter+V.ele.DAT.3.SG+PRF+1+SG
anteverti-lhes	anteverter+V.ele.DAT.3.PL+PRF+1+SG
anteverti-me	anteverter+V.eu.AD.1.SG+PRF+1+SG
anteverti-nos	anteverter+nós.AD.1.PL+PRF+1+SG
anteverti-o	anteverter+V.ele.ACC.3.M.SG+PRF+1+SG
anteverti-os	anteverter+V.ele.ACC.3.M.PL+PRF+1+SG
anteverti-te	anteverter+V.tu.AD.2.SG+PRF+1+SG
anteverti-vos	anteverter+V.vós.AD.2.PL+PRF+1+SG
anteverto-a	anteverter+V.ele.ACC.3.F.SG+PRS+1+SG
anteverto-as	anteverter+V.ele.ACC.3.F.PL+PRS+1+SG
anteverto-lhe	anteverter+V.ele.DAT.3.SG+PRS+1+SG
anteverto-lhes	anteverter+V.ele.DAT.3.PL+PRS+1+SG
anteverto-me	anteverter+V.eu.AD.1.SG+PRS+1+SG
anteverto-nos	anteverter+nós.AD.1.PL+PRS+1+SG
anteverto-o	anteverter+V.ele.ACC.3.M.SG+PRS+1+SG
anteverto-os	anteverter+V.ele.ACC.3.M.PL+PRS+1+SG
anteverto-te	anteverter+V.tu.AD.2.SG+PRS+1+SG
anteverto-vos	anteverter+V.vós.AD.2.PL+PRS+1+SG
antever-vos-á	antever+V.vós.AD.2.PL+FUT+3+SG
antever-vos	antever+V.vós.AD.2.PL+INF
antever-vos	antever+V.vós.AD.2.PL+INF+1+SG
antever-vos	antever+V.vós.AD.2.PL+INF+3+SG
antever-vos-ão	antever+V.vós.AD.2.PL+FUT+3+PL
antever-vos-ás	antever+V.vós.AD.2.PL+FUT+2+SG
antever-vos-ei	antever+V.vós.AD.2.PL+FUT+1+SG
antever-vos-eis	antever+V.vós.AD.2.PL+FUT+2+PL
antever-vos-emos	antever+V.vós.AD.2.PL+FUT+1+PL
antever-vos-ia	antever+V.vós.AD.2.PL+COND+1+SG
antever-vos-ia	antever+V.vós.AD.2.PL+COND+3+SG
antever-vos-iam	antever+V.vós.AD.2.PL+COND+3+PL
antever-vos-íamos	antever+V.vós.AD.2.PL+COND+1+PL
antever-vos-ias	antever+V.vós.AD.2.PL+COND+2+SG
antever-vos-íeis	antever+V.vós.AD.2.PL+COND+2+PL
antevê-se	antever+V.ele.REFL+PRS+3+SG
antevês-lhe	antever+V.ele.DAT.3.SG+PRS+2+SG
antevês-lhes	antever+V.ele.DAT.3.PL+PRS+2+SG
antevês-me	antever+V.eu.AD.1.SG+PRS+2+SG
antevês-te	antever+V.tu.AD.2.SG+PRS+2+SG
antevês-vos	antever+V.vós.AD.2.PL+PRS+2+SG
antevê-te	antever+V.tu.AD.2.SG+PRS+3+SG
antevê-vos	antever+V.vós.AD.2.PL+PRS+3+SG
antevia-a	antever+V.ele.ACC.3.F.SG+IMPF+1+SG
antevia-a	antever+V.ele.ACC.3.F.SG+IMPF+3+SG
antevi-a	antever+V.ele.ACC.3.F.SG+PRF+1+SG
antevia-as	antever+V.ele.ACC.3.F.PL+IMPF+1+SG
antevia-as	antever+V.ele.ACC.3.F.PL+IMPF+3+SG
antevia-la	antever+V.ele.ACC.3.F.SG+IMPF+2+SG
antevia-las	antever+V.ele.ACC.3.F.PL+IMPF+2+SG
antevia-lhe	antever+V.ele.DAT.3.SG+IMPF+1+SG
antevia-lhe	antever+V.ele.DAT.3.SG+IMPF+3+SG
antevia-lhes	antever+V.ele.DAT.3.PL+IMPF+1+SG
antevia-lhes	antever+V.ele.DAT.3.PL+IMPF+3+SG
antevia-lo	antever+V.ele.ACC.3.M.SG+IMPF+2+SG
antevia-los	antever+V.ele.ACC.3.M.PL+IMPF+2+SG
antevia-me	antever+V.eu.AD.1.SG+IMPF+1+SG
antevia-me	antever+V.eu.AD.1.SG+IMPF+3+SG
anteviam-lhe	antever+V.ele.DAT.3.SG+IMPF+3+PL
anteviam-lhes	antever+V.ele.DAT.3.PL+IMPF+3+PL
anteviam-me	antever+V.eu.AD.1.SG+IMPF+3+PL
anteviam-na	antever+V.ele.ACC.3.F.SG+IMPF+3+PL
anteviam-nas	antever+V.ele.ACC.3.F.PL+IMPF+3+PL
anteviam-no	antever+V.ele.ACC.3.M.SG+IMPF+3+PL
anteviam-nos	antever+V.ele.ACC.3.M.PL+IMPF+3+PL
anteviam-nos	antever+V.nós.AD.1.PL+IMPF+3+PL
antevíamo-la	antever+V.ele.ACC.3.F.SG+IMPF+1+PL
antevíamo-las	antever+V.ele.ACC.3.F.PL+IMPF+1+PL
antevíamo-lo	antever+V.ele.ACC.3.M.SG+IMPF+1+PL
antevíamo-los	antever+V.ele.ACC.3.M.PL+IMPF+1+PL
antevíamo-nos	antever+nós.AD.1.PL+IMPF+1+PL
antevíamos-lhe	antever+V.ele.DAT.3.SG+IMPF+1+PL
antevíamos-lhes	antever+V.ele.DAT.3.PL+IMPF+1+PL
antevíamos-me	antever+V.eu.AD.1.SG+IMPF+1+PL
antevíamos-te	antever+V.tu.AD.2.SG+IMPF+1+PL
antevíamos-vos	antever+V.vós.AD.2.PL+IMPF+1+PL
anteviam-se	antever+V.ele.REFL+IMPF+3+PL
anteviam-te	antever+V.tu.AD.2.SG+IMPF+3+PL
anteviam-vos	antever+V.vós.AD.2.PL+IMPF+3+PL
antevia-nos	antever+nós.AD.1.PL+IMPF+1+SG
antevia-nos	antever+nós.AD.1.PL+IMPF+2+SG
antevia-nos	antever+nós.AD.1.PL+IMPF+3+SG
antevia-o	antever+V.ele.ACC.3.M.SG+IMPF+1+SG
antevia-o	antever+V.ele.ACC.3.M.SG+IMPF+3+SG
antevia-os	antever+V.ele.ACC.3.M.PL+IMPF+1+SG
antevia-os	antever+V.ele.ACC.3.M.PL+IMPF+3+SG
antevi-as	antever+V.ele.ACC.3.F.PL+PRF+1+SG
antevia-se	antever+V.ele.REFL+IMPF+3+SG
antevias-lhe	antever+V.ele.DAT.3.SG+IMPF+2+SG
antevias-lhes	antever+V.ele.DAT.3.PL+IMPF+2+SG
antevias-me	antever+V.eu.AD.1.SG+IMPF+2+SG
antevias-te	antever+V.tu.AD.2.SG+IMPF+2+SG
antevias-vos	antever+V.vós.AD.2.PL+IMPF+2+SG
antevia-te	antever+V.tu.AD.2.SG+IMPF+1+SG
antevia-te	antever+V.tu.AD.2.SG+IMPF+3+SG
antevia-vos	antever+V.vós.AD.2.PL+IMPF+1+SG
antevia-vos	antever+V.vós.AD.2.PL+IMPF+3+SG
antevíei-la	antever+V.ele.ACC.3.F.SG+IMPF+2+PL
antevíei-las	antever+V.ele.ACC.3.F.PL+IMPF+2+PL
antevíei-lo	antever+V.ele.ACC.3.M.SG+IMPF+2+PL
antevíei-los	antever+V.ele.ACC.3.M.PL+IMPF+2+PL
antevíei-nos	antever+nós.AD.1.PL+IMPF+2+PL
antevíeis-lhe	antever+V.ele.DAT.3.SG+IMPF+2+PL
antevíeis-lhes	antever+V.ele.DAT.3.PL+IMPF+2+PL
antevíeis-me	antever+V.eu.AD.1.SG+IMPF+2+PL
antevíeis-te	antever+V.tu.AD.2.SG+IMPF+2+PL
antevíeis-vos	antever+V.vós.AD.2.PL+IMPF+2+PL
antevi-la	antever+V.ele.ACC.3.F.SG+SBJF+1+SG
antevi-la	antever+V.ele.ACC.3.F.SG+SBJF+3+SG
antevi-las	antever+V.ele.ACC.3.F.PL+SBJF+1+SG
antevi-las	antever+V.ele.ACC.3.F.PL+SBJF+3+SG
antevi-lhe	antever+V.ele.DAT.3.SG+PRF+1+SG
antevi-lhes	antever+V.ele.DAT.3.PL+PRF+1+SG
antevi-lo	antever+V.ele.ACC.3.M.SG+SBJF+1+SG
antevi-lo	antever+V.ele.ACC.3.M.SG+SBJF+3+SG
antevi-los	antever+V.ele.ACC.3.M.PL+SBJF+1+SG
antevi-los	antever+V.ele.ACC.3.M.PL+SBJF+3+SG
antevi-me	antever+V.eu.AD.1.SG+PRF+1+SG
antevimo-la	antever+V.ele.ACC.3.F.SG+PRF+1+PL
antevimo-las	antever+V.ele.ACC.3.F.PL+PRF+1+PL
antevimo-lo	antever+V.ele.ACC.3.M.SG+PRF+1+PL
antevimo-los	antever+V.ele.ACC.3.M.PL+PRF+1+PL
antevimo-nos	antever+nós.AD.1.PL+PRF+1+PL
antevimos-lhe	antever+V.ele.DAT.3.SG+PRF+1+PL
antevimos-lhes	antever+V.ele.DAT.3.PL+PRF+1+PL
antevimos-me	antever+V.eu.AD.1.SG+PRF+1+PL
antevimos-te	antever+V.tu.AD.2.SG+PRF+1+PL
antevimos-vos	antever+V.vós.AD.2.PL+PRF+1+PL
antevi-nos	antever+nós.AD.1.PL+PRF+1+SG
antevi-o	antever+V.ele.ACC.3.M.SG+PRF+1+SG
antevi-os	antever+V.ele.ACC.3.M.PL+PRF+1+SG
anteviram-lhe	antever+V.ele.DAT.3.SG+PRF+3+PL
anteviram-lhes	antever+V.ele.DAT.3.PL+PRF+3+PL
anteviram-me	antever+V.eu.AD.1.SG+PRF+3+PL
anteviram-na	antever+V.ele.ACC.3.F.SG+PRF+3+PL
anteviram-nas	antever+V.ele.ACC.3.F.PL+PRF+3+PL
anteviram-no	antever+V.ele.ACC.3.M.SG+PRF+3+PL
anteviram-nos	antever+V.ele.ACC.3.M.PL+PRF+3+PL
anteviram-nos	antever+V.nós.AD.1.PL+PRF+3+PL
anteviram-se	antever+V.ele.REFL+PRF+3+PL
anteviram-te	antever+V.tu.AD.2.SG+PRF+3+PL
anteviram-vos	antever+V.vós.AD.2.PL+PRF+3+PL
antevirde-la	antever+V.ele.ACC.3.F.SG+SBJF+2+PL
antevirde-las	antever+V.ele.ACC.3.F.PL+SBJF+2+PL
antevirde-lo	antever+V.ele.ACC.3.M.SG+SBJF+2+PL
antevirde-los	antever+V.ele.ACC.3.M.PL+SBJF+2+PL
antevirde-nos	antever+nós.AD.1.PL+SBJF+2+PL
antevirdes-lhe	antever+V.ele.DAT.3.SG+SBJF+2+PL
antevirdes-lhes	antever+V.ele.DAT.3.PL+SBJF+2+PL
antevirdes-me	antever+V.eu.AD.1.SG+SBJF+2+PL
antevirdes-te	antever+V.tu.AD.2.SG+SBJF+2+PL
antevirdes-vos	antever+V.vós.AD.2.PL+SBJF+2+PL
antevire-la	antever+V.ele.ACC.3.F.SG+SBJF+2+SG
antevire-las	antever+V.ele.ACC.3.F.PL+SBJF+2+SG
antevire-lo	antever+V.ele.ACC.3.M.SG+SBJF+2+SG
antevire-los	antever+V.ele.ACC.3.M.PL+SBJF+2+SG
antevirem-lhe	antever+V.ele.DAT.3.SG+SBJF+3+PL
antevirem-lhes	antever+V.ele.DAT.3.PL+SBJF+3+PL
antevirem-me	antever+V.eu.AD.1.SG+SBJF+3+PL
antevirem-na	antever+V.ele.ACC.3.F.SG+SBJF+3+PL
antevirem-nas	antever+V.ele.ACC.3.F.PL+SBJF+3+PL
antevirem-no	antever+V.ele.ACC.3.M.SG+SBJF+3+PL
antevirem-nos	antever+V.ele.ACC.3.M.PL+SBJF+3+PL
antevirem-nos	antever+V.nós.AD.1.PL+SBJF+3+PL
antevirem-se	antever+V.ele.REFL+SBJF+3+PL
antevirem-te	antever+V.tu.AD.2.SG+SBJF+3+PL
antevirem-vos	antever+V.vós.AD.2.PL+SBJF+3+PL
antevire-nos	antever+nós.AD.1.PL+SBJF+2+SG
antevires-lhe	antever+V.ele.DAT.3.SG+SBJF+2+SG
antevires-lhes	antever+V.ele.DAT.3.PL+SBJF+2+SG
antevires-me	antever+V.eu.AD.1.SG+SBJF+2+SG
antevires-te	antever+V.tu.AD.2.SG+SBJF+2+SG
antevires-vos	antever+V.vós.AD.2.PL+SBJF+2+SG
antevir-lhe	antever+V.ele.DAT.3.SG+SBJF+1+SG
antevir-lhe	antever+V.ele.DAT.3.SG+SBJF+3+SG
antevir-lhes	antever+V.ele.DAT.3.PL+SBJF+1+SG
antevir-lhes	antever+V.ele.DAT.3.PL+SBJF+3+SG
antevir-me	antever+V.eu.AD.1.SG+SBJF+1+SG
antevir-me	antever+V.eu.AD.1.SG+SBJF+3+SG
antevirmo-la	antever+V.ele.ACC.3.F.SG+SBJF+1+PL
antevirmo-las	antever+V.ele.ACC.3.F.PL+SBJF+1+PL
antevirmo-lo	antever+V.ele.ACC.3.M.SG+SBJF+1+PL
antevirmo-los	antever+V.ele.ACC.3.M.PL+SBJF+1+PL
antevirmo-nos	antever+nós.AD.1.PL+SBJF+1+PL
antevirmos-lhe	antever+V.ele.DAT.3.SG+SBJF+1+PL
antevirmos-lhes	antever+V.ele.DAT.3.PL+SBJF+1+PL
antevirmos-me	antever+V.eu.AD.1.SG+SBJF+1+PL
antevirmos-te	antever+V.tu.AD.2.SG+SBJF+1+PL
antevirmos-vos	antever+V.vós.AD.2.PL+SBJF+1+PL
antevir-nos	antever+nós.AD.1.PL+SBJF+1+SG
antevir-nos	antever+nós.AD.1.PL+SBJF+3+SG
antevir-se	antever+V.ele.REFL+SBJF+3+SG
antevir-te	antever+V.tu.AD.2.SG+SBJF+1+SG
antevir-te	antever+V.tu.AD.2.SG+SBJF+3+SG
antevir-vos	antever+V.vós.AD.2.PL+SBJF+1+SG
antevir-vos	antever+V.vós.AD.2.PL+SBJF+3+SG
anteviste-a	antever+V.ele.ACC.3.F.SG+PRF+2+SG
anteviste-as	antever+V.ele.ACC.3.F.PL+PRF+2+SG
anteviste-la	antever+V.ele.ACC.3.F.SG+PRF+2+PL
anteviste-las	antever+V.ele.ACC.3.F.PL+PRF+2+PL
anteviste-lhe	antever+V.ele.DAT.3.SG+PRF+2+SG
anteviste-lhes	antever+V.ele.DAT.3.PL+PRF+2+SG
anteviste-lo	antever+V.ele.ACC.3.M.SG+PRF+2+PL
anteviste-los	antever+V.ele.ACC.3.M.PL+PRF+2+PL
anteviste-me	antever+V.eu.AD.1.SG+PRF+2+SG
anteviste-nos	antever+nós.AD.1.PL+PRF+2+PL
anteviste-nos	antever+nós.AD.1.PL+PRF+2+SG
anteviste-o	antever+V.ele.ACC.3.M.SG+PRF+2+SG
anteviste-os	antever+V.ele.ACC.3.M.PL+PRF+2+SG
antevistes-lhe	antever+V.ele.DAT.3.SG+PRF+2+PL
antevistes-lhes	antever+V.ele.DAT.3.PL+PRF+2+PL
antevistes-me	antever+V.eu.AD.1.SG+PRF+2+PL
antevistes-te	antever+V.tu.AD.2.SG+PRF+2+PL
antevistes-vos	antever+V.vós.AD.2.PL+PRF+2+PL
anteviste-te	antever+V.tu.AD.2.SG+PRF+2+SG
anteviste-vos	antever+V.vós.AD.2.PL+PRF+2+SG
antevi-te	antever+V.tu.AD.2.SG+PRF+1+SG
anteviu-a	antever+V.ele.ACC.3.F.SG+PRF+3+SG
anteviu-as	antever+V.ele.ACC.3.F.PL+PRF+3+SG
anteviu-lhe	antever+V.ele.DAT.3.SG+PRF+3+SG
anteviu-lhes	antever+V.ele.DAT.3.PL+PRF+3+SG
anteviu-me	antever+V.eu.AD.1.SG+PRF+3+SG
anteviu-nos	antever+nós.AD.1.PL+PRF+3+SG
anteviu-o	antever+V.ele.ACC.3.M.SG+PRF+3+SG
anteviu-os	antever+V.ele.ACC.3.M.PL+PRF+3+SG
anteviu-se	antever+V.ele.REFL+PRF+3+SG
anteviu-te	antever+V.tu.AD.2.SG+PRF+3+SG
anteviu-vos	antever+V.vós.AD.2.PL+PRF+3+SG
antevi-vos	antever+V.vós.AD.2.PL+PRF+1+SG
ante-vos	antar+V.vós.AD.2.PL+IMP+3+SG
antipatiza-a	antipatizar+V.ele.ACC.3.F.SG+PRS+3+SG
antipatiza-as	antipatizar+V.ele.ACC.3.F.PL+PRS+3+SG
antipatizai-la	antipatizar+V.ele.ACC.3.F.SG+PRS+2+PL
antipatizai-las	antipatizar+V.ele.ACC.3.F.PL+PRS+2+PL
antipatizai-lo	antipatizar+V.ele.ACC.3.M.SG+PRS+2+PL
antipatizai-los	antipatizar+V.ele.ACC.3.M.PL+PRS+2+PL
antipatizai-nos	antipatizar+nós.AD.1.PL+PRS+2+PL
antipatizais-lhe	antipatizar+V.ele.DAT.3.SG+PRS+2+PL
antipatizais-lhes	antipatizar+V.ele.DAT.3.PL+PRS+2+PL
antipatizais-me	antipatizar+V.eu.AD.1.SG+PRS+2+PL
antipatizais-te	antipatizar+V.tu.AD.2.SG+PRS+2+PL
antipatizais-vos	antipatizar+V.vós.AD.2.PL+PRS+2+PL
antipatizá-la-á	antipatizar+V.ele.ACC.3.F.SG+FUT+3+SG
antipatizá-la	antipatizar+V.ele.ACC.3.F.SG+INF+1+SG
antipatizá-la	antipatizar+V.ele.ACC.3.F.SG+INF+3+SG
antipatiza-la	antipatizar+V.ele.ACC.3.F.SG+PRS+2+SG
antipatizá-la	antipatizar+V.ele.ACC.3.F.SG+SBJF+1+SG
antipatizá-la	antipatizar+V.ele.ACC.3.F.SG+SBJF+3+SG
antipatizá-la-ão	antipatizar+V.ele.ACC.3.F.SG+FUT+3+PL
antipatizá-la-ás	antipatizar+V.ele.ACC.3.F.SG+FUT+2+SG
antipatizá-la-ei	antipatizar+V.ele.ACC.3.F.SG+FUT+1+SG
antipatizá-la-eis	antipatizar+V.ele.ACC.3.F.SG+FUT+2+PL
antipatizá-la-emos	antipatizar+V.ele.ACC.3.F.SG+FUT+1+PL
antipatizá-la-ia	antipatizar+V.ele.ACC.3.F.SG+COND+1+SG
antipatizá-la-ia	antipatizar+V.ele.ACC.3.F.SG+COND+3+SG
antipatizá-la-iam	antipatizar+V.ele.ACC.3.F.SG+COND+3+PL
antipatizá-la-íamos	antipatizar+V.ele.ACC.3.F.SG+COND+1+PL
antipatizá-la-ias	antipatizar+V.ele.ACC.3.F.SG+COND+2+SG
antipatizá-la-íeis	antipatizar+V.ele.ACC.3.F.SG+COND+2+PL
antipatizá-las-á	antipatizar+V.ele.ACC.3.F.PL+FUT+3+SG
antipatizá-las	antipatizar+V.ele.ACC.3.F.PL+INF+1+SG
antipatizá-las	antipatizar+V.ele.ACC.3.F.PL+INF+3+SG
antipatiza-las	antipatizar+V.ele.ACC.3.F.PL+PRS+2+SG
antipatizá-las	antipatizar+V.ele.ACC.3.F.PL+SBJF+1+SG
antipatizá-las	antipatizar+V.ele.ACC.3.F.PL+SBJF+3+SG
antipatizá-las-ão	antipatizar+V.ele.ACC.3.F.PL+FUT+3+PL
antipatizá-las-ás	antipatizar+V.ele.ACC.3.F.PL+FUT+2+SG
antipatizá-las-ei	antipatizar+V.ele.ACC.3.F.PL+FUT+1+SG
antipatizá-las-eis	antipatizar+V.ele.ACC.3.F.PL+FUT+2+PL
antipatizá-las-emos	antipatizar+V.ele.ACC.3.F.PL+FUT+1+PL
antipatizá-las-ia	antipatizar+V.ele.ACC.3.F.PL+COND+1+SG
antipatizá-las-ia	antipatizar+V.ele.ACC.3.F.PL+COND+3+SG
antipatizá-las-iam	antipatizar+V.ele.ACC.3.F.PL+COND+3+PL
antipatizá-las-íamos	antipatizar+V.ele.ACC.3.F.PL+COND+1+PL
antipatizá-las-ias	antipatizar+V.ele.ACC.3.F.PL+COND+2+SG
antipatizá-las-íeis	antipatizar+V.ele.ACC.3.F.PL+COND+2+PL
antipatiza-lhe	antipatizar+V.ele.DAT.3.SG+PRS+3+SG
antipatiza-lhes	antipatizar+V.ele.DAT.3.PL+PRS+3+SG
antipatizá-lo-á	antipatizar+V.ele.ACC.3.M.SG+FUT+3+SG
antipatizá-lo	antipatizar+V.ele.ACC.3.M.SG+INF+1+SG
antipatizá-lo	antipatizar+V.ele.ACC.3.M.SG+INF+3+SG
antipatiza-lo	antipatizar+V.ele.ACC.3.M.SG+PRS+2+SG
antipatizá-lo	antipatizar+V.ele.ACC.3.M.SG+SBJF+1+SG
antipatizá-lo	antipatizar+V.ele.ACC.3.M.SG+SBJF+3+SG
antipatizá-lo-ão	antipatizar+V.ele.ACC.3.M.SG+FUT+3+PL
antipatizá-lo-ás	antipatizar+V.ele.ACC.3.M.SG+FUT+2+SG
antipatizá-lo-ei	antipatizar+V.ele.ACC.3.M.SG+FUT+1+SG
antipatizá-lo-eis	antipatizar+V.ele.ACC.3.M.SG+FUT+2+PL
antipatizá-lo-emos	antipatizar+V.ele.ACC.3.M.SG+FUT+1+PL
antipatizá-lo-ia	antipatizar+V.ele.ACC.3.M.SG+COND+1+SG
antipatizá-lo-ia	antipatizar+V.ele.ACC.3.M.SG+COND+3+SG
antipatizá-lo-iam	antipatizar+V.ele.ACC.3.M.SG+COND+3+PL
antipatizá-lo-íamos	antipatizar+V.ele.ACC.3.M.SG+COND+1+PL
antipatizá-lo-ias	antipatizar+V.ele.ACC.3.M.SG+COND+2+SG
antipatizá-lo-íeis	antipatizar+V.ele.ACC.3.M.SG+COND+2+PL
antipatizá-los-á	antipatizar+V.ele.ACC.3.M.PL+FUT+3+SG
antipatizá-los	antipatizar+V.ele.ACC.3.M.PL+INF+1+SG
antipatizá-los	antipatizar+V.ele.ACC.3.M.PL+INF+3+SG
antipatiza-los	antipatizar+V.ele.ACC.3.M.PL+PRS+2+SG
antipatizá-los	antipatizar+V.ele.ACC.3.M.PL+SBJF+1+SG
antipatizá-los	antipatizar+V.ele.ACC.3.M.PL+SBJF+3+SG
antipatizá-los-ão	antipatizar+V.ele.ACC.3.M.PL+FUT+3+PL
antipatizá-los-ás	antipatizar+V.ele.ACC.3.M.PL+FUT+2+SG
antipatizá-los-ei	antipatizar+V.ele.ACC.3.M.PL+FUT+1+SG
antipatizá-los-eis	antipatizar+V.ele.ACC.3.M.PL+FUT+2+PL
antipatizá-los-emos	antipatizar+V.ele.ACC.3.M.PL+FUT+1+PL
antipatizá-los-ia	antipatizar+V.ele.ACC.3.M.PL+COND+1+SG
antipatizá-los-ia	antipatizar+V.ele.ACC.3.M.PL+COND+3+SG
antipatizá-los-iam	antipatizar+V.ele.ACC.3.M.PL+COND+3+PL
antipatizá-los-íamos	antipatizar+V.ele.ACC.3.M.PL+COND+1+PL
antipatizá-los-ias	antipatizar+V.ele.ACC.3.M.PL+COND+2+SG
antipatizá-los-íeis	antipatizar+V.ele.ACC.3.M.PL+COND+2+PL
antipatiza-me	antipatizar+V.eu.AD.1.SG+PRS+3+SG
antipatizam-lhe	antipatizar+V.ele.DAT.3.SG+PRS+3+PL
antipatizam-lhes	antipatizar+V.ele.DAT.3.PL+PRS+3+PL
antipatizam-me	antipatizar+V.eu.AD.1.SG+PRS+3+PL
antipatizam-na	antipatizar+V.ele.ACC.3.F.SG+PRS+3+PL
antipatizam-nas	antipatizar+V.ele.ACC.3.F.PL+PRS+3+PL
antipatizam-no	antipatizar+V.ele.ACC.3.M.SG+PRS+3+PL
antipatizam-nos	antipatizar+V.ele.ACC.3.M.PL+PRS+3+PL
antipatizam-nos	antipatizar+V.nós.AD.1.PL+PRS+3+PL
antipatizamo-la	antipatizar+V.ele.ACC.3.F.SG+PRF+1+PL
antipatizamo-la	antipatizar+V.ele.ACC.3.F.SG+PRS+1+PL
antipatizamo-las	antipatizar+V.ele.ACC.3.F.PL+PRF+1+PL
antipatizamo-las	antipatizar+V.ele.ACC.3.F.PL+PRS+1+PL
antipatizamo-lo	antipatizar+V.ele.ACC.3.M.SG+PRF+1+PL
antipatizamo-lo	antipatizar+V.ele.ACC.3.M.SG+PRS+1+PL
antipatizamo-los	antipatizar+V.ele.ACC.3.M.PL+PRF+1+PL
antipatizamo-los	antipatizar+V.ele.ACC.3.M.PL+PRS+1+PL
antipatizamo-nos	antipatizar+nós.AD.1.PL+PRF+1+PL
antipatizamo-nos	antipatizar+nós.AD.1.PL+PRS+1+PL
antipatizamos-lhe	antipatizar+V.ele.DAT.3.SG+PRF+1+PL
antipatizamos-lhe	antipatizar+V.ele.DAT.3.SG+PRS+1+PL
antipatizamos-lhes	antipatizar+V.ele.DAT.3.PL+PRF+1+PL
antipatizamos-lhes	antipatizar+V.ele.DAT.3.PL+PRS+1+PL
antipatizamos-me	antipatizar+V.eu.AD.1.SG+PRF+1+PL
antipatizamos-me	antipatizar+V.eu.AD.1.SG+PRS+1+PL
antipatizamos-te	antipatizar+V.tu.AD.2.SG+PRF+1+PL
antipatizamos-te	antipatizar+V.tu.AD.2.SG+PRS+1+PL
antipatizamos-vos	antipatizar+V.vós.AD.2.PL+PRF+1+PL
antipatizamos-vos	antipatizar+V.vós.AD.2.PL+PRS+1+PL
antipatizam-se	antipatizar+V.ele.REFL+PRS+3+PL
antipatizam-te	antipatizar+V.tu.AD.2.SG+PRS+3+PL
antipatizam-vos	antipatizar+V.vós.AD.2.PL+PRS+3+PL
antipatizando-a	antipatizar+V.ele.ACC.3.F.SG+GRD
antipatizando-as	antipatizar+V.ele.ACC.3.F.PL+GRD
antipatizando-lhe	antipatizar+V.ele.DAT.3.SG+GRD
antipatizando-lhes	antipatizar+V.ele.DAT.3.PL+GRD
antipatizando-me	antipatizar+V.eu.AD.1.SG+GRD
antipatizando-nos	antipatizar+nós.AD.1.PL+GRD
antipatizando-o	antipatizar+V.ele.ACC.3.M.SG+GRD
antipatizando-os	antipatizar+V.ele.ACC.3.M.PL+GRD
antipatizando-se	antipatizar+V.ele.REFL+GRD
antipatizando-te	antipatizar+V.tu.AD.2.SG+GRD
antipatizando-vos	antipatizar+V.vós.AD.2.PL+GRD
antipatiza-nos	antipatizar+nós.AD.1.PL+PRS+2+SG
antipatiza-nos	antipatizar+nós.AD.1.PL+PRS+3+SG
antipatiza-o	antipatizar+V.ele.ACC.3.M.SG+PRS+3+SG
antipatiza-os	antipatizar+V.ele.ACC.3.M.PL+PRS+3+SG
antipatizara-a	antipatizar+V.ele.ACC.3.F.SG+PQP+1+SG
antipatizara-a	antipatizar+V.ele.ACC.3.F.SG+PQP+3+SG
antipatizara-as	antipatizar+V.ele.ACC.3.F.PL+PQP+1+SG
antipatizara-as	antipatizar+V.ele.ACC.3.F.PL+PQP+3+SG
antipatizara-la	antipatizar+V.ele.ACC.3.F.SG+PQP+2+SG
antipatizara-las	antipatizar+V.ele.ACC.3.F.PL+PQP+2+SG
antipatizara-lhe	antipatizar+V.ele.DAT.3.SG+PQP+1+SG
antipatizara-lhe	antipatizar+V.ele.DAT.3.SG+PQP+3+SG
antipatizara-lhes	antipatizar+V.ele.DAT.3.PL+PQP+1+SG
antipatizara-lhes	antipatizar+V.ele.DAT.3.PL+PQP+3+SG
antipatizara-lo	antipatizar+V.ele.ACC.3.M.SG+PQP+2+SG
antipatizara-los	antipatizar+V.ele.ACC.3.M.PL+PQP+2+SG
antipatizara-me	antipatizar+V.eu.AD.1.SG+PQP+1+SG
antipatizara-me	antipatizar+V.eu.AD.1.SG+PQP+3+SG
antipatizaram-lhe	antipatizar+V.ele.DAT.3.SG+PQP+3+PL
antipatizaram-lhe	antipatizar+V.ele.DAT.3.SG+PRF+3+PL
antipatizaram-lhes	antipatizar+V.ele.DAT.3.PL+PQP+3+PL
antipatizaram-lhes	antipatizar+V.ele.DAT.3.PL+PRF+3+PL
antipatizaram-me	antipatizar+V.eu.AD.1.SG+PQP+3+PL
antipatizaram-me	antipatizar+V.eu.AD.1.SG+PRF+3+PL
antipatizaram-na	antipatizar+V.ele.ACC.3.F.SG+PQP+3+PL
antipatizaram-na	antipatizar+V.ele.ACC.3.F.SG+PRF+3+PL
antipatizaram-nas	antipatizar+V.ele.ACC.3.F.PL+PQP+3+PL
antipatizaram-nas	antipatizar+V.ele.ACC.3.F.PL+PRF+3+PL
antipatizaram-no	antipatizar+V.ele.ACC.3.M.SG+PQP+3+PL
antipatizaram-no	antipatizar+V.ele.ACC.3.M.SG+PRF+3+PL
antipatizaram-nos	antipatizar+V.ele.ACC.3.M.PL+PQP+3+PL
antipatizaram-nos	antipatizar+V.ele.ACC.3.M.PL+PRF+3+PL
antipatizaram-nos	antipatizar+V.nós.AD.1.PL+PQP+3+PL
antipatizaram-nos	antipatizar+V.nós.AD.1.PL+PRF+3+PL
antipatizáramo-la	antipatizar+V.ele.ACC.3.F.SG+PQP+1+PL
antipatizáramo-las	antipatizar+V.ele.ACC.3.F.PL+PQP+1+PL
antipatizáramo-lo	antipatizar+V.ele.ACC.3.M.SG+PQP+1+PL
antipatizáramo-los	antipatizar+V.ele.ACC.3.M.PL+PQP+1+PL
antipatizáramo-nos	antipatizar+nós.AD.1.PL+PQP+1+PL
antipatizáramos-lhe	antipatizar+V.ele.DAT.3.SG+PQP+1+PL
antipatizáramos-lhes	antipatizar+V.ele.DAT.3.PL+PQP+1+PL
antipatizáramos-me	antipatizar+V.eu.AD.1.SG+PQP+1+PL
antipatizáramos-te	antipatizar+V.tu.AD.2.SG+PQP+1+PL
antipatizáramos-vos	antipatizar+V.vós.AD.2.PL+PQP+1+PL
antipatizaram-se	antipatizar+V.ele.REFL+PQP+3+PL
antipatizaram-se	antipatizar+V.ele.REFL+PRF+3+PL
antipatizaram-te	antipatizar+V.tu.AD.2.SG+PQP+3+PL
antipatizaram-te	antipatizar+V.tu.AD.2.SG+PRF+3+PL
antipatizaram-vos	antipatizar+V.vós.AD.2.PL+PQP+3+PL
antipatizaram-vos	antipatizar+V.vós.AD.2.PL+PRF+3+PL
antipatizara-nos	antipatizar+nós.AD.1.PL+PQP+1+SG
antipatizara-nos	antipatizar+nós.AD.1.PL+PQP+2+SG
antipatizara-nos	antipatizar+nós.AD.1.PL+PQP+3+SG
antipatizara-o	antipatizar+V.ele.ACC.3.M.SG+PQP+1+SG
antipatizara-o	antipatizar+V.ele.ACC.3.M.SG+PQP+3+SG
antipatizara-os	antipatizar+V.ele.ACC.3.M.PL+PQP+1+SG
antipatizara-os	antipatizar+V.ele.ACC.3.M.PL+PQP+3+SG
antipatizara-se	antipatizar+V.ele.REFL+PQP+1+SG
antipatizara-se	antipatizar+V.ele.REFL+PQP+3+SG
antipatizaras-lhe	antipatizar+V.ele.DAT.3.SG+PQP+2+SG
antipatizaras-lhes	antipatizar+V.ele.DAT.3.PL+PQP+2+SG
antipatizaras-me	antipatizar+V.eu.AD.1.SG+PQP+2+SG
antipatizaras-te	antipatizar+V.tu.AD.2.SG+PQP+2+SG
antipatizaras-vos	antipatizar+V.vós.AD.2.PL+PQP+2+SG
antipatizara-te	antipatizar+V.tu.AD.2.SG+PQP+1+SG
antipatizara-te	antipatizar+V.tu.AD.2.SG+PQP+3+SG
antipatizara-vos	antipatizar+V.vós.AD.2.PL+PQP+1+SG
antipatizara-vos	antipatizar+V.vós.AD.2.PL+PQP+3+SG
antipatizarde-la	antipatizar+V.ele.ACC.3.F.SG+INF+2+PL
antipatizarde-la	antipatizar+V.ele.ACC.3.F.SG+SBJF+2+PL
antipatizarde-las	antipatizar+V.ele.ACC.3.F.PL+INF+2+PL
antipatizarde-las	antipatizar+V.ele.ACC.3.F.PL+SBJF+2+PL
antipatizarde-lo	antipatizar+V.ele.ACC.3.M.SG+INF+2+PL
antipatizarde-lo	antipatizar+V.ele.ACC.3.M.SG+SBJF+2+PL
antipatizarde-los	antipatizar+V.ele.ACC.3.M.PL+INF+2+PL
antipatizarde-los	antipatizar+V.ele.ACC.3.M.PL+SBJF+2+PL
antipatizarde-nos	antipatizar+nós.AD.1.PL+INF+2+PL
antipatizarde-nos	antipatizar+nós.AD.1.PL+SBJF+2+PL
antipatizardes-lhe	antipatizar+V.ele.DAT.3.SG+INF+2+PL
antipatizardes-lhe	antipatizar+V.ele.DAT.3.SG+SBJF+2+PL
antipatizardes-lhes	antipatizar+V.ele.DAT.3.PL+INF+2+PL
antipatizardes-lhes	antipatizar+V.ele.DAT.3.PL+SBJF+2+PL
antipatizardes-me	antipatizar+V.eu.AD.1.SG+INF+2+PL
antipatizardes-me	antipatizar+V.eu.AD.1.SG+SBJF+2+PL
antipatizardes-te	antipatizar+V.tu.AD.2.SG+INF+2+PL
antipatizardes-te	antipatizar+V.tu.AD.2.SG+SBJF+2+PL
antipatizardes-vos	antipatizar+V.vós.AD.2.PL+INF+2+PL
antipatizardes-vos	antipatizar+V.vós.AD.2.PL+SBJF+2+PL
antipatizárei-la	antipatizar+V.ele.ACC.3.F.SG+PQP+2+PL
antipatizárei-las	antipatizar+V.ele.ACC.3.F.PL+PQP+2+PL
antipatizárei-lo	antipatizar+V.ele.ACC.3.M.SG+PQP+2+PL
antipatizárei-los	antipatizar+V.ele.ACC.3.M.PL+PQP+2+PL
antipatizárei-nos	antipatizar+nós.AD.1.PL+PQP+2+PL
antipatizáreis-lhe	antipatizar+V.ele.DAT.3.SG+PQP+2+PL
antipatizáreis-lhes	antipatizar+V.ele.DAT.3.PL+PQP+2+PL
antipatizáreis-me	antipatizar+V.eu.AD.1.SG+PQP+2+PL
antipatizáreis-te	antipatizar+V.tu.AD.2.SG+PQP+2+PL
antipatizáreis-vos	antipatizar+V.vós.AD.2.PL+PQP+2+PL
antipatizare-la	antipatizar+V.ele.ACC.3.F.SG+INF+2+SG
antipatizare-la	antipatizar+V.ele.ACC.3.F.SG+SBJF+2+SG
antipatizare-las	antipatizar+V.ele.ACC.3.F.PL+INF+2+SG
antipatizare-las	antipatizar+V.ele.ACC.3.F.PL+SBJF+2+SG
antipatizare-lo	antipatizar+V.ele.ACC.3.M.SG+INF+2+SG
antipatizare-lo	antipatizar+V.ele.ACC.3.M.SG+SBJF+2+SG
antipatizare-los	antipatizar+V.ele.ACC.3.M.PL+INF+2+SG
antipatizare-los	antipatizar+V.ele.ACC.3.M.PL+SBJF+2+SG
antipatizarem-lhe	antipatizar+V.ele.DAT.3.SG+INF+3+PL
antipatizarem-lhe	antipatizar+V.ele.DAT.3.SG+SBJF+3+PL
antipatizarem-lhes	antipatizar+V.ele.DAT.3.PL+INF+3+PL
antipatizarem-lhes	antipatizar+V.ele.DAT.3.PL+SBJF+3+PL
antipatizarem-me	antipatizar+V.eu.AD.1.SG+INF+3+PL
antipatizarem-me	antipatizar+V.eu.AD.1.SG+SBJF+3+PL
antipatizarem-na	antipatizar+V.ele.ACC.3.F.SG+INF+3+PL
antipatizarem-na	antipatizar+V.ele.ACC.3.F.SG+SBJF+3+PL
antipatizarem-nas	antipatizar+V.ele.ACC.3.F.PL+INF+3+PL
antipatizarem-nas	antipatizar+V.ele.ACC.3.F.PL+SBJF+3+PL
antipatizarem-no	antipatizar+V.ele.ACC.3.M.SG+INF+3+PL
antipatizarem-no	antipatizar+V.ele.ACC.3.M.SG+SBJF+3+PL
antipatizarem-nos	antipatizar+V.ele.ACC.3.M.PL+INF+3+PL
antipatizarem-nos	antipatizar+V.ele.ACC.3.M.PL+SBJF+3+PL
antipatizarem-nos	antipatizar+V.nós.AD.1.PL+INF+3+PL
antipatizarem-nos	antipatizar+V.nós.AD.1.PL+SBJF+3+PL
antipatizarem-se	antipatizar+V.ele.REFL+INF+3+PL
antipatizarem-se	antipatizar+V.ele.REFL+SBJF+3+PL
antipatizarem-te	antipatizar+V.tu.AD.2.SG+INF+3+PL
antipatizarem-te	antipatizar+V.tu.AD.2.SG+SBJF+3+PL
antipatizarem-vos	antipatizar+V.vós.AD.2.PL+INF+3+PL
antipatizarem-vos	antipatizar+V.vós.AD.2.PL+SBJF+3+PL
antipatizare-nos	antipatizar+nós.AD.1.PL+INF+2+SG
antipatizare-nos	antipatizar+nós.AD.1.PL+SBJF+2+SG
antipatizares-lhe	antipatizar+V.ele.DAT.3.SG+INF+2+SG
antipatizares-lhe	antipatizar+V.ele.DAT.3.SG+SBJF+2+SG
antipatizares-lhes	antipatizar+V.ele.DAT.3.PL+INF+2+SG
antipatizares-lhes	antipatizar+V.ele.DAT.3.PL+SBJF+2+SG
antipatizares-me	antipatizar+V.eu.AD.1.SG+INF+2+SG
antipatizares-me	antipatizar+V.eu.AD.1.SG+SBJF+2+SG
antipatizares-te	antipatizar+V.tu.AD.2.SG+INF+2+SG
antipatizares-te	antipatizar+V.tu.AD.2.SG+SBJF+2+SG
antipatizares-vos	antipatizar+V.vós.AD.2.PL+INF+2+SG
antipatizares-vos	antipatizar+V.vós.AD.2.PL+SBJF+2+SG
antipatizar-lhe-á	antipatizar+V.ele.DAT.3.SG+FUT+3+SG
antipatizar-lhe	antipatizar+V.ele.DAT.3.SG+INF
antipatizar-lhe	antipatizar+V.ele.DAT.3.SG+INF+1+SG
antipatizar-lhe	antipatizar+V.ele.DAT.3.SG+INF+3+SG
antipatizar-lhe	antipatizar+V.ele.DAT.3.SG+SBJF+1+SG
antipatizar-lhe	antipatizar+V.ele.DAT.3.SG+SBJF+3+SG
antipatizar-lhe-ão	antipatizar+V.ele.DAT.3.SG+FUT+3+PL
antipatizar-lhe-ás	antipatizar+V.ele.DAT.3.SG+FUT+2+SG
antipatizar-lhe-ei	antipatizar+V.ele.DAT.3.SG+FUT+1+SG
antipatizar-lhe-eis	antipatizar+V.ele.DAT.3.SG+FUT+2+PL
antipatizar-lhe-emos	antipatizar+V.ele.DAT.3.SG+FUT+1+PL
antipatizar-lhe-ia	antipatizar+V.ele.DAT.3.SG+COND+1+SG
antipatizar-lhe-ia	antipatizar+V.ele.DAT.3.SG+COND+3+SG
antipatizar-lhe-iam	antipatizar+V.ele.DAT.3.SG+COND+3+PL
antipatizar-lhe-íamos	antipatizar+V.ele.DAT.3.SG+COND+1+PL
antipatizar-lhe-ias	antipatizar+V.ele.DAT.3.SG+COND+2+SG
antipatizar-lhe-íeis	antipatizar+V.ele.DAT.3.SG+COND+2+PL
antipatizar-lhes-á	antipatizar+V.ele.DAT.3.PL+FUT+3+SG
antipatizar-lhes	antipatizar+V.ele.DAT.3.PL+INF
antipatizar-lhes	antipatizar+V.ele.DAT.3.PL+INF+1+SG
antipatizar-lhes	antipatizar+V.ele.DAT.3.PL+INF+3+SG
antipatizar-lhes	antipatizar+V.ele.DAT.3.PL+SBJF+1+SG
antipatizar-lhes	antipatizar+V.ele.DAT.3.PL+SBJF+3+SG
antipatizar-lhes-ão	antipatizar+V.ele.DAT.3.PL+FUT+3+PL
antipatizar-lhes-ás	antipatizar+V.ele.DAT.3.PL+FUT+2+SG
antipatizar-lhes-ei	antipatizar+V.ele.DAT.3.PL+FUT+1+SG
antipatizar-lhes-eis	antipatizar+V.ele.DAT.3.PL+FUT+2+PL
antipatizar-lhes-emos	antipatizar+V.ele.DAT.3.PL+FUT+1+PL
antipatizar-lhes-ia	antipatizar+V.ele.DAT.3.PL+COND+1+SG
antipatizar-lhes-ia	antipatizar+V.ele.DAT.3.PL+COND+3+SG
antipatizar-lhes-iam	antipatizar+V.ele.DAT.3.PL+COND+3+PL
antipatizar-lhes-íamos	antipatizar+V.ele.DAT.3.PL+COND+1+PL
antipatizar-lhes-ias	antipatizar+V.ele.DAT.3.PL+COND+2+SG
antipatizar-lhes-íeis	antipatizar+V.ele.DAT.3.PL+COND+2+PL
antipatizar-me-á	antipatizar+V.eu.AD.1.SG+FUT+3+SG
antipatizar-me	antipatizar+V.eu.AD.1.SG+INF
antipatizar-me	antipatizar+V.eu.AD.1.SG+INF+1+SG
antipatizar-me	antipatizar+V.eu.AD.1.SG+INF+3+SG
antipatizar-me	antipatizar+V.eu.AD.1.SG+SBJF+1+SG
antipatizar-me	antipatizar+V.eu.AD.1.SG+SBJF+3+SG
antipatizar-me-ão	antipatizar+V.eu.AD.1.SG+FUT+3+PL
antipatizar-me-ás	antipatizar+V.eu.AD.1.SG+FUT+2+SG
antipatizar-me-ei	antipatizar+V.eu.AD.1.SG+FUT+1+SG
antipatizar-me-eis	antipatizar+V.eu.AD.1.SG+FUT+2+PL
antipatizar-me-emos	antipatizar+V.eu.AD.1.SG+FUT+1+PL
antipatizar-me-ia	antipatizar+V.eu.AD.1.SG+COND+1+SG
antipatizar-me-ia	antipatizar+V.eu.AD.1.SG+COND+3+SG
antipatizar-me-iam	antipatizar+V.eu.AD.1.SG+COND+3+PL
antipatizar-me-íamos	antipatizar+V.eu.AD.1.SG+COND+1+PL
antipatizar-me-ias	antipatizar+V.eu.AD.1.SG+COND+2+SG
antipatizar-me-íeis	antipatizar+V.eu.AD.1.SG+COND+2+PL
antipatizarmo-la	antipatizar+V.ele.ACC.3.F.SG+INF+1+PL
antipatizarmo-la	antipatizar+V.ele.ACC.3.F.SG+SBJF+1+PL
antipatizarmo-las	antipatizar+V.ele.ACC.3.F.PL+INF+1+PL
antipatizarmo-las	antipatizar+V.ele.ACC.3.F.PL+SBJF+1+PL
antipatizarmo-lo	antipatizar+V.ele.ACC.3.M.SG+INF+1+PL
antipatizarmo-lo	antipatizar+V.ele.ACC.3.M.SG+SBJF+1+PL
antipatizarmo-los	antipatizar+V.ele.ACC.3.M.PL+INF+1+PL
antipatizarmo-los	antipatizar+V.ele.ACC.3.M.PL+SBJF+1+PL
antipatizarmo-nos	antipatizar+nós.AD.1.PL+INF+1+PL
antipatizarmo-nos	antipatizar+nós.AD.1.PL+SBJF+1+PL
antipatizarmos-lhe	antipatizar+V.ele.DAT.3.SG+INF+1+PL
antipatizarmos-lhe	antipatizar+V.ele.DAT.3.SG+SBJF+1+PL
antipatizarmos-lhes	antipatizar+V.ele.DAT.3.PL+INF+1+PL
antipatizarmos-lhes	antipatizar+V.ele.DAT.3.PL+SBJF+1+PL
antipatizarmos-me	antipatizar+V.eu.AD.1.SG+INF+1+PL
antipatizarmos-me	antipatizar+V.eu.AD.1.SG+SBJF+1+PL
antipatizarmos-te	antipatizar+V.tu.AD.2.SG+INF+1+PL
antipatizarmos-te	antipatizar+V.tu.AD.2.SG+SBJF+1+PL
antipatizarmos-vos	antipatizar+V.vós.AD.2.PL+INF+1+PL
antipatizarmos-vos	antipatizar+V.vós.AD.2.PL+SBJF+1+PL
antipatizar-nos-á	antipatizar+nós.AD.1.PL+FUT+3+SG
antipatizar-nos	antipatizar+nós.AD.1.PL+INF
antipatizar-nos	antipatizar+nós.AD.1.PL+INF+1+SG
antipatizar-nos	antipatizar+nós.AD.1.PL+INF+3+SG
antipatizar-nos	antipatizar+nós.AD.1.PL+SBJF+1+SG
antipatizar-nos	antipatizar+nós.AD.1.PL+SBJF+3+SG
antipatizar-nos-ão	antipatizar+nós.AD.1.PL+FUT+3+PL
antipatizar-nos-ás	antipatizar+nós.AD.1.PL+FUT+2+SG
antipatizar-nos-ei	antipatizar+nós.AD.1.PL+FUT+1+SG
antipatizar-nos-eis	antipatizar+nós.AD.1.PL+FUT+2+PL
antipatizar-nos-emos	antipatizar+nós.AD.1.PL+FUT+1+PL
antipatizar-nos-ia	antipatizar+nós.AD.1.PL+COND+1+SG
antipatizar-nos-ia	antipatizar+nós.AD.1.PL+COND+3+SG
antipatizar-nos-iam	antipatizar+nós.AD.1.PL+COND+3+PL
antipatizar-nos-íamos	antipatizar+nós.AD.1.PL+COND+1+PL
antipatizar-nos-ias	antipatizar+nós.AD.1.PL+COND+2+SG
antipatizar-nos-íeis	antipatizar+nós.AD.1.PL+COND+2+PL
antipatizar-se-á	antipatizar+V.ele.REFL+FUT+3+SG
antipatizar-se	antipatizar+V.ele.REFL+INF
antipatizar-se	antipatizar+V.ele.REFL+INF+3+SG
antipatizar-se	antipatizar+V.ele.REFL+SBJF+3+SG
antipatizar-se-ão	antipatizar+V.ele.REFL+FUT+3+PL
antipatizar-se-ia	antipatizar+V.ele.REFL+COND+3+SG
antipatizar-se-iam	antipatizar+V.ele.REFL+COND+3+PL
antipatizar-te-á	antipatizar+V.tu.AD.2.SG+FUT+3+SG
antipatizar-te	antipatizar+V.tu.AD.2.SG+INF
antipatizar-te	antipatizar+V.tu.AD.2.SG+INF+1+SG
antipatizar-te	antipatizar+V.tu.AD.2.SG+INF+3+SG
antipatizar-te	antipatizar+V.tu.AD.2.SG+SBJF+1+SG
antipatizar-te	antipatizar+V.tu.AD.2.SG+SBJF+3+SG
antipatizar-te-ão	antipatizar+V.tu.AD.2.SG+FUT+3+PL
antipatizar-te-ás	antipatizar+V.tu.AD.2.SG+FUT+2+SG
antipatizar-te-ei	antipatizar+V.tu.AD.2.SG+FUT+1+SG
antipatizar-te-eis	antipatizar+V.tu.AD.2.SG+FUT+2+PL
antipatizar-te-emos	antipatizar+V.tu.AD.2.SG+FUT+1+PL
antipatizar-te-ia	antipatizar+V.tu.AD.2.SG+COND+1+SG
antipatizar-te-ia	antipatizar+V.tu.AD.2.SG+COND+3+SG
antipatizar-te-iam	antipatizar+V.tu.AD.2.SG+COND+3+PL
antipatizar-te-íamos	antipatizar+V.tu.AD.2.SG+COND+1+PL
antipatizar-te-ias	antipatizar+V.tu.AD.2.SG+COND+2+SG
antipatizar-te-íeis	antipatizar+V.tu.AD.2.SG+COND+2+PL
antipatizar-vos-á	antipatizar+V.vós.AD.2.PL+FUT+3+SG
antipatizar-vos	antipatizar+V.vós.AD.2.PL+INF
antipatizar-vos	antipatizar+V.vós.AD.2.PL+INF+1+SG
antipatizar-vos	antipatizar+V.vós.AD.2.PL+INF+3+SG
antipatizar-vos	antipatizar+V.vós.AD.2.PL+SBJF+1+SG
antipatizar-vos	antipatizar+V.vós.AD.2.PL+SBJF+3+SG
antipatizar-vos-ão	antipatizar+V.vós.AD.2.PL+FUT+3+PL
antipatizar-vos-ás	antipatizar+V.vós.AD.2.PL+FUT+2+SG
antipatizar-vos-ei	antipatizar+V.vós.AD.2.PL+FUT+1+SG
antipatizar-vos-eis	antipatizar+V.vós.AD.2.PL+FUT+2+PL
antipatizar-vos-emos	antipatizar+V.vós.AD.2.PL+FUT+1+PL
antipatizar-vos-ia	antipatizar+V.vós.AD.2.PL+COND+1+SG
antipatizar-vos-ia	antipatizar+V.vós.AD.2.PL+COND+3+SG
antipatizar-vos-iam	antipatizar+V.vós.AD.2.PL+COND+3+PL
antipatizar-vos-íamos	antipatizar+V.vós.AD.2.PL+COND+1+PL
antipatizar-vos-ias	antipatizar+V.vós.AD.2.PL+COND+2+SG
antipatizar-vos-íeis	antipatizar+V.vós.AD.2.PL+COND+2+PL
antipatiza-se	antipatizar+V.ele.REFL+PRS+3+SG
antipatizas-lhe	antipatizar+V.ele.DAT.3.SG+PRS+2+SG
antipatizas-lhes	antipatizar+V.ele.DAT.3.PL+PRS+2+SG
antipatizas-me	antipatizar+V.eu.AD.1.SG+PRS+2+SG
antipatizaste-a	antipatizar+V.ele.ACC.3.F.SG+PRF+2+SG
antipatizas-te	antipatizar+V.tu.AD.2.SG+PRS+2+SG
antipatizaste-as	antipatizar+V.ele.ACC.3.F.PL+PRF+2+SG
antipatizaste-la	antipatizar+V.ele.ACC.3.F.SG+PRF+2+PL
antipatizaste-las	antipatizar+V.ele.ACC.3.F.PL+PRF+2+PL
antipatizaste-lhe	antipatizar+V.ele.DAT.3.SG+PRF+2+SG
antipatizaste-lhes	antipatizar+V.ele.DAT.3.PL+PRF+2+SG
antipatizaste-lo	antipatizar+V.ele.ACC.3.M.SG+PRF+2+PL
antipatizaste-los	antipatizar+V.ele.ACC.3.M.PL+PRF+2+PL
antipatizaste-me	antipatizar+V.eu.AD.1.SG+PRF+2+SG
antipatizaste-nos	antipatizar+nós.AD.1.PL+PRF+2+PL
antipatizaste-nos	antipatizar+nós.AD.1.PL+PRF+2+SG
antipatizaste-o	antipatizar+V.ele.ACC.3.M.SG+PRF+2+SG
antipatizaste-os	antipatizar+V.ele.ACC.3.M.PL+PRF+2+SG
antipatizastes-lhe	antipatizar+V.ele.DAT.3.SG+PRF+2+PL
antipatizastes-lhes	antipatizar+V.ele.DAT.3.PL+PRF+2+PL
antipatizastes-me	antipatizar+V.eu.AD.1.SG+PRF+2+PL
antipatizastes-te	antipatizar+V.tu.AD.2.SG+PRF+2+PL
antipatizastes-vos	antipatizar+V.vós.AD.2.PL+PRF+2+PL
antipatizaste-te	antipatizar+V.tu.AD.2.SG+PRF+2+SG
antipatizaste-vos	antipatizar+V.vós.AD.2.PL+PRF+2+SG
antipatizas-vos	antipatizar+V.vós.AD.2.PL+PRS+2+SG
antipatiza-te	antipatizar+V.tu.AD.2.SG+PRS+3+SG
antipatizava-a	antipatizar+V.ele.ACC.3.F.SG+IMPF+1+SG
antipatizava-a	antipatizar+V.ele.ACC.3.F.SG+IMPF+3+SG
antipatizava-as	antipatizar+V.ele.ACC.3.F.PL+IMPF+1+SG
antipatizava-as	antipatizar+V.ele.ACC.3.F.PL+IMPF+3+SG
antipatizava-la	antipatizar+V.ele.ACC.3.F.SG+IMPF+2+SG
antipatizava-las	antipatizar+V.ele.ACC.3.F.PL+IMPF+2+SG
antipatizava-lhe	antipatizar+V.ele.DAT.3.SG+IMPF+1+SG
antipatizava-lhe	antipatizar+V.ele.DAT.3.SG+IMPF+3+SG
antipatizava-lhes	antipatizar+V.ele.DAT.3.PL+IMPF+1+SG
antipatizava-lhes	antipatizar+V.ele.DAT.3.PL+IMPF+3+SG
antipatizava-lo	antipatizar+V.ele.ACC.3.M.SG+IMPF+2+SG
antipatizava-los	antipatizar+V.ele.ACC.3.M.PL+IMPF+2+SG
antipatizava-me	antipatizar+V.eu.AD.1.SG+IMPF+1+SG
antipatizava-me	antipatizar+V.eu.AD.1.SG+IMPF+3+SG
antipatizavam-lhe	antipatizar+V.ele.DAT.3.SG+IMPF+3+PL
antipatizavam-lhes	antipatizar+V.ele.DAT.3.PL+IMPF+3+PL
antipatizavam-me	antipatizar+V.eu.AD.1.SG+IMPF+3+PL
antipatizavam-na	antipatizar+V.ele.ACC.3.F.SG+IMPF+3+PL
antipatizavam-nas	antipatizar+V.ele.ACC.3.F.PL+IMPF+3+PL
antipatizavam-no	antipatizar+V.ele.ACC.3.M.SG+IMPF+3+PL
antipatizavam-nos	antipatizar+V.ele.ACC.3.M.PL+IMPF+3+PL
antipatizavam-nos	antipatizar+V.nós.AD.1.PL+IMPF+3+PL
antipatizávamo-la	antipatizar+V.ele.ACC.3.F.SG+IMPF+1+PL
antipatizávamo-las	antipatizar+V.ele.ACC.3.F.PL+IMPF+1+PL
antipatizávamo-lo	antipatizar+V.ele.ACC.3.M.SG+IMPF+1+PL
antipatizávamo-los	antipatizar+V.ele.ACC.3.M.PL+IMPF+1+PL
antipatizávamo-nos	antipatizar+nós.AD.1.PL+IMPF+1+PL
antipatizávamos-lhe	antipatizar+V.ele.DAT.3.SG+IMPF+1+PL
antipatizávamos-lhes	antipatizar+V.ele.DAT.3.PL+IMPF+1+PL
antipatizávamos-me	antipatizar+V.eu.AD.1.SG+IMPF+1+PL
antipatizávamos-te	antipatizar+V.tu.AD.2.SG+IMPF+1+PL
antipatizávamos-vos	antipatizar+V.vós.AD.2.PL+IMPF+1+PL
antipatizavam-se	antipatizar+V.ele.REFL+IMPF+3+PL
antipatizavam-te	antipatizar+V.tu.AD.2.SG+IMPF+3+PL
antipatizavam-vos	antipatizar+V.vós.AD.2.PL+IMPF+3+PL
antipatizava-nos	antipatizar+nós.AD.1.PL+IMPF+1+SG
antipatizava-nos	antipatizar+nós.AD.1.PL+IMPF+2+SG
antipatizava-nos	antipatizar+nós.AD.1.PL+IMPF+3+SG
antipatizava-o	antipatizar+V.ele.ACC.3.M.SG+IMPF+1+SG
antipatizava-o	antipatizar+V.ele.ACC.3.M.SG+IMPF+3+SG
antipatizava-os	antipatizar+V.ele.ACC.3.M.PL+IMPF+1+SG
antipatizava-os	antipatizar+V.ele.ACC.3.M.PL+IMPF+3+SG
antipatizava-se	antipatizar+V.ele.REFL+IMPF+1+SG
antipatizava-se	antipatizar+V.ele.REFL+IMPF+3+SG
antipatizavas-lhe	antipatizar+V.ele.DAT.3.SG+IMPF+2+SG
antipatizavas-lhes	antipatizar+V.ele.DAT.3.PL+IMPF+2+SG
antipatizavas-me	antipatizar+V.eu.AD.1.SG+IMPF+2+SG
antipatizavas-te	antipatizar+V.tu.AD.2.SG+IMPF+2+SG
antipatizavas-vos	antipatizar+V.vós.AD.2.PL+IMPF+2+SG
antipatizava-te	antipatizar+V.tu.AD.2.SG+IMPF+1+SG
antipatizava-te	antipatizar+V.tu.AD.2.SG+IMPF+3+SG
antipatizava-vos	antipatizar+V.vós.AD.2.PL+IMPF+1+SG
antipatizava-vos	antipatizar+V.vós.AD.2.PL+IMPF+3+SG
antipatizávei-la	antipatizar+V.ele.ACC.3.F.SG+IMPF+2+PL
antipatizávei-las	antipatizar+V.ele.ACC.3.F.PL+IMPF+2+PL
antipatizávei-lo	antipatizar+V.ele.ACC.3.M.SG+IMPF+2+PL
antipatizávei-los	antipatizar+V.ele.ACC.3.M.PL+IMPF+2+PL
antipatizávei-nos	antipatizar+nós.AD.1.PL+IMPF+2+PL
antipatizáveis-lhe	antipatizar+V.ele.DAT.3.SG+IMPF+2+PL
antipatizáveis-lhes	antipatizar+V.ele.DAT.3.PL+IMPF+2+PL
antipatizáveis-me	antipatizar+V.eu.AD.1.SG+IMPF+2+PL
antipatizáveis-te	antipatizar+V.tu.AD.2.SG+IMPF+2+PL
antipatizáveis-vos	antipatizar+V.vós.AD.2.PL+IMPF+2+PL
antipatiza-vos	antipatizar+V.vós.AD.2.PL+PRS+3+SG
antipatize-a	antipatizar+V.ele.ACC.3.F.SG+IMP+3+SG
antipatize-as	antipatizar+V.ele.ACC.3.F.PL+IMP+3+SG
antipatizei-a	antipatizar+V.ele.ACC.3.F.SG+PRF+1+SG
antipatizei-as	antipatizar+V.ele.ACC.3.F.PL+PRF+1+SG
antipatizei-lhe	antipatizar+V.ele.DAT.3.SG+PRF+1+SG
antipatizei-lhes	antipatizar+V.ele.DAT.3.PL+PRF+1+SG
antipatizei-me	antipatizar+V.eu.AD.1.SG+PRF+1+SG
antipatizei-nos	antipatizar+nós.AD.1.PL+PRF+1+SG
antipatizei-o	antipatizar+V.ele.ACC.3.M.SG+PRF+1+SG
antipatizei-os	antipatizar+V.ele.ACC.3.M.PL+PRF+1+SG
antipatizei-te	antipatizar+V.tu.AD.2.SG+PRF+1+SG
antipatizei-vos	antipatizar+V.vós.AD.2.PL+PRF+1+SG
antipatize-lhe	antipatizar+V.ele.DAT.3.SG+IMP+3+SG
antipatize-lhes	antipatizar+V.ele.DAT.3.PL+IMP+3+SG
antipatize-me	antipatizar+V.eu.AD.1.SG+IMP+3+SG
antipatizem-lhe	antipatizar+V.ele.DAT.3.SG+IMP+3+PL
antipatizem-lhes	antipatizar+V.ele.DAT.3.PL+IMP+3+PL
antipatizem-me	antipatizar+V.eu.AD.1.SG+IMP+3+PL
antipatizem-na	antipatizar+V.ele.ACC.3.F.SG+IMP+3+PL
antipatizem-nas	antipatizar+V.ele.ACC.3.F.PL+IMP+3+PL
antipatizem-no	antipatizar+V.ele.ACC.3.M.SG+IMP+3+PL
antipatizem-nos	antipatizar+V.ele.ACC.3.M.PL+IMP+3+PL
antipatizem-nos	antipatizar+V.nós.AD.1.PL+IMP+3+PL
antipatizemo-la	antipatizar+V.ele.ACC.3.F.SG+IMP+1+PL
antipatizemo-las	antipatizar+V.ele.ACC.3.F.PL+IMP+1+PL
antipatizemo-lo	antipatizar+V.ele.ACC.3.M.SG+IMP+1+PL
antipatizemo-los	antipatizar+V.ele.ACC.3.M.PL+IMP+1+PL
antipatizemo-nos	antipatizar+nós.AD.1.PL+IMP+1+PL
antipatizemos-lhe	antipatizar+V.ele.DAT.3.SG+IMP+1+PL
antipatizemos-lhes	antipatizar+V.ele.DAT.3.PL+IMP+1+PL
antipatizemos-me	antipatizar+V.eu.AD.1.SG+IMP+1+PL
antipatizemos-te	antipatizar+V.tu.AD.2.SG+IMP+1+PL
antipatizemos-vos	antipatizar+V.vós.AD.2.PL+IMP+1+PL
antipatizem-se	antipatizar+V.ele.REFL+IMP+3+PL
antipatizem-te	antipatizar+V.tu.AD.2.SG+IMP+3+PL
antipatizem-vos	antipatizar+V.vós.AD.2.PL+IMP+3+PL
antipatize-nos	antipatizar+nós.AD.1.PL+IMP+3+SG
antipatize-o	antipatizar+V.ele.ACC.3.M.SG+IMP+3+SG
antipatize-os	antipatizar+V.ele.ACC.3.M.PL+IMP+3+SG
antipatize-se	antipatizar+V.ele.REFL+IMP+3+SG
antipatize-te	antipatizar+V.tu.AD.2.SG+IMP+3+SG
antipatize-vos	antipatizar+V.vós.AD.2.PL+IMP+3+SG
antipatizo-a	antipatizar+V.ele.ACC.3.F.SG+PRS+1+SG
antipatizo-as	antipatizar+V.ele.ACC.3.F.PL+PRS+1+SG
antipatizo-lhe	antipatizar+V.ele.DAT.3.SG+PRS+1+SG
antipatizo-lhes	antipatizar+V.ele.DAT.3.PL+PRS+1+SG
antipatizo-me	antipatizar+V.eu.AD.1.SG+PRS+1+SG
antipatizo-nos	antipatizar+nós.AD.1.PL+PRS+1+SG
antipatizo-o	antipatizar+V.ele.ACC.3.M.SG+PRS+1+SG
antipatizo-os	antipatizar+V.ele.ACC.3.M.PL+PRS+1+SG
antipatizo-te	antipatizar+V.tu.AD.2.SG+PRS+1+SG
antipatizou-a	antipatizar+V.ele.ACC.3.F.SG+PRF+3+SG
antipatizou-as	antipatizar+V.ele.ACC.3.F.PL+PRF+3+SG
antipatizou-lhe	antipatizar+V.ele.DAT.3.SG+PRF+3+SG
antipatizou-lhes	antipatizar+V.ele.DAT.3.PL+PRF+3+SG
antipatizou-me	antipatizar+V.eu.AD.1.SG+PRF+3+SG
antipatizou-nos	antipatizar+nós.AD.1.PL+PRF+3+SG
antipatizou-o	antipatizar+V.ele.ACC.3.M.SG+PRF+3+SG
antipatizou-os	antipatizar+V.ele.ACC.3.M.PL+PRF+3+SG
antipatizou-se	antipatizar+V.ele.REFL+PRF+3+SG
antipatizou-te	antipatizar+V.tu.AD.2.SG+PRF+3+SG
antipatizou-vos	antipatizar+V.vós.AD.2.PL+PRF+3+SG
antipatizo-vos	antipatizar+V.vós.AD.2.PL+PRS+1+SG
antiqua-a	antiquar+V.ele.ACC.3.F.SG+PRS+3+SG
antiqua-as	antiquar+V.ele.ACC.3.F.PL+PRS+3+SG
antiquai-la	antiquar+V.ele.ACC.3.F.SG+PRS+2+PL
antiquai-las	antiquar+V.ele.ACC.3.F.PL+PRS+2+PL
antiquai-lo	antiquar+V.ele.ACC.3.M.SG+PRS+2+PL
antiquai-los	antiquar+V.ele.ACC.3.M.PL+PRS+2+PL
antiquai-nos	antiquar+nós.AD.1.PL+PRS+2+PL
antiquais-lhe	antiquar+V.ele.DAT.3.SG+PRS+2+PL
antiquais-lhes	antiquar+V.ele.DAT.3.PL+PRS+2+PL
antiquais-me	antiquar+V.eu.AD.1.SG+PRS+2+PL
antiquais-te	antiquar+V.tu.AD.2.SG+PRS+2+PL
antiquais-vos	antiquar+V.vós.AD.2.PL+PRS+2+PL
antiquá-la-á	antiquar+V.ele.ACC.3.F.SG+FUT+3+SG
antiquá-la	antiquar+V.ele.ACC.3.F.SG+INF+1+SG
antiquá-la	antiquar+V.ele.ACC.3.F.SG+INF+3+SG
antiqua-la	antiquar+V.ele.ACC.3.F.SG+PRS+2+SG
antiquá-la	antiquar+V.ele.ACC.3.F.SG+SBJF+1+SG
antiquá-la	antiquar+V.ele.ACC.3.F.SG+SBJF+3+SG
antiquá-la-ão	antiquar+V.ele.ACC.3.F.SG+FUT+3+PL
antiquá-la-ás	antiquar+V.ele.ACC.3.F.SG+FUT+2+SG
antiquá-la-ei	antiquar+V.ele.ACC.3.F.SG+FUT+1+SG
antiquá-la-eis	antiquar+V.ele.ACC.3.F.SG+FUT+2+PL
antiquá-la-emos	antiquar+V.ele.ACC.3.F.SG+FUT+1+PL
antiquá-la-ia	antiquar+V.ele.ACC.3.F.SG+COND+1+SG
antiquá-la-ia	antiquar+V.ele.ACC.3.F.SG+COND+3+SG
antiquá-la-iam	antiquar+V.ele.ACC.3.F.SG+COND+3+PL
antiquá-la-íamos	antiquar+V.ele.ACC.3.F.SG+COND+1+PL
antiquá-la-ias	antiquar+V.ele.ACC.3.F.SG+COND+2+SG
antiquá-la-íeis	antiquar+V.ele.ACC.3.F.SG+COND+2+PL
antiquá-las-á	antiquar+V.ele.ACC.3.F.PL+FUT+3+SG
antiquá-las	antiquar+V.ele.ACC.3.F.PL+INF+1+SG
antiquá-las	antiquar+V.ele.ACC.3.F.PL+INF+3+SG
antiqua-las	antiquar+V.ele.ACC.3.F.PL+PRS+2+SG
antiquá-las	antiquar+V.ele.ACC.3.F.PL+SBJF+1+SG
antiquá-las	antiquar+V.ele.ACC.3.F.PL+SBJF+3+SG
antiquá-las-ão	antiquar+V.ele.ACC.3.F.PL+FUT+3+PL
antiquá-las-ás	antiquar+V.ele.ACC.3.F.PL+FUT+2+SG
antiquá-las-ei	antiquar+V.ele.ACC.3.F.PL+FUT+1+SG
antiquá-las-eis	antiquar+V.ele.ACC.3.F.PL+FUT+2+PL
antiquá-las-emos	antiquar+V.ele.ACC.3.F.PL+FUT+1+PL
antiquá-las-ia	antiquar+V.ele.ACC.3.F.PL+COND+1+SG
antiquá-las-ia	antiquar+V.ele.ACC.3.F.PL+COND+3+SG
antiquá-las-iam	antiquar+V.ele.ACC.3.F.PL+COND+3+PL
antiquá-las-íamos	antiquar+V.ele.ACC.3.F.PL+COND+1+PL
antiquá-las-ias	antiquar+V.ele.ACC.3.F.PL+COND+2+SG
antiquá-las-íeis	antiquar+V.ele.ACC.3.F.PL+COND+2+PL
antiqua-lhe	antiquar+V.ele.DAT.3.SG+PRS+3+SG
antiqua-lhes	antiquar+V.ele.DAT.3.PL+PRS+3+SG
antiquá-lo-á	antiquar+V.ele.ACC.3.M.SG+FUT+3+SG
antiquá-lo	antiquar+V.ele.ACC.3.M.SG+INF+1+SG
antiquá-lo	antiquar+V.ele.ACC.3.M.SG+INF+3+SG
antiqua-lo	antiquar+V.ele.ACC.3.M.SG+PRS+2+SG
antiquá-lo	antiquar+V.ele.ACC.3.M.SG+SBJF+1+SG
antiquá-lo	antiquar+V.ele.ACC.3.M.SG+SBJF+3+SG
antiquá-lo-ão	antiquar+V.ele.ACC.3.M.SG+FUT+3+PL
antiquá-lo-ás	antiquar+V.ele.ACC.3.M.SG+FUT+2+SG
antiquá-lo-ei	antiquar+V.ele.ACC.3.M.SG+FUT+1+SG
antiquá-lo-eis	antiquar+V.ele.ACC.3.M.SG+FUT+2+PL
antiquá-lo-emos	antiquar+V.ele.ACC.3.M.SG+FUT+1+PL
antiquá-lo-ia	antiquar+V.ele.ACC.3.M.SG+COND+1+SG
antiquá-lo-ia	antiquar+V.ele.ACC.3.M.SG+COND+3+SG
antiquá-lo-iam	antiquar+V.ele.ACC.3.M.SG+COND+3+PL
antiquá-lo-íamos	antiquar+V.ele.ACC.3.M.SG+COND+1+PL
antiquá-lo-ias	antiquar+V.ele.ACC.3.M.SG+COND+2+SG
antiquá-lo-íeis	antiquar+V.ele.ACC.3.M.SG+COND+2+PL
antiquá-los-á	antiquar+V.ele.ACC.3.M.PL+FUT+3+SG
antiquá-los	antiquar+V.ele.ACC.3.M.PL+INF+1+SG
antiquá-los	antiquar+V.ele.ACC.3.M.PL+INF+3+SG
antiqua-los	antiquar+V.ele.ACC.3.M.PL+PRS+2+SG
antiquá-los	antiquar+V.ele.ACC.3.M.PL+SBJF+1+SG
antiquá-los	antiquar+V.ele.ACC.3.M.PL+SBJF+3+SG
antiquá-los-ão	antiquar+V.ele.ACC.3.M.PL+FUT+3+PL
antiquá-los-ás	antiquar+V.ele.ACC.3.M.PL+FUT+2+SG
antiquá-los-ei	antiquar+V.ele.ACC.3.M.PL+FUT+1+SG
antiquá-los-eis	antiquar+V.ele.ACC.3.M.PL+FUT+2+PL
antiquá-los-emos	antiquar+V.ele.ACC.3.M.PL+FUT+1+PL
antiquá-los-ia	antiquar+V.ele.ACC.3.M.PL+COND+1+SG
antiquá-los-ia	antiquar+V.ele.ACC.3.M.PL+COND+3+SG
antiquá-los-iam	antiquar+V.ele.ACC.3.M.PL+COND+3+PL
antiquá-los-íamos	antiquar+V.ele.ACC.3.M.PL+COND+1+PL
antiquá-los-ias	antiquar+V.ele.ACC.3.M.PL+COND+2+SG
antiquá-los-íeis	antiquar+V.ele.ACC.3.M.PL+COND+2+PL
antiqua-me	antiquar+V.eu.AD.1.SG+PRS+3+SG
antiquam-lhe	antiquar+V.ele.DAT.3.SG+PRS+3+PL
antiquam-lhes	antiquar+V.ele.DAT.3.PL+PRS+3+PL
antiquam-me	antiquar+V.eu.AD.1.SG+PRS+3+PL
antiquam-na	antiquar+V.ele.ACC.3.F.SG+PRS+3+PL
antiquam-nas	antiquar+V.ele.ACC.3.F.PL+PRS+3+PL
antiquam-no	antiquar+V.ele.ACC.3.M.SG+PRS+3+PL
antiquam-nos	antiquar+V.ele.ACC.3.M.PL+PRS+3+PL
antiquam-nos	antiquar+V.nós.AD.1.PL+PRS+3+PL
antiquamo-la	antiquar+V.ele.ACC.3.F.SG+PRF+1+PL
antiquamo-la	antiquar+V.ele.ACC.3.F.SG+PRS+1+PL
antiquamo-las	antiquar+V.ele.ACC.3.F.PL+PRF+1+PL
antiquamo-las	antiquar+V.ele.ACC.3.F.PL+PRS+1+PL
antiquamo-lo	antiquar+V.ele.ACC.3.M.SG+PRF+1+PL
antiquamo-lo	antiquar+V.ele.ACC.3.M.SG+PRS+1+PL
antiquamo-los	antiquar+V.ele.ACC.3.M.PL+PRF+1+PL
antiquamo-los	antiquar+V.ele.ACC.3.M.PL+PRS+1+PL
antiquamo-nos	antiquar+nós.AD.1.PL+PRF+1+PL
antiquamo-nos	antiquar+nós.AD.1.PL+PRS+1+PL
antiquamos-lhe	antiquar+V.ele.DAT.3.SG+PRF+1+PL
antiquamos-lhe	antiquar+V.ele.DAT.3.SG+PRS+1+PL
antiquamos-lhes	antiquar+V.ele.DAT.3.PL+PRF+1+PL
antiquamos-lhes	antiquar+V.ele.DAT.3.PL+PRS+1+PL
antiquamos-me	antiquar+V.eu.AD.1.SG+PRF+1+PL
antiquamos-me	antiquar+V.eu.AD.1.SG+PRS+1+PL
antiquamos-te	antiquar+V.tu.AD.2.SG+PRF+1+PL
antiquamos-te	antiquar+V.tu.AD.2.SG+PRS+1+PL
antiquamos-vos	antiquar+V.vós.AD.2.PL+PRF+1+PL
antiquamos-vos	antiquar+V.vós.AD.2.PL+PRS+1+PL
antiquam-se	antiquar+V.ele.REFL+PRS+3+PL
antiquam-te	antiquar+V.tu.AD.2.SG+PRS+3+PL
antiquam-vos	antiquar+V.vós.AD.2.PL+PRS+3+PL
antiquando-a	antiquar+V.ele.ACC.3.F.SG+GRD
antiquando-as	antiquar+V.ele.ACC.3.F.PL+GRD
antiquando-lhe	antiquar+V.ele.DAT.3.SG+GRD
antiquando-lhes	antiquar+V.ele.DAT.3.PL+GRD
antiquando-me	antiquar+V.eu.AD.1.SG+GRD
antiquando-nos	antiquar+nós.AD.1.PL+GRD
antiquando-o	antiquar+V.ele.ACC.3.M.SG+GRD
antiquando-os	antiquar+V.ele.ACC.3.M.PL+GRD
antiquando-se	antiquar+V.ele.REFL+GRD
antiquando-te	antiquar+V.tu.AD.2.SG+GRD
antiquando-vos	antiquar+V.vós.AD.2.PL+GRD
antiqua-nos	antiquar+nós.AD.1.PL+PRS+2+SG
antiqua-nos	antiquar+nós.AD.1.PL+PRS+3+SG
antiqua-o	antiquar+V.ele.ACC.3.M.SG+PRS+3+SG
antiqua-os	antiquar+V.ele.ACC.3.M.PL+PRS+3+SG
antiquara-a	antiquar+V.ele.ACC.3.F.SG+PQP+1+SG
antiquara-a	antiquar+V.ele.ACC.3.F.SG+PQP+3+SG
antiquara-as	antiquar+V.ele.ACC.3.F.PL+PQP+1+SG
antiquara-as	antiquar+V.ele.ACC.3.F.PL+PQP+3+SG
