antropomorfizar-te-ia	antropomorfizar+V.tu.AD.2.SG+COND+3+SG
antropomorfizar-te-iam	antropomorfizar+V.tu.AD.2.SG+COND+3+PL
antropomorfizar-te-íamos	antropomorfizar+V.tu.AD.2.SG+COND+1+PL
antropomorfizar-te-ias	antropomorfizar+V.tu.AD.2.SG+COND+2+SG
antropomorfizar-te-íeis	antropomorfizar+V.tu.AD.2.SG+COND+2+PL
antropomorfizar-vos-á	antropomorfizar+V.vós.AD.2.PL+FUT+3+SG
antropomorfizar-vos	antropomorfizar+V.vós.AD.2.PL+INF
antropomorfizar-vos	antropomorfizar+V.vós.AD.2.PL+INF+1+SG
antropomorfizar-vos	antropomorfizar+V.vós.AD.2.PL+INF+3+SG
antropomorfizar-vos	antropomorfizar+V.vós.AD.2.PL+SBJF+1+SG
antropomorfizar-vos	antropomorfizar+V.vós.AD.2.PL+SBJF+3+SG
antropomorfizar-vos-ão	antropomorfizar+V.vós.AD.2.PL+FUT+3+PL
antropomorfizar-vos-ás	antropomorfizar+V.vós.AD.2.PL+FUT+2+SG
antropomorfizar-vos-ei	antropomorfizar+V.vós.AD.2.PL+FUT+1+SG
antropomorfizar-vos-eis	antropomorfizar+V.vós.AD.2.PL+FUT+2+PL
antropomorfizar-vos-emos	antropomorfizar+V.vós.AD.2.PL+FUT+1+PL
antropomorfizar-vos-ia	antropomorfizar+V.vós.AD.2.PL+COND+1+SG
antropomorfizar-vos-ia	antropomorfizar+V.vós.AD.2.PL+COND+3+SG
antropomorfizar-vos-iam	antropomorfizar+V.vós.AD.2.PL+COND+3+PL
antropomorfizar-vos-íamos	antropomorfizar+V.vós.AD.2.PL+COND+1+PL
antropomorfizar-vos-ias	antropomorfizar+V.vós.AD.2.PL+COND+2+SG
antropomorfizar-vos-íeis	antropomorfizar+V.vós.AD.2.PL+COND+2+PL
antropomorfiza-se	antropomorfizar+V.ele.REFL+PRS+3+SG
antropomorfizas-lhe	antropomorfizar+V.ele.DAT.3.SG+PRS+2+SG
antropomorfizas-lhes	antropomorfizar+V.ele.DAT.3.PL+PRS+2+SG
antropomorfizas-me	antropomorfizar+V.eu.AD.1.SG+PRS+2+SG
antropomorfizaste-a	antropomorfizar+V.ele.ACC.3.F.SG+PRF+2+SG
antropomorfizas-te	antropomorfizar+V.tu.AD.2.SG+PRS+2+SG
antropomorfizaste-as	antropomorfizar+V.ele.ACC.3.F.PL+PRF+2+SG
antropomorfizaste-la	antropomorfizar+V.ele.ACC.3.F.SG+PRF+2+PL
antropomorfizaste-las	antropomorfizar+V.ele.ACC.3.F.PL+PRF+2+PL
antropomorfizaste-lhe	antropomorfizar+V.ele.DAT.3.SG+PRF+2+SG
antropomorfizaste-lhes	antropomorfizar+V.ele.DAT.3.PL+PRF+2+SG
antropomorfizaste-lo	antropomorfizar+V.ele.ACC.3.M.SG+PRF+2+PL
antropomorfizaste-los	antropomorfizar+V.ele.ACC.3.M.PL+PRF+2+PL
antropomorfizaste-me	antropomorfizar+V.eu.AD.1.SG+PRF+2+SG
antropomorfizaste-nos	antropomorfizar+nós.AD.1.PL+PRF+2+PL
antropomorfizaste-nos	antropomorfizar+nós.AD.1.PL+PRF+2+SG
antropomorfizaste-o	antropomorfizar+V.ele.ACC.3.M.SG+PRF+2+SG
antropomorfizaste-os	antropomorfizar+V.ele.ACC.3.M.PL+PRF+2+SG
antropomorfizastes-lhe	antropomorfizar+V.ele.DAT.3.SG+PRF+2+PL
antropomorfizastes-lhes	antropomorfizar+V.ele.DAT.3.PL+PRF+2+PL
antropomorfizastes-me	antropomorfizar+V.eu.AD.1.SG+PRF+2+PL
antropomorfizastes-te	antropomorfizar+V.tu.AD.2.SG+PRF+2+PL
antropomorfizastes-vos	antropomorfizar+V.vós.AD.2.PL+PRF+2+PL
antropomorfizaste-te	antropomorfizar+V.tu.AD.2.SG+PRF+2+SG
antropomorfizaste-vos	antropomorfizar+V.vós.AD.2.PL+PRF+2+SG
antropomorfizas-vos	antropomorfizar+V.vós.AD.2.PL+PRS+2+SG
antropomorfiza-te	antropomorfizar+V.tu.AD.2.SG+PRS+3+SG
antropomorfizava-a	antropomorfizar+V.ele.ACC.3.F.SG+IMPF+1+SG
antropomorfizava-a	antropomorfizar+V.ele.ACC.3.F.SG+IMPF+3+SG
antropomorfizava-as	antropomorfizar+V.ele.ACC.3.F.PL+IMPF+1+SG
antropomorfizava-as	antropomorfizar+V.ele.ACC.3.F.PL+IMPF+3+SG
antropomorfizava-la	antropomorfizar+V.ele.ACC.3.F.SG+IMPF+2+SG
antropomorfizava-las	antropomorfizar+V.ele.ACC.3.F.PL+IMPF+2+SG
antropomorfizava-lhe	antropomorfizar+V.ele.DAT.3.SG+IMPF+1+SG
antropomorfizava-lhe	antropomorfizar+V.ele.DAT.3.SG+IMPF+3+SG
antropomorfizava-lhes	antropomorfizar+V.ele.DAT.3.PL+IMPF+1+SG
antropomorfizava-lhes	antropomorfizar+V.ele.DAT.3.PL+IMPF+3+SG
antropomorfizava-lo	antropomorfizar+V.ele.ACC.3.M.SG+IMPF+2+SG
antropomorfizava-los	antropomorfizar+V.ele.ACC.3.M.PL+IMPF+2+SG
antropomorfizava-me	antropomorfizar+V.eu.AD.1.SG+IMPF+1+SG
antropomorfizava-me	antropomorfizar+V.eu.AD.1.SG+IMPF+3+SG
antropomorfizavam-lhe	antropomorfizar+V.ele.DAT.3.SG+IMPF+3+PL
antropomorfizavam-lhes	antropomorfizar+V.ele.DAT.3.PL+IMPF+3+PL
antropomorfizavam-me	antropomorfizar+V.eu.AD.1.SG+IMPF+3+PL
antropomorfizavam-na	antropomorfizar+V.ele.ACC.3.F.SG+IMPF+3+PL
antropomorfizavam-nas	antropomorfizar+V.ele.ACC.3.F.PL+IMPF+3+PL
antropomorfizavam-no	antropomorfizar+V.ele.ACC.3.M.SG+IMPF+3+PL
antropomorfizavam-nos	antropomorfizar+V.ele.ACC.3.M.PL+IMPF+3+PL
antropomorfizavam-nos	antropomorfizar+V.nós.AD.1.PL+IMPF+3+PL
antropomorfizávamo-la	antropomorfizar+V.ele.ACC.3.F.SG+IMPF+1+PL
antropomorfizávamo-las	antropomorfizar+V.ele.ACC.3.F.PL+IMPF+1+PL
antropomorfizávamo-lo	antropomorfizar+V.ele.ACC.3.M.SG+IMPF+1+PL
antropomorfizávamo-los	antropomorfizar+V.ele.ACC.3.M.PL+IMPF+1+PL
antropomorfizávamo-nos	antropomorfizar+nós.AD.1.PL+IMPF+1+PL
antropomorfizávamos-lhe	antropomorfizar+V.ele.DAT.3.SG+IMPF+1+PL
antropomorfizávamos-lhes	antropomorfizar+V.ele.DAT.3.PL+IMPF+1+PL
antropomorfizávamos-me	antropomorfizar+V.eu.AD.1.SG+IMPF+1+PL
antropomorfizávamos-te	antropomorfizar+V.tu.AD.2.SG+IMPF+1+PL
antropomorfizávamos-vos	antropomorfizar+V.vós.AD.2.PL+IMPF+1+PL
antropomorfizavam-se	antropomorfizar+V.ele.REFL+IMPF+3+PL
antropomorfizavam-te	antropomorfizar+V.tu.AD.2.SG+IMPF+3+PL
antropomorfizavam-vos	antropomorfizar+V.vós.AD.2.PL+IMPF+3+PL
antropomorfizava-nos	antropomorfizar+nós.AD.1.PL+IMPF+1+SG
antropomorfizava-nos	antropomorfizar+nós.AD.1.PL+IMPF+2+SG
antropomorfizava-nos	antropomorfizar+nós.AD.1.PL+IMPF+3+SG
antropomorfizava-o	antropomorfizar+V.ele.ACC.3.M.SG+IMPF+1+SG
antropomorfizava-o	antropomorfizar+V.ele.ACC.3.M.SG+IMPF+3+SG
antropomorfizava-os	antropomorfizar+V.ele.ACC.3.M.PL+IMPF+1+SG
antropomorfizava-os	antropomorfizar+V.ele.ACC.3.M.PL+IMPF+3+SG
antropomorfizava-se	antropomorfizar+V.ele.REFL+IMPF+1+SG
antropomorfizava-se	antropomorfizar+V.ele.REFL+IMPF+3+SG
antropomorfizavas-lhe	antropomorfizar+V.ele.DAT.3.SG+IMPF+2+SG
antropomorfizavas-lhes	antropomorfizar+V.ele.DAT.3.PL+IMPF+2+SG
antropomorfizavas-me	antropomorfizar+V.eu.AD.1.SG+IMPF+2+SG
antropomorfizavas-te	antropomorfizar+V.tu.AD.2.SG+IMPF+2+SG
antropomorfizavas-vos	antropomorfizar+V.vós.AD.2.PL+IMPF+2+SG
antropomorfizava-te	antropomorfizar+V.tu.AD.2.SG+IMPF+1+SG
antropomorfizava-te	antropomorfizar+V.tu.AD.2.SG+IMPF+3+SG
antropomorfizava-vos	antropomorfizar+V.vós.AD.2.PL+IMPF+1+SG
antropomorfizava-vos	antropomorfizar+V.vós.AD.2.PL+IMPF+3+SG
antropomorfizávei-la	antropomorfizar+V.ele.ACC.3.F.SG+IMPF+2+PL
antropomorfizávei-las	antropomorfizar+V.ele.ACC.3.F.PL+IMPF+2+PL
antropomorfizávei-lo	antropomorfizar+V.ele.ACC.3.M.SG+IMPF+2+PL
antropomorfizávei-los	antropomorfizar+V.ele.ACC.3.M.PL+IMPF+2+PL
antropomorfizávei-nos	antropomorfizar+nós.AD.1.PL+IMPF+2+PL
antropomorfizáveis-lhe	antropomorfizar+V.ele.DAT.3.SG+IMPF+2+PL
antropomorfizáveis-lhes	antropomorfizar+V.ele.DAT.3.PL+IMPF+2+PL
antropomorfizáveis-me	antropomorfizar+V.eu.AD.1.SG+IMPF+2+PL
antropomorfizáveis-te	antropomorfizar+V.tu.AD.2.SG+IMPF+2+PL
antropomorfizáveis-vos	antropomorfizar+V.vós.AD.2.PL+IMPF+2+PL
antropomorfiza-vos	antropomorfizar+V.vós.AD.2.PL+PRS+3+SG
antropomorfize-a	antropomorfizar+V.ele.ACC.3.F.SG+IMP+3+SG
antropomorfize-as	antropomorfizar+V.ele.ACC.3.F.PL+IMP+3+SG
antropomorfizei-a	antropomorfizar+V.ele.ACC.3.F.SG+PRF+1+SG
antropomorfizei-as	antropomorfizar+V.ele.ACC.3.F.PL+PRF+1+SG
antropomorfizei-lhe	antropomorfizar+V.ele.DAT.3.SG+PRF+1+SG
antropomorfizei-lhes	antropomorfizar+V.ele.DAT.3.PL+PRF+1+SG
antropomorfizei-me	antropomorfizar+V.eu.AD.1.SG+PRF+1+SG
antropomorfizei-nos	antropomorfizar+nós.AD.1.PL+PRF+1+SG
antropomorfizei-o	antropomorfizar+V.ele.ACC.3.M.SG+PRF+1+SG
antropomorfizei-os	antropomorfizar+V.ele.ACC.3.M.PL+PRF+1+SG
antropomorfizei-te	antropomorfizar+V.tu.AD.2.SG+PRF+1+SG
antropomorfizei-vos	antropomorfizar+V.vós.AD.2.PL+PRF+1+SG
antropomorfize-lhe	antropomorfizar+V.ele.DAT.3.SG+IMP+3+SG
antropomorfize-lhes	antropomorfizar+V.ele.DAT.3.PL+IMP+3+SG
antropomorfize-me	antropomorfizar+V.eu.AD.1.SG+IMP+3+SG
antropomorfizem-lhe	antropomorfizar+V.ele.DAT.3.SG+IMP+3+PL
antropomorfizem-lhes	antropomorfizar+V.ele.DAT.3.PL+IMP+3+PL
antropomorfizem-me	antropomorfizar+V.eu.AD.1.SG+IMP+3+PL
antropomorfizem-na	antropomorfizar+V.ele.ACC.3.F.SG+IMP+3+PL
antropomorfizem-nas	antropomorfizar+V.ele.ACC.3.F.PL+IMP+3+PL
antropomorfizem-no	antropomorfizar+V.ele.ACC.3.M.SG+IMP+3+PL
antropomorfizem-nos	antropomorfizar+V.ele.ACC.3.M.PL+IMP+3+PL
antropomorfizem-nos	antropomorfizar+V.nós.AD.1.PL+IMP+3+PL
antropomorfizemo-la	antropomorfizar+V.ele.ACC.3.F.SG+IMP+1+PL
antropomorfizemo-las	antropomorfizar+V.ele.ACC.3.F.PL+IMP+1+PL
antropomorfizemo-lo	antropomorfizar+V.ele.ACC.3.M.SG+IMP+1+PL
antropomorfizemo-los	antropomorfizar+V.ele.ACC.3.M.PL+IMP+1+PL
antropomorfizemo-nos	antropomorfizar+nós.AD.1.PL+IMP+1+PL
antropomorfizemos-lhe	antropomorfizar+V.ele.DAT.3.SG+IMP+1+PL
antropomorfizemos-lhes	antropomorfizar+V.ele.DAT.3.PL+IMP+1+PL
antropomorfizemos-me	antropomorfizar+V.eu.AD.1.SG+IMP+1+PL
antropomorfizemos-te	antropomorfizar+V.tu.AD.2.SG+IMP+1+PL
antropomorfizemos-vos	antropomorfizar+V.vós.AD.2.PL+IMP+1+PL
antropomorfizem-se	antropomorfizar+V.ele.REFL+IMP+3+PL
antropomorfizem-te	antropomorfizar+V.tu.AD.2.SG+IMP+3+PL
antropomorfizem-vos	antropomorfizar+V.vós.AD.2.PL+IMP+3+PL
antropomorfize-nos	antropomorfizar+nós.AD.1.PL+IMP+3+SG
antropomorfize-o	antropomorfizar+V.ele.ACC.3.M.SG+IMP+3+SG
antropomorfize-os	antropomorfizar+V.ele.ACC.3.M.PL+IMP+3+SG
antropomorfize-se	antropomorfizar+V.ele.REFL+IMP+3+SG
antropomorfize-te	antropomorfizar+V.tu.AD.2.SG+IMP+3+SG
antropomorfize-vos	antropomorfizar+V.vós.AD.2.PL+IMP+3+SG
antropomorfizo-a	antropomorfizar+V.ele.ACC.3.F.SG+PRS+1+SG
antropomorfizo-as	antropomorfizar+V.ele.ACC.3.F.PL+PRS+1+SG
antropomorfizo-lhe	antropomorfizar+V.ele.DAT.3.SG+PRS+1+SG
antropomorfizo-lhes	antropomorfizar+V.ele.DAT.3.PL+PRS+1+SG
antropomorfizo-me	antropomorfizar+V.eu.AD.1.SG+PRS+1+SG
antropomorfizo-nos	antropomorfizar+nós.AD.1.PL+PRS+1+SG
antropomorfizo-o	antropomorfizar+V.ele.ACC.3.M.SG+PRS+1+SG
antropomorfizo-os	antropomorfizar+V.ele.ACC.3.M.PL+PRS+1+SG
antropomorfizo-te	antropomorfizar+V.tu.AD.2.SG+PRS+1+SG
antropomorfizou-a	antropomorfizar+V.ele.ACC.3.F.SG+PRF+3+SG
antropomorfizou-as	antropomorfizar+V.ele.ACC.3.F.PL+PRF+3+SG
antropomorfizou-lhe	antropomorfizar+V.ele.DAT.3.SG+PRF+3+SG
antropomorfizou-lhes	antropomorfizar+V.ele.DAT.3.PL+PRF+3+SG
antropomorfizou-me	antropomorfizar+V.eu.AD.1.SG+PRF+3+SG
antropomorfizou-nos	antropomorfizar+nós.AD.1.PL+PRF+3+SG
antropomorfizou-o	antropomorfizar+V.ele.ACC.3.M.SG+PRF+3+SG
antropomorfizou-os	antropomorfizar+V.ele.ACC.3.M.PL+PRF+3+SG
antropomorfizou-se	antropomorfizar+V.ele.REFL+PRF+3+SG
antropomorfizou-te	antropomorfizar+V.tu.AD.2.SG+PRF+3+SG
antropomorfizou-vos	antropomorfizar+V.vós.AD.2.PL+PRF+3+SG
antropomorfizo-vos	antropomorfizar+V.vós.AD.2.PL+PRS+1+SG
anua-a	anuir+V.ele.ACC.3.F.SG+IMP+3+SG
anua-as	anuir+V.ele.ACC.3.F.PL+IMP+3+SG
anua-lhe	anuir+V.ele.DAT.3.SG+IMP+3+SG
anua-lhes	anuir+V.ele.DAT.3.PL+IMP+3+SG
anua-me	anuir+V.eu.AD.1.SG+IMP+3+SG
anuam-lhe	anuir+V.ele.DAT.3.SG+IMP+3+PL
anuam-lhes	anuir+V.ele.DAT.3.PL+IMP+3+PL
anuam-me	anuir+V.eu.AD.1.SG+IMP+3+PL
anuam-na	anuir+V.ele.ACC.3.F.SG+IMP+3+PL
anuam-nas	anuir+V.ele.ACC.3.F.PL+IMP+3+PL
anuam-no	anuir+V.ele.ACC.3.M.SG+IMP+3+PL
anuam-nos	anuir+V.ele.ACC.3.M.PL+IMP+3+PL
anuam-nos	anuir+V.nós.AD.1.PL+IMP+3+PL
anuamo-la	anuir+V.ele.ACC.3.F.SG+IMP+1+PL
anuamo-las	anuir+V.ele.ACC.3.F.PL+IMP+1+PL
anuamo-lo	anuir+V.ele.ACC.3.M.SG+IMP+1+PL
anuamo-los	anuir+V.ele.ACC.3.M.PL+IMP+1+PL
anuamo-nos	anuir+nós.AD.1.PL+IMP+1+PL
anuamos-lhe	anuir+V.ele.DAT.3.SG+IMP+1+PL
anuamos-lhes	anuir+V.ele.DAT.3.PL+IMP+1+PL
anuamos-me	anuir+V.eu.AD.1.SG+IMP+1+PL
anuamos-te	anuir+V.tu.AD.2.SG+IMP+1+PL
anuamos-vos	anuir+V.vós.AD.2.PL+IMP+1+PL
anuam-se	anuir+V.ele.REFL+IMP+3+PL
anuam-te	anuir+V.tu.AD.2.SG+IMP+3+PL
anuam-vos	anuir+V.vós.AD.2.PL+IMP+3+PL
anua-nos	anuir+nós.AD.1.PL+IMP+3+SG
anua-o	anuir+V.ele.ACC.3.M.SG+IMP+3+SG
anua-os	anuir+V.ele.ACC.3.M.PL+IMP+3+SG
anua-se	anuir+V.ele.REFL+IMP+3+SG
anua-te	anuir+V.tu.AD.2.SG+IMP+3+SG
anua-vos	anuir+V.vós.AD.2.PL+IMP+3+SG
anuem-lhe	anuir+V.ele.DAT.3.SG+PRS+3+PL
anuem-lhes	anuir+V.ele.DAT.3.PL+PRS+3+PL
anuem-me	anuir+V.eu.AD.1.SG+PRS+3+PL
anuem-na	anuir+V.ele.ACC.3.F.SG+PRS+3+PL
anuem-nas	anuir+V.ele.ACC.3.F.PL+PRS+3+PL
anuem-no	anuir+V.ele.ACC.3.M.SG+PRS+3+PL
anuem-nos	anuir+V.ele.ACC.3.M.PL+PRS+3+PL
anuem-nos	anuir+V.nós.AD.1.PL+PRS+3+PL
anuem-se	anuir+V.ele.REFL+PRS+3+PL
anuem-te	anuir+V.tu.AD.2.SG+PRS+3+PL
anuem-vos	anuir+V.vós.AD.2.PL+PRS+3+PL
anuía-a	anuir+V.ele.ACC.3.F.SG+IMPF+1+SG
anuía-a	anuir+V.ele.ACC.3.F.SG+IMPF+3+SG
anuí-a	anuir+V.ele.ACC.3.F.SG+PRF+1+SG
anui-a	anuir+V.ele.ACC.3.F.SG+PRS+3+SG
anuía-as	anuir+V.ele.ACC.3.F.PL+IMPF+1+SG
anuía-as	anuir+V.ele.ACC.3.F.PL+IMPF+3+SG
anuía-la	anuir+V.ele.ACC.3.F.SG+IMPF+2+SG
anuía-las	anuir+V.ele.ACC.3.F.PL+IMPF+2+SG
anuía-lhe	anuir+V.ele.DAT.3.SG+IMPF+1+SG
anuía-lhe	anuir+V.ele.DAT.3.SG+IMPF+3+SG
anuía-lhes	anuir+V.ele.DAT.3.PL+IMPF+1+SG
anuía-lhes	anuir+V.ele.DAT.3.PL+IMPF+3+SG
anuía-lo	anuir+V.ele.ACC.3.M.SG+IMPF+2+SG
anuía-los	anuir+V.ele.ACC.3.M.PL+IMPF+2+SG
anuía-me	anuir+V.eu.AD.1.SG+IMPF+1+SG
anuía-me	anuir+V.eu.AD.1.SG+IMPF+3+SG
anuíam-lhe	anuir+V.ele.DAT.3.SG+IMPF+3+PL
anuíam-lhes	anuir+V.ele.DAT.3.PL+IMPF+3+PL
anuíam-me	anuir+V.eu.AD.1.SG+IMPF+3+PL
anuíam-na	anuir+V.ele.ACC.3.F.SG+IMPF+3+PL
anuíam-nas	anuir+V.ele.ACC.3.F.PL+IMPF+3+PL
anuíam-no	anuir+V.ele.ACC.3.M.SG+IMPF+3+PL
anuíam-nos	anuir+nós.AD.1.PL+IMPF+3+PL
anuíamo-la	anuir+V.ele.ACC.3.F.SG+IMPF+1+PL
anuíamo-las	anuir+V.ele.ACC.3.F.PL+IMPF+1+PL
anuíamo-lo	anuir+V.ele.ACC.3.M.SG+IMPF+1+PL
anuíamo-los	anuir+V.ele.ACC.3.M.PL+IMPF+1+PL
anuíamo-nos	anuir+nós.AD.1.PL+IMPF+1+PL
anuíamos-lhe	anuir+V.ele.DAT.3.SG+IMPF+1+PL
anuíamos-lhes	anuir+V.ele.DAT.3.PL+IMPF+1+PL
anuíamos-me	anuir+V.eu.AD.1.SG+IMPF+1+PL
anuíamos-te	anuir+V.tu.AD.2.SG+IMPF+1+PL
anuíamos-vos	anuir+V.vós.AD.2.PL+IMPF+1+PL
anuíam-se	anuir+V.ele.REFL+IMPF+3+PL
anuíam-te	anuir+V.tu.AD.2.SG+IMPF+3+PL
anuíam-vos	anuir+V.vós.AD.2.PL+IMPF+3+PL
anuía-nos	anuir+nós.AD.1.PL+IMPF+1+SG
anuía-nos	anuir+nós.AD.1.PL+IMPF+2+SG
anuía-nos	anuir+nós.AD.1.PL+IMPF+3+SG
anuía-o	anuir+V.ele.ACC.3.M.SG+IMPF+1+SG
anuía-o	anuir+V.ele.ACC.3.M.SG+IMPF+3+SG
anuía-os	anuir+V.ele.ACC.3.M.PL+IMPF+1+SG
anuía-os	anuir+V.ele.ACC.3.M.PL+IMPF+3+SG
anuí-as	anuir+V.ele.ACC.3.F.PL+PRF+1+SG
anui-as	anuir+V.ele.ACC.3.F.PL+PRS+3+SG
anuía-se	anuir+V.ele.REFL+IMPF+3+SG
anuías-lhe	anuir+V.ele.DAT.3.SG+IMPF+2+SG
anuías-lhes	anuir+V.ele.DAT.3.PL+IMPF+2+SG
anuías-me	anuir+V.eu.AD.1.SG+IMPF+2+SG
anuías-te	anuir+V.tu.AD.2.SG+IMPF+2+SG
anuías-vos	anuir+V.vós.AD.2.PL+IMPF+2+SG
anuía-te	anuir+V.tu.AD.2.SG+IMPF+1+SG
anuía-te	anuir+V.tu.AD.2.SG+IMPF+3+SG
anuía-vos	anuir+V.vós.AD.2.PL+IMPF+1+SG
anuía-vos	anuir+V.vós.AD.2.PL+IMPF+3+SG
anuíei-la	anuir+V.ele.ACC.3.F.SG+IMPF+2+PL
anuíei-las	anuir+V.ele.ACC.3.F.PL+IMPF+2+PL
anuíei-lo	anuir+V.ele.ACC.3.M.SG+IMPF+2+PL
anuíei-los	anuir+V.ele.ACC.3.M.PL+IMPF+2+PL
anuíei-nos	anuir+nós.AD.1.PL+IMPF+2+PL
anuíeis-lhe	anuir+V.ele.DAT.3.SG+IMPF+2+PL
anuíeis-lhes	anuir+V.ele.DAT.3.PL+IMPF+2+PL
anuíeis-me	anuir+V.eu.AD.1.SG+IMPF+2+PL
anuíeis-te	anuir+V.tu.AD.2.SG+IMPF+2+PL
anuíeis-vos	anuir+V.vós.AD.2.PL+IMPF+2+PL
anui-la-á	anuir+V.ele.ACC.3.F.SG+FUT+3+SG
anui-la	anuir+V.ele.ACC.3.F.SG+INF+1+SG
anui-la	anuir+V.ele.ACC.3.F.SG+INF+3+SG
anuí-la	anuir+V.ele.ACC.3.F.SG+PRS+2+PL
anui-la	anuir+V.ele.ACC.3.F.SG+PRS+2+SG
anui-la	anuir+V.ele.ACC.3.F.SG+SBJF+1+SG
anui-la	anuir+V.ele.ACC.3.F.SG+SBJF+3+SG
anui-la-ão	anuir+V.ele.ACC.3.F.SG+FUT+3+PL
anui-la-ás	anuir+V.ele.ACC.3.F.SG+FUT+2+SG
anui-la-ei	anuir+V.ele.ACC.3.F.SG+FUT+1+SG
anui-la-eis	anuir+V.ele.ACC.3.F.SG+FUT+2+PL
anui-la-emos	anuir+V.ele.ACC.3.F.SG+FUT+1+PL
anui-la-ia	anuir+V.ele.ACC.3.F.SG+COND+1+SG
anui-la-ia	anuir+V.ele.ACC.3.F.SG+COND+3+SG
anui-la-iam	anuir+V.ele.ACC.3.F.SG+COND+3+PL
anui-la-íamos	anuir+V.ele.ACC.3.F.SG+COND+1+PL
anui-la-ias	anuir+V.ele.ACC.3.F.SG+COND+2+SG
anui-la-íeis	anuir+V.ele.ACC.3.F.SG+COND+2+PL
anui-las-á	anuir+V.ele.ACC.3.F.PL+FUT+3+SG
anui-las	anuir+V.ele.ACC.3.F.PL+INF+1+SG
anui-las	anuir+V.ele.ACC.3.F.PL+INF+3+SG
anuí-las	anuir+V.ele.ACC.3.F.PL+PRS+2+PL
anui-las	anuir+V.ele.ACC.3.F.PL+PRS+2+SG
anui-las	anuir+V.ele.ACC.3.F.PL+SBJF+1+SG
anui-las	anuir+V.ele.ACC.3.F.PL+SBJF+3+SG
anui-las-ão	anuir+V.ele.ACC.3.F.PL+FUT+3+PL
anui-las-ás	anuir+V.ele.ACC.3.F.PL+FUT+2+SG
anui-las-ei	anuir+V.ele.ACC.3.F.PL+FUT+1+SG
anui-las-eis	anuir+V.ele.ACC.3.F.PL+FUT+2+PL
anui-las-emos	anuir+V.ele.ACC.3.F.PL+FUT+1+PL
anui-las-ia	anuir+V.ele.ACC.3.F.PL+COND+1+SG
anui-las-ia	anuir+V.ele.ACC.3.F.PL+COND+3+SG
anui-las-iam	anuir+V.ele.ACC.3.F.PL+COND+3+PL
anui-las-íamos	anuir+V.ele.ACC.3.F.PL+COND+1+PL
anui-las-ias	anuir+V.ele.ACC.3.F.PL+COND+2+SG
anui-las-íeis	anuir+V.ele.ACC.3.F.PL+COND+2+PL
anuí-lhe	anuir+V.ele.DAT.3.SG+PRF+1+SG
anui-lhe	anuir+V.ele.DAT.3.SG+PRS+3+SG
anuí-lhes	anuir+V.ele.DAT.3.PL+PRF+1+SG
anui-lhes	anuir+V.ele.DAT.3.PL+PRS+3+SG
anui-lo-á	anuir+V.ele.ACC.3.M.SG+FUT+3+SG
anui-lo	anuir+V.ele.ACC.3.M.SG+INF+1+SG
anui-lo	anuir+V.ele.ACC.3.M.SG+INF+3+SG
anuí-lo	anuir+V.ele.ACC.3.M.SG+PRS+2+PL
anui-lo	anuir+V.ele.ACC.3.M.SG+PRS+2+SG
anui-lo	anuir+V.ele.ACC.3.M.SG+SBJF+1+SG
anui-lo	anuir+V.ele.ACC.3.M.SG+SBJF+3+SG
anui-lo-ão	anuir+V.ele.ACC.3.M.SG+FUT+3+PL
anui-lo-ás	anuir+V.ele.ACC.3.M.SG+FUT+2+SG
anui-lo-ei	anuir+V.ele.ACC.3.M.SG+FUT+1+SG
anui-lo-eis	anuir+V.ele.ACC.3.M.SG+FUT+2+PL
anui-lo-emos	anuir+V.ele.ACC.3.M.SG+FUT+1+PL
anui-lo-ia	anuir+V.ele.ACC.3.M.SG+COND+1+SG
anui-lo-ia	anuir+V.ele.ACC.3.M.SG+COND+3+SG
anui-lo-iam	anuir+V.ele.ACC.3.M.SG+COND+3+PL
anui-lo-íamos	anuir+V.ele.ACC.3.M.SG+COND+1+PL
anui-lo-ias	anuir+V.ele.ACC.3.M.SG+COND+2+SG
anui-lo-íeis	anuir+V.ele.ACC.3.M.SG+COND+2+PL
anui-los-á	anuir+V.ele.ACC.3.M.PL+FUT+3+SG
anui-los	anuir+V.ele.ACC.3.M.PL+INF+1+SG
anui-los	anuir+V.ele.ACC.3.M.PL+INF+3+SG
anuí-los	anuir+V.ele.ACC.3.M.PL+PRS+2+PL
anui-los	anuir+V.ele.ACC.3.M.PL+PRS+2+SG
anui-los	anuir+V.ele.ACC.3.M.PL+SBJF+1+SG
anui-los	anuir+V.ele.ACC.3.M.PL+SBJF+3+SG
anui-los-ão	anuir+V.ele.ACC.3.M.PL+FUT+3+PL
anui-los-ás	anuir+V.ele.ACC.3.M.PL+FUT+2+SG
anui-los-ei	anuir+V.ele.ACC.3.M.PL+FUT+1+SG
anui-los-eis	anuir+V.ele.ACC.3.M.PL+FUT+2+PL
anui-los-emos	anuir+V.ele.ACC.3.M.PL+FUT+1+PL
anui-los-ia	anuir+V.ele.ACC.3.M.PL+COND+1+SG
anui-los-ia	anuir+V.ele.ACC.3.M.PL+COND+3+SG
anui-los-iam	anuir+V.ele.ACC.3.M.PL+COND+3+PL
anui-los-íamos	anuir+V.ele.ACC.3.M.PL+COND+1+PL
anui-los-ias	anuir+V.ele.ACC.3.M.PL+COND+2+SG
anui-los-íeis	anuir+V.ele.ACC.3.M.PL+COND+2+PL
anuí-me	anuir+V.eu.AD.1.SG+PRF+1+SG
anui-me	anuir+V.eu.AD.1.SG+PRS+3+SG
anuímo-la	anuir+V.ele.ACC.3.F.SG+PRF+1+PL
anuímo-la	anuir+V.ele.ACC.3.F.SG+PRS+1+PL
anuímo-las	anuir+V.ele.ACC.3.F.PL+PRF+1+PL
anuímo-las	anuir+V.ele.ACC.3.F.PL+PRS+1+PL
anuímo-lo	anuir+V.ele.ACC.3.M.SG+PRF+1+PL
anuímo-lo	anuir+V.ele.ACC.3.M.SG+PRS+1+PL
anuímo-los	anuir+V.ele.ACC.3.M.PL+PRF+1+PL
anuímo-los	anuir+V.ele.ACC.3.M.PL+PRS+1+PL
anuímo-nos	anuir+nós.AD.1.PL+PRF+1+PL
anuímo-nos	anuir+nós.AD.1.PL+PRS+1+PL
anuímos-lhe	anuir+V.ele.DAT.3.SG+PRF+1+PL
anuímos-lhe	anuir+V.ele.DAT.3.SG+PRS+1+PL
anuímos-lhes	anuir+V.ele.DAT.3.PL+PRF+1+PL
anuímos-lhes	anuir+V.ele.DAT.3.PL+PRS+1+PL
anuímos-me	anuir+V.eu.AD.1.SG+PRF+1+PL
anuímos-me	anuir+V.eu.AD.1.SG+PRS+1+PL
anuímos-te	anuir+V.tu.AD.2.SG+PRF+1+PL
anuímos-te	anuir+V.tu.AD.2.SG+PRS+1+PL
anuímos-vos	anuir+V.vós.AD.2.PL+PRF+1+PL
anuímos-vos	anuir+V.vós.AD.2.PL+PRS+1+PL
anuindo-a	anuir+V.ele.ACC.3.F.SG+GRD
anuindo-as	anuir+V.ele.ACC.3.F.PL+GRD
anuindo-lhe	anuir+V.ele.DAT.3.SG+GRD
anuindo-lhes	anuir+V.ele.DAT.3.PL+GRD
anuindo-me	anuir+V.eu.AD.1.SG+GRD
anuindo-nos	anuir+nós.AD.1.PL+GRD
anuindo-o	anuir+V.ele.ACC.3.M.SG+GRD
anuindo-os	anuir+V.ele.ACC.3.M.PL+GRD
anuindo-se	anuir+V.ele.REFL+GRD
anuindo-te	anuir+V.tu.AD.2.SG+GRD
anuindo-vos	anuir+V.vós.AD.2.PL+GRD
anuí-nos	anuir+nós.AD.1.PL+PRF+1+SG
anuí-nos	anuir+nós.AD.1.PL+PRS+2+PL
anui-nos	anuir+nós.AD.1.PL+PRS+2+SG
anui-nos	anuir+nós.AD.1.PL+PRS+3+SG
anuí-o	anuir+V.ele.ACC.3.M.SG+PRF+1+SG
anui-o	anuir+V.ele.ACC.3.M.SG+PRS+3+SG
anuí-os	anuir+V.ele.ACC.3.M.PL+PRF+1+SG
anui-os	anuir+V.ele.ACC.3.M.PL+PRS+3+SG
anuíra-a	anuir+V.ele.ACC.3.F.SG+PQP+1+SG
anuíra-a	anuir+V.ele.ACC.3.F.SG+PQP+3+SG
anuíra-as	anuir+V.ele.ACC.3.F.PL+PQP+1+SG
anuíra-as	anuir+V.ele.ACC.3.F.PL+PQP+3+SG
anuíra-la	anuir+V.ele.ACC.3.F.SG+PQP+2+SG
anuíra-las	anuir+V.ele.ACC.3.F.PL+PQP+2+SG
anuíra-lhe	anuir+V.ele.DAT.3.SG+PQP+1+SG
anuíra-lhe	anuir+V.ele.DAT.3.SG+PQP+3+SG
anuíra-lhes	anuir+V.ele.DAT.3.PL+PQP+1+SG
anuíra-lhes	anuir+V.ele.DAT.3.PL+PQP+3+SG
anuíra-lo	anuir+V.ele.ACC.3.M.SG+PQP+2+SG
anuíra-los	anuir+V.ele.ACC.3.M.PL+PQP+2+SG
anuíra-me	anuir+V.eu.AD.1.SG+PQP+1+SG
anuíra-me	anuir+V.eu.AD.1.SG+PQP+3+SG
anuíram-lhe	anuir+V.ele.DAT.3.SG+PQP+3+PL
anuíram-lhe	anuir+V.ele.DAT.3.SG+PRF+3+PL
anuíram-lhes	anuir+V.ele.DAT.3.PL+PQP+3+PL
anuíram-lhes	anuir+V.ele.DAT.3.PL+PRF+3+PL
anuíram-me	anuir+V.eu.AD.1.SG+PQP+3+PL
anuíram-me	anuir+V.eu.AD.1.SG+PRF+3+PL
anuíram-na	anuir+V.ele.ACC.3.F.SG+PQP+3+PL
anuíram-na	anuir+V.ele.ACC.3.F.SG+PRF+3+PL
anuíram-nas	anuir+V.ele.ACC.3.F.PL+PQP+3+PL
anuíram-nas	anuir+V.ele.ACC.3.F.PL+PRF+3+PL
anuíram-no	anuir+V.ele.ACC.3.M.SG+PQP+3+PL
anuíram-no	anuir+V.ele.ACC.3.M.SG+PRF+3+PL
anuíram-nos	anuir+nós.AD.1.PL+PQP+3+PL
anuíram-nos	anuir+nós.AD.1.PL+PRF+3+PL
anuíramo-la	anuir+V.ele.ACC.3.F.SG+PQP+1+PL
anuíramo-las	anuir+V.ele.ACC.3.F.PL+PQP+1+PL
anuíramo-lo	anuir+V.ele.ACC.3.M.SG+PQP+1+PL
anuíramo-los	anuir+V.ele.ACC.3.M.PL+PQP+1+PL
anuíramo-nos	anuir+nós.AD.1.PL+PQP+1+PL
anuíramos-lhe	anuir+V.ele.DAT.3.SG+PQP+1+PL
anuíramos-lhes	anuir+V.ele.DAT.3.PL+PQP+1+PL
anuíramos-me	anuir+V.eu.AD.1.SG+PQP+1+PL
anuíramos-te	anuir+V.tu.AD.2.SG+PQP+1+PL
anuíramos-vos	anuir+V.vós.AD.2.PL+PQP+1+PL
anuíram-se	anuir+V.ele.REFL+PQP+3+PL
anuíram-se	anuir+V.ele.REFL+PRF+3+PL
anuíram-te	anuir+V.tu.AD.2.SG+PQP+3+PL
anuíram-te	anuir+V.tu.AD.2.SG+PRF+3+PL
anuíram-vos	anuir+V.vós.AD.2.PL+PQP+3+PL
anuíram-vos	anuir+V.vós.AD.2.PL+PRF+3+PL
anuíra-nos	anuir+nós.AD.1.PL+PQP+1+SG
anuíra-nos	anuir+nós.AD.1.PL+PQP+2+SG
anuíra-nos	anuir+nós.AD.1.PL+PQP+3+SG
anuíra-o	anuir+V.ele.ACC.3.M.SG+PQP+1+SG
anuíra-o	anuir+V.ele.ACC.3.M.SG+PQP+3+SG
anuíra-os	anuir+V.ele.ACC.3.M.PL+PQP+1+SG
anuíra-os	anuir+V.ele.ACC.3.M.PL+PQP+3+SG
anuíra-se	anuir+V.ele.REFL+PQP+3+SG
anuíras-lhe	anuir+V.ele.DAT.3.SG+PQP+2+SG
anuíras-lhes	anuir+V.ele.DAT.3.PL+PQP+2+SG
anuíras-me	anuir+V.eu.AD.1.SG+PQP+2+SG
anuíras-te	anuir+V.tu.AD.2.SG+PQP+2+SG
anuíras-vos	anuir+V.vós.AD.2.PL+PQP+2+SG
anuíra-te	anuir+V.tu.AD.2.SG+PQP+1+SG
anuíra-te	anuir+V.tu.AD.2.SG+PQP+3+SG
anuíra-vos	anuir+V.vós.AD.2.PL+PQP+1+SG
anuíra-vos	anuir+V.vós.AD.2.PL+PQP+3+SG
anuirde-la	anuir+V.ele.ACC.3.F.SG+INF+2+PL
anuirde-la	anuir+V.ele.ACC.3.F.SG+SBJF+2+PL
anuirde-las	anuir+V.ele.ACC.3.F.PL+INF+2+PL
anuirde-las	anuir+V.ele.ACC.3.F.PL+SBJF+2+PL
anuirde-lo	anuir+V.ele.ACC.3.M.SG+INF+2+PL
anuirde-lo	anuir+V.ele.ACC.3.M.SG+SBJF+2+PL
anuirde-los	anuir+V.ele.ACC.3.M.PL+INF+2+PL
anuirde-los	anuir+V.ele.ACC.3.M.PL+SBJF+2+PL
anuirde-nos	anuir+nós.AD.1.PL+INF+2+PL
anuirde-nos	anuir+nós.AD.1.PL+SBJF+2+PL
anuirdes-lhe	anuir+V.ele.DAT.3.SG+INF+2+PL
anuirdes-lhe	anuir+V.ele.DAT.3.SG+SBJF+2+PL
anuirdes-lhes	anuir+V.ele.DAT.3.PL+INF+2+PL
anuirdes-lhes	anuir+V.ele.DAT.3.PL+SBJF+2+PL
anuirdes-me	anuir+V.eu.AD.1.SG+INF+2+PL
anuirdes-me	anuir+V.eu.AD.1.SG+SBJF+2+PL
anuirdes-te	anuir+V.tu.AD.2.SG+INF+2+PL
anuirdes-te	anuir+V.tu.AD.2.SG+SBJF+2+PL
anuirdes-vos	anuir+V.vós.AD.2.PL+INF+2+PL
anuirdes-vos	anuir+V.vós.AD.2.PL+SBJF+2+PL
anuírei-la	anuir+V.ele.ACC.3.F.SG+PQP+2+PL
anuírei-las	anuir+V.ele.ACC.3.F.PL+PQP+2+PL
anuírei-lo	anuir+V.ele.ACC.3.M.SG+PQP+2+PL
anuírei-los	anuir+V.ele.ACC.3.M.PL+PQP+2+PL
anuírei-nos	anuir+nós.AD.1.PL+PQP+2+PL
anuíreis-lhe	anuir+V.ele.DAT.3.SG+PQP+2+PL
anuíreis-lhes	anuir+V.ele.DAT.3.PL+PQP+2+PL
anuíreis-me	anuir+V.eu.AD.1.SG+PQP+2+PL
anuíreis-te	anuir+V.tu.AD.2.SG+PQP+2+PL
anuíreis-vos	anuir+V.vós.AD.2.PL+PQP+2+PL
anuíre-la	anuir+V.ele.ACC.3.F.SG+INF+2+SG
anuíre-la	anuir+V.ele.ACC.3.F.SG+SBJF+2+SG
anuíre-las	anuir+V.ele.ACC.3.F.PL+INF+2+SG
anuíre-las	anuir+V.ele.ACC.3.F.PL+SBJF+2+SG
anuíre-lo	anuir+V.ele.ACC.3.M.SG+INF+2+SG
anuíre-lo	anuir+V.ele.ACC.3.M.SG+SBJF+2+SG
anuíre-los	anuir+V.ele.ACC.3.M.PL+INF+2+SG
anuíre-los	anuir+V.ele.ACC.3.M.PL+SBJF+2+SG
anuírem-lhe	anuir+V.ele.DAT.3.SG+INF+3+PL
anuírem-lhe	anuir+V.ele.DAT.3.SG+SBJF+3+PL
anuírem-lhes	anuir+V.ele.DAT.3.PL+INF+3+PL
anuírem-lhes	anuir+V.ele.DAT.3.PL+SBJF+3+PL
anuírem-me	anuir+V.eu.AD.1.SG+INF+3+PL
anuírem-me	anuir+V.eu.AD.1.SG+SBJF+3+PL
anuírem-na	anuir+V.ele.ACC.3.F.SG+INF+3+PL
anuírem-na	anuir+V.ele.ACC.3.F.SG+SBJF+3+PL
anuírem-nas	anuir+V.ele.ACC.3.F.PL+INF+3+PL
anuírem-nas	anuir+V.ele.ACC.3.F.PL+SBJF+3+PL
anuírem-no	anuir+V.ele.ACC.3.M.SG+INF+3+PL
anuírem-no	anuir+V.ele.ACC.3.M.SG+SBJF+3+PL
anuírem-nos	anuir+nós.AD.1.PL+INF+3+PL
anuírem-nos	anuir+nós.AD.1.PL+SBJF+3+PL
anuírem-se	anuir+V.ele.REFL+INF+3+PL
anuírem-se	anuir+V.ele.REFL+SBJF+3+PL
anuírem-te	anuir+V.tu.AD.2.SG+INF+3+PL
anuírem-te	anuir+V.tu.AD.2.SG+SBJF+3+PL
anuírem-vos	anuir+V.vós.AD.2.PL+INF+3+PL
anuírem-vos	anuir+V.vós.AD.2.PL+SBJF+3+PL
anuíre-nos	anuir+nós.AD.1.PL+INF+2+SG
anuíre-nos	anuir+nós.AD.1.PL+SBJF+2+SG
anuíres-lhe	anuir+V.ele.DAT.3.SG+INF+2+SG
anuíres-lhe	anuir+V.ele.DAT.3.SG+SBJF+2+SG
anuíres-lhes	anuir+V.ele.DAT.3.PL+INF+2+SG
anuíres-lhes	anuir+V.ele.DAT.3.PL+SBJF+2+SG
anuíres-me	anuir+V.eu.AD.1.SG+INF+2+SG
anuíres-me	anuir+V.eu.AD.1.SG+SBJF+2+SG
anuíres-te	anuir+V.tu.AD.2.SG+INF+2+SG
anuíres-te	anuir+V.tu.AD.2.SG+SBJF+2+SG
anuíres-vos	anuir+V.vós.AD.2.PL+INF+2+SG
anuíres-vos	anuir+V.vós.AD.2.PL+SBJF+2+SG
anuir-lhe-á	anuir+V.ele.DAT.3.SG+FUT+3+SG
anuirlhe	anuir+V.None+INF
anuirlhe	anuir+V.None+INF+3+1
anuirlhe	anuir+V.None+INF+3+SG
anuirlhe	anuir+V.None+SBJF+1+SG
anuirlhe	anuir+V.None+SBJF+3+SG
anuir-lhe-ão	anuir+V.ele.DAT.3.SG+FUT+3+PL
anuir-lhe-ás	anuir+V.ele.DAT.3.SG+FUT+2+SG
anuir-lhe-ei	anuir+V.ele.DAT.3.SG+FUT+1+SG
anuir-lhe-eis	anuir+V.ele.DAT.3.SG+FUT+2+PL
anuir-lhe-emos	anuir+V.ele.DAT.3.SG+FUT+1+PL
anuir-lhe-ia	anuir+V.ele.DAT.3.SG+COND+1+SG
anuir-lhe-ia	anuir+V.ele.DAT.3.SG+COND+3+SG
anuir-lhe-iam	anuir+V.ele.DAT.3.SG+COND+3+PL
anuir-lhe-íamos	anuir+V.ele.DAT.3.SG+COND+1+PL
anuir-lhe-ias	anuir+V.ele.DAT.3.SG+COND+2+SG
anuir-lhe-íeis	anuir+V.ele.DAT.3.SG+COND+2+PL
anuir-lhes-á	anuir+V.ele.DAT.3.PL+FUT+3+SG
anuirlhes	anuir+V.None+INF
anuirlhes	anuir+V.None+INF+3+1
anuirlhes	anuir+V.None+INF+3+SG
anuirlhes	anuir+V.None+SBJF+1+SG
anuirlhes	anuir+V.None+SBJF+3+SG
anuir-lhes-ão	anuir+V.ele.DAT.3.PL+FUT+3+PL
anuir-lhes-ás	anuir+V.ele.DAT.3.PL+FUT+2+SG
anuir-lhes-ei	anuir+V.ele.DAT.3.PL+FUT+1+SG
anuir-lhes-eis	anuir+V.ele.DAT.3.PL+FUT+2+PL
anuir-lhes-emos	anuir+V.ele.DAT.3.PL+FUT+1+PL
anuir-lhes-ia	anuir+V.ele.DAT.3.PL+COND+1+SG
anuir-lhes-ia	anuir+V.ele.DAT.3.PL+COND+3+SG
anuir-lhes-iam	anuir+V.ele.DAT.3.PL+COND+3+PL
anuir-lhes-íamos	anuir+V.ele.DAT.3.PL+COND+1+PL
anuir-lhes-ias	anuir+V.ele.DAT.3.PL+COND+2+SG
anuir-lhes-íeis	anuir+V.ele.DAT.3.PL+COND+2+PL
anuir-me-á	anuir+V.eu.AD.1.SG+FUT+3+SG
anuirme	anuir+V.None+INF
anuirme	anuir+V.None+INF+3+1
anuirme	anuir+V.None+INF+3+SG
anuirme	anuir+V.None+SBJF+1+SG
anuirme	anuir+V.None+SBJF+3+SG
anuir-me-ão	anuir+V.eu.AD.1.SG+FUT+3+PL
anuir-me-ás	anuir+V.eu.AD.1.SG+FUT+2+SG
anuir-me-ei	anuir+V.eu.AD.1.SG+FUT+1+SG
anuir-me-eis	anuir+V.eu.AD.1.SG+FUT+2+PL
anuir-me-emos	anuir+V.eu.AD.1.SG+FUT+1+PL
anuir-me-ia	anuir+V.eu.AD.1.SG+COND+1+SG
anuir-me-ia	anuir+V.eu.AD.1.SG+COND+3+SG
anuir-me-iam	anuir+V.eu.AD.1.SG+COND+3+PL
anuir-me-íamos	anuir+V.eu.AD.1.SG+COND+1+PL
anuir-me-ias	anuir+V.eu.AD.1.SG+COND+2+SG
anuir-me-íeis	anuir+V.eu.AD.1.SG+COND+2+PL
anuirmo-la	anuir+V.ele.ACC.3.F.SG+INF+1+PL
anuirmo-la	anuir+V.ele.ACC.3.F.SG+SBJF+1+PL
anuirmo-las	anuir+V.ele.ACC.3.F.PL+INF+1+PL
anuirmo-las	anuir+V.ele.ACC.3.F.PL+SBJF+1+PL
anuirmo-lo	anuir+V.ele.ACC.3.M.SG+INF+1+PL
anuirmo-lo	anuir+V.ele.ACC.3.M.SG+SBJF+1+PL
anuirmo-los	anuir+V.ele.ACC.3.M.PL+INF+1+PL
anuirmo-los	anuir+V.ele.ACC.3.M.PL+SBJF+1+PL
anuirmo-nos	anuir+nós.AD.1.PL+INF+1+PL
anuirmo-nos	anuir+nós.AD.1.PL+SBJF+1+PL
anuirmos-lhe	anuir+V.ele.DAT.3.SG+INF+1+PL
anuirmos-lhe	anuir+V.ele.DAT.3.SG+SBJF+1+PL
anuirmos-lhes	anuir+V.ele.DAT.3.PL+INF+1+PL
anuirmos-lhes	anuir+V.ele.DAT.3.PL+SBJF+1+PL
anuirmos-me	anuir+V.eu.AD.1.SG+INF+1+PL
anuirmos-me	anuir+V.eu.AD.1.SG+SBJF+1+PL
anuirmos-te	anuir+V.tu.AD.2.SG+INF+1+PL
anuirmos-te	anuir+V.tu.AD.2.SG+SBJF+1+PL
anuirmos-vos	anuir+V.vós.AD.2.PL+INF+1+PL
anuirmos-vos	anuir+V.vós.AD.2.PL+SBJF+1+PL
anuir-nos-á	anuir+nós.AD.1.PL+FUT+3+SG
anuirnos	anuir+V.None+INF
anuirnos	anuir+V.None+INF+3+1
anuirnos	anuir+V.None+INF+3+SG
anuirnos	anuir+V.None+SBJF+1+SG
anuirnos	anuir+V.None+SBJF+3+SG
anuir-nos-ão	anuir+nós.AD.1.PL+FUT+3+PL
anuir-nos-ás	anuir+nós.AD.1.PL+FUT+2+SG
anuir-nos-ei	anuir+nós.AD.1.PL+FUT+1+SG
anuir-nos-eis	anuir+nós.AD.1.PL+FUT+2+PL
anuir-nos-emos	anuir+nós.AD.1.PL+FUT+1+PL
anuir-nos-ia	anuir+nós.AD.1.PL+COND+1+SG
anuir-nos-ia	anuir+nós.AD.1.PL+COND+3+SG
anuir-nos-iam	anuir+nós.AD.1.PL+COND+3+PL
anuir-nos-íamos	anuir+nós.AD.1.PL+COND+1+PL
anuir-nos-ias	anuir+nós.AD.1.PL+COND+2+SG
anuir-nos-íeis	anuir+nós.AD.1.PL+COND+2+PL
anuir-se-á	anuir+V.ele.REFL+FUT+3+SG
anuir-se	anuir+V.ele.REFL+INF
anuir-se	anuir+V.ele.REFL+INF+3+SG
anuir-se	anuir+V.ele.REFL+SBJF+3+SG
anuir-se-ão	anuir+V.ele.REFL+FUT+3+PL
anuir-se-ia	anuir+V.ele.REFL+COND+3+SG
anuir-se-iam	anuir+V.ele.REFL+COND+3+PL
anuir-te-á	anuir+V.tu.AD.2.SG+FUT+3+SG
anuirte	anuir+V.None+INF
anuirte	anuir+V.None+INF+3+1
anuirte	anuir+V.None+INF+3+SG
anuirte	anuir+V.None+SBJF+1+SG
anuirte	anuir+V.None+SBJF+3+SG
anuir-te-ão	anuir+V.tu.AD.2.SG+FUT+3+PL
anuir-te-ás	anuir+V.tu.AD.2.SG+FUT+2+SG
anuir-te-ei	anuir+V.tu.AD.2.SG+FUT+1+SG
anuir-te-eis	anuir+V.tu.AD.2.SG+FUT+2+PL
anuir-te-emos	anuir+V.tu.AD.2.SG+FUT+1+PL
anuir-te-ia	anuir+V.tu.AD.2.SG+COND+1+SG
anuir-te-ia	anuir+V.tu.AD.2.SG+COND+3+SG
anuir-te-iam	anuir+V.tu.AD.2.SG+COND+3+PL
anuir-te-íamos	anuir+V.tu.AD.2.SG+COND+1+PL
anuir-te-ias	anuir+V.tu.AD.2.SG+COND+2+SG
anuir-te-íeis	anuir+V.tu.AD.2.SG+COND+2+PL
anuir-vos-á	anuir+V.vós.AD.2.PL+FUT+3+SG
anuirvos	anuir+V.None+INF
anuirvos	anuir+V.None+INF+3+1
anuirvos	anuir+V.None+INF+3+SG
anuirvos	anuir+V.None+SBJF+1+SG
anuirvos	anuir+V.None+SBJF+3+SG
anuir-vos-ão	anuir+V.vós.AD.2.PL+FUT+3+PL
anuir-vos-ás	anuir+V.vós.AD.2.PL+FUT+2+SG
anuir-vos-ei	anuir+V.vós.AD.2.PL+FUT+1+SG
anuir-vos-eis	anuir+V.vós.AD.2.PL+FUT+2+PL
anuir-vos-emos	anuir+V.vós.AD.2.PL+FUT+1+PL
anuir-vos-ia	anuir+V.vós.AD.2.PL+COND+1+SG
anuir-vos-ia	anuir+V.vós.AD.2.PL+COND+3+SG
anuir-vos-iam	anuir+V.vós.AD.2.PL+COND+3+PL
anuir-vos-íamos	anuir+V.vós.AD.2.PL+COND+1+PL
anuir-vos-ias	anuir+V.vós.AD.2.PL+COND+2+SG
anuir-vos-íeis	anuir+V.vós.AD.2.PL+COND+2+PL
anui-se	anuir+V.ele.REFL+PRS+3+SG
anuís-lhe	anuir+V.ele.DAT.3.SG+PRS+2+PL
anuis-lhe	anuir+V.ele.DAT.3.SG+PRS+2+SG
anuís-lhes	anuir+V.ele.DAT.3.PL+PRS+2+PL
anuis-lhes	anuir+V.ele.DAT.3.PL+PRS+2+SG
anuís-me	anuir+V.eu.AD.1.SG+PRS+2+PL
anuis-me	anuir+V.eu.AD.1.SG+PRS+2+SG
anuíste-a	anuir+V.ele.ACC.3.F.SG+PRF+2+SG
anuís-te	anuir+V.tu.AD.2.SG+PRS+2+PL
anuis-te	anuir+V.tu.AD.2.SG+PRS+2+SG
anuíste-as	anuir+V.ele.ACC.3.F.PL+PRF+2+SG
anuíste-la	anuir+V.ele.ACC.3.F.SG+PRF+2+PL
anuíste-las	anuir+V.ele.ACC.3.F.PL+PRF+2+PL
anuíste-lhe	anuir+V.ele.DAT.3.SG+PRF+2+SG
anuíste-lhes	anuir+V.ele.DAT.3.PL+PRF+2+SG
anuíste-lo	anuir+V.ele.ACC.3.M.SG+PRF+2+PL
anuíste-los	anuir+V.ele.ACC.3.M.PL+PRF+2+PL
anuíste-me	anuir+V.eu.AD.1.SG+PRF+2+SG
anuíste-nos	anuir+nós.AD.1.PL+PRF+2+PL
anuíste-nos	anuir+nós.AD.1.PL+PRF+2+SG
anuíste-o	anuir+V.ele.ACC.3.M.SG+PRF+2+SG
anuíste-os	anuir+V.ele.ACC.3.M.PL+PRF+2+SG
anuístes-lhe	anuir+V.ele.DAT.3.SG+PRF+2+PL
anuístes-lhes	anuir+V.ele.DAT.3.PL+PRF+2+PL
anuístes-me	anuir+V.eu.AD.1.SG+PRF+2+PL
anuístes-te	anuir+V.tu.AD.2.SG+PRF+2+PL
anuístes-vos	anuir+V.vós.AD.2.PL+PRF+2+PL
anuíste-te	anuir+V.tu.AD.2.SG+PRF+2+SG
anuíste-vos	anuir+V.vós.AD.2.PL+PRF+2+SG
anuís-vos	anuir+V.vós.AD.2.PL+PRS+2+PL
anuis-vos	anuir+V.vós.AD.2.PL+PRS+2+SG
anuí-te	anuir+V.tu.AD.2.SG+PRF+1+SG
anui-te	anuir+V.tu.AD.2.SG+PRS+3+SG
anuiu-a	anuir+V.ele.ACC.3.F.SG+PRF+3+SG
anuiu-as	anuir+V.ele.ACC.3.F.PL+PRF+3+SG
anuiu-lhe	anuir+V.ele.DAT.3.SG+PRF+3+SG
anuiu-lhes	anuir+V.ele.DAT.3.PL+PRF+3+SG
anuiu-me	anuir+V.eu.AD.1.SG+PRF+3+SG
anuiu-nos	anuir+nós.AD.1.PL+PRF+3+SG
anuiu-o	anuir+V.ele.ACC.3.M.SG+PRF+3+SG
anuiu-os	anuir+V.ele.ACC.3.M.PL+PRF+3+SG
anuiu-se	anuir+V.ele.REFL+PRF+3+SG
anuiu-te	anuir+V.tu.AD.2.SG+PRF+3+SG
anuiu-vos	anuir+V.vós.AD.2.PL+PRF+3+SG
anuí-vos	anuir+V.vós.AD.2.PL+PRF+1+SG
anui-vos	anuir+V.vós.AD.2.PL+PRS+3+SG
anula-a	anular+V.ele.ACC.3.F.SG+PRS+3+SG
anula-as	anular+V.ele.ACC.3.F.PL+PRS+3+SG
anulai-la	anular+V.ele.ACC.3.F.SG+PRS+2+PL
anulai-las	anular+V.ele.ACC.3.F.PL+PRS+2+PL
anulai-lo	anular+V.ele.ACC.3.M.SG+PRS+2+PL
anulai-los	anular+V.ele.ACC.3.M.PL+PRS+2+PL
anulai-nos	anular+nós.AD.1.PL+PRS+2+PL
anulais-lhe	anular+V.ele.DAT.3.SG+PRS+2+PL
anulais-lhes	anular+V.ele.DAT.3.PL+PRS+2+PL
anulais-me	anular+V.eu.AD.1.SG+PRS+2+PL
anulais-te	anular+V.tu.AD.2.SG+PRS+2+PL
anulais-vos	anular+V.vós.AD.2.PL+PRS+2+PL
anulá-la-á	anular+V.ele.ACC.3.F.SG+FUT+3+SG
anulá-la	anular+V.ele.ACC.3.F.SG+INF+1+SG
anulá-la	anular+V.ele.ACC.3.F.SG+INF+3+SG
anula-la	anular+V.ele.ACC.3.F.SG+PRS+2+SG
anulá-la	anular+V.ele.ACC.3.F.SG+SBJF+1+SG
anulá-la	anular+V.ele.ACC.3.F.SG+SBJF+3+SG
anulá-la-ão	anular+V.ele.ACC.3.F.SG+FUT+3+PL
anulá-la-ás	anular+V.ele.ACC.3.F.SG+FUT+2+SG
anulá-la-ei	anular+V.ele.ACC.3.F.SG+FUT+1+SG
anulá-la-eis	anular+V.ele.ACC.3.F.SG+FUT+2+PL
anulá-la-emos	anular+V.ele.ACC.3.F.SG+FUT+1+PL
anulá-la-ia	anular+V.ele.ACC.3.F.SG+COND+1+SG
anulá-la-ia	anular+V.ele.ACC.3.F.SG+COND+3+SG
anulá-la-iam	anular+V.ele.ACC.3.F.SG+COND+3+PL
anulá-la-íamos	anular+V.ele.ACC.3.F.SG+COND+1+PL
anulá-la-ias	anular+V.ele.ACC.3.F.SG+COND+2+SG
anulá-la-íeis	anular+V.ele.ACC.3.F.SG+COND+2+PL
anulá-las-á	anular+V.ele.ACC.3.F.PL+FUT+3+SG
anulá-las	anular+V.ele.ACC.3.F.PL+INF+1+SG
anulá-las	anular+V.ele.ACC.3.F.PL+INF+3+SG
anula-las	anular+V.ele.ACC.3.F.PL+PRS+2+SG
anulá-las	anular+V.ele.ACC.3.F.PL+SBJF+1+SG
anulá-las	anular+V.ele.ACC.3.F.PL+SBJF+3+SG
anulá-las-ão	anular+V.ele.ACC.3.F.PL+FUT+3+PL
anulá-las-ás	anular+V.ele.ACC.3.F.PL+FUT+2+SG
anulá-las-ei	anular+V.ele.ACC.3.F.PL+FUT+1+SG
anulá-las-eis	anular+V.ele.ACC.3.F.PL+FUT+2+PL
anulá-las-emos	anular+V.ele.ACC.3.F.PL+FUT+1+PL
anulá-las-ia	anular+V.ele.ACC.3.F.PL+COND+1+SG
anulá-las-ia	anular+V.ele.ACC.3.F.PL+COND+3+SG
anulá-las-iam	anular+V.ele.ACC.3.F.PL+COND+3+PL
anulá-las-íamos	anular+V.ele.ACC.3.F.PL+COND+1+PL
anulá-las-ias	anular+V.ele.ACC.3.F.PL+COND+2+SG
anulá-las-íeis	anular+V.ele.ACC.3.F.PL+COND+2+PL
anula-lhe	anular+V.ele.DAT.3.SG+PRS+3+SG
anula-lhes	anular+V.ele.DAT.3.PL+PRS+3+SG
anulá-lo-á	anular+V.ele.ACC.3.M.SG+FUT+3+SG
anulá-lo	anular+V.ele.ACC.3.M.SG+INF+1+SG
anulá-lo	anular+V.ele.ACC.3.M.SG+INF+3+SG
anula-lo	anular+V.ele.ACC.3.M.SG+PRS+2+SG
anulá-lo	anular+V.ele.ACC.3.M.SG+SBJF+1+SG
anulá-lo	anular+V.ele.ACC.3.M.SG+SBJF+3+SG
anulá-lo-ão	anular+V.ele.ACC.3.M.SG+FUT+3+PL
anulá-lo-ás	anular+V.ele.ACC.3.M.SG+FUT+2+SG
anulá-lo-ei	anular+V.ele.ACC.3.M.SG+FUT+1+SG
anulá-lo-eis	anular+V.ele.ACC.3.M.SG+FUT+2+PL
anulá-lo-emos	anular+V.ele.ACC.3.M.SG+FUT+1+PL
anulá-lo-ia	anular+V.ele.ACC.3.M.SG+COND+1+SG
anulá-lo-ia	anular+V.ele.ACC.3.M.SG+COND+3+SG
anulá-lo-iam	anular+V.ele.ACC.3.M.SG+COND+3+PL
anulá-lo-íamos	anular+V.ele.ACC.3.M.SG+COND+1+PL
anulá-lo-ias	anular+V.ele.ACC.3.M.SG+COND+2+SG
anulá-lo-íeis	anular+V.ele.ACC.3.M.SG+COND+2+PL
anulá-los-á	anular+V.ele.ACC.3.M.PL+FUT+3+SG
anulá-los	anular+V.ele.ACC.3.M.PL+INF+1+SG
anulá-los	anular+V.ele.ACC.3.M.PL+INF+3+SG
anula-los	anular+V.ele.ACC.3.M.PL+PRS+2+SG
anulá-los	anular+V.ele.ACC.3.M.PL+SBJF+1+SG
anulá-los	anular+V.ele.ACC.3.M.PL+SBJF+3+SG
anulá-los-ão	anular+V.ele.ACC.3.M.PL+FUT+3+PL
anulá-los-ás	anular+V.ele.ACC.3.M.PL+FUT+2+SG
anulá-los-ei	anular+V.ele.ACC.3.M.PL+FUT+1+SG
anulá-los-eis	anular+V.ele.ACC.3.M.PL+FUT+2+PL
anulá-los-emos	anular+V.ele.ACC.3.M.PL+FUT+1+PL
anulá-los-ia	anular+V.ele.ACC.3.M.PL+COND+1+SG
anulá-los-ia	anular+V.ele.ACC.3.M.PL+COND+3+SG
anulá-los-iam	anular+V.ele.ACC.3.M.PL+COND+3+PL
anulá-los-íamos	anular+V.ele.ACC.3.M.PL+COND+1+PL
anulá-los-ias	anular+V.ele.ACC.3.M.PL+COND+2+SG
anulá-los-íeis	anular+V.ele.ACC.3.M.PL+COND+2+PL
anula-me	anular+V.eu.AD.1.SG+PRS+3+SG
anulam-lhe	anular+V.ele.DAT.3.SG+PRS+3+PL
anulam-lhes	anular+V.ele.DAT.3.PL+PRS+3+PL
anulam-me	anular+V.eu.AD.1.SG+PRS+3+PL
anulam-na	anular+V.ele.ACC.3.F.SG+PRS+3+PL
anulam-nas	anular+V.ele.ACC.3.F.PL+PRS+3+PL
anulam-no	anular+V.ele.ACC.3.M.SG+PRS+3+PL
anulam-nos	anular+V.ele.ACC.3.M.PL+PRS+3+PL
anulam-nos	anular+V.nós.AD.1.PL+PRS+3+PL
anulamo-la	anular+V.ele.ACC.3.F.SG+PRF+1+PL
anulamo-la	anular+V.ele.ACC.3.F.SG+PRS+1+PL
anulamo-las	anular+V.ele.ACC.3.F.PL+PRF+1+PL
anulamo-las	anular+V.ele.ACC.3.F.PL+PRS+1+PL
anulamo-lo	anular+V.ele.ACC.3.M.SG+PRF+1+PL
anulamo-lo	anular+V.ele.ACC.3.M.SG+PRS+1+PL
anulamo-los	anular+V.ele.ACC.3.M.PL+PRF+1+PL
anulamo-los	anular+V.ele.ACC.3.M.PL+PRS+1+PL
anulamo-nos	anular+nós.AD.1.PL+PRF+1+PL
anulamo-nos	anular+nós.AD.1.PL+PRS+1+PL
anulamos-lhe	anular+V.ele.DAT.3.SG+PRF+1+PL
anulamos-lhe	anular+V.ele.DAT.3.SG+PRS+1+PL
anulamos-lhes	anular+V.ele.DAT.3.PL+PRF+1+PL
anulamos-lhes	anular+V.ele.DAT.3.PL+PRS+1+PL
anulamos-me	anular+V.eu.AD.1.SG+PRF+1+PL
anulamos-me	anular+V.eu.AD.1.SG+PRS+1+PL
anulamos-te	anular+V.tu.AD.2.SG+PRF+1+PL
anulamos-te	anular+V.tu.AD.2.SG+PRS+1+PL
anulamos-vos	anular+V.vós.AD.2.PL+PRF+1+PL
anulamos-vos	anular+V.vós.AD.2.PL+PRS+1+PL
anulam-se	anular+V.ele.REFL+PRS+3+PL
anulam-te	anular+V.tu.AD.2.SG+PRS+3+PL
anulam-vos	anular+V.vós.AD.2.PL+PRS+3+PL
anulando-a	anular+V.ele.ACC.3.F.SG+GRD
anulando-as	anular+V.ele.ACC.3.F.PL+GRD
anulando-lhe	anular+V.ele.DAT.3.SG+GRD
anulando-lhes	anular+V.ele.DAT.3.PL+GRD
anulando-me	anular+V.eu.AD.1.SG+GRD
anulando-nos	anular+nós.AD.1.PL+GRD
anulando-o	anular+V.ele.ACC.3.M.SG+GRD
anulando-os	anular+V.ele.ACC.3.M.PL+GRD
anulando-se	anular+V.ele.REFL+GRD
anulando-te	anular+V.tu.AD.2.SG+GRD
anulando-vos	anular+V.vós.AD.2.PL+GRD
anula-nos	anular+nós.AD.1.PL+PRS+2+SG
anula-nos	anular+nós.AD.1.PL+PRS+3+SG
anula-o	anular+V.ele.ACC.3.M.SG+PRS+3+SG
anula-os	anular+V.ele.ACC.3.M.PL+PRS+3+SG
anulara-a	anular+V.ele.ACC.3.F.SG+PQP+1+SG
anulara-a	anular+V.ele.ACC.3.F.SG+PQP+3+SG
anulara-as	anular+V.ele.ACC.3.F.PL+PQP+1+SG
anulara-as	anular+V.ele.ACC.3.F.PL+PQP+3+SG
anulara-la	anular+V.ele.ACC.3.F.SG+PQP+2+SG
anulara-las	anular+V.ele.ACC.3.F.PL+PQP+2+SG
anulara-lhe	anular+V.ele.DAT.3.SG+PQP+1+SG
anulara-lhe	anular+V.ele.DAT.3.SG+PQP+3+SG
anulara-lhes	anular+V.ele.DAT.3.PL+PQP+1+SG
anulara-lhes	anular+V.ele.DAT.3.PL+PQP+3+SG
anulara-lo	anular+V.ele.ACC.3.M.SG+PQP+2+SG
anulara-los	anular+V.ele.ACC.3.M.PL+PQP+2+SG
anulara-me	anular+V.eu.AD.1.SG+PQP+1+SG
anulara-me	anular+V.eu.AD.1.SG+PQP+3+SG
anularam-lhe	anular+V.ele.DAT.3.SG+PQP+3+PL
anularam-lhe	anular+V.ele.DAT.3.SG+PRF+3+PL
anularam-lhes	anular+V.ele.DAT.3.PL+PQP+3+PL
anularam-lhes	anular+V.ele.DAT.3.PL+PRF+3+PL
anularam-me	anular+V.eu.AD.1.SG+PQP+3+PL
anularam-me	anular+V.eu.AD.1.SG+PRF+3+PL
anularam-na	anular+V.ele.ACC.3.F.SG+PQP+3+PL
anularam-na	anular+V.ele.ACC.3.F.SG+PRF+3+PL
anularam-nas	anular+V.ele.ACC.3.F.PL+PQP+3+PL
anularam-nas	anular+V.ele.ACC.3.F.PL+PRF+3+PL
anularam-no	anular+V.ele.ACC.3.M.SG+PQP+3+PL
anularam-no	anular+V.ele.ACC.3.M.SG+PRF+3+PL
anularam-nos	anular+V.ele.ACC.3.M.PL+PQP+3+PL
anularam-nos	anular+V.ele.ACC.3.M.PL+PRF+3+PL
anularam-nos	anular+V.nós.AD.1.PL+PQP+3+PL
anularam-nos	anular+V.nós.AD.1.PL+PRF+3+PL
anuláramo-la	anular+V.ele.ACC.3.F.SG+PQP+1+PL
anuláramo-las	anular+V.ele.ACC.3.F.PL+PQP+1+PL
anuláramo-lo	anular+V.ele.ACC.3.M.SG+PQP+1+PL
anuláramo-los	anular+V.ele.ACC.3.M.PL+PQP+1+PL
anuláramo-nos	anular+nós.AD.1.PL+PQP+1+PL
anuláramos-lhe	anular+V.ele.DAT.3.SG+PQP+1+PL
anuláramos-lhes	anular+V.ele.DAT.3.PL+PQP+1+PL
anuláramos-me	anular+V.eu.AD.1.SG+PQP+1+PL
anuláramos-te	anular+V.tu.AD.2.SG+PQP+1+PL
anuláramos-vos	anular+V.vós.AD.2.PL+PQP+1+PL
anularam-se	anular+V.ele.REFL+PQP+3+PL
anularam-se	anular+V.ele.REFL+PRF+3+PL
anularam-te	anular+V.tu.AD.2.SG+PQP+3+PL
anularam-te	anular+V.tu.AD.2.SG+PRF+3+PL
anularam-vos	anular+V.vós.AD.2.PL+PQP+3+PL
anularam-vos	anular+V.vós.AD.2.PL+PRF+3+PL
anulara-nos	anular+nós.AD.1.PL+PQP+1+SG
anulara-nos	anular+nós.AD.1.PL+PQP+2+SG
anulara-nos	anular+nós.AD.1.PL+PQP+3+SG
anulara-o	anular+V.ele.ACC.3.M.SG+PQP+1+SG
anulara-o	anular+V.ele.ACC.3.M.SG+PQP+3+SG
anulara-os	anular+V.ele.ACC.3.M.PL+PQP+1+SG
anulara-os	anular+V.ele.ACC.3.M.PL+PQP+3+SG
anulara-se	anular+V.ele.REFL+PQP+1+SG
anulara-se	anular+V.ele.REFL+PQP+3+SG
anularas-lhe	anular+V.ele.DAT.3.SG+PQP+2+SG
anularas-lhes	anular+V.ele.DAT.3.PL+PQP+2+SG
anularas-me	anular+V.eu.AD.1.SG+PQP+2+SG
anularas-te	anular+V.tu.AD.2.SG+PQP+2+SG
anularas-vos	anular+V.vós.AD.2.PL+PQP+2+SG
anulara-te	anular+V.tu.AD.2.SG+PQP+1+SG
anulara-te	anular+V.tu.AD.2.SG+PQP+3+SG
anulara-vos	anular+V.vós.AD.2.PL+PQP+1+SG
anulara-vos	anular+V.vós.AD.2.PL+PQP+3+SG
anularde-la	anular+V.ele.ACC.3.F.SG+INF+2+PL
anularde-la	anular+V.ele.ACC.3.F.SG+SBJF+2+PL
anularde-las	anular+V.ele.ACC.3.F.PL+INF+2+PL
anularde-las	anular+V.ele.ACC.3.F.PL+SBJF+2+PL
anularde-lo	anular+V.ele.ACC.3.M.SG+INF+2+PL
anularde-lo	anular+V.ele.ACC.3.M.SG+SBJF+2+PL
anularde-los	anular+V.ele.ACC.3.M.PL+INF+2+PL
anularde-los	anular+V.ele.ACC.3.M.PL+SBJF+2+PL
anularde-nos	anular+nós.AD.1.PL+INF+2+PL
anularde-nos	anular+nós.AD.1.PL+SBJF+2+PL
anulardes-lhe	anular+V.ele.DAT.3.SG+INF+2+PL
anulardes-lhe	anular+V.ele.DAT.3.SG+SBJF+2+PL
anulardes-lhes	anular+V.ele.DAT.3.PL+INF+2+PL
anulardes-lhes	anular+V.ele.DAT.3.PL+SBJF+2+PL
anulardes-me	anular+V.eu.AD.1.SG+INF+2+PL
anulardes-me	anular+V.eu.AD.1.SG+SBJF+2+PL
anulardes-te	anular+V.tu.AD.2.SG+INF+2+PL
anulardes-te	anular+V.tu.AD.2.SG+SBJF+2+PL
anulardes-vos	anular+V.vós.AD.2.PL+INF+2+PL
anulardes-vos	anular+V.vós.AD.2.PL+SBJF+2+PL
anulárei-la	anular+V.ele.ACC.3.F.SG+PQP+2+PL
anulárei-las	anular+V.ele.ACC.3.F.PL+PQP+2+PL
anulárei-lo	anular+V.ele.ACC.3.M.SG+PQP+2+PL
anulárei-los	anular+V.ele.ACC.3.M.PL+PQP+2+PL
anulárei-nos	anular+nós.AD.1.PL+PQP+2+PL
anuláreis-lhe	anular+V.ele.DAT.3.SG+PQP+2+PL
anuláreis-lhes	anular+V.ele.DAT.3.PL+PQP+2+PL
anuláreis-me	anular+V.eu.AD.1.SG+PQP+2+PL
anuláreis-te	anular+V.tu.AD.2.SG+PQP+2+PL
anuláreis-vos	anular+V.vós.AD.2.PL+PQP+2+PL
anulare-la	anular+V.ele.ACC.3.F.SG+INF+2+SG
anulare-la	anular+V.ele.ACC.3.F.SG+SBJF+2+SG
anulare-las	anular+V.ele.ACC.3.F.PL+INF+2+SG
anulare-las	anular+V.ele.ACC.3.F.PL+SBJF+2+SG
anulare-lo	anular+V.ele.ACC.3.M.SG+INF+2+SG
anulare-lo	anular+V.ele.ACC.3.M.SG+SBJF+2+SG
anulare-los	anular+V.ele.ACC.3.M.PL+INF+2+SG
anulare-los	anular+V.ele.ACC.3.M.PL+SBJF+2+SG
anularem-lhe	anular+V.ele.DAT.3.SG+INF+3+PL
anularem-lhe	anular+V.ele.DAT.3.SG+SBJF+3+PL
anularem-lhes	anular+V.ele.DAT.3.PL+INF+3+PL
anularem-lhes	anular+V.ele.DAT.3.PL+SBJF+3+PL
anularem-me	anular+V.eu.AD.1.SG+INF+3+PL
anularem-me	anular+V.eu.AD.1.SG+SBJF+3+PL
anularem-na	anular+V.ele.ACC.3.F.SG+INF+3+PL
anularem-na	anular+V.ele.ACC.3.F.SG+SBJF+3+PL
anularem-nas	anular+V.ele.ACC.3.F.PL+INF+3+PL
anularem-nas	anular+V.ele.ACC.3.F.PL+SBJF+3+PL
anularem-no	anular+V.ele.ACC.3.M.SG+INF+3+PL
anularem-no	anular+V.ele.ACC.3.M.SG+SBJF+3+PL
anularem-nos	anular+V.ele.ACC.3.M.PL+INF+3+PL
anularem-nos	anular+V.ele.ACC.3.M.PL+SBJF+3+PL
anularem-nos	anular+V.nós.AD.1.PL+INF+3+PL
anularem-nos	anular+V.nós.AD.1.PL+SBJF+3+PL
anularem-se	anular+V.ele.REFL+INF+3+PL
anularem-se	anular+V.ele.REFL+SBJF+3+PL
anularem-te	anular+V.tu.AD.2.SG+INF+3+PL
anularem-te	anular+V.tu.AD.2.SG+SBJF+3+PL
anularem-vos	anular+V.vós.AD.2.PL+INF+3+PL
anularem-vos	anular+V.vós.AD.2.PL+SBJF+3+PL
anulare-nos	anular+nós.AD.1.PL+INF+2+SG
anulare-nos	anular+nós.AD.1.PL+SBJF+2+SG
anulares-lhe	anular+V.ele.DAT.3.SG+INF+2+SG
anulares-lhe	anular+V.ele.DAT.3.SG+SBJF+2+SG
anulares-lhes	anular+V.ele.DAT.3.PL+INF+2+SG
anulares-lhes	anular+V.ele.DAT.3.PL+SBJF+2+SG
anulares-me	anular+V.eu.AD.1.SG+INF+2+SG
anulares-me	anular+V.eu.AD.1.SG+SBJF+2+SG
anulares-te	anular+V.tu.AD.2.SG+INF+2+SG
anulares-te	anular+V.tu.AD.2.SG+SBJF+2+SG
anulares-vos	anular+V.vós.AD.2.PL+INF+2+SG
anulares-vos	anular+V.vós.AD.2.PL+SBJF+2+SG
anular-lhe-á	anular+V.ele.DAT.3.SG+FUT+3+SG
anular-lhe	anular+V.ele.DAT.3.SG+INF
anular-lhe	anular+V.ele.DAT.3.SG+INF+1+SG
anular-lhe	anular+V.ele.DAT.3.SG+INF+3+SG
anular-lhe	anular+V.ele.DAT.3.SG+SBJF+1+SG
anular-lhe	anular+V.ele.DAT.3.SG+SBJF+3+SG
anular-lhe-ão	anular+V.ele.DAT.3.SG+FUT+3+PL
anular-lhe-ás	anular+V.ele.DAT.3.SG+FUT+2+SG
anular-lhe-ei	anular+V.ele.DAT.3.SG+FUT+1+SG
anular-lhe-eis	anular+V.ele.DAT.3.SG+FUT+2+PL
anular-lhe-emos	anular+V.ele.DAT.3.SG+FUT+1+PL
anular-lhe-ia	anular+V.ele.DAT.3.SG+COND+1+SG
anular-lhe-ia	anular+V.ele.DAT.3.SG+COND+3+SG
anular-lhe-iam	anular+V.ele.DAT.3.SG+COND+3+PL
anular-lhe-íamos	anular+V.ele.DAT.3.SG+COND+1+PL
anular-lhe-ias	anular+V.ele.DAT.3.SG+COND+2+SG
anular-lhe-íeis	anular+V.ele.DAT.3.SG+COND+2+PL
anular-lhes-á	anular+V.ele.DAT.3.PL+FUT+3+SG
anular-lhes	anular+V.ele.DAT.3.PL+INF
anular-lhes	anular+V.ele.DAT.3.PL+INF+1+SG
anular-lhes	anular+V.ele.DAT.3.PL+INF+3+SG
anular-lhes	anular+V.ele.DAT.3.PL+SBJF+1+SG
anular-lhes	anular+V.ele.DAT.3.PL+SBJF+3+SG
anular-lhes-ão	anular+V.ele.DAT.3.PL+FUT+3+PL
anular-lhes-ás	anular+V.ele.DAT.3.PL+FUT+2+SG
anular-lhes-ei	anular+V.ele.DAT.3.PL+FUT+1+SG
anular-lhes-eis	anular+V.ele.DAT.3.PL+FUT+2+PL
anular-lhes-emos	anular+V.ele.DAT.3.PL+FUT+1+PL
