apalmatoar-lhe-eis	apalmatoar+V.ele.DAT.3.SG+FUT+2+PL
apalmatoar-lhe-emos	apalmatoar+V.ele.DAT.3.SG+FUT+1+PL
apalmatoar-lhe-ia	apalmatoar+V.ele.DAT.3.SG+COND+1+SG
apalmatoar-lhe-ia	apalmatoar+V.ele.DAT.3.SG+COND+3+SG
apalmatoar-lhe-iam	apalmatoar+V.ele.DAT.3.SG+COND+3+PL
apalmatoar-lhe-íamos	apalmatoar+V.ele.DAT.3.SG+COND+1+PL
apalmatoar-lhe-ias	apalmatoar+V.ele.DAT.3.SG+COND+2+SG
apalmatoar-lhe-íeis	apalmatoar+V.ele.DAT.3.SG+COND+2+PL
apalmatoar-lhes-á	apalmatoar+V.ele.DAT.3.PL+FUT+3+SG
apalmatoar-lhes-ão	apalmatoar+V.ele.DAT.3.PL+FUT+3+PL
apalmatoar-lhes	apalmatoar+V.ele.DAT.3.PL+INF
apalmatoar-lhes	apalmatoar+V.ele.DAT.3.PL+INF+1+SG
apalmatoar-lhes	apalmatoar+V.ele.DAT.3.PL+INF+3+SG
apalmatoar-lhes	apalmatoar+V.ele.DAT.3.PL+SBJF+1+SG
apalmatoar-lhes	apalmatoar+V.ele.DAT.3.PL+SBJF+3+SG
apalmatoar-lhes-ás	apalmatoar+V.ele.DAT.3.PL+FUT+2+SG
apalmatoar-lhes-ei	apalmatoar+V.ele.DAT.3.PL+FUT+1+SG
apalmatoar-lhes-eis	apalmatoar+V.ele.DAT.3.PL+FUT+2+PL
apalmatoar-lhes-emos	apalmatoar+V.ele.DAT.3.PL+FUT+1+PL
apalmatoar-lhes-ia	apalmatoar+V.ele.DAT.3.PL+COND+1+SG
apalmatoar-lhes-ia	apalmatoar+V.ele.DAT.3.PL+COND+3+SG
apalmatoar-lhes-iam	apalmatoar+V.ele.DAT.3.PL+COND+3+PL
apalmatoar-lhes-íamos	apalmatoar+V.ele.DAT.3.PL+COND+1+PL
apalmatoar-lhes-ias	apalmatoar+V.ele.DAT.3.PL+COND+2+SG
apalmatoar-lhes-íeis	apalmatoar+V.ele.DAT.3.PL+COND+2+PL
apalmatoar-me-á	apalmatoar+V.eu.AD.1.SG+FUT+3+SG
apalmatoar-me-ão	apalmatoar+V.eu.AD.1.SG+FUT+3+PL
apalmatoar-me	apalmatoar+V.eu.AD.1.SG+INF
apalmatoar-me	apalmatoar+V.eu.AD.1.SG+INF+1+SG
apalmatoar-me	apalmatoar+V.eu.AD.1.SG+INF+3+SG
apalmatoar-me	apalmatoar+V.eu.AD.1.SG+SBJF+1+SG
apalmatoar-me	apalmatoar+V.eu.AD.1.SG+SBJF+3+SG
apalmatoar-me-ás	apalmatoar+V.eu.AD.1.SG+FUT+2+SG
apalmatoar-me-ei	apalmatoar+V.eu.AD.1.SG+FUT+1+SG
apalmatoar-me-eis	apalmatoar+V.eu.AD.1.SG+FUT+2+PL
apalmatoar-me-emos	apalmatoar+V.eu.AD.1.SG+FUT+1+PL
apalmatoar-me-ia	apalmatoar+V.eu.AD.1.SG+COND+1+SG
apalmatoar-me-ia	apalmatoar+V.eu.AD.1.SG+COND+3+SG
apalmatoar-me-iam	apalmatoar+V.eu.AD.1.SG+COND+3+PL
apalmatoar-me-íamos	apalmatoar+V.eu.AD.1.SG+COND+1+PL
apalmatoar-me-ias	apalmatoar+V.eu.AD.1.SG+COND+2+SG
apalmatoar-me-íeis	apalmatoar+V.eu.AD.1.SG+COND+2+PL
apalmatoarmo-la	apalmatoar+V.ele.ACC.3.F.SG+INF+1+PL
apalmatoarmo-la	apalmatoar+V.ele.ACC.3.F.SG+SBJF+1+PL
apalmatoarmo-las	apalmatoar+V.ele.ACC.3.F.PL+INF+1+PL
apalmatoarmo-las	apalmatoar+V.ele.ACC.3.F.PL+SBJF+1+PL
apalmatoarmo-lo	apalmatoar+V.ele.ACC.3.M.SG+INF+1+PL
apalmatoarmo-lo	apalmatoar+V.ele.ACC.3.M.SG+SBJF+1+PL
apalmatoarmo-los	apalmatoar+V.ele.ACC.3.M.PL+INF+1+PL
apalmatoarmo-los	apalmatoar+V.ele.ACC.3.M.PL+SBJF+1+PL
apalmatoarmo-nos	apalmatoar+nós.AD.1.PL+INF+1+PL
apalmatoarmo-nos	apalmatoar+nós.AD.1.PL+SBJF+1+PL
apalmatoarmos-lhe	apalmatoar+V.ele.DAT.3.SG+INF+1+PL
apalmatoarmos-lhe	apalmatoar+V.ele.DAT.3.SG+SBJF+1+PL
apalmatoarmos-lhes	apalmatoar+V.ele.DAT.3.PL+INF+1+PL
apalmatoarmos-lhes	apalmatoar+V.ele.DAT.3.PL+SBJF+1+PL
apalmatoarmos-me	apalmatoar+V.eu.AD.1.SG+INF+1+PL
apalmatoarmos-me	apalmatoar+V.eu.AD.1.SG+SBJF+1+PL
apalmatoarmos-te	apalmatoar+V.tu.AD.2.SG+INF+1+PL
apalmatoarmos-te	apalmatoar+V.tu.AD.2.SG+SBJF+1+PL
apalmatoarmos-vos	apalmatoar+V.vós.AD.2.PL+INF+1+PL
apalmatoarmos-vos	apalmatoar+V.vós.AD.2.PL+SBJF+1+PL
apalmatoar-nos-á	apalmatoar+nós.AD.1.PL+FUT+3+SG
apalmatoar-nos-ão	apalmatoar+nós.AD.1.PL+FUT+3+PL
apalmatoar-nos	apalmatoar+nós.AD.1.PL+INF
apalmatoar-nos	apalmatoar+nós.AD.1.PL+INF+1+SG
apalmatoar-nos	apalmatoar+nós.AD.1.PL+INF+3+SG
apalmatoar-nos	apalmatoar+nós.AD.1.PL+SBJF+1+SG
apalmatoar-nos	apalmatoar+nós.AD.1.PL+SBJF+3+SG
apalmatoar-nos-ás	apalmatoar+nós.AD.1.PL+FUT+2+SG
apalmatoar-nos-ei	apalmatoar+nós.AD.1.PL+FUT+1+SG
apalmatoar-nos-eis	apalmatoar+nós.AD.1.PL+FUT+2+PL
apalmatoar-nos-emos	apalmatoar+nós.AD.1.PL+FUT+1+PL
apalmatoar-nos-ia	apalmatoar+nós.AD.1.PL+COND+1+SG
apalmatoar-nos-ia	apalmatoar+nós.AD.1.PL+COND+3+SG
apalmatoar-nos-iam	apalmatoar+nós.AD.1.PL+COND+3+PL
apalmatoar-nos-íamos	apalmatoar+nós.AD.1.PL+COND+1+PL
apalmatoar-nos-ias	apalmatoar+nós.AD.1.PL+COND+2+SG
apalmatoar-nos-íeis	apalmatoar+nós.AD.1.PL+COND+2+PL
apalmatoar-se-á	apalmatoar+V.ele.REFL+FUT+3+SG
apalmatoar-se-ão	apalmatoar+V.ele.REFL+FUT+3+PL
apalmatoar-se	apalmatoar+V.ele.REFL+INF
apalmatoar-se	apalmatoar+V.ele.REFL+INF+3+SG
apalmatoar-se	apalmatoar+V.ele.REFL+SBJF+3+SG
apalmatoar-se-ia	apalmatoar+V.ele.REFL+COND+3+SG
apalmatoar-se-iam	apalmatoar+V.ele.REFL+COND+3+PL
apalmatoar-te-á	apalmatoar+V.tu.AD.2.SG+FUT+3+SG
apalmatoar-te-ão	apalmatoar+V.tu.AD.2.SG+FUT+3+PL
apalmatoar-te	apalmatoar+V.tu.AD.2.SG+INF
apalmatoar-te	apalmatoar+V.tu.AD.2.SG+INF+1+SG
apalmatoar-te	apalmatoar+V.tu.AD.2.SG+INF+3+SG
apalmatoar-te	apalmatoar+V.tu.AD.2.SG+SBJF+1+SG
apalmatoar-te	apalmatoar+V.tu.AD.2.SG+SBJF+3+SG
apalmatoar-te-ás	apalmatoar+V.tu.AD.2.SG+FUT+2+SG
apalmatoar-te-ei	apalmatoar+V.tu.AD.2.SG+FUT+1+SG
apalmatoar-te-eis	apalmatoar+V.tu.AD.2.SG+FUT+2+PL
apalmatoar-te-emos	apalmatoar+V.tu.AD.2.SG+FUT+1+PL
apalmatoar-te-ia	apalmatoar+V.tu.AD.2.SG+COND+1+SG
apalmatoar-te-ia	apalmatoar+V.tu.AD.2.SG+COND+3+SG
apalmatoar-te-iam	apalmatoar+V.tu.AD.2.SG+COND+3+PL
apalmatoar-te-íamos	apalmatoar+V.tu.AD.2.SG+COND+1+PL
apalmatoar-te-ias	apalmatoar+V.tu.AD.2.SG+COND+2+SG
apalmatoar-te-íeis	apalmatoar+V.tu.AD.2.SG+COND+2+PL
apalmatoar-vos-á	apalmatoar+V.vós.AD.2.PL+FUT+3+SG
apalmatoar-vos-ão	apalmatoar+V.vós.AD.2.PL+FUT+3+PL
apalmatoar-vos	apalmatoar+V.vós.AD.2.PL+INF
apalmatoar-vos	apalmatoar+V.vós.AD.2.PL+INF+1+SG
apalmatoar-vos	apalmatoar+V.vós.AD.2.PL+INF+3+SG
apalmatoar-vos	apalmatoar+V.vós.AD.2.PL+SBJF+1+SG
apalmatoar-vos	apalmatoar+V.vós.AD.2.PL+SBJF+3+SG
apalmatoar-vos-ás	apalmatoar+V.vós.AD.2.PL+FUT+2+SG
apalmatoar-vos-ei	apalmatoar+V.vós.AD.2.PL+FUT+1+SG
apalmatoar-vos-eis	apalmatoar+V.vós.AD.2.PL+FUT+2+PL
apalmatoar-vos-emos	apalmatoar+V.vós.AD.2.PL+FUT+1+PL
apalmatoar-vos-ia	apalmatoar+V.vós.AD.2.PL+COND+1+SG
apalmatoar-vos-ia	apalmatoar+V.vós.AD.2.PL+COND+3+SG
apalmatoar-vos-iam	apalmatoar+V.vós.AD.2.PL+COND+3+PL
apalmatoar-vos-íamos	apalmatoar+V.vós.AD.2.PL+COND+1+PL
apalmatoar-vos-ias	apalmatoar+V.vós.AD.2.PL+COND+2+SG
apalmatoar-vos-íeis	apalmatoar+V.vós.AD.2.PL+COND+2+PL
apalmatoa-se	apalmatoar+V.ele.REFL+PRS+3+SG
apalmatoas-lhe	apalmatoar+V.ele.DAT.3.SG+PRS+2+SG
apalmatoas-lhes	apalmatoar+V.ele.DAT.3.PL+PRS+2+SG
apalmatoas-me	apalmatoar+V.eu.AD.1.SG+PRS+2+SG
apalmatoaste-a	apalmatoar+V.ele.ACC.3.F.SG+PRF+2+SG
apalmatoas-te	apalmatoar+V.tu.AD.2.SG+PRS+2+SG
apalmatoaste-as	apalmatoar+V.ele.ACC.3.F.PL+PRF+2+SG
apalmatoaste-la	apalmatoar+V.ele.ACC.3.F.SG+PRF+2+PL
apalmatoaste-las	apalmatoar+V.ele.ACC.3.F.PL+PRF+2+PL
apalmatoaste-lhe	apalmatoar+V.ele.DAT.3.SG+PRF+2+SG
apalmatoaste-lhes	apalmatoar+V.ele.DAT.3.PL+PRF+2+SG
apalmatoaste-lo	apalmatoar+V.ele.ACC.3.M.SG+PRF+2+PL
apalmatoaste-los	apalmatoar+V.ele.ACC.3.M.PL+PRF+2+PL
apalmatoaste-me	apalmatoar+V.eu.AD.1.SG+PRF+2+SG
apalmatoaste-nos	apalmatoar+nós.AD.1.PL+PRF+2+PL
apalmatoaste-nos	apalmatoar+nós.AD.1.PL+PRF+2+SG
apalmatoaste-o	apalmatoar+V.ele.ACC.3.M.SG+PRF+2+SG
apalmatoaste-os	apalmatoar+V.ele.ACC.3.M.PL+PRF+2+SG
apalmatoastes-lhe	apalmatoar+V.ele.DAT.3.SG+PRF+2+PL
apalmatoastes-lhes	apalmatoar+V.ele.DAT.3.PL+PRF+2+PL
apalmatoastes-me	apalmatoar+V.eu.AD.1.SG+PRF+2+PL
apalmatoastes-te	apalmatoar+V.tu.AD.2.SG+PRF+2+PL
apalmatoastes-vos	apalmatoar+V.vós.AD.2.PL+PRF+2+PL
apalmatoaste-te	apalmatoar+V.tu.AD.2.SG+PRF+2+SG
apalmatoaste-vos	apalmatoar+V.vós.AD.2.PL+PRF+2+SG
apalmatoas-vos	apalmatoar+V.vós.AD.2.PL+PRS+2+SG
apalmatoa-te	apalmatoar+V.tu.AD.2.SG+PRS+3+SG
apalmatoava-a	apalmatoar+V.ele.ACC.3.F.SG+IMPF+1+SG
apalmatoava-a	apalmatoar+V.ele.ACC.3.F.SG+IMPF+3+SG
apalmatoava-as	apalmatoar+V.ele.ACC.3.F.PL+IMPF+1+SG
apalmatoava-as	apalmatoar+V.ele.ACC.3.F.PL+IMPF+3+SG
apalmatoava-la	apalmatoar+V.ele.ACC.3.F.SG+IMPF+2+SG
apalmatoava-las	apalmatoar+V.ele.ACC.3.F.PL+IMPF+2+SG
apalmatoava-lhe	apalmatoar+V.ele.DAT.3.SG+IMPF+1+SG
apalmatoava-lhe	apalmatoar+V.ele.DAT.3.SG+IMPF+3+SG
apalmatoava-lhes	apalmatoar+V.ele.DAT.3.PL+IMPF+1+SG
apalmatoava-lhes	apalmatoar+V.ele.DAT.3.PL+IMPF+3+SG
apalmatoava-lo	apalmatoar+V.ele.ACC.3.M.SG+IMPF+2+SG
apalmatoava-los	apalmatoar+V.ele.ACC.3.M.PL+IMPF+2+SG
apalmatoava-me	apalmatoar+V.eu.AD.1.SG+IMPF+1+SG
apalmatoava-me	apalmatoar+V.eu.AD.1.SG+IMPF+3+SG
apalmatoavam-lhe	apalmatoar+V.ele.DAT.3.SG+IMPF+3+PL
apalmatoavam-lhes	apalmatoar+V.ele.DAT.3.PL+IMPF+3+PL
apalmatoavam-me	apalmatoar+V.eu.AD.1.SG+IMPF+3+PL
apalmatoavam-na	apalmatoar+V.ele.ACC.3.F.SG+IMPF+3+PL
apalmatoavam-nas	apalmatoar+V.ele.ACC.3.F.PL+IMPF+3+PL
apalmatoavam-no	apalmatoar+V.ele.ACC.3.M.SG+IMPF+3+PL
apalmatoavam-nos	apalmatoar+V.ele.ACC.3.M.PL+IMPF+3+PL
apalmatoavam-nos	apalmatoar+V.nós.AD.1.PL+IMPF+3+PL
apalmatoávamo-la	apalmatoar+V.ele.ACC.3.F.SG+IMPF+1+PL
apalmatoávamo-las	apalmatoar+V.ele.ACC.3.F.PL+IMPF+1+PL
apalmatoávamo-lo	apalmatoar+V.ele.ACC.3.M.SG+IMPF+1+PL
apalmatoávamo-los	apalmatoar+V.ele.ACC.3.M.PL+IMPF+1+PL
apalmatoávamo-nos	apalmatoar+nós.AD.1.PL+IMPF+1+PL
apalmatoávamos-lhe	apalmatoar+V.ele.DAT.3.SG+IMPF+1+PL
apalmatoávamos-lhes	apalmatoar+V.ele.DAT.3.PL+IMPF+1+PL
apalmatoávamos-me	apalmatoar+V.eu.AD.1.SG+IMPF+1+PL
apalmatoávamos-te	apalmatoar+V.tu.AD.2.SG+IMPF+1+PL
apalmatoávamos-vos	apalmatoar+V.vós.AD.2.PL+IMPF+1+PL
apalmatoavam-se	apalmatoar+V.ele.REFL+IMPF+3+PL
apalmatoavam-te	apalmatoar+V.tu.AD.2.SG+IMPF+3+PL
apalmatoavam-vos	apalmatoar+V.vós.AD.2.PL+IMPF+3+PL
apalmatoava-nos	apalmatoar+nós.AD.1.PL+IMPF+1+SG
apalmatoava-nos	apalmatoar+nós.AD.1.PL+IMPF+2+SG
apalmatoava-nos	apalmatoar+nós.AD.1.PL+IMPF+3+SG
apalmatoava-o	apalmatoar+V.ele.ACC.3.M.SG+IMPF+1+SG
apalmatoava-o	apalmatoar+V.ele.ACC.3.M.SG+IMPF+3+SG
apalmatoava-os	apalmatoar+V.ele.ACC.3.M.PL+IMPF+1+SG
apalmatoava-os	apalmatoar+V.ele.ACC.3.M.PL+IMPF+3+SG
apalmatoava-se	apalmatoar+V.ele.REFL+IMPF+1+SG
apalmatoava-se	apalmatoar+V.ele.REFL+IMPF+3+SG
apalmatoavas-lhe	apalmatoar+V.ele.DAT.3.SG+IMPF+2+SG
apalmatoavas-lhes	apalmatoar+V.ele.DAT.3.PL+IMPF+2+SG
apalmatoavas-me	apalmatoar+V.eu.AD.1.SG+IMPF+2+SG
apalmatoavas-te	apalmatoar+V.tu.AD.2.SG+IMPF+2+SG
apalmatoavas-vos	apalmatoar+V.vós.AD.2.PL+IMPF+2+SG
apalmatoava-te	apalmatoar+V.tu.AD.2.SG+IMPF+1+SG
apalmatoava-te	apalmatoar+V.tu.AD.2.SG+IMPF+3+SG
apalmatoava-vos	apalmatoar+V.vós.AD.2.PL+IMPF+1+SG
apalmatoava-vos	apalmatoar+V.vós.AD.2.PL+IMPF+3+SG
apalmatoávei-la	apalmatoar+V.ele.ACC.3.F.SG+IMPF+2+PL
apalmatoávei-las	apalmatoar+V.ele.ACC.3.F.PL+IMPF+2+PL
apalmatoávei-lo	apalmatoar+V.ele.ACC.3.M.SG+IMPF+2+PL
apalmatoávei-los	apalmatoar+V.ele.ACC.3.M.PL+IMPF+2+PL
apalmatoávei-nos	apalmatoar+nós.AD.1.PL+IMPF+2+PL
apalmatoáveis-lhe	apalmatoar+V.ele.DAT.3.SG+IMPF+2+PL
apalmatoáveis-lhes	apalmatoar+V.ele.DAT.3.PL+IMPF+2+PL
apalmatoáveis-me	apalmatoar+V.eu.AD.1.SG+IMPF+2+PL
apalmatoáveis-te	apalmatoar+V.tu.AD.2.SG+IMPF+2+PL
apalmatoáveis-vos	apalmatoar+V.vós.AD.2.PL+IMPF+2+PL
apalmatoa-vos	apalmatoar+V.vós.AD.2.PL+PRS+3+SG
apalmatoe-a	apalmatoar+V.ele.ACC.3.F.SG+IMP+3+SG
apalmatoe-as	apalmatoar+V.ele.ACC.3.F.PL+IMP+3+SG
apalmatoei-a	apalmatoar+V.ele.ACC.3.F.SG+PRF+1+SG
apalmatoei-as	apalmatoar+V.ele.ACC.3.F.PL+PRF+1+SG
apalmatoei-lhe	apalmatoar+V.ele.DAT.3.SG+PRF+1+SG
apalmatoei-lhes	apalmatoar+V.ele.DAT.3.PL+PRF+1+SG
apalmatoei-me	apalmatoar+V.eu.AD.1.SG+PRF+1+SG
apalmatoei-nos	apalmatoar+nós.AD.1.PL+PRF+1+SG
apalmatoei-o	apalmatoar+V.ele.ACC.3.M.SG+PRF+1+SG
apalmatoei-os	apalmatoar+V.ele.ACC.3.M.PL+PRF+1+SG
apalmatoei-te	apalmatoar+V.tu.AD.2.SG+PRF+1+SG
apalmatoei-vos	apalmatoar+V.vós.AD.2.PL+PRF+1+SG
apalmatoe-lhe	apalmatoar+V.ele.DAT.3.SG+IMP+3+SG
apalmatoe-lhes	apalmatoar+V.ele.DAT.3.PL+IMP+3+SG
apalmatoe-me	apalmatoar+V.eu.AD.1.SG+IMP+3+SG
apalmatoem-lhe	apalmatoar+V.ele.DAT.3.SG+IMP+3+PL
apalmatoem-lhes	apalmatoar+V.ele.DAT.3.PL+IMP+3+PL
apalmatoem-me	apalmatoar+V.eu.AD.1.SG+IMP+3+PL
apalmatoem-na	apalmatoar+V.ele.ACC.3.F.SG+IMP+3+PL
apalmatoem-nas	apalmatoar+V.ele.ACC.3.F.PL+IMP+3+PL
apalmatoem-no	apalmatoar+V.ele.ACC.3.M.SG+IMP+3+PL
apalmatoem-nos	apalmatoar+V.ele.ACC.3.M.PL+IMP+3+PL
apalmatoem-nos	apalmatoar+V.nós.AD.1.PL+IMP+3+PL
apalmatoemo-la	apalmatoar+V.ele.ACC.3.F.SG+IMP+1+PL
apalmatoemo-las	apalmatoar+V.ele.ACC.3.F.PL+IMP+1+PL
apalmatoemo-lo	apalmatoar+V.ele.ACC.3.M.SG+IMP+1+PL
apalmatoemo-los	apalmatoar+V.ele.ACC.3.M.PL+IMP+1+PL
apalmatoemo-nos	apalmatoar+nós.AD.1.PL+IMP+1+PL
apalmatoemos-lhe	apalmatoar+V.ele.DAT.3.SG+IMP+1+PL
apalmatoemos-lhes	apalmatoar+V.ele.DAT.3.PL+IMP+1+PL
apalmatoemos-me	apalmatoar+V.eu.AD.1.SG+IMP+1+PL
apalmatoemos-te	apalmatoar+V.tu.AD.2.SG+IMP+1+PL
apalmatoemos-vos	apalmatoar+V.vós.AD.2.PL+IMP+1+PL
apalmatoem-se	apalmatoar+V.ele.REFL+IMP+3+PL
apalmatoem-te	apalmatoar+V.tu.AD.2.SG+IMP+3+PL
apalmatoem-vos	apalmatoar+V.vós.AD.2.PL+IMP+3+PL
apalmatoe-nos	apalmatoar+nós.AD.1.PL+IMP+3+SG
apalmatoe-o	apalmatoar+V.ele.ACC.3.M.SG+IMP+3+SG
apalmatoe-os	apalmatoar+V.ele.ACC.3.M.PL+IMP+3+SG
apalmatoe-se	apalmatoar+V.ele.REFL+IMP+3+SG
apalmatoe-te	apalmatoar+V.tu.AD.2.SG+IMP+3+SG
apalmatoe-vos	apalmatoar+V.vós.AD.2.PL+IMP+3+SG
apalmatoo-a	apalmatoar+V.ele.ACC.3.F.SG+PRS+1+SG
apalmatoo-as	apalmatoar+V.ele.ACC.3.F.PL+PRS+1+SG
apalmatoo-lhe	apalmatoar+V.ele.DAT.3.SG+PRS+1+SG
apalmatoo-lhes	apalmatoar+V.ele.DAT.3.PL+PRS+1+SG
apalmatoo-me	apalmatoar+V.eu.AD.1.SG+PRS+1+SG
apalmatoo-nos	apalmatoar+nós.AD.1.PL+PRS+1+SG
apalmatoo-o	apalmatoar+V.ele.ACC.3.M.SG+PRS+1+SG
apalmatoo-os	apalmatoar+V.ele.ACC.3.M.PL+PRS+1+SG
apalmatoo-te	apalmatoar+V.tu.AD.2.SG+PRS+1+SG
apalmatoou-a	apalmatoar+V.ele.ACC.3.F.SG+PRF+3+SG
apalmatoou-as	apalmatoar+V.ele.ACC.3.F.PL+PRF+3+SG
apalmatoou-lhe	apalmatoar+V.ele.DAT.3.SG+PRF+3+SG
apalmatoou-lhes	apalmatoar+V.ele.DAT.3.PL+PRF+3+SG
apalmatoou-me	apalmatoar+V.eu.AD.1.SG+PRF+3+SG
apalmatoou-nos	apalmatoar+nós.AD.1.PL+PRF+3+SG
apalmatoou-o	apalmatoar+V.ele.ACC.3.M.SG+PRF+3+SG
apalmatoou-os	apalmatoar+V.ele.ACC.3.M.PL+PRF+3+SG
apalmatoou-se	apalmatoar+V.ele.REFL+PRF+3+SG
apalmatoou-te	apalmatoar+V.tu.AD.2.SG+PRF+3+SG
apalmatoou-vos	apalmatoar+V.vós.AD.2.PL+PRF+3+SG
apalmatoo-vos	apalmatoar+V.vós.AD.2.PL+PRS+1+SG
apalmava-a	apalmar+V.ele.ACC.3.F.SG+IMPF+1+SG
apalmava-a	apalmar+V.ele.ACC.3.F.SG+IMPF+3+SG
apalmava-as	apalmar+V.ele.ACC.3.F.PL+IMPF+1+SG
apalmava-as	apalmar+V.ele.ACC.3.F.PL+IMPF+3+SG
apalmava-la	apalmar+V.ele.ACC.3.F.SG+IMPF+2+SG
apalmava-las	apalmar+V.ele.ACC.3.F.PL+IMPF+2+SG
apalmava-lhe	apalmar+V.ele.DAT.3.SG+IMPF+1+SG
apalmava-lhe	apalmar+V.ele.DAT.3.SG+IMPF+3+SG
apalmava-lhes	apalmar+V.ele.DAT.3.PL+IMPF+1+SG
apalmava-lhes	apalmar+V.ele.DAT.3.PL+IMPF+3+SG
apalmava-lo	apalmar+V.ele.ACC.3.M.SG+IMPF+2+SG
apalmava-los	apalmar+V.ele.ACC.3.M.PL+IMPF+2+SG
apalmava-me	apalmar+V.eu.AD.1.SG+IMPF+1+SG
apalmava-me	apalmar+V.eu.AD.1.SG+IMPF+3+SG
apalmavam-lhe	apalmar+V.ele.DAT.3.SG+IMPF+3+PL
apalmavam-lhes	apalmar+V.ele.DAT.3.PL+IMPF+3+PL
apalmavam-me	apalmar+V.eu.AD.1.SG+IMPF+3+PL
apalmavam-na	apalmar+V.ele.ACC.3.F.SG+IMPF+3+PL
apalmavam-nas	apalmar+V.ele.ACC.3.F.PL+IMPF+3+PL
apalmavam-no	apalmar+V.ele.ACC.3.M.SG+IMPF+3+PL
apalmavam-nos	apalmar+V.ele.ACC.3.M.PL+IMPF+3+PL
apalmavam-nos	apalmar+V.nós.AD.1.PL+IMPF+3+PL
apalmávamo-la	apalmar+V.ele.ACC.3.F.SG+IMPF+1+PL
apalmávamo-las	apalmar+V.ele.ACC.3.F.PL+IMPF+1+PL
apalmávamo-lo	apalmar+V.ele.ACC.3.M.SG+IMPF+1+PL
apalmávamo-los	apalmar+V.ele.ACC.3.M.PL+IMPF+1+PL
apalmávamo-nos	apalmar+V.ele.ACC.3.M.PL+IMPF+1+PL
apalmávamo-nos	apalmar+V.nós.AD.1.PL+IMPF+1+PL
apalmávamos-lhe	apalmar+V.ele.DAT.3.SG+IMPF+1+PL
apalmávamos-lhes	apalmar+V.ele.DAT.3.PL+IMPF+1+PL
apalmávamos-me	apalmar+V.eu.AD.1.SG+IMPF+1+PL
apalmávamos-te	apalmar+V.tu.AD.2.SG+IMPF+1+PL
apalmávamos-vos	apalmar+V.vós.AD.2.PL+IMPF+1+PL
apalmavam-se	apalmar+V.ele.REFL+IMPF+3+PL
apalmavam-te	apalmar+V.tu.AD.2.SG+IMPF+3+PL
apalmavam-vos	apalmar+V.vós.AD.2.PL+IMPF+3+PL
apalmava-nos	apalmar+nós.AD.1.PL+IMPF+1+SG
apalmava-nos	apalmar+nós.AD.1.PL+IMPF+2+SG
apalmava-nos	apalmar+nós.AD.1.PL+IMPF+3+SG
apalmava-o	apalmar+V.ele.ACC.3.M.SG+IMPF+1+SG
apalmava-o	apalmar+V.ele.ACC.3.M.SG+IMPF+3+SG
apalmava-os	apalmar+V.ele.ACC.3.M.PL+IMPF+1+SG
apalmava-os	apalmar+V.ele.ACC.3.M.PL+IMPF+3+SG
apalmava-se	apalmar+V.ele.REFL+IMPF+1+SG
apalmava-se	apalmar+V.ele.REFL+IMPF+3+SG
apalmavas-lhe	apalmar+V.ele.DAT.3.SG+IMPF+2+SG
apalmavas-lhes	apalmar+V.ele.DAT.3.PL+IMPF+2+SG
apalmavas-me	apalmar+V.eu.AD.1.SG+IMPF+2+SG
apalmavas-te	apalmar+V.tu.AD.2.SG+IMPF+2+SG
apalmavas-vos	apalmar+V.vós.AD.2.PL+IMPF+2+SG
apalmava-te	apalmar+V.tu.AD.2.SG+IMPF+1+SG
apalmava-te	apalmar+V.tu.AD.2.SG+IMPF+3+SG
apalmava-vos	apalmar+V.vós.AD.2.PL+IMPF+1+SG
apalmava-vos	apalmar+V.vós.AD.2.PL+IMPF+3+SG
apalmávei-la	apalmar+V.ele.ACC.3.F.SG+IMPF+2+PL
apalmávei-las	apalmar+V.ele.ACC.3.F.PL+IMPF+2+PL
apalmávei-lo	apalmar+V.ele.ACC.3.M.SG+IMPF+2+PL
apalmávei-los	apalmar+V.ele.ACC.3.M.PL+IMPF+2+PL
apalmávei-nos	apalmar+V.ele.ACC.3.M.PL+IMPF+2+PL
apalmávei-nos	apalmar+V.nós.AD.1.PL+IMPF+2+PL
apalmáveis-lhe	apalmar+V.ele.DAT.3.SG+IMPF+2+PL
apalmáveis-lhes	apalmar+V.ele.DAT.3.PL+IMPF+2+PL
apalmáveis-me	apalmar+V.eu.AD.1.SG+IMPF+2+PL
apalmáveis-te	apalmar+V.tu.AD.2.SG+IMPF+2+PL
apalmáveis-vos	apalmar+V.vós.AD.2.PL+IMPF+2+PL
apalma-vos	apalmar+V.vós.AD.2.PL+PRS+3+SG
apalme-a	apalmar+V.ele.ACC.3.F.SG+IMP+3+SG
apalme-as	apalmar+V.ele.ACC.3.F.PL+IMP+3+SG
apalmei-a	apalmar+V.ele.ACC.3.F.SG+PRF+1+SG
apalmei-as	apalmar+V.ele.ACC.3.F.PL+PRF+1+SG
apalmei-lhe	apalmar+V.ele.DAT.3.SG+PRF+1+SG
apalmei-lhes	apalmar+V.ele.DAT.3.PL+PRF+1+SG
apalmei-me	apalmar+V.eu.AD.1.SG+PRF+1+SG
apalmei-nos	apalmar+nós.AD.1.PL+PRF+1+SG
apalmei-o	apalmar+V.ele.ACC.3.M.SG+PRF+1+SG
apalmei-os	apalmar+V.ele.ACC.3.M.PL+PRF+1+SG
apalmei-te	apalmar+V.tu.AD.2.SG+PRF+1+SG
apalmei-vos	apalmar+V.vós.AD.2.PL+PRF+1+SG
apalme-lhe	apalmar+V.ele.DAT.3.SG+IMP+3+SG
apalme-lhes	apalmar+V.ele.DAT.3.PL+IMP+3+SG
apalme-me	apalmar+V.eu.AD.1.SG+IMP+3+SG
apalmem-lhe	apalmar+V.ele.DAT.3.SG+IMP+3+PL
apalmem-lhes	apalmar+V.ele.DAT.3.PL+IMP+3+PL
apalmem-me	apalmar+V.eu.AD.1.SG+IMP+3+PL
apalmem-na	apalmar+V.ele.ACC.3.F.SG+IMP+3+PL
apalmem-nas	apalmar+V.ele.ACC.3.F.PL+IMP+3+PL
apalmem-no	apalmar+V.ele.ACC.3.M.SG+IMP+3+PL
apalmem-nos	apalmar+V.ele.ACC.3.M.PL+IMP+3+PL
apalmem-nos	apalmar+V.nós.AD.1.PL+IMP+3+PL
apalmemo-la	apalmar+V.ele.ACC.3.F.SG+IMP+1+PL
apalmemo-las	apalmar+V.ele.ACC.3.F.PL+IMP+1+PL
apalmemo-lo	apalmar+V.ele.ACC.3.M.SG+IMP+1+PL
apalmemo-los	apalmar+V.ele.ACC.3.M.PL+IMP+1+PL
apalmemo-nos	apalmar+nós.AD.1.PL+IMP+1+PL
apalmemos-lhe	apalmar+V.ele.DAT.3.SG+IMP+1+PL
apalmemos-lhes	apalmar+V.ele.DAT.3.PL+IMP+1+PL
apalmemos-me	apalmar+V.eu.AD.1.SG+IMP+1+PL
apalmemos-te	apalmar+V.tu.AD.2.SG+IMP+1+PL
apalmemos-vos	apalmar+V.vós.AD.2.PL+IMP+1+PL
apalmem-se	apalmar+V.ele.REFL+IMP+3+PL
apalmem-te	apalmar+V.tu.AD.2.SG+IMP+3+PL
apalmem-vos	apalmar+V.vós.AD.2.PL+IMP+3+PL
apalme-nos	apalmar+nós.AD.1.PL+IMP+3+SG
apalme-o	apalmar+V.ele.ACC.3.M.SG+IMP+3+SG
apalme-os	apalmar+V.ele.ACC.3.M.PL+IMP+3+SG
apalme-se	apalmar+V.ele.REFL+IMP+3+SG
apalme-te	apalmar+V.tu.AD.2.SG+IMP+3+SG
apalme-vos	apalmar+V.vós.AD.2.PL+IMP+3+SG
apalmo-a	apalmar+V.ele.ACC.3.F.SG+PRS+1+SG
apalmo-as	apalmar+V.ele.ACC.3.F.PL+PRS+1+SG
apalmo-lhe	apalmar+V.ele.DAT.3.SG+PRS+1+SG
apalmo-lhes	apalmar+V.ele.DAT.3.PL+PRS+1+SG
apalmo-me	apalmar+V.eu.AD.1.SG+PRS+1+SG
apalmo-nos	apalmar+nós.AD.1.PL+PRS+1+SG
apalmo-o	apalmar+V.ele.ACC.3.M.SG+PRS+1+SG
apalmo-os	apalmar+V.ele.ACC.3.M.PL+PRS+1+SG
apalmo-te	apalmar+V.tu.AD.2.SG+PRS+1+SG
apalmou-a	apalmar+V.ele.ACC.3.F.SG+PRF+3+SG
apalmou-as	apalmar+V.ele.ACC.3.F.PL+PRF+3+SG
apalmou-lhe	apalmar+V.ele.DAT.3.SG+PRF+3+SG
apalmou-lhes	apalmar+V.ele.DAT.3.PL+PRF+3+SG
apalmou-me	apalmar+V.eu.AD.1.SG+PRF+3+SG
apalmou-nos	apalmar+nós.AD.1.PL+PRF+3+SG
apalmou-o	apalmar+V.ele.ACC.3.M.SG+PRF+3+SG
apalmou-os	apalmar+V.ele.ACC.3.M.PL+PRF+3+SG
apalmou-se	apalmar+V.ele.REFL+PRF+3+SG
apalmou-te	apalmar+V.tu.AD.2.SG+PRF+3+SG
apalmou-vos	apalmar+V.vós.AD.2.PL+PRF+3+SG
apalmo-vos	apalmar+V.vós.AD.2.PL+PRS+1+SG
apalpa-a	apalpar+V.ele.ACC.3.F.SG+PRS+3+SG
apalpa-as	apalpar+V.ele.ACC.3.F.PL+PRS+3+SG
apalpai-la	apalpar+V.ele.ACC.3.F.SG+PRS+2+PL
apalpai-las	apalpar+V.ele.ACC.3.F.PL+PRS+2+PL
apalpai-lo	apalpar+V.ele.ACC.3.M.SG+PRS+2+PL
apalpai-los	apalpar+V.ele.ACC.3.M.PL+PRS+2+PL
apalpai-nos	apalpar+nós.AD.1.PL+PRS+2+PL
apalpais-lhe	apalpar+V.ele.DAT.3.SG+PRS+2+PL
apalpais-lhes	apalpar+V.ele.DAT.3.PL+PRS+2+PL
apalpais-me	apalpar+V.eu.AD.1.SG+PRS+2+PL
apalpais-te	apalpar+V.tu.AD.2.SG+PRS+2+PL
apalpais-vos	apalpar+V.vós.AD.2.PL+PRS+2+PL
apalpá-la-á	apalpar+V.ele.ACC.3.F.SG+FUT+3+SG
apalpá-la-ão	apalpar+V.ele.ACC.3.F.SG+FUT+3+PL
apalpá-la	apalpar+V.ele.ACC.3.F.SG+INF+1+SG
apalpá-la	apalpar+V.ele.ACC.3.F.SG+INF+3+SG
apalpa-la	apalpar+V.ele.ACC.3.F.SG+PRS+2+SG
apalpá-la	apalpar+V.ele.ACC.3.F.SG+SBJF+1+SG
apalpá-la	apalpar+V.ele.ACC.3.F.SG+SBJF+3+SG
apalpá-la-ás	apalpar+V.ele.ACC.3.F.SG+FUT+2+SG
apalpá-la-ei	apalpar+V.ele.ACC.3.F.SG+FUT+1+SG
apalpá-la-eis	apalpar+V.ele.ACC.3.F.SG+FUT+2+PL
apalpá-la-emos	apalpar+V.ele.ACC.3.F.SG+FUT+1+PL
apalpá-la-ia	apalpar+V.ele.ACC.3.F.SG+COND+1+SG
apalpá-la-ia	apalpar+V.ele.ACC.3.F.SG+COND+3+SG
apalpá-la-iam	apalpar+V.ele.ACC.3.F.SG+COND+3+PL
apalpá-la-íamos	apalpar+V.ele.ACC.3.F.SG+COND+1+PL
apalpá-la-ias	apalpar+V.ele.ACC.3.F.SG+COND+2+SG
apalpá-la-íeis	apalpar+V.ele.ACC.3.F.SG+COND+2+PL
apalpá-las-á	apalpar+V.ele.ACC.3.F.PL+FUT+3+SG
apalpá-las-ão	apalpar+V.ele.ACC.3.F.PL+FUT+3+PL
apalpá-las	apalpar+V.ele.ACC.3.F.PL+INF+1+SG
apalpá-las	apalpar+V.ele.ACC.3.F.PL+INF+3+SG
apalpa-las	apalpar+V.ele.ACC.3.F.PL+PRS+2+SG
apalpá-las	apalpar+V.ele.ACC.3.F.PL+SBJF+1+SG
apalpá-las	apalpar+V.ele.ACC.3.F.PL+SBJF+3+SG
apalpá-las-ás	apalpar+V.ele.ACC.3.F.PL+FUT+2+SG
apalpá-las-ei	apalpar+V.ele.ACC.3.F.PL+FUT+1+SG
apalpá-las-eis	apalpar+V.ele.ACC.3.F.PL+FUT+2+PL
apalpá-las-emos	apalpar+V.ele.ACC.3.F.PL+FUT+1+PL
apalpá-las-ia	apalpar+V.ele.ACC.3.F.PL+COND+1+SG
apalpá-las-ia	apalpar+V.ele.ACC.3.F.PL+COND+3+SG
apalpá-las-iam	apalpar+V.ele.ACC.3.F.PL+COND+3+PL
apalpá-las-íamos	apalpar+V.ele.ACC.3.F.PL+COND+1+PL
apalpá-las-ias	apalpar+V.ele.ACC.3.F.PL+COND+2+SG
apalpá-las-íeis	apalpar+V.ele.ACC.3.F.PL+COND+2+PL
apalpa-lhe	apalpar+V.ele.DAT.3.SG+PRS+3+SG
apalpa-lhes	apalpar+V.ele.DAT.3.PL+PRS+3+SG
apalpá-lo-á	apalpar+V.ele.ACC.3.M.SG+FUT+3+SG
apalpá-lo-ão	apalpar+V.ele.ACC.3.M.SG+FUT+3+PL
apalpá-lo	apalpar+V.ele.ACC.3.M.SG+INF+1+SG
apalpá-lo	apalpar+V.ele.ACC.3.M.SG+INF+3+SG
apalpa-lo	apalpar+V.ele.ACC.3.M.SG+PRS+2+SG
apalpá-lo	apalpar+V.ele.ACC.3.M.SG+SBJF+1+SG
apalpá-lo	apalpar+V.ele.ACC.3.M.SG+SBJF+3+SG
apalpá-lo-ás	apalpar+V.ele.ACC.3.M.SG+FUT+2+SG
apalpá-lo-ei	apalpar+V.ele.ACC.3.M.SG+FUT+1+SG
apalpá-lo-eis	apalpar+V.ele.ACC.3.M.SG+FUT+2+PL
apalpá-lo-emos	apalpar+V.ele.ACC.3.M.SG+FUT+1+PL
apalpá-lo-ia	apalpar+V.ele.ACC.3.M.SG+COND+1+SG
apalpá-lo-ia	apalpar+V.ele.ACC.3.M.SG+COND+3+SG
apalpá-lo-iam	apalpar+V.ele.ACC.3.M.SG+COND+3+PL
apalpá-lo-íamos	apalpar+V.ele.ACC.3.M.SG+COND+1+PL
apalpá-lo-ias	apalpar+V.ele.ACC.3.M.SG+COND+2+SG
apalpá-lo-íeis	apalpar+V.ele.ACC.3.M.SG+COND+2+PL
apalpá-los-á	apalpar+V.ele.ACC.3.M.PL+FUT+3+SG
apalpá-los-ão	apalpar+V.ele.ACC.3.M.PL+FUT+3+PL
apalpá-los	apalpar+V.ele.ACC.3.M.PL+INF+1+SG
apalpá-los	apalpar+V.ele.ACC.3.M.PL+INF+3+SG
apalpa-los	apalpar+V.ele.ACC.3.M.PL+PRS+2+SG
apalpá-los	apalpar+V.ele.ACC.3.M.PL+SBJF+1+SG
apalpá-los	apalpar+V.ele.ACC.3.M.PL+SBJF+3+SG
apalpá-los-ás	apalpar+V.ele.ACC.3.M.PL+FUT+2+SG
apalpá-los-ei	apalpar+V.ele.ACC.3.M.PL+FUT+1+SG
apalpá-los-eis	apalpar+V.ele.ACC.3.M.PL+FUT+2+PL
apalpá-los-emos	apalpar+V.ele.ACC.3.M.PL+FUT+1+PL
apalpá-los-ia	apalpar+V.ele.ACC.3.M.PL+COND+1+SG
apalpá-los-ia	apalpar+V.ele.ACC.3.M.PL+COND+3+SG
apalpá-los-iam	apalpar+V.ele.ACC.3.M.PL+COND+3+PL
apalpá-los-íamos	apalpar+V.ele.ACC.3.M.PL+COND+1+PL
apalpá-los-ias	apalpar+V.ele.ACC.3.M.PL+COND+2+SG
apalpá-los-íeis	apalpar+V.ele.ACC.3.M.PL+COND+2+PL
apalpa-me	apalpar+V.eu.AD.1.SG+PRS+3+SG
apalpam-lhe	apalpar+V.ele.DAT.3.SG+PRS+3+PL
apalpam-lhes	apalpar+V.ele.DAT.3.PL+PRS+3+PL
apalpam-me	apalpar+V.eu.AD.1.SG+PRS+3+PL
apalpam-na	apalpar+V.ele.ACC.3.F.SG+PRS+3+PL
apalpam-nas	apalpar+V.ele.ACC.3.F.PL+PRS+3+PL
apalpam-no	apalpar+V.ele.ACC.3.M.SG+PRS+3+PL
apalpam-nos	apalpar+V.ele.ACC.3.M.PL+PRS+3+PL
apalpam-nos	apalpar+V.nós.AD.1.PL+PRS+3+PL
apalpamo-la	apalpar+V.ele.ACC.3.F.SG+PRF+1+PL
apalpamo-la	apalpar+V.ele.ACC.3.F.SG+PRS+1+PL
apalpamo-las	apalpar+V.ele.ACC.3.F.PL+PRF+1+PL
apalpamo-las	apalpar+V.ele.ACC.3.F.PL+PRS+1+PL
apalpamo-lo	apalpar+V.ele.ACC.3.M.SG+PRF+1+PL
apalpamo-lo	apalpar+V.ele.ACC.3.M.SG+PRS+1+PL
apalpamo-los	apalpar+V.ele.ACC.3.M.PL+PRF+1+PL
apalpamo-los	apalpar+V.ele.ACC.3.M.PL+PRS+1+PL
apalpamo-nos	apalpar+nós.AD.1.PL+PRF+1+PL
apalpamo-nos	apalpar+nós.AD.1.PL+PRS+1+PL
apalpamos-lhe	apalpar+V.ele.DAT.3.SG+PRF+1+PL
apalpamos-lhe	apalpar+V.ele.DAT.3.SG+PRS+1+PL
apalpamos-lhes	apalpar+V.ele.DAT.3.PL+PRF+1+PL
apalpamos-lhes	apalpar+V.ele.DAT.3.PL+PRS+1+PL
apalpamos-me	apalpar+V.eu.AD.1.SG+PRF+1+PL
apalpamos-me	apalpar+V.eu.AD.1.SG+PRS+1+PL
apalpamos-te	apalpar+V.tu.AD.2.SG+PRF+1+PL
apalpamos-te	apalpar+V.tu.AD.2.SG+PRS+1+PL
apalpamos-vos	apalpar+V.vós.AD.2.PL+PRF+1+PL
apalpamos-vos	apalpar+V.vós.AD.2.PL+PRS+1+PL
apalpam-se	apalpar+V.ele.REFL+PRS+3+PL
apalpam-te	apalpar+V.tu.AD.2.SG+PRS+3+PL
apalpam-vos	apalpar+V.vós.AD.2.PL+PRS+3+PL
apalpando-a	apalpar+V.ele.ACC.3.F.SG+GRD
apalpando-as	apalpar+V.ele.ACC.3.F.PL+GRD
apalpando-lhe	apalpar+V.ele.DAT.3.SG+GRD
apalpando-lhes	apalpar+V.ele.DAT.3.PL+GRD
apalpando-me	apalpar+V.eu.AD.1.SG+GRD
apalpando-nos	apalpar+nós.AD.1.PL+GRD
apalpando-o	apalpar+V.ele.ACC.3.M.SG+GRD
apalpando-os	apalpar+V.ele.ACC.3.M.PL+GRD
apalpando-se	apalpar+V.ele.REFL+GRD
apalpando-te	apalpar+V.tu.AD.2.SG+GRD
apalpando-vos	apalpar+V.vós.AD.2.PL+GRD
apalpa-nos	apalpar+nós.AD.1.PL+PRS+2+SG
apalpa-nos	apalpar+nós.AD.1.PL+PRS+3+SG
apalpa-o	apalpar+V.ele.ACC.3.M.SG+PRS+3+SG
apalpa-os	apalpar+V.ele.ACC.3.M.PL+PRS+3+SG
apalpara-a	apalpar+V.ele.ACC.3.F.SG+PQP+1+SG
apalpara-a	apalpar+V.ele.ACC.3.F.SG+PQP+3+SG
apalpara-as	apalpar+V.ele.ACC.3.F.PL+PQP+1+SG
apalpara-as	apalpar+V.ele.ACC.3.F.PL+PQP+3+SG
apalpara-la	apalpar+V.ele.ACC.3.F.SG+PQP+2+SG
apalpara-las	apalpar+V.ele.ACC.3.F.PL+PQP+2+SG
apalpara-lhe	apalpar+V.ele.DAT.3.SG+PQP+1+SG
apalpara-lhe	apalpar+V.ele.DAT.3.SG+PQP+3+SG
apalpara-lhes	apalpar+V.ele.DAT.3.PL+PQP+1+SG
apalpara-lhes	apalpar+V.ele.DAT.3.PL+PQP+3+SG
apalpara-lo	apalpar+V.ele.ACC.3.M.SG+PQP+2+SG
apalpara-los	apalpar+V.ele.ACC.3.M.PL+PQP+2+SG
apalpara-me	apalpar+V.eu.AD.1.SG+PQP+1+SG
apalpara-me	apalpar+V.eu.AD.1.SG+PQP+3+SG
apalparam-lhe	apalpar+V.ele.DAT.3.SG+PQP+3+PL
apalparam-lhe	apalpar+V.ele.DAT.3.SG+PRF+3+PL
apalparam-lhes	apalpar+V.ele.DAT.3.PL+PQP+3+PL
apalparam-lhes	apalpar+V.ele.DAT.3.PL+PRF+3+PL
apalparam-me	apalpar+V.eu.AD.1.SG+PQP+3+PL
apalparam-me	apalpar+V.eu.AD.1.SG+PRF+3+PL
apalparam-na	apalpar+V.ele.ACC.3.F.SG+PQP+3+PL
apalparam-na	apalpar+V.ele.ACC.3.F.SG+PRF+3+PL
apalparam-nas	apalpar+V.ele.ACC.3.F.PL+PQP+3+PL
apalparam-nas	apalpar+V.ele.ACC.3.F.PL+PRF+3+PL
apalparam-no	apalpar+V.ele.ACC.3.M.SG+PQP+3+PL
apalparam-no	apalpar+V.ele.ACC.3.M.SG+PRF+3+PL
apalparam-nos	apalpar+V.ele.ACC.3.M.PL+PQP+3+PL
apalparam-nos	apalpar+V.ele.ACC.3.M.PL+PRF+3+PL
apalparam-nos	apalpar+V.nós.AD.1.PL+PQP+3+PL
apalparam-nos	apalpar+V.nós.AD.1.PL+PRF+3+PL
apalpáramo-la	apalpar+V.ele.ACC.3.F.SG+PQP+1+PL
apalpáramo-las	apalpar+V.ele.ACC.3.F.PL+PQP+1+PL
apalpáramo-lo	apalpar+V.ele.ACC.3.M.SG+PQP+1+PL
apalpáramo-los	apalpar+V.ele.ACC.3.M.PL+PQP+1+PL
apalpáramo-nos	apalpar+nós.AD.1.PL+PQP+1+PL
apalpáramos-lhe	apalpar+V.ele.DAT.3.SG+PQP+1+PL
apalpáramos-lhes	apalpar+V.ele.DAT.3.PL+PQP+1+PL
apalpáramos-me	apalpar+V.eu.AD.1.SG+PQP+1+PL
apalpáramos-te	apalpar+V.tu.AD.2.SG+PQP+1+PL
apalpáramos-vos	apalpar+V.vós.AD.2.PL+PQP+1+PL
apalparam-se	apalpar+V.ele.REFL+PQP+3+PL
apalparam-se	apalpar+V.ele.REFL+PRF+3+PL
apalparam-te	apalpar+V.tu.AD.2.SG+PQP+3+PL
apalparam-te	apalpar+V.tu.AD.2.SG+PRF+3+PL
apalparam-vos	apalpar+V.vós.AD.2.PL+PQP+3+PL
apalparam-vos	apalpar+V.vós.AD.2.PL+PRF+3+PL
apalpara-nos	apalpar+nós.AD.1.PL+PQP+1+SG
apalpara-nos	apalpar+nós.AD.1.PL+PQP+2+SG
apalpara-nos	apalpar+nós.AD.1.PL+PQP+3+SG
apalpara-o	apalpar+V.ele.ACC.3.M.SG+PQP+1+SG
apalpara-o	apalpar+V.ele.ACC.3.M.SG+PQP+3+SG
apalpara-os	apalpar+V.ele.ACC.3.M.PL+PQP+1+SG
apalpara-os	apalpar+V.ele.ACC.3.M.PL+PQP+3+SG
apalpara-se	apalpar+V.ele.REFL+PQP+1+SG
apalpara-se	apalpar+V.ele.REFL+PQP+3+SG
apalparas-lhe	apalpar+V.ele.DAT.3.SG+PQP+2+SG
apalparas-lhes	apalpar+V.ele.DAT.3.PL+PQP+2+SG
apalparas-me	apalpar+V.eu.AD.1.SG+PQP+2+SG
apalparas-te	apalpar+V.tu.AD.2.SG+PQP+2+SG
apalparas-vos	apalpar+V.vós.AD.2.PL+PQP+2+SG
apalpara-te	apalpar+V.tu.AD.2.SG+PQP+1+SG
apalpara-te	apalpar+V.tu.AD.2.SG+PQP+3+SG
apalpara-vos	apalpar+V.vós.AD.2.PL+PQP+1+SG
apalpara-vos	apalpar+V.vós.AD.2.PL+PQP+3+SG
apalparde-la	apalpar+V.ele.ACC.3.F.SG+INF+2+PL
apalparde-la	apalpar+V.ele.ACC.3.F.SG+SBJF+2+PL
apalparde-las	apalpar+V.ele.ACC.3.F.PL+INF+2+PL
apalparde-las	apalpar+V.ele.ACC.3.F.PL+SBJF+2+PL
apalparde-lo	apalpar+V.ele.ACC.3.M.SG+INF+2+PL
apalparde-lo	apalpar+V.ele.ACC.3.M.SG+SBJF+2+PL
apalparde-los	apalpar+V.ele.ACC.3.M.PL+INF+2+PL
apalparde-los	apalpar+V.ele.ACC.3.M.PL+SBJF+2+PL
apalparde-nos	apalpar+nós.AD.1.PL+INF+2+PL
apalparde-nos	apalpar+nós.AD.1.PL+SBJF+2+PL
apalpardes-lhe	apalpar+V.ele.DAT.3.SG+INF+2+PL
apalpardes-lhe	apalpar+V.ele.DAT.3.SG+SBJF+2+PL
apalpardes-lhes	apalpar+V.ele.DAT.3.PL+INF+2+PL
apalpardes-lhes	apalpar+V.ele.DAT.3.PL+SBJF+2+PL
apalpardes-me	apalpar+V.eu.AD.1.SG+INF+2+PL
apalpardes-me	apalpar+V.eu.AD.1.SG+SBJF+2+PL
apalpardes-te	apalpar+V.tu.AD.2.SG+INF+2+PL
apalpardes-te	apalpar+V.tu.AD.2.SG+SBJF+2+PL
apalpardes-vos	apalpar+V.vós.AD.2.PL+INF+2+PL
apalpardes-vos	apalpar+V.vós.AD.2.PL+SBJF+2+PL
apalpárei-la	apalpar+V.ele.ACC.3.F.SG+PQP+2+PL
apalpárei-las	apalpar+V.ele.ACC.3.F.PL+PQP+2+PL
apalpárei-lo	apalpar+V.ele.ACC.3.M.SG+PQP+2+PL
apalpárei-los	apalpar+V.ele.ACC.3.M.PL+PQP+2+PL
apalpárei-nos	apalpar+nós.AD.1.PL+PQP+2+PL
apalpáreis-lhe	apalpar+V.ele.DAT.3.SG+PQP+2+PL
apalpáreis-lhes	apalpar+V.ele.DAT.3.PL+PQP+2+PL
apalpáreis-me	apalpar+V.eu.AD.1.SG+PQP+2+PL
apalpáreis-te	apalpar+V.tu.AD.2.SG+PQP+2+PL
apalpáreis-vos	apalpar+V.vós.AD.2.PL+PQP+2+PL
apalpare-la	apalpar+V.ele.ACC.3.F.SG+INF+2+SG
apalpare-la	apalpar+V.ele.ACC.3.F.SG+SBJF+2+SG
apalpare-las	apalpar+V.ele.ACC.3.F.PL+INF+2+SG
apalpare-las	apalpar+V.ele.ACC.3.F.PL+SBJF+2+SG
apalpare-lo	apalpar+V.ele.ACC.3.M.SG+INF+2+SG
apalpare-lo	apalpar+V.ele.ACC.3.M.SG+SBJF+2+SG
apalpare-los	apalpar+V.ele.ACC.3.M.PL+INF+2+SG
apalpare-los	apalpar+V.ele.ACC.3.M.PL+SBJF+2+SG
apalparem-lhe	apalpar+V.ele.DAT.3.SG+INF+3+PL
apalparem-lhe	apalpar+V.ele.DAT.3.SG+SBJF+3+PL
apalparem-lhes	apalpar+V.ele.DAT.3.PL+INF+3+PL
apalparem-lhes	apalpar+V.ele.DAT.3.PL+SBJF+3+PL
apalparem-me	apalpar+V.eu.AD.1.SG+INF+3+PL
apalparem-me	apalpar+V.eu.AD.1.SG+SBJF+3+PL
apalparem-na	apalpar+V.ele.ACC.3.F.SG+INF+3+PL
apalparem-na	apalpar+V.ele.ACC.3.F.SG+SBJF+3+PL
apalparem-nas	apalpar+V.ele.ACC.3.F.PL+INF+3+PL
apalparem-nas	apalpar+V.ele.ACC.3.F.PL+SBJF+3+PL
apalparem-no	apalpar+V.ele.ACC.3.M.SG+INF+3+PL
apalparem-no	apalpar+V.ele.ACC.3.M.SG+SBJF+3+PL
apalparem-nos	apalpar+V.ele.ACC.3.M.PL+INF+3+PL
apalparem-nos	apalpar+V.ele.ACC.3.M.PL+SBJF+3+PL
apalparem-nos	apalpar+V.nós.AD.1.PL+INF+3+PL
apalparem-nos	apalpar+V.nós.AD.1.PL+SBJF+3+PL
apalparem-se	apalpar+V.ele.REFL+INF+3+PL
apalparem-se	apalpar+V.ele.REFL+SBJF+3+PL
apalparem-te	apalpar+V.tu.AD.2.SG+INF+3+PL
apalparem-te	apalpar+V.tu.AD.2.SG+SBJF+3+PL
apalparem-vos	apalpar+V.vós.AD.2.PL+INF+3+PL
apalparem-vos	apalpar+V.vós.AD.2.PL+SBJF+3+PL
apalpare-nos	apalpar+nós.AD.1.PL+INF+2+SG
apalpare-nos	apalpar+nós.AD.1.PL+SBJF+2+SG
apalpares-lhe	apalpar+V.ele.DAT.3.SG+INF+2+SG
apalpares-lhe	apalpar+V.ele.DAT.3.SG+SBJF+2+SG
apalpares-lhes	apalpar+V.ele.DAT.3.PL+INF+2+SG
apalpares-lhes	apalpar+V.ele.DAT.3.PL+SBJF+2+SG
apalpares-me	apalpar+V.eu.AD.1.SG+INF+2+SG
apalpares-me	apalpar+V.eu.AD.1.SG+SBJF+2+SG
apalpares-te	apalpar+V.tu.AD.2.SG+INF+2+SG
apalpares-te	apalpar+V.tu.AD.2.SG+SBJF+2+SG
apalpares-vos	apalpar+V.vós.AD.2.PL+INF+2+SG
apalpares-vos	apalpar+V.vós.AD.2.PL+SBJF+2+SG
apalpar-lhe-á	apalpar+V.ele.DAT.3.SG+FUT+3+SG
apalpar-lhe-ão	apalpar+V.ele.DAT.3.SG+FUT+3+PL
apalpar-lhe	apalpar+V.ele.DAT.3.SG+INF
apalpar-lhe	apalpar+V.ele.DAT.3.SG+INF+1+SG
apalpar-lhe	apalpar+V.ele.DAT.3.SG+INF+3+SG
apalpar-lhe	apalpar+V.ele.DAT.3.SG+SBJF+1+SG
apalpar-lhe	apalpar+V.ele.DAT.3.SG+SBJF+3+SG
apalpar-lhe-ás	apalpar+V.ele.DAT.3.SG+FUT+2+SG
apalpar-lhe-ei	apalpar+V.ele.DAT.3.SG+FUT+1+SG
apalpar-lhe-eis	apalpar+V.ele.DAT.3.SG+FUT+2+PL
apalpar-lhe-emos	apalpar+V.ele.DAT.3.SG+FUT+1+PL
apalpar-lhe-ia	apalpar+V.ele.DAT.3.SG+COND+1+SG
apalpar-lhe-ia	apalpar+V.ele.DAT.3.SG+COND+3+SG
apalpar-lhe-iam	apalpar+V.ele.DAT.3.SG+COND+3+PL
apalpar-lhe-íamos	apalpar+V.ele.DAT.3.SG+COND+1+PL
apalpar-lhe-ias	apalpar+V.ele.DAT.3.SG+COND+2+SG
apalpar-lhe-íeis	apalpar+V.ele.DAT.3.SG+COND+2+PL
apalpar-lhes-á	apalpar+V.ele.DAT.3.PL+FUT+3+SG
apalpar-lhes-ão	apalpar+V.ele.DAT.3.PL+FUT+3+PL
apalpar-lhes	apalpar+V.ele.DAT.3.PL+INF
apalpar-lhes	apalpar+V.ele.DAT.3.PL+INF+1+SG
apalpar-lhes	apalpar+V.ele.DAT.3.PL+INF+3+SG
apalpar-lhes	apalpar+V.ele.DAT.3.PL+SBJF+1+SG
apalpar-lhes	apalpar+V.ele.DAT.3.PL+SBJF+3+SG
apalpar-lhes-ás	apalpar+V.ele.DAT.3.PL+FUT+2+SG
apalpar-lhes-ei	apalpar+V.ele.DAT.3.PL+FUT+1+SG
apalpar-lhes-eis	apalpar+V.ele.DAT.3.PL+FUT+2+PL
apalpar-lhes-emos	apalpar+V.ele.DAT.3.PL+FUT+1+PL
apalpar-lhes-ia	apalpar+V.ele.DAT.3.PL+COND+1+SG
apalpar-lhes-ia	apalpar+V.ele.DAT.3.PL+COND+3+SG
apalpar-lhes-iam	apalpar+V.ele.DAT.3.PL+COND+3+PL
apalpar-lhes-íamos	apalpar+V.ele.DAT.3.PL+COND+1+PL
apalpar-lhes-ias	apalpar+V.ele.DAT.3.PL+COND+2+SG
apalpar-lhes-íeis	apalpar+V.ele.DAT.3.PL+COND+2+PL
apalpar-me-á	apalpar+V.eu.AD.1.SG+FUT+3+SG
apalpar-me-ão	apalpar+V.eu.AD.1.SG+FUT+3+PL
apalpar-me	apalpar+V.eu.AD.1.SG+INF
apalpar-me	apalpar+V.eu.AD.1.SG+INF+1+SG
apalpar-me	apalpar+V.eu.AD.1.SG+INF+3+SG
apalpar-me	apalpar+V.eu.AD.1.SG+SBJF+1+SG
apalpar-me	apalpar+V.eu.AD.1.SG+SBJF+3+SG
apalpar-me-ás	apalpar+V.eu.AD.1.SG+FUT+2+SG
apalpar-me-ei	apalpar+V.eu.AD.1.SG+FUT+1+SG
apalpar-me-eis	apalpar+V.eu.AD.1.SG+FUT+2+PL
apalpar-me-emos	apalpar+V.eu.AD.1.SG+FUT+1+PL
apalpar-me-ia	apalpar+V.eu.AD.1.SG+COND+1+SG
apalpar-me-ia	apalpar+V.eu.AD.1.SG+COND+3+SG
apalpar-me-iam	apalpar+V.eu.AD.1.SG+COND+3+PL
apalpar-me-íamos	apalpar+V.eu.AD.1.SG+COND+1+PL
apalpar-me-ias	apalpar+V.eu.AD.1.SG+COND+2+SG
apalpar-me-íeis	apalpar+V.eu.AD.1.SG+COND+2+PL
apalparmo-la	apalpar+V.ele.ACC.3.F.SG+INF+1+PL
apalparmo-la	apalpar+V.ele.ACC.3.F.SG+SBJF+1+PL
apalparmo-las	apalpar+V.ele.ACC.3.F.PL+INF+1+PL
apalparmo-las	apalpar+V.ele.ACC.3.F.PL+SBJF+1+PL
apalparmo-lo	apalpar+V.ele.ACC.3.M.SG+INF+1+PL
apalparmo-lo	apalpar+V.ele.ACC.3.M.SG+SBJF+1+PL
apalparmo-los	apalpar+V.ele.ACC.3.M.PL+INF+1+PL
apalparmo-los	apalpar+V.ele.ACC.3.M.PL+SBJF+1+PL
apalparmo-nos	apalpar+nós.AD.1.PL+INF+1+PL
apalparmo-nos	apalpar+nós.AD.1.PL+SBJF+1+PL
apalparmos-lhe	apalpar+V.ele.DAT.3.SG+INF+1+PL
apalparmos-lhe	apalpar+V.ele.DAT.3.SG+SBJF+1+PL
apalparmos-lhes	apalpar+V.ele.DAT.3.PL+INF+1+PL
apalparmos-lhes	apalpar+V.ele.DAT.3.PL+SBJF+1+PL
apalparmos-me	apalpar+V.eu.AD.1.SG+INF+1+PL
apalparmos-me	apalpar+V.eu.AD.1.SG+SBJF+1+PL
apalparmos-te	apalpar+V.tu.AD.2.SG+INF+1+PL
apalparmos-te	apalpar+V.tu.AD.2.SG+SBJF+1+PL
apalparmos-vos	apalpar+V.vós.AD.2.PL+INF+1+PL
apalparmos-vos	apalpar+V.vós.AD.2.PL+SBJF+1+PL
apalpar-nos-á	apalpar+nós.AD.1.PL+FUT+3+SG
apalpar-nos-ão	apalpar+nós.AD.1.PL+FUT+3+PL
apalpar-nos	apalpar+nós.AD.1.PL+INF
apalpar-nos	apalpar+nós.AD.1.PL+INF+1+SG
apalpar-nos	apalpar+nós.AD.1.PL+INF+3+SG
apalpar-nos	apalpar+nós.AD.1.PL+SBJF+1+SG
apalpar-nos	apalpar+nós.AD.1.PL+SBJF+3+SG
apalpar-nos-ás	apalpar+nós.AD.1.PL+FUT+2+SG
apalpar-nos-ei	apalpar+nós.AD.1.PL+FUT+1+SG
apalpar-nos-eis	apalpar+nós.AD.1.PL+FUT+2+PL
apalpar-nos-emos	apalpar+nós.AD.1.PL+FUT+1+PL
apalpar-nos-ia	apalpar+nós.AD.1.PL+COND+1+SG
apalpar-nos-ia	apalpar+nós.AD.1.PL+COND+3+SG
apalpar-nos-iam	apalpar+nós.AD.1.PL+COND+3+PL
apalpar-nos-íamos	apalpar+nós.AD.1.PL+COND+1+PL
apalpar-nos-ias	apalpar+nós.AD.1.PL+COND+2+SG
apalpar-nos-íeis	apalpar+nós.AD.1.PL+COND+2+PL
apalpar-se-á	apalpar+V.ele.REFL+FUT+3+SG
apalpar-se-ão	apalpar+V.ele.REFL+FUT+3+PL
apalpar-se	apalpar+V.ele.REFL+INF
apalpar-se	apalpar+V.ele.REFL+INF+3+SG
apalpar-se	apalpar+V.ele.REFL+SBJF+3+SG
apalpar-se-ia	apalpar+V.ele.REFL+COND+3+SG
apalpar-se-iam	apalpar+V.ele.REFL+COND+3+PL
apalpar-te-á	apalpar+V.tu.AD.2.SG+FUT+3+SG
apalpar-te-ão	apalpar+V.tu.AD.2.SG+FUT+3+PL
apalpar-te	apalpar+V.tu.AD.2.SG+INF
apalpar-te	apalpar+V.tu.AD.2.SG+INF+1+SG
apalpar-te	apalpar+V.tu.AD.2.SG+INF+3+SG
apalpar-te	apalpar+V.tu.AD.2.SG+SBJF+1+SG
apalpar-te	apalpar+V.tu.AD.2.SG+SBJF+3+SG
apalpar-te-ás	apalpar+V.tu.AD.2.SG+FUT+2+SG
apalpar-te-ei	apalpar+V.tu.AD.2.SG+FUT+1+SG
apalpar-te-eis	apalpar+V.tu.AD.2.SG+FUT+2+PL
apalpar-te-emos	apalpar+V.tu.AD.2.SG+FUT+1+PL
apalpar-te-ia	apalpar+V.tu.AD.2.SG+COND+1+SG
apalpar-te-ia	apalpar+V.tu.AD.2.SG+COND+3+SG
apalpar-te-iam	apalpar+V.tu.AD.2.SG+COND+3+PL
apalpar-te-íamos	apalpar+V.tu.AD.2.SG+COND+1+PL
apalpar-te-ias	apalpar+V.tu.AD.2.SG+COND+2+SG
apalpar-te-íeis	apalpar+V.tu.AD.2.SG+COND+2+PL
apalpar-vos-á	apalpar+V.vós.AD.2.PL+FUT+3+SG
apalpar-vos-ão	apalpar+V.vós.AD.2.PL+FUT+3+PL
apalpar-vos	apalpar+V.vós.AD.2.PL+INF
apalpar-vos	apalpar+V.vós.AD.2.PL+INF+1+SG
apalpar-vos	apalpar+V.vós.AD.2.PL+INF+3+SG
apalpar-vos	apalpar+V.vós.AD.2.PL+SBJF+1+SG
apalpar-vos	apalpar+V.vós.AD.2.PL+SBJF+3+SG
apalpar-vos-ás	apalpar+V.vós.AD.2.PL+FUT+2+SG
apalpar-vos-ei	apalpar+V.vós.AD.2.PL+FUT+1+SG
apalpar-vos-eis	apalpar+V.vós.AD.2.PL+FUT+2+PL
apalpar-vos-emos	apalpar+V.vós.AD.2.PL+FUT+1+PL
apalpar-vos-ia	apalpar+V.vós.AD.2.PL+COND+1+SG
apalpar-vos-ia	apalpar+V.vós.AD.2.PL+COND+3+SG
apalpar-vos-iam	apalpar+V.vós.AD.2.PL+COND+3+PL
apalpar-vos-íamos	apalpar+V.vós.AD.2.PL+COND+1+PL
apalpar-vos-ias	apalpar+V.vós.AD.2.PL+COND+2+SG
apalpar-vos-íeis	apalpar+V.vós.AD.2.PL+COND+2+PL
apalpa-se	apalpar+V.ele.REFL+PRS+3+SG
apalpas-lhe	apalpar+V.ele.DAT.3.SG+PRS+2+SG
apalpas-lhes	apalpar+V.ele.DAT.3.PL+PRS+2+SG
apalpas-me	apalpar+V.eu.AD.1.SG+PRS+2+SG
apalpaste-a	apalpar+V.ele.ACC.3.F.SG+PRF+2+SG
apalpas-te	apalpar+V.tu.AD.2.SG+PRS+2+SG
apalpaste-as	apalpar+V.ele.ACC.3.F.PL+PRF+2+SG
apalpaste-la	apalpar+V.ele.ACC.3.F.SG+PRF+2+PL
apalpaste-las	apalpar+V.ele.ACC.3.F.PL+PRF+2+PL
apalpaste-lhe	apalpar+V.ele.DAT.3.SG+PRF+2+SG
apalpaste-lhes	apalpar+V.ele.DAT.3.PL+PRF+2+SG
apalpaste-lo	apalpar+V.ele.ACC.3.M.SG+PRF+2+PL
apalpaste-los	apalpar+V.ele.ACC.3.M.PL+PRF+2+PL
apalpaste-me	apalpar+V.eu.AD.1.SG+PRF+2+SG
apalpaste-nos	apalpar+nós.AD.1.PL+PRF+2+PL
apalpaste-nos	apalpar+nós.AD.1.PL+PRF+2+SG
apalpaste-o	apalpar+V.ele.ACC.3.M.SG+PRF+2+SG
apalpaste-os	apalpar+V.ele.ACC.3.M.PL+PRF+2+SG
apalpastes-lhe	apalpar+V.ele.DAT.3.SG+PRF+2+PL
apalpastes-lhes	apalpar+V.ele.DAT.3.PL+PRF+2+PL
apalpastes-me	apalpar+V.eu.AD.1.SG+PRF+2+PL
apalpastes-te	apalpar+V.tu.AD.2.SG+PRF+2+PL
apalpastes-vos	apalpar+V.vós.AD.2.PL+PRF+2+PL
apalpaste-te	apalpar+V.tu.AD.2.SG+PRF+2+SG
apalpaste-vos	apalpar+V.vós.AD.2.PL+PRF+2+SG
apalpas-vos	apalpar+V.vós.AD.2.PL+PRS+2+SG
apalpa-te	apalpar+V.tu.AD.2.SG+PRS+3+SG
apalpava-a	apalpar+V.ele.ACC.3.F.SG+IMPF+1+SG
apalpava-a	apalpar+V.ele.ACC.3.F.SG+IMPF+3+SG
apalpava-as	apalpar+V.ele.ACC.3.F.PL+IMPF+1+SG
apalpava-as	apalpar+V.ele.ACC.3.F.PL+IMPF+3+SG
apalpava-la	apalpar+V.ele.ACC.3.F.SG+IMPF+2+SG
apalpava-las	apalpar+V.ele.ACC.3.F.PL+IMPF+2+SG
apalpava-lhe	apalpar+V.ele.DAT.3.SG+IMPF+1+SG
apalpava-lhe	apalpar+V.ele.DAT.3.SG+IMPF+3+SG
apalpava-lhes	apalpar+V.ele.DAT.3.PL+IMPF+1+SG
apalpava-lhes	apalpar+V.ele.DAT.3.PL+IMPF+3+SG
apalpava-lo	apalpar+V.ele.ACC.3.M.SG+IMPF+2+SG
apalpava-los	apalpar+V.ele.ACC.3.M.PL+IMPF+2+SG
apalpava-me	apalpar+V.eu.AD.1.SG+IMPF+1+SG
apalpava-me	apalpar+V.eu.AD.1.SG+IMPF+3+SG
apalpavam-lhe	apalpar+V.ele.DAT.3.SG+IMPF+3+PL
apalpavam-lhes	apalpar+V.ele.DAT.3.PL+IMPF+3+PL
apalpavam-me	apalpar+V.eu.AD.1.SG+IMPF+3+PL
apalpavam-na	apalpar+V.ele.ACC.3.F.SG+IMPF+3+PL
apalpavam-nas	apalpar+V.ele.ACC.3.F.PL+IMPF+3+PL
apalpavam-no	apalpar+V.ele.ACC.3.M.SG+IMPF+3+PL
apalpavam-nos	apalpar+V.ele.ACC.3.M.PL+IMPF+3+PL
apalpavam-nos	apalpar+V.nós.AD.1.PL+IMPF+3+PL
apalpávamo-la	apalpar+V.ele.ACC.3.F.SG+IMPF+1+PL
apalpávamo-las	apalpar+V.ele.ACC.3.F.PL+IMPF+1+PL
apalpávamo-lo	apalpar+V.ele.ACC.3.M.SG+IMPF+1+PL
apalpávamo-los	apalpar+V.ele.ACC.3.M.PL+IMPF+1+PL
apalpávamo-nos	apalpar+nós.AD.1.PL+IMPF+1+PL
apalpávamos-lhe	apalpar+V.ele.DAT.3.SG+IMPF+1+PL
apalpávamos-lhes	apalpar+V.ele.DAT.3.PL+IMPF+1+PL
apalpávamos-me	apalpar+V.eu.AD.1.SG+IMPF+1+PL
apalpávamos-te	apalpar+V.tu.AD.2.SG+IMPF+1+PL
apalpávamos-vos	apalpar+V.vós.AD.2.PL+IMPF+1+PL
apalpavam-se	apalpar+V.ele.REFL+IMPF+3+PL
apalpavam-te	apalpar+V.tu.AD.2.SG+IMPF+3+PL
apalpavam-vos	apalpar+V.vós.AD.2.PL+IMPF+3+PL
apalpava-nos	apalpar+nós.AD.1.PL+IMPF+1+SG
apalpava-nos	apalpar+nós.AD.1.PL+IMPF+2+SG
apalpava-nos	apalpar+nós.AD.1.PL+IMPF+3+SG
apalpava-o	apalpar+V.ele.ACC.3.M.SG+IMPF+1+SG
apalpava-o	apalpar+V.ele.ACC.3.M.SG+IMPF+3+SG
apalpava-os	apalpar+V.ele.ACC.3.M.PL+IMPF+1+SG
apalpava-os	apalpar+V.ele.ACC.3.M.PL+IMPF+3+SG
apalpava-se	apalpar+V.ele.REFL+IMPF+1+SG
apalpava-se	apalpar+V.ele.REFL+IMPF+3+SG
apalpavas-lhe	apalpar+V.ele.DAT.3.SG+IMPF+2+SG
apalpavas-lhes	apalpar+V.ele.DAT.3.PL+IMPF+2+SG
apalpavas-me	apalpar+V.eu.AD.1.SG+IMPF+2+SG
apalpavas-te	apalpar+V.tu.AD.2.SG+IMPF+2+SG
apalpavas-vos	apalpar+V.vós.AD.2.PL+IMPF+2+SG
apalpava-te	apalpar+V.tu.AD.2.SG+IMPF+1+SG
apalpava-te	apalpar+V.tu.AD.2.SG+IMPF+3+SG
apalpava-vos	apalpar+V.vós.AD.2.PL+IMPF+1+SG
apalpava-vos	apalpar+V.vós.AD.2.PL+IMPF+3+SG
apalpávei-la	apalpar+V.ele.ACC.3.F.SG+IMPF+2+PL
apalpávei-las	apalpar+V.ele.ACC.3.F.PL+IMPF+2+PL
apalpávei-lo	apalpar+V.ele.ACC.3.M.SG+IMPF+2+PL
apalpávei-los	apalpar+V.ele.ACC.3.M.PL+IMPF+2+PL
apalpávei-nos	apalpar+nós.AD.1.PL+IMPF+2+PL
apalpáveis-lhe	apalpar+V.ele.DAT.3.SG+IMPF+2+PL
apalpáveis-lhes	apalpar+V.ele.DAT.3.PL+IMPF+2+PL
apalpáveis-me	apalpar+V.eu.AD.1.SG+IMPF+2+PL
apalpáveis-te	apalpar+V.tu.AD.2.SG+IMPF+2+PL
apalpáveis-vos	apalpar+V.vós.AD.2.PL+IMPF+2+PL
apalpa-vos	apalpar+V.vós.AD.2.PL+PRS+3+SG
apalpe-a	apalpar+V.ele.ACC.3.F.SG+IMP+3+SG
apalpe-as	apalpar+V.ele.ACC.3.F.PL+IMP+3+SG
apalpei-a	apalpar+V.ele.ACC.3.F.SG+PRF+1+SG
apalpei-as	apalpar+V.ele.ACC.3.F.PL+PRF+1+SG
apalpei-lhe	apalpar+V.ele.DAT.3.SG+PRF+1+SG
apalpei-lhes	apalpar+V.ele.DAT.3.PL+PRF+1+SG
apalpei-me	apalpar+V.eu.AD.1.SG+PRF+1+SG
apalpei-nos	apalpar+nós.AD.1.PL+PRF+1+SG
apalpei-o	apalpar+V.ele.ACC.3.M.SG+PRF+1+SG
apalpei-os	apalpar+V.ele.ACC.3.M.PL+PRF+1+SG
apalpei-te	apalpar+V.tu.AD.2.SG+PRF+1+SG
apalpei-vos	apalpar+V.vós.AD.2.PL+PRF+1+SG
apalpe-lhe	apalpar+V.ele.DAT.3.SG+IMP+3+SG
apalpe-lhes	apalpar+V.ele.DAT.3.PL+IMP+3+SG
apalpe-me	apalpar+V.eu.AD.1.SG+IMP+3+SG
apalpem-lhe	apalpar+V.ele.DAT.3.SG+IMP+3+PL
apalpem-lhes	apalpar+V.ele.DAT.3.PL+IMP+3+PL
apalpem-me	apalpar+V.eu.AD.1.SG+IMP+3+PL
apalpem-na	apalpar+V.ele.ACC.3.F.SG+IMP+3+PL
apalpem-nas	apalpar+V.ele.ACC.3.F.PL+IMP+3+PL
apalpem-no	apalpar+V.ele.ACC.3.M.SG+IMP+3+PL
apalpem-nos	apalpar+V.ele.ACC.3.M.PL+IMP+3+PL
apalpem-nos	apalpar+V.nós.AD.1.PL+IMP+3+PL
apalpemo-la	apalpar+V.ele.ACC.3.F.SG+IMP+1+PL
apalpemo-las	apalpar+V.ele.ACC.3.F.PL+IMP+1+PL
apalpemo-lo	apalpar+V.ele.ACC.3.M.SG+IMP+1+PL
apalpemo-los	apalpar+V.ele.ACC.3.M.PL+IMP+1+PL
apalpemo-nos	apalpar+nós.AD.1.PL+IMP+1+PL
apalpemos-lhe	apalpar+V.ele.DAT.3.SG+IMP+1+PL
apalpemos-lhes	apalpar+V.ele.DAT.3.PL+IMP+1+PL
apalpemos-me	apalpar+V.eu.AD.1.SG+IMP+1+PL
apalpemos-te	apalpar+V.tu.AD.2.SG+IMP+1+PL
apalpemos-vos	apalpar+V.vós.AD.2.PL+IMP+1+PL
apalpem-se	apalpar+V.ele.REFL+IMP+3+PL
apalpem-te	apalpar+V.tu.AD.2.SG+IMP+3+PL
apalpem-vos	apalpar+V.vós.AD.2.PL+IMP+3+PL
apalpe-nos	apalpar+nós.AD.1.PL+IMP+3+SG
apalpe-o	apalpar+V.ele.ACC.3.M.SG+IMP+3+SG
apalpe-os	apalpar+V.ele.ACC.3.M.PL+IMP+3+SG
apalpe-se	apalpar+V.ele.REFL+IMP+3+SG
apalpe-te	apalpar+V.tu.AD.2.SG+IMP+3+SG
apalpe-vos	apalpar+V.vós.AD.2.PL+IMP+3+SG
apalpo-a	apalpar+V.ele.ACC.3.F.SG+PRS+1+SG
apalpo-as	apalpar+V.ele.ACC.3.F.PL+PRS+1+SG
apalpo-lhe	apalpar+V.ele.DAT.3.SG+PRS+1+SG
apalpo-lhes	apalpar+V.ele.DAT.3.PL+PRS+1+SG
apalpo-me	apalpar+V.eu.AD.1.SG+PRS+1+SG
apalpo-nos	apalpar+nós.AD.1.PL+PRS+1+SG
apalpo-o	apalpar+V.ele.ACC.3.M.SG+PRS+1+SG
apalpo-os	apalpar+V.ele.ACC.3.M.PL+PRS+1+SG
apalpo-te	apalpar+V.tu.AD.2.SG+PRS+1+SG
apalpou-a	apalpar+V.ele.ACC.3.F.SG+PRF+3+SG
apalpou-as	apalpar+V.ele.ACC.3.F.PL+PRF+3+SG
apalpou-lhe	apalpar+V.ele.DAT.3.SG+PRF+3+SG
apalpou-lhes	apalpar+V.ele.DAT.3.PL+PRF+3+SG
apalpou-me	apalpar+V.eu.AD.1.SG+PRF+3+SG
apalpou-nos	apalpar+nós.AD.1.PL+PRF+3+SG
apalpou-o	apalpar+V.ele.ACC.3.M.SG+PRF+3+SG
apalpou-os	apalpar+V.ele.ACC.3.M.PL+PRF+3+SG
apalpou-se	apalpar+V.ele.REFL+PRF+3+SG
apalpou-te	apalpar+V.tu.AD.2.SG+PRF+3+SG
apalpou-vos	apalpar+V.vós.AD.2.PL+PRF+3+SG
apalpo-vos	apalpar+V.vós.AD.2.PL+PRS+1+SG
apanagia-a	apanagiar+V.ele.ACC.3.F.SG+PRS+3+SG
apanagia-as	apanagiar+V.ele.ACC.3.F.PL+PRS+3+SG
apanagiai-la	apanagiar+V.ele.ACC.3.F.SG+PRS+2+PL
apanagiai-las	apanagiar+V.ele.ACC.3.F.PL+PRS+2+PL
apanagiai-lo	apanagiar+V.ele.ACC.3.M.SG+PRS+2+PL
apanagiai-los	apanagiar+V.ele.ACC.3.M.PL+PRS+2+PL
apanagiai-nos	apanagiar+nós.AD.1.PL+PRS+2+PL
apanagiais-lhe	apanagiar+V.ele.DAT.3.SG+PRS+2+PL
apanagiais-lhes	apanagiar+V.ele.DAT.3.PL+PRS+2+PL
apanagiais-me	apanagiar+V.eu.AD.1.SG+PRS+2+PL
apanagiais-te	apanagiar+V.tu.AD.2.SG+PRS+2+PL
apanagiais-vos	apanagiar+V.vós.AD.2.PL+PRS+2+PL
apanagiá-la-á	apanagiar+V.ele.ACC.3.F.SG+FUT+3+SG
apanagiá-la-ão	apanagiar+V.ele.ACC.3.F.SG+FUT+3+PL
apanagiá-la	apanagiar+V.ele.ACC.3.F.SG+INF+1+SG
apanagiá-la	apanagiar+V.ele.ACC.3.F.SG+INF+3+SG
apanagia-la	apanagiar+V.ele.ACC.3.F.SG+PRS+2+SG
apanagiá-la	apanagiar+V.ele.ACC.3.F.SG+SBJF+1+SG
apanagiá-la	apanagiar+V.ele.ACC.3.F.SG+SBJF+3+SG
apanagiá-la-ás	apanagiar+V.ele.ACC.3.F.SG+FUT+2+SG
apanagiá-la-ei	apanagiar+V.ele.ACC.3.F.SG+FUT+1+SG
apanagiá-la-eis	apanagiar+V.ele.ACC.3.F.SG+FUT+2+PL
apanagiá-la-emos	apanagiar+V.ele.ACC.3.F.SG+FUT+1+PL
apanagiá-la-ia	apanagiar+V.ele.ACC.3.F.SG+COND+1+SG
apanagiá-la-ia	apanagiar+V.ele.ACC.3.F.SG+COND+3+SG
apanagiá-la-iam	apanagiar+V.ele.ACC.3.F.SG+COND+3+PL
apanagiá-la-íamos	apanagiar+V.ele.ACC.3.F.SG+COND+1+PL
apanagiá-la-ias	apanagiar+V.ele.ACC.3.F.SG+COND+2+SG
apanagiá-la-íeis	apanagiar+V.ele.ACC.3.F.SG+COND+2+PL
apanagiá-las-á	apanagiar+V.ele.ACC.3.F.PL+FUT+3+SG
apanagiá-las-ão	apanagiar+V.ele.ACC.3.F.PL+FUT+3+PL
apanagiá-las	apanagiar+V.ele.ACC.3.F.PL+INF+1+SG
apanagiá-las	apanagiar+V.ele.ACC.3.F.PL+INF+3+SG
apanagia-las	apanagiar+V.ele.ACC.3.F.PL+PRS+2+SG
apanagiá-las	apanagiar+V.ele.ACC.3.F.PL+SBJF+1+SG
apanagiá-las	apanagiar+V.ele.ACC.3.F.PL+SBJF+3+SG
apanagiá-las-ás	apanagiar+V.ele.ACC.3.F.PL+FUT+2+SG
apanagiá-las-ei	apanagiar+V.ele.ACC.3.F.PL+FUT+1+SG
apanagiá-las-eis	apanagiar+V.ele.ACC.3.F.PL+FUT+2+PL
apanagiá-las-emos	apanagiar+V.ele.ACC.3.F.PL+FUT+1+PL
apanagiá-las-ia	apanagiar+V.ele.ACC.3.F.PL+COND+1+SG
apanagiá-las-ia	apanagiar+V.ele.ACC.3.F.PL+COND+3+SG
apanagiá-las-iam	apanagiar+V.ele.ACC.3.F.PL+COND+3+PL
apanagiá-las-íamos	apanagiar+V.ele.ACC.3.F.PL+COND+1+PL
apanagiá-las-ias	apanagiar+V.ele.ACC.3.F.PL+COND+2+SG
apanagiá-las-íeis	apanagiar+V.ele.ACC.3.F.PL+COND+2+PL
apanagia-lhe	apanagiar+V.ele.DAT.3.SG+PRS+3+SG
apanagia-lhes	apanagiar+V.ele.DAT.3.PL+PRS+3+SG
apanagiá-lo-á	apanagiar+V.ele.ACC.3.M.SG+FUT+3+SG
