aparreirar-te	aparreirar+V.tu.AD.2.SG+INF
aparreirar-te	aparreirar+V.tu.AD.2.SG+INF+1+SG
aparreirar-te	aparreirar+V.tu.AD.2.SG+INF+3+SG
aparreirar-te	aparreirar+V.tu.AD.2.SG+SBJF+1+SG
aparreirar-te	aparreirar+V.tu.AD.2.SG+SBJF+3+SG
aparreirar-te-ás	aparreirar+V.tu.AD.2.SG+FUT+2+SG
aparreirar-te-ei	aparreirar+V.tu.AD.2.SG+FUT+1+SG
aparreirar-te-eis	aparreirar+V.tu.AD.2.SG+FUT+2+PL
aparreirar-te-emos	aparreirar+V.tu.AD.2.SG+FUT+1+PL
aparreirar-te-ia	aparreirar+V.tu.AD.2.SG+COND+1+SG
aparreirar-te-ia	aparreirar+V.tu.AD.2.SG+COND+3+SG
aparreirar-te-iam	aparreirar+V.tu.AD.2.SG+COND+3+PL
aparreirar-te-íamos	aparreirar+V.tu.AD.2.SG+COND+1+PL
aparreirar-te-ias	aparreirar+V.tu.AD.2.SG+COND+2+SG
aparreirar-te-íeis	aparreirar+V.tu.AD.2.SG+COND+2+PL
aparreirar-vos-á	aparreirar+V.vós.AD.2.PL+FUT+3+SG
aparreirar-vos-ão	aparreirar+V.vós.AD.2.PL+FUT+3+PL
aparreirar-vos	aparreirar+V.vós.AD.2.PL+INF
aparreirar-vos	aparreirar+V.vós.AD.2.PL+INF+1+SG
aparreirar-vos	aparreirar+V.vós.AD.2.PL+INF+3+SG
aparreirar-vos	aparreirar+V.vós.AD.2.PL+SBJF+1+SG
aparreirar-vos	aparreirar+V.vós.AD.2.PL+SBJF+3+SG
aparreirar-vos-ás	aparreirar+V.vós.AD.2.PL+FUT+2+SG
aparreirar-vos-ei	aparreirar+V.vós.AD.2.PL+FUT+1+SG
aparreirar-vos-eis	aparreirar+V.vós.AD.2.PL+FUT+2+PL
aparreirar-vos-emos	aparreirar+V.vós.AD.2.PL+FUT+1+PL
aparreirar-vos-ia	aparreirar+V.vós.AD.2.PL+COND+1+SG
aparreirar-vos-ia	aparreirar+V.vós.AD.2.PL+COND+3+SG
aparreirar-vos-iam	aparreirar+V.vós.AD.2.PL+COND+3+PL
aparreirar-vos-íamos	aparreirar+V.vós.AD.2.PL+COND+1+PL
aparreirar-vos-ias	aparreirar+V.vós.AD.2.PL+COND+2+SG
aparreirar-vos-íeis	aparreirar+V.vós.AD.2.PL+COND+2+PL
aparreira-se	aparreirar+V.ele.REFL+PRS+3+SG
aparreiras-lhe	aparreirar+V.ele.DAT.3.SG+PRS+2+SG
aparreiras-lhes	aparreirar+V.ele.DAT.3.PL+PRS+2+SG
aparreiras-me	aparreirar+V.eu.AD.1.SG+PRS+2+SG
aparreiraste-a	aparreirar+V.ele.ACC.3.F.SG+PRF+2+SG
aparreiras-te	aparreirar+V.tu.AD.2.SG+PRS+2+SG
aparreiraste-as	aparreirar+V.ele.ACC.3.F.PL+PRF+2+SG
aparreiraste-la	aparreirar+V.ele.ACC.3.F.SG+PRF+2+PL
aparreiraste-las	aparreirar+V.ele.ACC.3.F.PL+PRF+2+PL
aparreiraste-lhe	aparreirar+V.ele.DAT.3.SG+PRF+2+SG
aparreiraste-lhes	aparreirar+V.ele.DAT.3.PL+PRF+2+SG
aparreiraste-lo	aparreirar+V.ele.ACC.3.M.SG+PRF+2+PL
aparreiraste-los	aparreirar+V.ele.ACC.3.M.PL+PRF+2+PL
aparreiraste-me	aparreirar+V.eu.AD.1.SG+PRF+2+SG
aparreiraste-nos	aparreirar+nós.AD.1.PL+PRF+2+PL
aparreiraste-nos	aparreirar+nós.AD.1.PL+PRF+2+SG
aparreiraste-o	aparreirar+V.ele.ACC.3.M.SG+PRF+2+SG
aparreiraste-os	aparreirar+V.ele.ACC.3.M.PL+PRF+2+SG
aparreirastes-lhe	aparreirar+V.ele.DAT.3.SG+PRF+2+PL
aparreirastes-lhes	aparreirar+V.ele.DAT.3.PL+PRF+2+PL
aparreirastes-me	aparreirar+V.eu.AD.1.SG+PRF+2+PL
aparreirastes-te	aparreirar+V.tu.AD.2.SG+PRF+2+PL
aparreirastes-vos	aparreirar+V.vós.AD.2.PL+PRF+2+PL
aparreiraste-te	aparreirar+V.tu.AD.2.SG+PRF+2+SG
aparreiraste-vos	aparreirar+V.vós.AD.2.PL+PRF+2+SG
aparreiras-vos	aparreirar+V.vós.AD.2.PL+PRS+2+SG
aparreira-te	aparreirar+V.tu.AD.2.SG+PRS+3+SG
aparreirava-a	aparreirar+V.ele.ACC.3.F.SG+IMPF+1+SG
aparreirava-a	aparreirar+V.ele.ACC.3.F.SG+IMPF+3+SG
aparreirava-as	aparreirar+V.ele.ACC.3.F.PL+IMPF+1+SG
aparreirava-as	aparreirar+V.ele.ACC.3.F.PL+IMPF+3+SG
aparreirava-la	aparreirar+V.ele.ACC.3.F.SG+IMPF+2+SG
aparreirava-las	aparreirar+V.ele.ACC.3.F.PL+IMPF+2+SG
aparreirava-lhe	aparreirar+V.ele.DAT.3.SG+IMPF+1+SG
aparreirava-lhe	aparreirar+V.ele.DAT.3.SG+IMPF+3+SG
aparreirava-lhes	aparreirar+V.ele.DAT.3.PL+IMPF+1+SG
aparreirava-lhes	aparreirar+V.ele.DAT.3.PL+IMPF+3+SG
aparreirava-lo	aparreirar+V.ele.ACC.3.M.SG+IMPF+2+SG
aparreirava-los	aparreirar+V.ele.ACC.3.M.PL+IMPF+2+SG
aparreirava-me	aparreirar+V.eu.AD.1.SG+IMPF+1+SG
aparreirava-me	aparreirar+V.eu.AD.1.SG+IMPF+3+SG
aparreiravam-lhe	aparreirar+V.ele.DAT.3.SG+IMPF+3+PL
aparreiravam-lhes	aparreirar+V.ele.DAT.3.PL+IMPF+3+PL
aparreiravam-me	aparreirar+V.eu.AD.1.SG+IMPF+3+PL
aparreiravam-na	aparreirar+V.ele.ACC.3.F.SG+IMPF+3+PL
aparreiravam-nas	aparreirar+V.ele.ACC.3.F.PL+IMPF+3+PL
aparreiravam-no	aparreirar+V.ele.ACC.3.M.SG+IMPF+3+PL
aparreiravam-nos	aparreirar+V.ele.ACC.3.M.PL+IMPF+3+PL
aparreiravam-nos	aparreirar+V.nós.AD.1.PL+IMPF+3+PL
aparreirávamo-la	aparreirar+V.ele.ACC.3.F.SG+IMPF+1+PL
aparreirávamo-las	aparreirar+V.ele.ACC.3.F.PL+IMPF+1+PL
aparreirávamo-lo	aparreirar+V.ele.ACC.3.M.SG+IMPF+1+PL
aparreirávamo-los	aparreirar+V.ele.ACC.3.M.PL+IMPF+1+PL
aparreirávamo-nos	aparreirar+nós.AD.1.PL+IMPF+1+PL
aparreirávamos-lhe	aparreirar+V.ele.DAT.3.SG+IMPF+1+PL
aparreirávamos-lhes	aparreirar+V.ele.DAT.3.PL+IMPF+1+PL
aparreirávamos-me	aparreirar+V.eu.AD.1.SG+IMPF+1+PL
aparreirávamos-te	aparreirar+V.tu.AD.2.SG+IMPF+1+PL
aparreirávamos-vos	aparreirar+V.vós.AD.2.PL+IMPF+1+PL
aparreiravam-se	aparreirar+V.ele.REFL+IMPF+3+PL
aparreiravam-te	aparreirar+V.tu.AD.2.SG+IMPF+3+PL
aparreiravam-vos	aparreirar+V.vós.AD.2.PL+IMPF+3+PL
aparreirava-nos	aparreirar+nós.AD.1.PL+IMPF+1+SG
aparreirava-nos	aparreirar+nós.AD.1.PL+IMPF+2+SG
aparreirava-nos	aparreirar+nós.AD.1.PL+IMPF+3+SG
aparreirava-o	aparreirar+V.ele.ACC.3.M.SG+IMPF+1+SG
aparreirava-o	aparreirar+V.ele.ACC.3.M.SG+IMPF+3+SG
aparreirava-os	aparreirar+V.ele.ACC.3.M.PL+IMPF+1+SG
aparreirava-os	aparreirar+V.ele.ACC.3.M.PL+IMPF+3+SG
aparreirava-se	aparreirar+V.ele.REFL+IMPF+1+SG
aparreirava-se	aparreirar+V.ele.REFL+IMPF+3+SG
aparreiravas-lhe	aparreirar+V.ele.DAT.3.SG+IMPF+2+SG
aparreiravas-lhes	aparreirar+V.ele.DAT.3.PL+IMPF+2+SG
aparreiravas-me	aparreirar+V.eu.AD.1.SG+IMPF+2+SG
aparreiravas-te	aparreirar+V.tu.AD.2.SG+IMPF+2+SG
aparreiravas-vos	aparreirar+V.vós.AD.2.PL+IMPF+2+SG
aparreirava-te	aparreirar+V.tu.AD.2.SG+IMPF+1+SG
aparreirava-te	aparreirar+V.tu.AD.2.SG+IMPF+3+SG
aparreirava-vos	aparreirar+V.vós.AD.2.PL+IMPF+1+SG
aparreirava-vos	aparreirar+V.vós.AD.2.PL+IMPF+3+SG
aparreirávei-la	aparreirar+V.ele.ACC.3.F.SG+IMPF+2+PL
aparreirávei-las	aparreirar+V.ele.ACC.3.F.PL+IMPF+2+PL
aparreirávei-lo	aparreirar+V.ele.ACC.3.M.SG+IMPF+2+PL
aparreirávei-los	aparreirar+V.ele.ACC.3.M.PL+IMPF+2+PL
aparreirávei-nos	aparreirar+nós.AD.1.PL+IMPF+2+PL
aparreiráveis-lhe	aparreirar+V.ele.DAT.3.SG+IMPF+2+PL
aparreiráveis-lhes	aparreirar+V.ele.DAT.3.PL+IMPF+2+PL
aparreiráveis-me	aparreirar+V.eu.AD.1.SG+IMPF+2+PL
aparreiráveis-te	aparreirar+V.tu.AD.2.SG+IMPF+2+PL
aparreiráveis-vos	aparreirar+V.vós.AD.2.PL+IMPF+2+PL
aparreira-vos	aparreirar+V.vós.AD.2.PL+PRS+3+SG
aparreire-a	aparreirar+V.ele.ACC.3.F.SG+IMP+3+SG
aparreire-as	aparreirar+V.ele.ACC.3.F.PL+IMP+3+SG
aparreirei-a	aparreirar+V.ele.ACC.3.F.SG+PRF+1+SG
aparreirei-as	aparreirar+V.ele.ACC.3.F.PL+PRF+1+SG
aparreirei-lhe	aparreirar+V.ele.DAT.3.SG+PRF+1+SG
aparreirei-lhes	aparreirar+V.ele.DAT.3.PL+PRF+1+SG
aparreirei-me	aparreirar+V.eu.AD.1.SG+PRF+1+SG
aparreirei-nos	aparreirar+nós.AD.1.PL+PRF+1+SG
aparreirei-o	aparreirar+V.ele.ACC.3.M.SG+PRF+1+SG
aparreirei-os	aparreirar+V.ele.ACC.3.M.PL+PRF+1+SG
aparreirei-te	aparreirar+V.tu.AD.2.SG+PRF+1+SG
aparreirei-vos	aparreirar+V.vós.AD.2.PL+PRF+1+SG
aparreire-lhe	aparreirar+V.ele.DAT.3.SG+IMP+3+SG
aparreire-lhes	aparreirar+V.ele.DAT.3.PL+IMP+3+SG
aparreire-me	aparreirar+V.eu.AD.1.SG+IMP+3+SG
aparreirem-lhe	aparreirar+V.ele.DAT.3.SG+IMP+3+PL
aparreirem-lhes	aparreirar+V.ele.DAT.3.PL+IMP+3+PL
aparreirem-me	aparreirar+V.eu.AD.1.SG+IMP+3+PL
aparreirem-na	aparreirar+V.ele.ACC.3.F.SG+IMP+3+PL
aparreirem-nas	aparreirar+V.ele.ACC.3.F.PL+IMP+3+PL
aparreirem-no	aparreirar+V.ele.ACC.3.M.SG+IMP+3+PL
aparreirem-nos	aparreirar+V.ele.ACC.3.M.PL+IMP+3+PL
aparreirem-nos	aparreirar+V.nós.AD.1.PL+IMP+3+PL
aparreiremo-la	aparreirar+V.ele.ACC.3.F.SG+IMP+1+PL
aparreiremo-las	aparreirar+V.ele.ACC.3.F.PL+IMP+1+PL
aparreiremo-lo	aparreirar+V.ele.ACC.3.M.SG+IMP+1+PL
aparreiremo-los	aparreirar+V.ele.ACC.3.M.PL+IMP+1+PL
aparreiremo-nos	aparreirar+nós.AD.1.PL+IMP+1+PL
aparreiremos-lhe	aparreirar+V.ele.DAT.3.SG+IMP+1+PL
aparreiremos-lhes	aparreirar+V.ele.DAT.3.PL+IMP+1+PL
aparreiremos-me	aparreirar+V.eu.AD.1.SG+IMP+1+PL
aparreiremos-te	aparreirar+V.tu.AD.2.SG+IMP+1+PL
aparreiremos-vos	aparreirar+V.vós.AD.2.PL+IMP+1+PL
aparreirem-se	aparreirar+V.ele.REFL+IMP+3+PL
aparreirem-te	aparreirar+V.tu.AD.2.SG+IMP+3+PL
aparreirem-vos	aparreirar+V.vós.AD.2.PL+IMP+3+PL
aparreire-nos	aparreirar+nós.AD.1.PL+IMP+3+SG
aparreire-o	aparreirar+V.ele.ACC.3.M.SG+IMP+3+SG
aparreire-os	aparreirar+V.ele.ACC.3.M.PL+IMP+3+SG
aparreire-se	aparreirar+V.ele.REFL+IMP+3+SG
aparreire-te	aparreirar+V.tu.AD.2.SG+IMP+3+SG
aparreire-vos	aparreirar+V.vós.AD.2.PL+IMP+3+SG
aparreiro-a	aparreirar+V.ele.ACC.3.F.SG+PRS+1+SG
aparreiro-as	aparreirar+V.ele.ACC.3.F.PL+PRS+1+SG
aparreiro-lhe	aparreirar+V.ele.DAT.3.SG+PRS+1+SG
aparreiro-lhes	aparreirar+V.ele.DAT.3.PL+PRS+1+SG
aparreiro-me	aparreirar+V.eu.AD.1.SG+PRS+1+SG
aparreiro-nos	aparreirar+nós.AD.1.PL+PRS+1+SG
aparreiro-o	aparreirar+V.ele.ACC.3.M.SG+PRS+1+SG
aparreiro-os	aparreirar+V.ele.ACC.3.M.PL+PRS+1+SG
aparreiro-te	aparreirar+V.tu.AD.2.SG+PRS+1+SG
aparreirou-a	aparreirar+V.ele.ACC.3.F.SG+PRF+3+SG
aparreirou-as	aparreirar+V.ele.ACC.3.F.PL+PRF+3+SG
aparreirou-lhe	aparreirar+V.ele.DAT.3.SG+PRF+3+SG
aparreirou-lhes	aparreirar+V.ele.DAT.3.PL+PRF+3+SG
aparreirou-me	aparreirar+V.eu.AD.1.SG+PRF+3+SG
aparreirou-nos	aparreirar+nós.AD.1.PL+PRF+3+SG
aparreirou-o	aparreirar+V.ele.ACC.3.M.SG+PRF+3+SG
aparreirou-os	aparreirar+V.ele.ACC.3.M.PL+PRF+3+SG
aparreirou-se	aparreirar+V.ele.REFL+PRF+3+SG
aparreirou-te	aparreirar+V.tu.AD.2.SG+PRF+3+SG
aparreirou-vos	aparreirar+V.vós.AD.2.PL+PRF+3+SG
aparreiro-vos	aparreirar+V.vós.AD.2.PL+PRS+1+SG
aparrei-te	aparrar+V.tu.AD.2.SG+PRF+1+SG
aparrei-vos	aparrar+V.vós.AD.2.PL+PRF+1+SG
aparre-lhe	aparrar+V.ele.DAT.3.SG+IMP+3+SG
aparre-lhes	aparrar+V.ele.DAT.3.PL+IMP+3+SG
aparre-me	aparrar+V.eu.AD.1.SG+IMP+3+SG
aparrem-lhe	aparrar+V.ele.DAT.3.SG+IMP+3+PL
aparrem-lhes	aparrar+V.ele.DAT.3.PL+IMP+3+PL
aparrem-me	aparrar+V.eu.AD.1.SG+IMP+3+PL
aparrem-na	aparrar+V.ele.ACC.3.F.SG+IMP+3+PL
aparrem-nas	aparrar+V.ele.ACC.3.F.PL+IMP+3+PL
aparrem-no	aparrar+V.ele.ACC.3.M.SG+IMP+3+PL
aparrem-nos	aparrar+V.ele.ACC.3.M.PL+IMP+3+PL
aparrem-nos	aparrar+V.nós.AD.1.PL+IMP+3+PL
aparremo-la	aparrar+V.ele.ACC.3.F.SG+IMP+1+PL
aparremo-las	aparrar+V.ele.ACC.3.F.PL+IMP+1+PL
aparremo-lo	aparrar+V.ele.ACC.3.M.SG+IMP+1+PL
aparremo-los	aparrar+V.ele.ACC.3.M.PL+IMP+1+PL
aparremo-nos	aparrar+nós.AD.1.PL+IMP+1+PL
aparremos-lhe	aparrar+V.ele.DAT.3.SG+IMP+1+PL
aparremos-lhes	aparrar+V.ele.DAT.3.PL+IMP+1+PL
aparremos-me	aparrar+V.eu.AD.1.SG+IMP+1+PL
aparremos-te	aparrar+V.tu.AD.2.SG+IMP+1+PL
aparremos-vos	aparrar+V.vós.AD.2.PL+IMP+1+PL
aparrem-se	aparrar+V.ele.REFL+IMP+3+PL
aparrem-te	aparrar+V.tu.AD.2.SG+IMP+3+PL
aparrem-vos	aparrar+V.vós.AD.2.PL+IMP+3+PL
aparre-nos	aparrar+nós.AD.1.PL+IMP+3+SG
aparre-o	aparrar+V.ele.ACC.3.M.SG+IMP+3+SG
aparre-os	aparrar+V.ele.ACC.3.M.PL+IMP+3+SG
aparre-se	aparrar+V.ele.REFL+IMP+3+SG
aparre-te	aparrar+V.tu.AD.2.SG+IMP+3+SG
aparre-vos	aparrar+V.vós.AD.2.PL+IMP+3+SG
aparro-a	aparrar+V.ele.ACC.3.F.SG+PRS+1+SG
aparro-as	aparrar+V.ele.ACC.3.F.PL+PRS+1+SG
aparro-lhe	aparrar+V.ele.DAT.3.SG+PRS+1+SG
aparro-lhes	aparrar+V.ele.DAT.3.PL+PRS+1+SG
aparro-me	aparrar+V.eu.AD.1.SG+PRS+1+SG
aparro-nos	aparrar+nós.AD.1.PL+PRS+1+SG
aparro-o	aparrar+V.ele.ACC.3.M.SG+PRS+1+SG
aparro-os	aparrar+V.ele.ACC.3.M.PL+PRS+1+SG
aparro-te	aparrar+V.tu.AD.2.SG+PRS+1+SG
aparrou-a	aparrar+V.ele.ACC.3.F.SG+PRF+3+SG
aparrou-as	aparrar+V.ele.ACC.3.F.PL+PRF+3+SG
aparrou-lhe	aparrar+V.ele.DAT.3.SG+PRF+3+SG
aparrou-lhes	aparrar+V.ele.DAT.3.PL+PRF+3+SG
aparrou-me	aparrar+V.eu.AD.1.SG+PRF+3+SG
aparrou-nos	aparrar+nós.AD.1.PL+PRF+3+SG
aparrou-o	aparrar+V.ele.ACC.3.M.SG+PRF+3+SG
aparrou-os	aparrar+V.ele.ACC.3.M.PL+PRF+3+SG
aparrou-se	aparrar+V.ele.REFL+PRF+3+SG
aparrou-te	aparrar+V.tu.AD.2.SG+PRF+3+SG
aparrou-vos	aparrar+V.vós.AD.2.PL+PRF+3+SG
aparro-vos	aparrar+V.vós.AD.2.PL+PRS+1+SG
aparta-a	apartar+V.ele.ACC.3.F.SG+PRS+3+SG
aparta-as	apartar+V.ele.ACC.3.F.PL+PRS+3+SG
apartai-la	apartar+V.ele.ACC.3.F.SG+PRS+2+PL
apartai-las	apartar+V.ele.ACC.3.F.PL+PRS+2+PL
apartai-lo	apartar+V.ele.ACC.3.M.SG+PRS+2+PL
apartai-los	apartar+V.ele.ACC.3.M.PL+PRS+2+PL
apartai-nos	apartar+nós.AD.1.PL+PRS+2+PL
apartais-lhe	apartar+V.ele.DAT.3.SG+PRS+2+PL
apartais-lhes	apartar+V.ele.DAT.3.PL+PRS+2+PL
apartais-me	apartar+V.eu.AD.1.SG+PRS+2+PL
apartais-te	apartar+V.tu.AD.2.SG+PRS+2+PL
apartais-vos	apartar+V.vós.AD.2.PL+PRS+2+PL
apartá-la-á	apartar+V.ele.ACC.3.F.SG+FUT+3+SG
apartá-la-ão	apartar+V.ele.ACC.3.F.SG+FUT+3+PL
apartá-la	apartar+V.ele.ACC.3.F.SG+INF+1+SG
apartá-la	apartar+V.ele.ACC.3.F.SG+INF+3+SG
aparta-la	apartar+V.ele.ACC.3.F.SG+PRS+2+SG
apartá-la	apartar+V.ele.ACC.3.F.SG+SBJF+1+SG
apartá-la	apartar+V.ele.ACC.3.F.SG+SBJF+3+SG
apartá-la-ás	apartar+V.ele.ACC.3.F.SG+FUT+2+SG
apartá-la-ei	apartar+V.ele.ACC.3.F.SG+FUT+1+SG
apartá-la-eis	apartar+V.ele.ACC.3.F.SG+FUT+2+PL
apartá-la-emos	apartar+V.ele.ACC.3.F.SG+FUT+1+PL
apartá-la-ia	apartar+V.ele.ACC.3.F.SG+COND+1+SG
apartá-la-ia	apartar+V.ele.ACC.3.F.SG+COND+3+SG
apartá-la-iam	apartar+V.ele.ACC.3.F.SG+COND+3+PL
apartá-la-íamos	apartar+V.ele.ACC.3.F.SG+COND+1+PL
apartá-la-ias	apartar+V.ele.ACC.3.F.SG+COND+2+SG
apartá-la-íeis	apartar+V.ele.ACC.3.F.SG+COND+2+PL
apartá-las-á	apartar+V.ele.ACC.3.F.PL+FUT+3+SG
apartá-las-ão	apartar+V.ele.ACC.3.F.PL+FUT+3+PL
apartá-las	apartar+V.ele.ACC.3.F.PL+INF+1+SG
apartá-las	apartar+V.ele.ACC.3.F.PL+INF+3+SG
aparta-las	apartar+V.ele.ACC.3.F.PL+PRS+2+SG
apartá-las	apartar+V.ele.ACC.3.F.PL+SBJF+1+SG
apartá-las	apartar+V.ele.ACC.3.F.PL+SBJF+3+SG
apartá-las-ás	apartar+V.ele.ACC.3.F.PL+FUT+2+SG
apartá-las-ei	apartar+V.ele.ACC.3.F.PL+FUT+1+SG
apartá-las-eis	apartar+V.ele.ACC.3.F.PL+FUT+2+PL
apartá-las-emos	apartar+V.ele.ACC.3.F.PL+FUT+1+PL
apartá-las-ia	apartar+V.ele.ACC.3.F.PL+COND+1+SG
apartá-las-ia	apartar+V.ele.ACC.3.F.PL+COND+3+SG
apartá-las-iam	apartar+V.ele.ACC.3.F.PL+COND+3+PL
apartá-las-íamos	apartar+V.ele.ACC.3.F.PL+COND+1+PL
apartá-las-ias	apartar+V.ele.ACC.3.F.PL+COND+2+SG
apartá-las-íeis	apartar+V.ele.ACC.3.F.PL+COND+2+PL
aparta-lhe	apartar+V.ele.DAT.3.SG+PRS+3+SG
aparta-lhes	apartar+V.ele.DAT.3.PL+PRS+3+SG
apartá-lo-á	apartar+V.ele.ACC.3.M.SG+FUT+3+SG
apartá-lo-ão	apartar+V.ele.ACC.3.M.SG+FUT+3+PL
apartá-lo	apartar+V.ele.ACC.3.M.SG+INF+1+SG
apartá-lo	apartar+V.ele.ACC.3.M.SG+INF+3+SG
aparta-lo	apartar+V.ele.ACC.3.M.SG+PRS+2+SG
apartá-lo	apartar+V.ele.ACC.3.M.SG+SBJF+1+SG
apartá-lo	apartar+V.ele.ACC.3.M.SG+SBJF+3+SG
apartá-lo-ás	apartar+V.ele.ACC.3.M.SG+FUT+2+SG
apartá-lo-ei	apartar+V.ele.ACC.3.M.SG+FUT+1+SG
apartá-lo-eis	apartar+V.ele.ACC.3.M.SG+FUT+2+PL
apartá-lo-emos	apartar+V.ele.ACC.3.M.SG+FUT+1+PL
apartá-lo-ia	apartar+V.ele.ACC.3.M.SG+COND+1+SG
apartá-lo-ia	apartar+V.ele.ACC.3.M.SG+COND+3+SG
apartá-lo-iam	apartar+V.ele.ACC.3.M.SG+COND+3+PL
apartá-lo-íamos	apartar+V.ele.ACC.3.M.SG+COND+1+PL
apartá-lo-ias	apartar+V.ele.ACC.3.M.SG+COND+2+SG
apartá-lo-íeis	apartar+V.ele.ACC.3.M.SG+COND+2+PL
apartá-los-á	apartar+V.ele.ACC.3.M.PL+FUT+3+SG
apartá-los-ão	apartar+V.ele.ACC.3.M.PL+FUT+3+PL
apartá-los	apartar+V.ele.ACC.3.M.PL+INF+1+SG
apartá-los	apartar+V.ele.ACC.3.M.PL+INF+3+SG
aparta-los	apartar+V.ele.ACC.3.M.PL+PRS+2+SG
apartá-los	apartar+V.ele.ACC.3.M.PL+SBJF+1+SG
apartá-los	apartar+V.ele.ACC.3.M.PL+SBJF+3+SG
apartá-los-ás	apartar+V.ele.ACC.3.M.PL+FUT+2+SG
apartá-los-ei	apartar+V.ele.ACC.3.M.PL+FUT+1+SG
apartá-los-eis	apartar+V.ele.ACC.3.M.PL+FUT+2+PL
apartá-los-emos	apartar+V.ele.ACC.3.M.PL+FUT+1+PL
apartá-los-ia	apartar+V.ele.ACC.3.M.PL+COND+1+SG
apartá-los-ia	apartar+V.ele.ACC.3.M.PL+COND+3+SG
apartá-los-iam	apartar+V.ele.ACC.3.M.PL+COND+3+PL
apartá-los-íamos	apartar+V.ele.ACC.3.M.PL+COND+1+PL
apartá-los-ias	apartar+V.ele.ACC.3.M.PL+COND+2+SG
apartá-los-íeis	apartar+V.ele.ACC.3.M.PL+COND+2+PL
aparta-me	apartar+V.eu.AD.1.SG+PRS+3+SG
apartam-lhe	apartar+V.ele.DAT.3.SG+PRS+3+PL
apartam-lhes	apartar+V.ele.DAT.3.PL+PRS+3+PL
apartam-me	apartar+V.eu.AD.1.SG+PRS+3+PL
apartam-na	apartar+V.ele.ACC.3.F.SG+PRS+3+PL
apartam-nas	apartar+V.ele.ACC.3.F.PL+PRS+3+PL
apartam-no	apartar+V.ele.ACC.3.M.SG+PRS+3+PL
apartam-nos	apartar+V.ele.ACC.3.M.PL+PRS+3+PL
apartam-nos	apartar+V.nós.AD.1.PL+PRS+3+PL
apartamo-la	apartar+V.ele.ACC.3.F.SG+PRF+1+PL
apartamo-la	apartar+V.ele.ACC.3.F.SG+PRS+1+PL
apartamo-las	apartar+V.ele.ACC.3.F.PL+PRF+1+PL
apartamo-las	apartar+V.ele.ACC.3.F.PL+PRS+1+PL
apartamo-lo	apartar+V.ele.ACC.3.M.SG+PRF+1+PL
apartamo-lo	apartar+V.ele.ACC.3.M.SG+PRS+1+PL
apartamo-los	apartar+V.ele.ACC.3.M.PL+PRF+1+PL
apartamo-los	apartar+V.ele.ACC.3.M.PL+PRS+1+PL
apartamo-nos	apartar+nós.AD.1.PL+PRF+1+PL
apartamo-nos	apartar+nós.AD.1.PL+PRS+1+PL
apartamos-lhe	apartar+V.ele.DAT.3.SG+PRF+1+PL
apartamos-lhe	apartar+V.ele.DAT.3.SG+PRS+1+PL
apartamos-lhes	apartar+V.ele.DAT.3.PL+PRF+1+PL
apartamos-lhes	apartar+V.ele.DAT.3.PL+PRS+1+PL
apartamos-me	apartar+V.eu.AD.1.SG+PRF+1+PL
apartamos-me	apartar+V.eu.AD.1.SG+PRS+1+PL
apartamos-te	apartar+V.tu.AD.2.SG+PRF+1+PL
apartamos-te	apartar+V.tu.AD.2.SG+PRS+1+PL
apartamos-vos	apartar+V.vós.AD.2.PL+PRF+1+PL
apartamos-vos	apartar+V.vós.AD.2.PL+PRS+1+PL
apartam-se	apartar+V.ele.REFL+PRS+3+PL
apartam-te	apartar+V.tu.AD.2.SG+PRS+3+PL
apartam-vos	apartar+V.vós.AD.2.PL+PRS+3+PL
apartando-a	apartar+V.ele.ACC.3.F.SG+GRD
apartando-as	apartar+V.ele.ACC.3.F.PL+GRD
apartando-lhe	apartar+V.ele.DAT.3.SG+GRD
apartando-lhes	apartar+V.ele.DAT.3.PL+GRD
apartando-me	apartar+V.eu.AD.1.SG+GRD
apartando-nos	apartar+nós.AD.1.PL+GRD
apartando-o	apartar+V.ele.ACC.3.M.SG+GRD
apartando-os	apartar+V.ele.ACC.3.M.PL+GRD
apartando-se	apartar+V.ele.REFL+GRD
apartando-te	apartar+V.tu.AD.2.SG+GRD
apartando-vos	apartar+V.vós.AD.2.PL+GRD
aparta-nos	apartar+nós.AD.1.PL+PRS+2+SG
aparta-nos	apartar+nós.AD.1.PL+PRS+3+SG
aparta-o	apartar+V.ele.ACC.3.M.SG+PRS+3+SG
aparta-os	apartar+V.ele.ACC.3.M.PL+PRS+3+SG
apartara-a	apartar+V.ele.ACC.3.F.SG+PQP+1+SG
apartara-a	apartar+V.ele.ACC.3.F.SG+PQP+3+SG
apartara-as	apartar+V.ele.ACC.3.F.PL+PQP+1+SG
apartara-as	apartar+V.ele.ACC.3.F.PL+PQP+3+SG
apartara-la	apartar+V.ele.ACC.3.F.SG+PQP+2+SG
apartara-las	apartar+V.ele.ACC.3.F.PL+PQP+2+SG
apartara-lhe	apartar+V.ele.DAT.3.SG+PQP+1+SG
apartara-lhe	apartar+V.ele.DAT.3.SG+PQP+3+SG
apartara-lhes	apartar+V.ele.DAT.3.PL+PQP+1+SG
apartara-lhes	apartar+V.ele.DAT.3.PL+PQP+3+SG
apartara-lo	apartar+V.ele.ACC.3.M.SG+PQP+2+SG
apartara-los	apartar+V.ele.ACC.3.M.PL+PQP+2+SG
apartara-me	apartar+V.eu.AD.1.SG+PQP+1+SG
apartara-me	apartar+V.eu.AD.1.SG+PQP+3+SG
apartaram-lhe	apartar+V.ele.DAT.3.SG+PQP+3+PL
apartaram-lhe	apartar+V.ele.DAT.3.SG+PRF+3+PL
apartaram-lhes	apartar+V.ele.DAT.3.PL+PQP+3+PL
apartaram-lhes	apartar+V.ele.DAT.3.PL+PRF+3+PL
apartaram-me	apartar+V.eu.AD.1.SG+PQP+3+PL
apartaram-me	apartar+V.eu.AD.1.SG+PRF+3+PL
apartaram-na	apartar+V.ele.ACC.3.F.SG+PQP+3+PL
apartaram-na	apartar+V.ele.ACC.3.F.SG+PRF+3+PL
apartaram-nas	apartar+V.ele.ACC.3.F.PL+PQP+3+PL
apartaram-nas	apartar+V.ele.ACC.3.F.PL+PRF+3+PL
apartaram-no	apartar+V.ele.ACC.3.M.SG+PQP+3+PL
apartaram-no	apartar+V.ele.ACC.3.M.SG+PRF+3+PL
apartaram-nos	apartar+V.ele.ACC.3.M.PL+PQP+3+PL
apartaram-nos	apartar+V.ele.ACC.3.M.PL+PRF+3+PL
apartaram-nos	apartar+V.nós.AD.1.PL+PQP+3+PL
apartaram-nos	apartar+V.nós.AD.1.PL+PRF+3+PL
apartáramo-la	apartar+V.ele.ACC.3.F.SG+PQP+1+PL
apartáramo-las	apartar+V.ele.ACC.3.F.PL+PQP+1+PL
apartáramo-lo	apartar+V.ele.ACC.3.M.SG+PQP+1+PL
apartáramo-los	apartar+V.ele.ACC.3.M.PL+PQP+1+PL
apartáramo-nos	apartar+nós.AD.1.PL+PQP+1+PL
apartáramos-lhe	apartar+V.ele.DAT.3.SG+PQP+1+PL
apartáramos-lhes	apartar+V.ele.DAT.3.PL+PQP+1+PL
apartáramos-me	apartar+V.eu.AD.1.SG+PQP+1+PL
apartáramos-te	apartar+V.tu.AD.2.SG+PQP+1+PL
apartáramos-vos	apartar+V.vós.AD.2.PL+PQP+1+PL
apartaram-se	apartar+V.ele.REFL+PQP+3+PL
apartaram-se	apartar+V.ele.REFL+PRF+3+PL
apartaram-te	apartar+V.tu.AD.2.SG+PQP+3+PL
apartaram-te	apartar+V.tu.AD.2.SG+PRF+3+PL
apartaram-vos	apartar+V.vós.AD.2.PL+PQP+3+PL
apartaram-vos	apartar+V.vós.AD.2.PL+PRF+3+PL
apartara-nos	apartar+nós.AD.1.PL+PQP+1+SG
apartara-nos	apartar+nós.AD.1.PL+PQP+2+SG
apartara-nos	apartar+nós.AD.1.PL+PQP+3+SG
apartara-o	apartar+V.ele.ACC.3.M.SG+PQP+1+SG
apartara-o	apartar+V.ele.ACC.3.M.SG+PQP+3+SG
apartara-os	apartar+V.ele.ACC.3.M.PL+PQP+1+SG
apartara-os	apartar+V.ele.ACC.3.M.PL+PQP+3+SG
apartara-se	apartar+V.ele.REFL+PQP+1+SG
apartara-se	apartar+V.ele.REFL+PQP+3+SG
apartaras-lhe	apartar+V.ele.DAT.3.SG+PQP+2+SG
apartaras-lhes	apartar+V.ele.DAT.3.PL+PQP+2+SG
apartaras-me	apartar+V.eu.AD.1.SG+PQP+2+SG
apartaras-te	apartar+V.tu.AD.2.SG+PQP+2+SG
apartaras-vos	apartar+V.vós.AD.2.PL+PQP+2+SG
apartara-te	apartar+V.tu.AD.2.SG+PQP+1+SG
apartara-te	apartar+V.tu.AD.2.SG+PQP+3+SG
apartara-vos	apartar+V.vós.AD.2.PL+PQP+1+SG
apartara-vos	apartar+V.vós.AD.2.PL+PQP+3+SG
apartarde-la	apartar+V.ele.ACC.3.F.SG+INF+2+PL
apartarde-la	apartar+V.ele.ACC.3.F.SG+SBJF+2+PL
apartarde-las	apartar+V.ele.ACC.3.F.PL+INF+2+PL
apartarde-las	apartar+V.ele.ACC.3.F.PL+SBJF+2+PL
apartarde-lo	apartar+V.ele.ACC.3.M.SG+INF+2+PL
apartarde-lo	apartar+V.ele.ACC.3.M.SG+SBJF+2+PL
apartarde-los	apartar+V.ele.ACC.3.M.PL+INF+2+PL
apartarde-los	apartar+V.ele.ACC.3.M.PL+SBJF+2+PL
apartarde-nos	apartar+nós.AD.1.PL+INF+2+PL
apartarde-nos	apartar+nós.AD.1.PL+SBJF+2+PL
apartardes-lhe	apartar+V.ele.DAT.3.SG+INF+2+PL
apartardes-lhe	apartar+V.ele.DAT.3.SG+SBJF+2+PL
apartardes-lhes	apartar+V.ele.DAT.3.PL+INF+2+PL
apartardes-lhes	apartar+V.ele.DAT.3.PL+SBJF+2+PL
apartardes-me	apartar+V.eu.AD.1.SG+INF+2+PL
apartardes-me	apartar+V.eu.AD.1.SG+SBJF+2+PL
apartardes-te	apartar+V.tu.AD.2.SG+INF+2+PL
apartardes-te	apartar+V.tu.AD.2.SG+SBJF+2+PL
apartardes-vos	apartar+V.vós.AD.2.PL+INF+2+PL
apartardes-vos	apartar+V.vós.AD.2.PL+SBJF+2+PL
apartárei-la	apartar+V.ele.ACC.3.F.SG+PQP+2+PL
apartárei-las	apartar+V.ele.ACC.3.F.PL+PQP+2+PL
apartárei-lo	apartar+V.ele.ACC.3.M.SG+PQP+2+PL
apartárei-los	apartar+V.ele.ACC.3.M.PL+PQP+2+PL
apartárei-nos	apartar+nós.AD.1.PL+PQP+2+PL
apartáreis-lhe	apartar+V.ele.DAT.3.SG+PQP+2+PL
apartáreis-lhes	apartar+V.ele.DAT.3.PL+PQP+2+PL
apartáreis-me	apartar+V.eu.AD.1.SG+PQP+2+PL
apartáreis-te	apartar+V.tu.AD.2.SG+PQP+2+PL
apartáreis-vos	apartar+V.vós.AD.2.PL+PQP+2+PL
apartare-la	apartar+V.ele.ACC.3.F.SG+INF+2+SG
apartare-la	apartar+V.ele.ACC.3.F.SG+SBJF+2+SG
apartare-las	apartar+V.ele.ACC.3.F.PL+INF+2+SG
apartare-las	apartar+V.ele.ACC.3.F.PL+SBJF+2+SG
apartare-lo	apartar+V.ele.ACC.3.M.SG+INF+2+SG
apartare-lo	apartar+V.ele.ACC.3.M.SG+SBJF+2+SG
apartare-los	apartar+V.ele.ACC.3.M.PL+INF+2+SG
apartare-los	apartar+V.ele.ACC.3.M.PL+SBJF+2+SG
apartarem-lhe	apartar+V.ele.DAT.3.SG+INF+3+PL
apartarem-lhe	apartar+V.ele.DAT.3.SG+SBJF+3+PL
apartarem-lhes	apartar+V.ele.DAT.3.PL+INF+3+PL
apartarem-lhes	apartar+V.ele.DAT.3.PL+SBJF+3+PL
apartarem-me	apartar+V.eu.AD.1.SG+INF+3+PL
apartarem-me	apartar+V.eu.AD.1.SG+SBJF+3+PL
apartarem-na	apartar+V.ele.ACC.3.F.SG+INF+3+PL
apartarem-na	apartar+V.ele.ACC.3.F.SG+SBJF+3+PL
apartarem-nas	apartar+V.ele.ACC.3.F.PL+INF+3+PL
apartarem-nas	apartar+V.ele.ACC.3.F.PL+SBJF+3+PL
apartarem-no	apartar+V.ele.ACC.3.M.SG+INF+3+PL
apartarem-no	apartar+V.ele.ACC.3.M.SG+SBJF+3+PL
apartarem-nos	apartar+V.ele.ACC.3.M.PL+INF+3+PL
apartarem-nos	apartar+V.ele.ACC.3.M.PL+SBJF+3+PL
apartarem-nos	apartar+V.nós.AD.1.PL+INF+3+PL
apartarem-nos	apartar+V.nós.AD.1.PL+SBJF+3+PL
apartarem-se	apartar+V.ele.REFL+INF+3+PL
apartarem-se	apartar+V.ele.REFL+SBJF+3+PL
apartarem-te	apartar+V.tu.AD.2.SG+INF+3+PL
apartarem-te	apartar+V.tu.AD.2.SG+SBJF+3+PL
apartarem-vos	apartar+V.vós.AD.2.PL+INF+3+PL
apartarem-vos	apartar+V.vós.AD.2.PL+SBJF+3+PL
apartare-nos	apartar+nós.AD.1.PL+INF+2+SG
apartare-nos	apartar+nós.AD.1.PL+SBJF+2+SG
apartares-lhe	apartar+V.ele.DAT.3.SG+INF+2+SG
apartares-lhe	apartar+V.ele.DAT.3.SG+SBJF+2+SG
apartares-lhes	apartar+V.ele.DAT.3.PL+INF+2+SG
apartares-lhes	apartar+V.ele.DAT.3.PL+SBJF+2+SG
apartares-me	apartar+V.eu.AD.1.SG+INF+2+SG
apartares-me	apartar+V.eu.AD.1.SG+SBJF+2+SG
apartares-te	apartar+V.tu.AD.2.SG+INF+2+SG
apartares-te	apartar+V.tu.AD.2.SG+SBJF+2+SG
apartares-vos	apartar+V.vós.AD.2.PL+INF+2+SG
apartares-vos	apartar+V.vós.AD.2.PL+SBJF+2+SG
apartar-lhe-á	apartar+V.ele.DAT.3.SG+FUT+3+SG
apartar-lhe-ão	apartar+V.ele.DAT.3.SG+FUT+3+PL
apartar-lhe	apartar+V.ele.DAT.3.SG+INF
apartar-lhe	apartar+V.ele.DAT.3.SG+INF+1+SG
apartar-lhe	apartar+V.ele.DAT.3.SG+INF+3+SG
apartar-lhe	apartar+V.ele.DAT.3.SG+SBJF+1+SG
apartar-lhe	apartar+V.ele.DAT.3.SG+SBJF+3+SG
apartar-lhe-ás	apartar+V.ele.DAT.3.SG+FUT+2+SG
apartar-lhe-ei	apartar+V.ele.DAT.3.SG+FUT+1+SG
apartar-lhe-eis	apartar+V.ele.DAT.3.SG+FUT+2+PL
apartar-lhe-emos	apartar+V.ele.DAT.3.SG+FUT+1+PL
apartar-lhe-ia	apartar+V.ele.DAT.3.SG+COND+1+SG
apartar-lhe-ia	apartar+V.ele.DAT.3.SG+COND+3+SG
apartar-lhe-iam	apartar+V.ele.DAT.3.SG+COND+3+PL
apartar-lhe-íamos	apartar+V.ele.DAT.3.SG+COND+1+PL
apartar-lhe-ias	apartar+V.ele.DAT.3.SG+COND+2+SG
apartar-lhe-íeis	apartar+V.ele.DAT.3.SG+COND+2+PL
apartar-lhes-á	apartar+V.ele.DAT.3.PL+FUT+3+SG
apartar-lhes-ão	apartar+V.ele.DAT.3.PL+FUT+3+PL
apartar-lhes	apartar+V.ele.DAT.3.PL+INF
apartar-lhes	apartar+V.ele.DAT.3.PL+INF+1+SG
apartar-lhes	apartar+V.ele.DAT.3.PL+INF+3+SG
apartar-lhes	apartar+V.ele.DAT.3.PL+SBJF+1+SG
apartar-lhes	apartar+V.ele.DAT.3.PL+SBJF+3+SG
apartar-lhes-ás	apartar+V.ele.DAT.3.PL+FUT+2+SG
apartar-lhes-ei	apartar+V.ele.DAT.3.PL+FUT+1+SG
apartar-lhes-eis	apartar+V.ele.DAT.3.PL+FUT+2+PL
apartar-lhes-emos	apartar+V.ele.DAT.3.PL+FUT+1+PL
apartar-lhes-ia	apartar+V.ele.DAT.3.PL+COND+1+SG
apartar-lhes-ia	apartar+V.ele.DAT.3.PL+COND+3+SG
apartar-lhes-iam	apartar+V.ele.DAT.3.PL+COND+3+PL
apartar-lhes-íamos	apartar+V.ele.DAT.3.PL+COND+1+PL
apartar-lhes-ias	apartar+V.ele.DAT.3.PL+COND+2+SG
apartar-lhes-íeis	apartar+V.ele.DAT.3.PL+COND+2+PL
apartar-me-á	apartar+V.eu.AD.1.SG+FUT+3+SG
apartar-me-ão	apartar+V.eu.AD.1.SG+FUT+3+PL
apartar-me	apartar+V.eu.AD.1.SG+INF
apartar-me	apartar+V.eu.AD.1.SG+INF+1+SG
apartar-me	apartar+V.eu.AD.1.SG+INF+3+SG
apartar-me	apartar+V.eu.AD.1.SG+SBJF+1+SG
apartar-me	apartar+V.eu.AD.1.SG+SBJF+3+SG
apartar-me-ás	apartar+V.eu.AD.1.SG+FUT+2+SG
apartar-me-ei	apartar+V.eu.AD.1.SG+FUT+1+SG
apartar-me-eis	apartar+V.eu.AD.1.SG+FUT+2+PL
apartar-me-emos	apartar+V.eu.AD.1.SG+FUT+1+PL
apartar-me-ia	apartar+V.eu.AD.1.SG+COND+1+SG
apartar-me-ia	apartar+V.eu.AD.1.SG+COND+3+SG
apartar-me-iam	apartar+V.eu.AD.1.SG+COND+3+PL
apartar-me-íamos	apartar+V.eu.AD.1.SG+COND+1+PL
apartar-me-ias	apartar+V.eu.AD.1.SG+COND+2+SG
apartar-me-íeis	apartar+V.eu.AD.1.SG+COND+2+PL
apartarmo-la	apartar+V.ele.ACC.3.F.SG+INF+1+PL
apartarmo-la	apartar+V.ele.ACC.3.F.SG+SBJF+1+PL
apartarmo-las	apartar+V.ele.ACC.3.F.PL+INF+1+PL
apartarmo-las	apartar+V.ele.ACC.3.F.PL+SBJF+1+PL
apartarmo-lo	apartar+V.ele.ACC.3.M.SG+INF+1+PL
apartarmo-lo	apartar+V.ele.ACC.3.M.SG+SBJF+1+PL
apartarmo-los	apartar+V.ele.ACC.3.M.PL+INF+1+PL
apartarmo-los	apartar+V.ele.ACC.3.M.PL+SBJF+1+PL
apartarmo-nos	apartar+nós.AD.1.PL+INF+1+PL
apartarmo-nos	apartar+nós.AD.1.PL+SBJF+1+PL
apartarmos-lhe	apartar+V.ele.DAT.3.SG+INF+1+PL
apartarmos-lhe	apartar+V.ele.DAT.3.SG+SBJF+1+PL
apartarmos-lhes	apartar+V.ele.DAT.3.PL+INF+1+PL
apartarmos-lhes	apartar+V.ele.DAT.3.PL+SBJF+1+PL
apartarmos-me	apartar+V.eu.AD.1.SG+INF+1+PL
apartarmos-me	apartar+V.eu.AD.1.SG+SBJF+1+PL
apartarmos-te	apartar+V.tu.AD.2.SG+INF+1+PL
apartarmos-te	apartar+V.tu.AD.2.SG+SBJF+1+PL
apartarmos-vos	apartar+V.vós.AD.2.PL+INF+1+PL
apartarmos-vos	apartar+V.vós.AD.2.PL+SBJF+1+PL
apartar-nos-á	apartar+nós.AD.1.PL+FUT+3+SG
apartar-nos-ão	apartar+nós.AD.1.PL+FUT+3+PL
apartar-nos	apartar+nós.AD.1.PL+INF
apartar-nos	apartar+nós.AD.1.PL+INF+1+SG
apartar-nos	apartar+nós.AD.1.PL+INF+3+SG
apartar-nos	apartar+nós.AD.1.PL+SBJF+1+SG
apartar-nos	apartar+nós.AD.1.PL+SBJF+3+SG
apartar-nos-ás	apartar+nós.AD.1.PL+FUT+2+SG
apartar-nos-ei	apartar+nós.AD.1.PL+FUT+1+SG
apartar-nos-eis	apartar+nós.AD.1.PL+FUT+2+PL
apartar-nos-emos	apartar+nós.AD.1.PL+FUT+1+PL
apartar-nos-ia	apartar+nós.AD.1.PL+COND+1+SG
apartar-nos-ia	apartar+nós.AD.1.PL+COND+3+SG
apartar-nos-iam	apartar+nós.AD.1.PL+COND+3+PL
apartar-nos-íamos	apartar+nós.AD.1.PL+COND+1+PL
apartar-nos-ias	apartar+nós.AD.1.PL+COND+2+SG
apartar-nos-íeis	apartar+nós.AD.1.PL+COND+2+PL
apartar-se-á	apartar+V.ele.REFL+FUT+3+SG
apartar-se-ão	apartar+V.ele.REFL+FUT+3+PL
apartar-se	apartar+V.ele.REFL+INF
apartar-se	apartar+V.ele.REFL+INF+3+SG
apartar-se	apartar+V.ele.REFL+SBJF+3+SG
apartar-se-ia	apartar+V.ele.REFL+COND+3+SG
apartar-se-iam	apartar+V.ele.REFL+COND+3+PL
apartar-te-á	apartar+V.tu.AD.2.SG+FUT+3+SG
apartar-te-ão	apartar+V.tu.AD.2.SG+FUT+3+PL
apartar-te	apartar+V.tu.AD.2.SG+INF
apartar-te	apartar+V.tu.AD.2.SG+INF+1+SG
apartar-te	apartar+V.tu.AD.2.SG+INF+3+SG
apartar-te	apartar+V.tu.AD.2.SG+SBJF+1+SG
apartar-te	apartar+V.tu.AD.2.SG+SBJF+3+SG
apartar-te-ás	apartar+V.tu.AD.2.SG+FUT+2+SG
apartar-te-ei	apartar+V.tu.AD.2.SG+FUT+1+SG
apartar-te-eis	apartar+V.tu.AD.2.SG+FUT+2+PL
apartar-te-emos	apartar+V.tu.AD.2.SG+FUT+1+PL
apartar-te-ia	apartar+V.tu.AD.2.SG+COND+1+SG
apartar-te-ia	apartar+V.tu.AD.2.SG+COND+3+SG
apartar-te-iam	apartar+V.tu.AD.2.SG+COND+3+PL
apartar-te-íamos	apartar+V.tu.AD.2.SG+COND+1+PL
apartar-te-ias	apartar+V.tu.AD.2.SG+COND+2+SG
apartar-te-íeis	apartar+V.tu.AD.2.SG+COND+2+PL
apartar-vos-á	apartar+V.vós.AD.2.PL+FUT+3+SG
apartar-vos-ão	apartar+V.vós.AD.2.PL+FUT+3+PL
apartar-vos	apartar+V.vós.AD.2.PL+INF
apartar-vos	apartar+V.vós.AD.2.PL+INF+1+SG
apartar-vos	apartar+V.vós.AD.2.PL+INF+3+SG
apartar-vos	apartar+V.vós.AD.2.PL+SBJF+1+SG
apartar-vos	apartar+V.vós.AD.2.PL+SBJF+3+SG
apartar-vos-ás	apartar+V.vós.AD.2.PL+FUT+2+SG
apartar-vos-ei	apartar+V.vós.AD.2.PL+FUT+1+SG
apartar-vos-eis	apartar+V.vós.AD.2.PL+FUT+2+PL
apartar-vos-emos	apartar+V.vós.AD.2.PL+FUT+1+PL
apartar-vos-ia	apartar+V.vós.AD.2.PL+COND+1+SG
apartar-vos-ia	apartar+V.vós.AD.2.PL+COND+3+SG
apartar-vos-iam	apartar+V.vós.AD.2.PL+COND+3+PL
apartar-vos-íamos	apartar+V.vós.AD.2.PL+COND+1+PL
apartar-vos-ias	apartar+V.vós.AD.2.PL+COND+2+SG
apartar-vos-íeis	apartar+V.vós.AD.2.PL+COND+2+PL
aparta-se	apartar+V.ele.REFL+PRS+3+SG
apartas-lhe	apartar+V.ele.DAT.3.SG+PRS+2+SG
apartas-lhes	apartar+V.ele.DAT.3.PL+PRS+2+SG
apartas-me	apartar+V.eu.AD.1.SG+PRS+2+SG
apartaste-a	apartar+V.ele.ACC.3.F.SG+PRF+2+SG
apartas-te	apartar+V.tu.AD.2.SG+PRS+2+SG
apartaste-as	apartar+V.ele.ACC.3.F.PL+PRF+2+SG
apartaste-la	apartar+V.ele.ACC.3.F.SG+PRF+2+PL
apartaste-las	apartar+V.ele.ACC.3.F.PL+PRF+2+PL
apartaste-lhe	apartar+V.ele.DAT.3.SG+PRF+2+SG
apartaste-lhes	apartar+V.ele.DAT.3.PL+PRF+2+SG
apartaste-lo	apartar+V.ele.ACC.3.M.SG+PRF+2+PL
apartaste-los	apartar+V.ele.ACC.3.M.PL+PRF+2+PL
apartaste-me	apartar+V.eu.AD.1.SG+PRF+2+SG
apartaste-nos	apartar+nós.AD.1.PL+PRF+2+PL
apartaste-nos	apartar+nós.AD.1.PL+PRF+2+SG
apartaste-o	apartar+V.ele.ACC.3.M.SG+PRF+2+SG
apartaste-os	apartar+V.ele.ACC.3.M.PL+PRF+2+SG
apartastes-lhe	apartar+V.ele.DAT.3.SG+PRF+2+PL
apartastes-lhes	apartar+V.ele.DAT.3.PL+PRF+2+PL
apartastes-me	apartar+V.eu.AD.1.SG+PRF+2+PL
apartastes-te	apartar+V.tu.AD.2.SG+PRF+2+PL
apartastes-vos	apartar+V.vós.AD.2.PL+PRF+2+PL
apartaste-te	apartar+V.tu.AD.2.SG+PRF+2+SG
apartaste-vos	apartar+V.vós.AD.2.PL+PRF+2+SG
apartas-vos	apartar+V.vós.AD.2.PL+PRS+2+SG
aparta-te	apartar+V.tu.AD.2.SG+PRS+3+SG
apartava-a	apartar+V.ele.ACC.3.F.SG+IMPF+1+SG
apartava-a	apartar+V.ele.ACC.3.F.SG+IMPF+3+SG
apartava-as	apartar+V.ele.ACC.3.F.PL+IMPF+1+SG
apartava-as	apartar+V.ele.ACC.3.F.PL+IMPF+3+SG
apartava-la	apartar+V.ele.ACC.3.F.SG+IMPF+2+SG
apartava-las	apartar+V.ele.ACC.3.F.PL+IMPF+2+SG
apartava-lhe	apartar+V.ele.DAT.3.SG+IMPF+1+SG
apartava-lhe	apartar+V.ele.DAT.3.SG+IMPF+3+SG
apartava-lhes	apartar+V.ele.DAT.3.PL+IMPF+1+SG
apartava-lhes	apartar+V.ele.DAT.3.PL+IMPF+3+SG
apartava-lo	apartar+V.ele.ACC.3.M.SG+IMPF+2+SG
apartava-los	apartar+V.ele.ACC.3.M.PL+IMPF+2+SG
apartava-me	apartar+V.eu.AD.1.SG+IMPF+1+SG
apartava-me	apartar+V.eu.AD.1.SG+IMPF+3+SG
apartavam-lhe	apartar+V.ele.DAT.3.SG+IMPF+3+PL
apartavam-lhes	apartar+V.ele.DAT.3.PL+IMPF+3+PL
apartavam-me	apartar+V.eu.AD.1.SG+IMPF+3+PL
apartavam-na	apartar+V.ele.ACC.3.F.SG+IMPF+3+PL
apartavam-nas	apartar+V.ele.ACC.3.F.PL+IMPF+3+PL
apartavam-no	apartar+V.ele.ACC.3.M.SG+IMPF+3+PL
apartavam-nos	apartar+V.ele.ACC.3.M.PL+IMPF+3+PL
apartavam-nos	apartar+V.nós.AD.1.PL+IMPF+3+PL
apartávamo-la	apartar+V.ele.ACC.3.F.SG+IMPF+1+PL
apartávamo-las	apartar+V.ele.ACC.3.F.PL+IMPF+1+PL
apartávamo-lo	apartar+V.ele.ACC.3.M.SG+IMPF+1+PL
apartávamo-los	apartar+V.ele.ACC.3.M.PL+IMPF+1+PL
apartávamo-nos	apartar+nós.AD.1.PL+IMPF+1+PL
apartávamos-lhe	apartar+V.ele.DAT.3.SG+IMPF+1+PL
apartávamos-lhes	apartar+V.ele.DAT.3.PL+IMPF+1+PL
apartávamos-me	apartar+V.eu.AD.1.SG+IMPF+1+PL
apartávamos-te	apartar+V.tu.AD.2.SG+IMPF+1+PL
apartávamos-vos	apartar+V.vós.AD.2.PL+IMPF+1+PL
apartavam-se	apartar+V.ele.REFL+IMPF+3+PL
apartavam-te	apartar+V.tu.AD.2.SG+IMPF+3+PL
apartavam-vos	apartar+V.vós.AD.2.PL+IMPF+3+PL
apartava-nos	apartar+nós.AD.1.PL+IMPF+1+SG
apartava-nos	apartar+nós.AD.1.PL+IMPF+2+SG
apartava-nos	apartar+nós.AD.1.PL+IMPF+3+SG
apartava-o	apartar+V.ele.ACC.3.M.SG+IMPF+1+SG
apartava-o	apartar+V.ele.ACC.3.M.SG+IMPF+3+SG
apartava-os	apartar+V.ele.ACC.3.M.PL+IMPF+1+SG
apartava-os	apartar+V.ele.ACC.3.M.PL+IMPF+3+SG
apartava-se	apartar+V.ele.REFL+IMPF+1+SG
apartava-se	apartar+V.ele.REFL+IMPF+3+SG
apartavas-lhe	apartar+V.ele.DAT.3.SG+IMPF+2+SG
apartavas-lhes	apartar+V.ele.DAT.3.PL+IMPF+2+SG
apartavas-me	apartar+V.eu.AD.1.SG+IMPF+2+SG
apartavas-te	apartar+V.tu.AD.2.SG+IMPF+2+SG
apartavas-vos	apartar+V.vós.AD.2.PL+IMPF+2+SG
apartava-te	apartar+V.tu.AD.2.SG+IMPF+1+SG
apartava-te	apartar+V.tu.AD.2.SG+IMPF+3+SG
apartava-vos	apartar+V.vós.AD.2.PL+IMPF+1+SG
apartava-vos	apartar+V.vós.AD.2.PL+IMPF+3+SG
apartávei-la	apartar+V.ele.ACC.3.F.SG+IMPF+2+PL
apartávei-las	apartar+V.ele.ACC.3.F.PL+IMPF+2+PL
apartávei-lo	apartar+V.ele.ACC.3.M.SG+IMPF+2+PL
apartávei-los	apartar+V.ele.ACC.3.M.PL+IMPF+2+PL
apartávei-nos	apartar+nós.AD.1.PL+IMPF+2+PL
apartáveis-lhe	apartar+V.ele.DAT.3.SG+IMPF+2+PL
apartáveis-lhes	apartar+V.ele.DAT.3.PL+IMPF+2+PL
apartáveis-me	apartar+V.eu.AD.1.SG+IMPF+2+PL
apartáveis-te	apartar+V.tu.AD.2.SG+IMPF+2+PL
apartáveis-vos	apartar+V.vós.AD.2.PL+IMPF+2+PL
aparta-vos	apartar+V.vós.AD.2.PL+PRS+3+SG
aparte-a	apartar+V.ele.ACC.3.F.SG+IMP+3+SG
aparteai-la	apartear+V.ele.ACC.3.F.SG+PRS+2+PL
aparteai-las	apartear+V.ele.ACC.3.F.PL+PRS+2+PL
aparteai-lo	apartear+V.ele.ACC.3.M.SG+PRS+2+PL
aparteai-los	apartear+V.ele.ACC.3.M.PL+PRS+2+PL
aparteai-nos	apartear+nós.AD.1.PL+PRS+2+PL
aparteais-lhe	apartear+V.ele.DAT.3.SG+PRS+2+PL
aparteais-lhes	apartear+V.ele.DAT.3.PL+PRS+2+PL
aparteais-me	apartear+V.eu.AD.1.SG+PRS+2+PL
aparteais-te	apartear+V.tu.AD.2.SG+PRS+2+PL
aparteais-vos	apartear+V.vós.AD.2.PL+PRS+2+PL
aparteá-la-á	apartear+V.ele.ACC.3.F.SG+FUT+3+SG
aparteá-la-ão	apartear+V.ele.ACC.3.F.SG+FUT+3+PL
aparteá-la	apartear+V.ele.ACC.3.F.SG+INF+1+SG
aparteá-la	apartear+V.ele.ACC.3.F.SG+INF+3+SG
aparteá-la	apartear+V.ele.ACC.3.F.SG+SBJF+1+SG
aparteá-la	apartear+V.ele.ACC.3.F.SG+SBJF+3+SG
aparteá-la-ás	apartear+V.ele.ACC.3.F.SG+FUT+2+SG
aparteá-la-ei	apartear+V.ele.ACC.3.F.SG+FUT+1+SG
aparteá-la-eis	apartear+V.ele.ACC.3.F.SG+FUT+2+PL
aparteá-la-emos	apartear+V.ele.ACC.3.F.SG+FUT+1+PL
aparteá-la-ia	apartear+V.ele.ACC.3.F.SG+COND+1+SG
aparteá-la-ia	apartear+V.ele.ACC.3.F.SG+COND+3+SG
aparteá-la-iam	apartear+V.ele.ACC.3.F.SG+COND+3+PL
aparteá-la-íamos	apartear+V.ele.ACC.3.F.SG+COND+1+PL
aparteá-la-ias	apartear+V.ele.ACC.3.F.SG+COND+2+SG
aparteá-la-íeis	apartear+V.ele.ACC.3.F.SG+COND+2+PL
aparteá-las-á	apartear+V.ele.ACC.3.F.PL+FUT+3+SG
aparteá-las-ão	apartear+V.ele.ACC.3.F.PL+FUT+3+PL
aparteá-las	apartear+V.ele.ACC.3.F.PL+INF+1+SG
aparteá-las	apartear+V.ele.ACC.3.F.PL+INF+3+SG
aparteá-las	apartear+V.ele.ACC.3.F.PL+SBJF+1+SG
aparteá-las	apartear+V.ele.ACC.3.F.PL+SBJF+3+SG
aparteá-las-ás	apartear+V.ele.ACC.3.F.PL+FUT+2+SG
aparteá-las-ei	apartear+V.ele.ACC.3.F.PL+FUT+1+SG
aparteá-las-eis	apartear+V.ele.ACC.3.F.PL+FUT+2+PL
aparteá-las-emos	apartear+V.ele.ACC.3.F.PL+FUT+1+PL
aparteá-las-ia	apartear+V.ele.ACC.3.F.PL+COND+1+SG
aparteá-las-ia	apartear+V.ele.ACC.3.F.PL+COND+3+SG
aparteá-las-iam	apartear+V.ele.ACC.3.F.PL+COND+3+PL
aparteá-las-íamos	apartear+V.ele.ACC.3.F.PL+COND+1+PL
aparteá-las-ias	apartear+V.ele.ACC.3.F.PL+COND+2+SG
aparteá-las-íeis	apartear+V.ele.ACC.3.F.PL+COND+2+PL
aparteá-lo-á	apartear+V.ele.ACC.3.M.SG+FUT+3+SG
aparteá-lo-ão	apartear+V.ele.ACC.3.M.SG+FUT+3+PL
aparteá-lo	apartear+V.ele.ACC.3.M.SG+INF+1+SG
aparteá-lo	apartear+V.ele.ACC.3.M.SG+INF+3+SG
aparteá-lo	apartear+V.ele.ACC.3.M.SG+SBJF+1+SG
aparteá-lo	apartear+V.ele.ACC.3.M.SG+SBJF+3+SG
aparteá-lo-ás	apartear+V.ele.ACC.3.M.SG+FUT+2+SG
aparteá-lo-ei	apartear+V.ele.ACC.3.M.SG+FUT+1+SG
aparteá-lo-eis	apartear+V.ele.ACC.3.M.SG+FUT+2+PL
aparteá-lo-emos	apartear+V.ele.ACC.3.M.SG+FUT+1+PL
aparteá-lo-ia	apartear+V.ele.ACC.3.M.SG+COND+1+SG
aparteá-lo-ia	apartear+V.ele.ACC.3.M.SG+COND+3+SG
aparteá-lo-iam	apartear+V.ele.ACC.3.M.SG+COND+3+PL
aparteá-lo-íamos	apartear+V.ele.ACC.3.M.SG+COND+1+PL
aparteá-lo-ias	apartear+V.ele.ACC.3.M.SG+COND+2+SG
aparteá-lo-íeis	apartear+V.ele.ACC.3.M.SG+COND+2+PL
aparteá-los-á	apartear+V.ele.ACC.3.M.PL+FUT+3+SG
aparteá-los-ão	apartear+V.ele.ACC.3.M.PL+FUT+3+PL
aparteá-los	apartear+V.ele.ACC.3.M.PL+INF+1+SG
aparteá-los	apartear+V.ele.ACC.3.M.PL+INF+3+SG
aparteá-los	apartear+V.ele.ACC.3.M.PL+SBJF+1+SG
aparteá-los	apartear+V.ele.ACC.3.M.PL+SBJF+3+SG
aparteá-los-ás	apartear+V.ele.ACC.3.M.PL+FUT+2+SG
aparteá-los-ei	apartear+V.ele.ACC.3.M.PL+FUT+1+SG
aparteá-los-eis	apartear+V.ele.ACC.3.M.PL+FUT+2+PL
aparteá-los-emos	apartear+V.ele.ACC.3.M.PL+FUT+1+PL
aparteá-los-ia	apartear+V.ele.ACC.3.M.PL+COND+1+SG
aparteá-los-ia	apartear+V.ele.ACC.3.M.PL+COND+3+SG
aparteá-los-iam	apartear+V.ele.ACC.3.M.PL+COND+3+PL
aparteá-los-íamos	apartear+V.ele.ACC.3.M.PL+COND+1+PL
aparteá-los-ias	apartear+V.ele.ACC.3.M.PL+COND+2+SG
aparteá-los-íeis	apartear+V.ele.ACC.3.M.PL+COND+2+PL
aparteamo-la	apartear+V.ele.ACC.3.F.SG+PRF+1+PL
aparteamo-la	apartear+V.ele.ACC.3.F.SG+PRS+1+PL
aparteamo-las	apartear+V.ele.ACC.3.F.PL+PRF+1+PL
aparteamo-las	apartear+V.ele.ACC.3.F.PL+PRS+1+PL
aparteamo-lo	apartear+V.ele.ACC.3.M.SG+PRF+1+PL
aparteamo-lo	apartear+V.ele.ACC.3.M.SG+PRS+1+PL
aparteamo-los	apartear+V.ele.ACC.3.M.PL+PRF+1+PL
aparteamo-los	apartear+V.ele.ACC.3.M.PL+PRS+1+PL
aparteamo-nos	apartear+nós.AD.1.PL+PRF+1+PL
aparteamo-nos	apartear+nós.AD.1.PL+PRS+1+PL
aparteamos-lhe	apartear+V.ele.DAT.3.SG+PRF+1+PL
aparteamos-lhe	apartear+V.ele.DAT.3.SG+PRS+1+PL
aparteamos-lhes	apartear+V.ele.DAT.3.PL+PRF+1+PL
aparteamos-lhes	apartear+V.ele.DAT.3.PL+PRS+1+PL
aparteamos-me	apartear+V.eu.AD.1.SG+PRF+1+PL
aparteamos-me	apartear+V.eu.AD.1.SG+PRS+1+PL
aparteamos-te	apartear+V.tu.AD.2.SG+PRF+1+PL
aparteamos-te	apartear+V.tu.AD.2.SG+PRS+1+PL
aparteamos-vos	apartear+V.vós.AD.2.PL+PRF+1+PL
aparteamos-vos	apartear+V.vós.AD.2.PL+PRS+1+PL
aparteando-a	apartear+V.ele.ACC.3.F.SG+GRD
aparteando-as	apartear+V.ele.ACC.3.F.PL+GRD
aparteando-lhe	apartear+V.ele.DAT.3.SG+GRD
aparteando-lhes	apartear+V.ele.DAT.3.PL+GRD
aparteando-me	apartear+V.eu.AD.1.SG+GRD
aparteando-nos	apartear+nós.AD.1.PL+GRD
aparteando-o	apartear+V.ele.ACC.3.M.SG+GRD
aparteando-os	apartear+V.ele.ACC.3.M.PL+GRD
aparteando-se	apartear+V.ele.REFL+GRD
aparteando-te	apartear+V.tu.AD.2.SG+GRD
aparteando-vos	apartear+V.vós.AD.2.PL+GRD
aparteara-a	apartear+V.ele.ACC.3.F.SG+PQP+1+SG
aparteara-a	apartear+V.ele.ACC.3.F.SG+PQP+3+SG
aparteara-as	apartear+V.ele.ACC.3.F.PL+PQP+1+SG
aparteara-as	apartear+V.ele.ACC.3.F.PL+PQP+3+SG
aparteara-la	apartear+V.ele.ACC.3.F.SG+PQP+2+SG
aparteara-las	apartear+V.ele.ACC.3.F.PL+PQP+2+SG
aparteara-lhe	apartear+V.ele.DAT.3.SG+PQP+1+SG
aparteara-lhe	apartear+V.ele.DAT.3.SG+PQP+3+SG
aparteara-lhes	apartear+V.ele.DAT.3.PL+PQP+1+SG
aparteara-lhes	apartear+V.ele.DAT.3.PL+PQP+3+SG
aparteara-lo	apartear+V.ele.ACC.3.M.SG+PQP+2+SG
aparteara-los	apartear+V.ele.ACC.3.M.PL+PQP+2+SG
aparteara-me	apartear+V.eu.AD.1.SG+PQP+1+SG
aparteara-me	apartear+V.eu.AD.1.SG+PQP+3+SG
apartearam-lhe	apartear+V.ele.DAT.3.SG+PQP+3+PL
apartearam-lhe	apartear+V.ele.DAT.3.SG+PRF+3+PL
apartearam-lhes	apartear+V.ele.DAT.3.PL+PQP+3+PL
apartearam-lhes	apartear+V.ele.DAT.3.PL+PRF+3+PL
apartearam-me	apartear+V.eu.AD.1.SG+PQP+3+PL
apartearam-me	apartear+V.eu.AD.1.SG+PRF+3+PL
apartearam-na	apartear+V.ele.ACC.3.F.SG+PQP+3+PL
apartearam-na	apartear+V.ele.ACC.3.F.SG+PRF+3+PL
apartearam-nas	apartear+V.ele.ACC.3.F.PL+PQP+3+PL
apartearam-nas	apartear+V.ele.ACC.3.F.PL+PRF+3+PL
apartearam-no	apartear+V.ele.ACC.3.M.SG+PQP+3+PL
apartearam-no	apartear+V.ele.ACC.3.M.SG+PRF+3+PL
apartearam-nos	apartear+V.ele.ACC.3.M.PL+PQP+3+PL
apartearam-nos	apartear+V.ele.ACC.3.M.PL+PRF+3+PL
apartearam-nos	apartear+V.nós.AD.1.PL+PQP+3+PL
apartearam-nos	apartear+V.nós.AD.1.PL+PRF+3+PL
aparteáramo-la	apartear+V.ele.ACC.3.F.SG+PQP+1+PL
aparteáramo-las	apartear+V.ele.ACC.3.F.PL+PQP+1+PL
aparteáramo-lo	apartear+V.ele.ACC.3.M.SG+PQP+1+PL
aparteáramo-los	apartear+V.ele.ACC.3.M.PL+PQP+1+PL
aparteáramo-nos	apartear+nós.AD.1.PL+PQP+1+PL
aparteáramos-lhe	apartear+V.ele.DAT.3.SG+PQP+1+PL
aparteáramos-lhes	apartear+V.ele.DAT.3.PL+PQP+1+PL
aparteáramos-me	apartear+V.eu.AD.1.SG+PQP+1+PL
aparteáramos-te	apartear+V.tu.AD.2.SG+PQP+1+PL
aparteáramos-vos	apartear+V.vós.AD.2.PL+PQP+1+PL
apartearam-se	apartear+V.ele.REFL+PQP+3+PL
apartearam-se	apartear+V.ele.REFL+PRF+3+PL
apartearam-te	apartear+V.tu.AD.2.SG+PQP+3+PL
apartearam-te	apartear+V.tu.AD.2.SG+PRF+3+PL
apartearam-vos	apartear+V.vós.AD.2.PL+PQP+3+PL
apartearam-vos	apartear+V.vós.AD.2.PL+PRF+3+PL
aparteara-nos	apartear+nós.AD.1.PL+PQP+1+SG
aparteara-nos	apartear+nós.AD.1.PL+PQP+2+SG
aparteara-nos	apartear+nós.AD.1.PL+PQP+3+SG
aparteara-o	apartear+V.ele.ACC.3.M.SG+PQP+1+SG
aparteara-o	apartear+V.ele.ACC.3.M.SG+PQP+3+SG
aparteara-os	apartear+V.ele.ACC.3.M.PL+PQP+1+SG
aparteara-os	apartear+V.ele.ACC.3.M.PL+PQP+3+SG
aparteara-se	apartear+V.ele.REFL+PQP+1+SG
aparteara-se	apartear+V.ele.REFL+PQP+3+SG
apartearas-lhe	apartear+V.ele.DAT.3.SG+PQP+2+SG
apartearas-lhes	apartear+V.ele.DAT.3.PL+PQP+2+SG
apartearas-me	apartear+V.eu.AD.1.SG+PQP+2+SG
apartearas-te	apartear+V.tu.AD.2.SG+PQP+2+SG
apartearas-vos	apartear+V.vós.AD.2.PL+PQP+2+SG
aparteara-te	apartear+V.tu.AD.2.SG+PQP+1+SG
aparteara-te	apartear+V.tu.AD.2.SG+PQP+3+SG
aparteara-vos	apartear+V.vós.AD.2.PL+PQP+1+SG
aparteara-vos	apartear+V.vós.AD.2.PL+PQP+3+SG
apartearde-la	apartear+V.ele.ACC.3.F.SG+INF+2+PL
apartearde-la	apartear+V.ele.ACC.3.F.SG+SBJF+2+PL
apartearde-las	apartear+V.ele.ACC.3.F.PL+INF+2+PL
apartearde-las	apartear+V.ele.ACC.3.F.PL+SBJF+2+PL
apartearde-lo	apartear+V.ele.ACC.3.M.SG+INF+2+PL
apartearde-lo	apartear+V.ele.ACC.3.M.SG+SBJF+2+PL
apartearde-los	apartear+V.ele.ACC.3.M.PL+INF+2+PL
apartearde-los	apartear+V.ele.ACC.3.M.PL+SBJF+2+PL
apartearde-nos	apartear+nós.AD.1.PL+INF+2+PL
apartearde-nos	apartear+nós.AD.1.PL+SBJF+2+PL
aparteardes-lhe	apartear+V.ele.DAT.3.SG+INF+2+PL
aparteardes-lhe	apartear+V.ele.DAT.3.SG+SBJF+2+PL
aparteardes-lhes	apartear+V.ele.DAT.3.PL+INF+2+PL
aparteardes-lhes	apartear+V.ele.DAT.3.PL+SBJF+2+PL
aparteardes-me	apartear+V.eu.AD.1.SG+INF+2+PL
aparteardes-me	apartear+V.eu.AD.1.SG+SBJF+2+PL
aparteardes-te	apartear+V.tu.AD.2.SG+INF+2+PL
aparteardes-te	apartear+V.tu.AD.2.SG+SBJF+2+PL
aparteardes-vos	apartear+V.vós.AD.2.PL+INF+2+PL
aparteardes-vos	apartear+V.vós.AD.2.PL+SBJF+2+PL
aparteárei-la	apartear+V.ele.ACC.3.F.SG+PQP+2+PL
aparteárei-las	apartear+V.ele.ACC.3.F.PL+PQP+2+PL
aparteárei-lo	apartear+V.ele.ACC.3.M.SG+PQP+2+PL
aparteárei-los	apartear+V.ele.ACC.3.M.PL+PQP+2+PL
aparteárei-nos	apartear+nós.AD.1.PL+PQP+2+PL
aparteáreis-lhe	apartear+V.ele.DAT.3.SG+PQP+2+PL
aparteáreis-lhes	apartear+V.ele.DAT.3.PL+PQP+2+PL
aparteáreis-me	apartear+V.eu.AD.1.SG+PQP+2+PL
aparteáreis-te	apartear+V.tu.AD.2.SG+PQP+2+PL
aparteáreis-vos	apartear+V.vós.AD.2.PL+PQP+2+PL
aparteare-la	apartear+V.ele.ACC.3.F.SG+INF+2+SG
aparteare-la	apartear+V.ele.ACC.3.F.SG+SBJF+2+SG
aparteare-las	apartear+V.ele.ACC.3.F.PL+INF+2+SG
aparteare-las	apartear+V.ele.ACC.3.F.PL+SBJF+2+SG
aparteare-lo	apartear+V.ele.ACC.3.M.SG+INF+2+SG
aparteare-lo	apartear+V.ele.ACC.3.M.SG+SBJF+2+SG
aparteare-los	apartear+V.ele.ACC.3.M.PL+INF+2+SG
aparteare-los	apartear+V.ele.ACC.3.M.PL+SBJF+2+SG
apartearem-lhe	apartear+V.ele.DAT.3.SG+INF+3+PL
apartearem-lhe	apartear+V.ele.DAT.3.SG+SBJF+3+PL
apartearem-lhes	apartear+V.ele.DAT.3.PL+INF+3+PL
apartearem-lhes	apartear+V.ele.DAT.3.PL+SBJF+3+PL
apartearem-me	apartear+V.eu.AD.1.SG+INF+3+PL
apartearem-me	apartear+V.eu.AD.1.SG+SBJF+3+PL
apartearem-na	apartear+V.ele.ACC.3.F.SG+INF+3+PL
apartearem-na	apartear+V.ele.ACC.3.F.SG+SBJF+3+PL
apartearem-nas	apartear+V.ele.ACC.3.F.PL+INF+3+PL
apartearem-nas	apartear+V.ele.ACC.3.F.PL+SBJF+3+PL
apartearem-no	apartear+V.ele.ACC.3.M.SG+INF+3+PL
apartearem-no	apartear+V.ele.ACC.3.M.SG+SBJF+3+PL
apartearem-nos	apartear+V.ele.ACC.3.M.PL+INF+3+PL
apartearem-nos	apartear+V.ele.ACC.3.M.PL+SBJF+3+PL
apartearem-nos	apartear+V.nós.AD.1.PL+INF+3+PL
apartearem-nos	apartear+V.nós.AD.1.PL+SBJF+3+PL
apartearem-se	apartear+V.ele.REFL+INF+3+PL
apartearem-se	apartear+V.ele.REFL+SBJF+3+PL
apartearem-te	apartear+V.tu.AD.2.SG+INF+3+PL
apartearem-te	apartear+V.tu.AD.2.SG+SBJF+3+PL
apartearem-vos	apartear+V.vós.AD.2.PL+INF+3+PL
apartearem-vos	apartear+V.vós.AD.2.PL+SBJF+3+PL
aparteare-nos	apartear+nós.AD.1.PL+INF+2+SG
aparteare-nos	apartear+nós.AD.1.PL+SBJF+2+SG
aparteares-lhe	apartear+V.ele.DAT.3.SG+INF+2+SG
aparteares-lhe	apartear+V.ele.DAT.3.SG+SBJF+2+SG
aparteares-lhes	apartear+V.ele.DAT.3.PL+INF+2+SG
aparteares-lhes	apartear+V.ele.DAT.3.PL+SBJF+2+SG
aparteares-me	apartear+V.eu.AD.1.SG+INF+2+SG
aparteares-me	apartear+V.eu.AD.1.SG+SBJF+2+SG
aparteares-te	apartear+V.tu.AD.2.SG+INF+2+SG
aparteares-te	apartear+V.tu.AD.2.SG+SBJF+2+SG
aparteares-vos	apartear+V.vós.AD.2.PL+INF+2+SG
aparteares-vos	apartear+V.vós.AD.2.PL+SBJF+2+SG
apartear-lhe-á	apartear+V.ele.DAT.3.SG+FUT+3+SG
apartear-lhe-ão	apartear+V.ele.DAT.3.SG+FUT+3+PL
apartear-lhe	apartear+V.ele.DAT.3.SG+INF
apartear-lhe	apartear+V.ele.DAT.3.SG+INF+1+SG
apartear-lhe	apartear+V.ele.DAT.3.SG+INF+3+SG
apartear-lhe	apartear+V.ele.DAT.3.SG+SBJF+1+SG
apartear-lhe	apartear+V.ele.DAT.3.SG+SBJF+3+SG
apartear-lhe-ás	apartear+V.ele.DAT.3.SG+FUT+2+SG
apartear-lhe-ei	apartear+V.ele.DAT.3.SG+FUT+1+SG
apartear-lhe-eis	apartear+V.ele.DAT.3.SG+FUT+2+PL
apartear-lhe-emos	apartear+V.ele.DAT.3.SG+FUT+1+PL
apartear-lhe-ia	apartear+V.ele.DAT.3.SG+COND+1+SG
apartear-lhe-ia	apartear+V.ele.DAT.3.SG+COND+3+SG
apartear-lhe-iam	apartear+V.ele.DAT.3.SG+COND+3+PL
apartear-lhe-íamos	apartear+V.ele.DAT.3.SG+COND+1+PL
apartear-lhe-ias	apartear+V.ele.DAT.3.SG+COND+2+SG
apartear-lhe-íeis	apartear+V.ele.DAT.3.SG+COND+2+PL
apartear-lhes-á	apartear+V.ele.DAT.3.PL+FUT+3+SG
apartear-lhes-ão	apartear+V.ele.DAT.3.PL+FUT+3+PL
apartear-lhes	apartear+V.ele.DAT.3.PL+INF
apartear-lhes	apartear+V.ele.DAT.3.PL+INF+1+SG
apartear-lhes	apartear+V.ele.DAT.3.PL+INF+3+SG
apartear-lhes	apartear+V.ele.DAT.3.PL+SBJF+1+SG
apartear-lhes	apartear+V.ele.DAT.3.PL+SBJF+3+SG
apartear-lhes-ás	apartear+V.ele.DAT.3.PL+FUT+2+SG
apartear-lhes-ei	apartear+V.ele.DAT.3.PL+FUT+1+SG
apartear-lhes-eis	apartear+V.ele.DAT.3.PL+FUT+2+PL
apartear-lhes-emos	apartear+V.ele.DAT.3.PL+FUT+1+PL
apartear-lhes-ia	apartear+V.ele.DAT.3.PL+COND+1+SG
apartear-lhes-ia	apartear+V.ele.DAT.3.PL+COND+3+SG
apartear-lhes-iam	apartear+V.ele.DAT.3.PL+COND+3+PL
apartear-lhes-íamos	apartear+V.ele.DAT.3.PL+COND+1+PL
apartear-lhes-ias	apartear+V.ele.DAT.3.PL+COND+2+SG
apartear-lhes-íeis	apartear+V.ele.DAT.3.PL+COND+2+PL
