apaulaste-nos	apaular+nós.AD.1.PL+PRF+2+PL
apaulaste-nos	apaular+nós.AD.1.PL+PRF+2+SG
apaulaste-o	apaular+V.ele.ACC.3.M.SG+PRF+2+SG
apaulaste-os	apaular+V.ele.ACC.3.M.PL+PRF+2+SG
apaulastes-lhe	apaular+V.ele.DAT.3.SG+PRF+2+PL
apaulastes-lhes	apaular+V.ele.DAT.3.PL+PRF+2+PL
apaulastes-me	apaular+V.eu.AD.1.SG+PRF+2+PL
apaulastes-te	apaular+V.tu.AD.2.SG+PRF+2+PL
apaulastes-vos	apaular+V.vós.AD.2.PL+PRF+2+PL
apaulaste-te	apaular+V.tu.AD.2.SG+PRF+2+SG
apaulaste-vos	apaular+V.vós.AD.2.PL+PRF+2+SG
apaulas-vos	apaular+V.vós.AD.2.PL+PRS+2+SG
apaula-te	apaular+V.tu.AD.2.SG+PRS+3+SG
apaulava-a	apaular+V.ele.ACC.3.F.SG+IMPF+1+SG
apaulava-a	apaular+V.ele.ACC.3.F.SG+IMPF+3+SG
apaulava-as	apaular+V.ele.ACC.3.F.PL+IMPF+1+SG
apaulava-as	apaular+V.ele.ACC.3.F.PL+IMPF+3+SG
apaulava-la	apaular+V.ele.ACC.3.F.SG+IMPF+2+SG
apaulava-las	apaular+V.ele.ACC.3.F.PL+IMPF+2+SG
apaulava-lhe	apaular+V.ele.DAT.3.SG+IMPF+1+SG
apaulava-lhe	apaular+V.ele.DAT.3.SG+IMPF+3+SG
apaulava-lhes	apaular+V.ele.DAT.3.PL+IMPF+1+SG
apaulava-lhes	apaular+V.ele.DAT.3.PL+IMPF+3+SG
apaulava-lo	apaular+V.ele.ACC.3.M.SG+IMPF+2+SG
apaulava-los	apaular+V.ele.ACC.3.M.PL+IMPF+2+SG
apaulava-me	apaular+V.eu.AD.1.SG+IMPF+1+SG
apaulava-me	apaular+V.eu.AD.1.SG+IMPF+3+SG
apaulavam-lhe	apaular+V.ele.DAT.3.SG+IMPF+3+PL
apaulavam-lhes	apaular+V.ele.DAT.3.PL+IMPF+3+PL
apaulavam-me	apaular+V.eu.AD.1.SG+IMPF+3+PL
apaulavam-na	apaular+V.ele.ACC.3.F.SG+IMPF+3+PL
apaulavam-nas	apaular+V.ele.ACC.3.F.PL+IMPF+3+PL
apaulavam-no	apaular+V.ele.ACC.3.M.SG+IMPF+3+PL
apaulavam-nos	apaular+V.ele.ACC.3.M.PL+IMPF+3+PL
apaulavam-nos	apaular+V.nós.AD.1.PL+IMPF+3+PL
apaulávamo-la	apaular+V.ele.ACC.3.F.SG+IMPF+1+PL
apaulávamo-las	apaular+V.ele.ACC.3.F.PL+IMPF+1+PL
apaulávamo-lo	apaular+V.ele.ACC.3.M.SG+IMPF+1+PL
apaulávamo-los	apaular+V.ele.ACC.3.M.PL+IMPF+1+PL
apaulávamo-nos	apaular+nós.AD.1.PL+IMPF+1+PL
apaulávamos-lhe	apaular+V.ele.DAT.3.SG+IMPF+1+PL
apaulávamos-lhes	apaular+V.ele.DAT.3.PL+IMPF+1+PL
apaulávamos-me	apaular+V.eu.AD.1.SG+IMPF+1+PL
apaulávamos-te	apaular+V.tu.AD.2.SG+IMPF+1+PL
apaulávamos-vos	apaular+V.vós.AD.2.PL+IMPF+1+PL
apaulavam-se	apaular+V.ele.REFL+IMPF+3+PL
apaulavam-te	apaular+V.tu.AD.2.SG+IMPF+3+PL
apaulavam-vos	apaular+V.vós.AD.2.PL+IMPF+3+PL
apaulava-nos	apaular+nós.AD.1.PL+IMPF+1+SG
apaulava-nos	apaular+nós.AD.1.PL+IMPF+2+SG
apaulava-nos	apaular+nós.AD.1.PL+IMPF+3+SG
apaulava-o	apaular+V.ele.ACC.3.M.SG+IMPF+1+SG
apaulava-o	apaular+V.ele.ACC.3.M.SG+IMPF+3+SG
apaulava-os	apaular+V.ele.ACC.3.M.PL+IMPF+1+SG
apaulava-os	apaular+V.ele.ACC.3.M.PL+IMPF+3+SG
apaulava-se	apaular+V.ele.REFL+IMPF+1+SG
apaulava-se	apaular+V.ele.REFL+IMPF+3+SG
apaulavas-lhe	apaular+V.ele.DAT.3.SG+IMPF+2+SG
apaulavas-lhes	apaular+V.ele.DAT.3.PL+IMPF+2+SG
apaulavas-me	apaular+V.eu.AD.1.SG+IMPF+2+SG
apaulavas-te	apaular+V.tu.AD.2.SG+IMPF+2+SG
apaulavas-vos	apaular+V.vós.AD.2.PL+IMPF+2+SG
apaulava-te	apaular+V.tu.AD.2.SG+IMPF+1+SG
apaulava-te	apaular+V.tu.AD.2.SG+IMPF+3+SG
apaulava-vos	apaular+V.vós.AD.2.PL+IMPF+1+SG
apaulava-vos	apaular+V.vós.AD.2.PL+IMPF+3+SG
apaulávei-la	apaular+V.ele.ACC.3.F.SG+IMPF+2+PL
apaulávei-las	apaular+V.ele.ACC.3.F.PL+IMPF+2+PL
apaulávei-lo	apaular+V.ele.ACC.3.M.SG+IMPF+2+PL
apaulávei-los	apaular+V.ele.ACC.3.M.PL+IMPF+2+PL
apaulávei-nos	apaular+nós.AD.1.PL+IMPF+2+PL
apauláveis-lhe	apaular+V.ele.DAT.3.SG+IMPF+2+PL
apauláveis-lhes	apaular+V.ele.DAT.3.PL+IMPF+2+PL
apauláveis-me	apaular+V.eu.AD.1.SG+IMPF+2+PL
apauláveis-te	apaular+V.tu.AD.2.SG+IMPF+2+PL
apauláveis-vos	apaular+V.vós.AD.2.PL+IMPF+2+PL
apaula-vos	apaular+V.vós.AD.2.PL+PRS+3+SG
apaule-a	apaular+V.ele.ACC.3.F.SG+IMP+3+SG
apaule-as	apaular+V.ele.ACC.3.F.PL+IMP+3+SG
apaulei-a	apaular+V.ele.ACC.3.F.SG+PRF+1+SG
apaulei-as	apaular+V.ele.ACC.3.F.PL+PRF+1+SG
apaulei-lhe	apaular+V.ele.DAT.3.SG+PRF+1+SG
apaulei-lhes	apaular+V.ele.DAT.3.PL+PRF+1+SG
apaulei-me	apaular+V.eu.AD.1.SG+PRF+1+SG
apaulei-nos	apaular+nós.AD.1.PL+PRF+1+SG
apaulei-o	apaular+V.ele.ACC.3.M.SG+PRF+1+SG
apaulei-os	apaular+V.ele.ACC.3.M.PL+PRF+1+SG
apaulei-te	apaular+V.tu.AD.2.SG+PRF+1+SG
apaulei-vos	apaular+V.vós.AD.2.PL+PRF+1+SG
apaule-lhe	apaular+V.ele.DAT.3.SG+IMP+3+SG
apaule-lhes	apaular+V.ele.DAT.3.PL+IMP+3+SG
apaule-me	apaular+V.eu.AD.1.SG+IMP+3+SG
apaulem-lhe	apaular+V.ele.DAT.3.SG+IMP+3+PL
apaulem-lhes	apaular+V.ele.DAT.3.PL+IMP+3+PL
apaulem-me	apaular+V.eu.AD.1.SG+IMP+3+PL
apaulem-na	apaular+V.ele.ACC.3.F.SG+IMP+3+PL
apaulem-nas	apaular+V.ele.ACC.3.F.PL+IMP+3+PL
apaulem-no	apaular+V.ele.ACC.3.M.SG+IMP+3+PL
apaulem-nos	apaular+V.ele.ACC.3.M.PL+IMP+3+PL
apaulem-nos	apaular+V.nós.AD.1.PL+IMP+3+PL
apaulemo-la	apaular+V.ele.ACC.3.F.SG+IMP+1+PL
apaulemo-las	apaular+V.ele.ACC.3.F.PL+IMP+1+PL
apaulemo-lo	apaular+V.ele.ACC.3.M.SG+IMP+1+PL
apaulemo-los	apaular+V.ele.ACC.3.M.PL+IMP+1+PL
apaulemo-nos	apaular+nós.AD.1.PL+IMP+1+PL
apaulemos-lhe	apaular+V.ele.DAT.3.SG+IMP+1+PL
apaulemos-lhes	apaular+V.ele.DAT.3.PL+IMP+1+PL
apaulemos-me	apaular+V.eu.AD.1.SG+IMP+1+PL
apaulemos-te	apaular+V.tu.AD.2.SG+IMP+1+PL
apaulemos-vos	apaular+V.vós.AD.2.PL+IMP+1+PL
apaulem-se	apaular+V.ele.REFL+IMP+3+PL
apaulem-te	apaular+V.tu.AD.2.SG+IMP+3+PL
apaulem-vos	apaular+V.vós.AD.2.PL+IMP+3+PL
apaule-nos	apaular+nós.AD.1.PL+IMP+3+SG
apaule-o	apaular+V.ele.ACC.3.M.SG+IMP+3+SG
apaule-os	apaular+V.ele.ACC.3.M.PL+IMP+3+SG
apaule-se	apaular+V.ele.REFL+IMP+3+SG
apaule-te	apaular+V.tu.AD.2.SG+IMP+3+SG
apaule-vos	apaular+V.vós.AD.2.PL+IMP+3+SG
apaulista-a	apaulistar+V.ele.ACC.3.F.SG+PRS+3+SG
apaulista-as	apaulistar+V.ele.ACC.3.F.PL+PRS+3+SG
apaulistai-la	apaulistar+V.ele.ACC.3.F.SG+PRS+2+PL
apaulistai-las	apaulistar+V.ele.ACC.3.F.PL+PRS+2+PL
apaulistai-lo	apaulistar+V.ele.ACC.3.M.SG+PRS+2+PL
apaulistai-los	apaulistar+V.ele.ACC.3.M.PL+PRS+2+PL
apaulistai-nos	apaulistar+nós.AD.1.PL+PRS+2+PL
apaulistais-lhe	apaulistar+V.ele.DAT.3.SG+PRS+2+PL
apaulistais-lhes	apaulistar+V.ele.DAT.3.PL+PRS+2+PL
apaulistais-me	apaulistar+V.eu.AD.1.SG+PRS+2+PL
apaulistais-te	apaulistar+V.tu.AD.2.SG+PRS+2+PL
apaulistais-vos	apaulistar+V.vós.AD.2.PL+PRS+2+PL
apaulistá-la-á	apaulistar+V.ele.ACC.3.F.SG+FUT+3+SG
apaulistá-la-ão	apaulistar+V.ele.ACC.3.F.SG+FUT+3+PL
apaulistá-la	apaulistar+V.ele.ACC.3.F.SG+INF+1+SG
apaulistá-la	apaulistar+V.ele.ACC.3.F.SG+INF+3+SG
apaulista-la	apaulistar+V.ele.ACC.3.F.SG+PRS+2+SG
apaulistá-la	apaulistar+V.ele.ACC.3.F.SG+SBJF+1+SG
apaulistá-la	apaulistar+V.ele.ACC.3.F.SG+SBJF+3+SG
apaulistá-la-ás	apaulistar+V.ele.ACC.3.F.SG+FUT+2+SG
apaulistá-la-ei	apaulistar+V.ele.ACC.3.F.SG+FUT+1+SG
apaulistá-la-eis	apaulistar+V.ele.ACC.3.F.SG+FUT+2+PL
apaulistá-la-emos	apaulistar+V.ele.ACC.3.F.SG+FUT+1+PL
apaulistá-la-ia	apaulistar+V.ele.ACC.3.F.SG+COND+1+SG
apaulistá-la-ia	apaulistar+V.ele.ACC.3.F.SG+COND+3+SG
apaulistá-la-iam	apaulistar+V.ele.ACC.3.F.SG+COND+3+PL
apaulistá-la-íamos	apaulistar+V.ele.ACC.3.F.SG+COND+1+PL
apaulistá-la-ias	apaulistar+V.ele.ACC.3.F.SG+COND+2+SG
apaulistá-la-íeis	apaulistar+V.ele.ACC.3.F.SG+COND+2+PL
apaulistá-las-á	apaulistar+V.ele.ACC.3.F.PL+FUT+3+SG
apaulistá-las-ão	apaulistar+V.ele.ACC.3.F.PL+FUT+3+PL
apaulistá-las	apaulistar+V.ele.ACC.3.F.PL+INF+1+SG
apaulistá-las	apaulistar+V.ele.ACC.3.F.PL+INF+3+SG
apaulista-las	apaulistar+V.ele.ACC.3.F.PL+PRS+2+SG
apaulistá-las	apaulistar+V.ele.ACC.3.F.PL+SBJF+1+SG
apaulistá-las	apaulistar+V.ele.ACC.3.F.PL+SBJF+3+SG
apaulistá-las-ás	apaulistar+V.ele.ACC.3.F.PL+FUT+2+SG
apaulistá-las-ei	apaulistar+V.ele.ACC.3.F.PL+FUT+1+SG
apaulistá-las-eis	apaulistar+V.ele.ACC.3.F.PL+FUT+2+PL
apaulistá-las-emos	apaulistar+V.ele.ACC.3.F.PL+FUT+1+PL
apaulistá-las-ia	apaulistar+V.ele.ACC.3.F.PL+COND+1+SG
apaulistá-las-ia	apaulistar+V.ele.ACC.3.F.PL+COND+3+SG
apaulistá-las-iam	apaulistar+V.ele.ACC.3.F.PL+COND+3+PL
apaulistá-las-íamos	apaulistar+V.ele.ACC.3.F.PL+COND+1+PL
apaulistá-las-ias	apaulistar+V.ele.ACC.3.F.PL+COND+2+SG
apaulistá-las-íeis	apaulistar+V.ele.ACC.3.F.PL+COND+2+PL
apaulista-lhe	apaulistar+V.ele.DAT.3.SG+PRS+3+SG
apaulista-lhes	apaulistar+V.ele.DAT.3.PL+PRS+3+SG
apaulistá-lo-á	apaulistar+V.ele.ACC.3.M.SG+FUT+3+SG
apaulistá-lo-ão	apaulistar+V.ele.ACC.3.M.SG+FUT+3+PL
apaulistá-lo	apaulistar+V.ele.ACC.3.M.SG+INF+1+SG
apaulistá-lo	apaulistar+V.ele.ACC.3.M.SG+INF+3+SG
apaulista-lo	apaulistar+V.ele.ACC.3.M.SG+PRS+2+SG
apaulistá-lo	apaulistar+V.ele.ACC.3.M.SG+SBJF+1+SG
apaulistá-lo	apaulistar+V.ele.ACC.3.M.SG+SBJF+3+SG
apaulistá-lo-ás	apaulistar+V.ele.ACC.3.M.SG+FUT+2+SG
apaulistá-lo-ei	apaulistar+V.ele.ACC.3.M.SG+FUT+1+SG
apaulistá-lo-eis	apaulistar+V.ele.ACC.3.M.SG+FUT+2+PL
apaulistá-lo-emos	apaulistar+V.ele.ACC.3.M.SG+FUT+1+PL
apaulistá-lo-ia	apaulistar+V.ele.ACC.3.M.SG+COND+1+SG
apaulistá-lo-ia	apaulistar+V.ele.ACC.3.M.SG+COND+3+SG
apaulistá-lo-iam	apaulistar+V.ele.ACC.3.M.SG+COND+3+PL
apaulistá-lo-íamos	apaulistar+V.ele.ACC.3.M.SG+COND+1+PL
apaulistá-lo-ias	apaulistar+V.ele.ACC.3.M.SG+COND+2+SG
apaulistá-lo-íeis	apaulistar+V.ele.ACC.3.M.SG+COND+2+PL
apaulistá-los-á	apaulistar+V.ele.ACC.3.M.PL+FUT+3+SG
apaulistá-los-ão	apaulistar+V.ele.ACC.3.M.PL+FUT+3+PL
apaulistá-los	apaulistar+V.ele.ACC.3.M.PL+INF+1+SG
apaulistá-los	apaulistar+V.ele.ACC.3.M.PL+INF+3+SG
apaulista-los	apaulistar+V.ele.ACC.3.M.PL+PRS+2+SG
apaulistá-los	apaulistar+V.ele.ACC.3.M.PL+SBJF+1+SG
apaulistá-los	apaulistar+V.ele.ACC.3.M.PL+SBJF+3+SG
apaulistá-los-ás	apaulistar+V.ele.ACC.3.M.PL+FUT+2+SG
apaulistá-los-ei	apaulistar+V.ele.ACC.3.M.PL+FUT+1+SG
apaulistá-los-eis	apaulistar+V.ele.ACC.3.M.PL+FUT+2+PL
apaulistá-los-emos	apaulistar+V.ele.ACC.3.M.PL+FUT+1+PL
apaulistá-los-ia	apaulistar+V.ele.ACC.3.M.PL+COND+1+SG
apaulistá-los-ia	apaulistar+V.ele.ACC.3.M.PL+COND+3+SG
apaulistá-los-iam	apaulistar+V.ele.ACC.3.M.PL+COND+3+PL
apaulistá-los-íamos	apaulistar+V.ele.ACC.3.M.PL+COND+1+PL
apaulistá-los-ias	apaulistar+V.ele.ACC.3.M.PL+COND+2+SG
apaulistá-los-íeis	apaulistar+V.ele.ACC.3.M.PL+COND+2+PL
apaulista-me	apaulistar+V.eu.AD.1.SG+PRS+3+SG
apaulistam-lhe	apaulistar+V.ele.DAT.3.SG+PRS+3+PL
apaulistam-lhes	apaulistar+V.ele.DAT.3.PL+PRS+3+PL
apaulistam-me	apaulistar+V.eu.AD.1.SG+PRS+3+PL
apaulistam-na	apaulistar+V.ele.ACC.3.F.SG+PRS+3+PL
apaulistam-nas	apaulistar+V.ele.ACC.3.F.PL+PRS+3+PL
apaulistam-no	apaulistar+V.ele.ACC.3.M.SG+PRS+3+PL
apaulistam-nos	apaulistar+V.ele.ACC.3.M.PL+PRS+3+PL
apaulistam-nos	apaulistar+V.nós.AD.1.PL+PRS+3+PL
apaulistamo-la	apaulistar+V.ele.ACC.3.F.SG+PRF+1+PL
apaulistamo-la	apaulistar+V.ele.ACC.3.F.SG+PRS+1+PL
apaulistamo-las	apaulistar+V.ele.ACC.3.F.PL+PRF+1+PL
apaulistamo-las	apaulistar+V.ele.ACC.3.F.PL+PRS+1+PL
apaulistamo-lo	apaulistar+V.ele.ACC.3.M.SG+PRF+1+PL
apaulistamo-lo	apaulistar+V.ele.ACC.3.M.SG+PRS+1+PL
apaulistamo-los	apaulistar+V.ele.ACC.3.M.PL+PRF+1+PL
apaulistamo-los	apaulistar+V.ele.ACC.3.M.PL+PRS+1+PL
apaulistamo-nos	apaulistar+nós.AD.1.PL+PRF+1+PL
apaulistamo-nos	apaulistar+nós.AD.1.PL+PRS+1+PL
apaulistamos-lhe	apaulistar+V.ele.DAT.3.SG+PRF+1+PL
apaulistamos-lhe	apaulistar+V.ele.DAT.3.SG+PRS+1+PL
apaulistamos-lhes	apaulistar+V.ele.DAT.3.PL+PRF+1+PL
apaulistamos-lhes	apaulistar+V.ele.DAT.3.PL+PRS+1+PL
apaulistamos-me	apaulistar+V.eu.AD.1.SG+PRF+1+PL
apaulistamos-me	apaulistar+V.eu.AD.1.SG+PRS+1+PL
apaulistamos-te	apaulistar+V.tu.AD.2.SG+PRF+1+PL
apaulistamos-te	apaulistar+V.tu.AD.2.SG+PRS+1+PL
apaulistamos-vos	apaulistar+V.vós.AD.2.PL+PRF+1+PL
apaulistamos-vos	apaulistar+V.vós.AD.2.PL+PRS+1+PL
apaulistam-se	apaulistar+V.ele.REFL+PRS+3+PL
apaulistam-te	apaulistar+V.tu.AD.2.SG+PRS+3+PL
apaulistam-vos	apaulistar+V.vós.AD.2.PL+PRS+3+PL
apaulistando-a	apaulistar+V.ele.ACC.3.F.SG+GRD
apaulistando-as	apaulistar+V.ele.ACC.3.F.PL+GRD
apaulistando-lhe	apaulistar+V.ele.DAT.3.SG+GRD
apaulistando-lhes	apaulistar+V.ele.DAT.3.PL+GRD
apaulistando-me	apaulistar+V.eu.AD.1.SG+GRD
apaulistando-nos	apaulistar+nós.AD.1.PL+GRD
apaulistando-o	apaulistar+V.ele.ACC.3.M.SG+GRD
apaulistando-os	apaulistar+V.ele.ACC.3.M.PL+GRD
apaulistando-se	apaulistar+V.ele.REFL+GRD
apaulistando-te	apaulistar+V.tu.AD.2.SG+GRD
apaulistando-vos	apaulistar+V.vós.AD.2.PL+GRD
apaulistaniza-a	apaulistanizar+V.ele.ACC.3.F.SG+PRS+3+SG
apaulistaniza-as	apaulistanizar+V.ele.ACC.3.F.PL+PRS+3+SG
apaulistanizai-la	apaulistanizar+V.ele.ACC.3.F.SG+PRS+2+PL
apaulistanizai-las	apaulistanizar+V.ele.ACC.3.F.PL+PRS+2+PL
apaulistanizai-lo	apaulistanizar+V.ele.ACC.3.M.SG+PRS+2+PL
apaulistanizai-los	apaulistanizar+V.ele.ACC.3.M.PL+PRS+2+PL
apaulistanizai-nos	apaulistanizar+nós.AD.1.PL+PRS+2+PL
apaulistanizais-lhe	apaulistanizar+V.ele.DAT.3.SG+PRS+2+PL
apaulistanizais-lhes	apaulistanizar+V.ele.DAT.3.PL+PRS+2+PL
apaulistanizais-me	apaulistanizar+V.eu.AD.1.SG+PRS+2+PL
apaulistanizais-te	apaulistanizar+V.tu.AD.2.SG+PRS+2+PL
apaulistanizais-vos	apaulistanizar+V.vós.AD.2.PL+PRS+2+PL
apaulistanizá-la-á	apaulistanizar+V.ele.ACC.3.F.SG+FUT+3+SG
apaulistanizá-la-ão	apaulistanizar+V.ele.ACC.3.F.SG+FUT+3+PL
apaulistanizá-la	apaulistanizar+V.ele.ACC.3.F.SG+INF+1+SG
apaulistanizá-la	apaulistanizar+V.ele.ACC.3.F.SG+INF+3+SG
apaulistaniza-la	apaulistanizar+V.ele.ACC.3.F.SG+PRS+2+SG
apaulistanizá-la	apaulistanizar+V.ele.ACC.3.F.SG+SBJF+1+SG
apaulistanizá-la	apaulistanizar+V.ele.ACC.3.F.SG+SBJF+3+SG
apaulistanizá-la-ás	apaulistanizar+V.ele.ACC.3.F.SG+FUT+2+SG
apaulistanizá-la-ei	apaulistanizar+V.ele.ACC.3.F.SG+FUT+1+SG
apaulistanizá-la-eis	apaulistanizar+V.ele.ACC.3.F.SG+FUT+2+PL
apaulistanizá-la-emos	apaulistanizar+V.ele.ACC.3.F.SG+FUT+1+PL
apaulistanizá-la-ia	apaulistanizar+V.ele.ACC.3.F.SG+COND+1+SG
apaulistanizá-la-ia	apaulistanizar+V.ele.ACC.3.F.SG+COND+3+SG
apaulistanizá-la-iam	apaulistanizar+V.ele.ACC.3.F.SG+COND+3+PL
apaulistanizá-la-íamos	apaulistanizar+V.ele.ACC.3.F.SG+COND+1+PL
apaulistanizá-la-ias	apaulistanizar+V.ele.ACC.3.F.SG+COND+2+SG
apaulistanizá-la-íeis	apaulistanizar+V.ele.ACC.3.F.SG+COND+2+PL
apaulistanizá-las-á	apaulistanizar+V.ele.ACC.3.F.PL+FUT+3+SG
apaulistanizá-las-ão	apaulistanizar+V.ele.ACC.3.F.PL+FUT+3+PL
apaulistanizá-las	apaulistanizar+V.ele.ACC.3.F.PL+INF+1+SG
apaulistanizá-las	apaulistanizar+V.ele.ACC.3.F.PL+INF+3+SG
apaulistaniza-las	apaulistanizar+V.ele.ACC.3.F.PL+PRS+2+SG
apaulistanizá-las	apaulistanizar+V.ele.ACC.3.F.PL+SBJF+1+SG
apaulistanizá-las	apaulistanizar+V.ele.ACC.3.F.PL+SBJF+3+SG
apaulistanizá-las-ás	apaulistanizar+V.ele.ACC.3.F.PL+FUT+2+SG
apaulistanizá-las-ei	apaulistanizar+V.ele.ACC.3.F.PL+FUT+1+SG
apaulistanizá-las-eis	apaulistanizar+V.ele.ACC.3.F.PL+FUT+2+PL
apaulistanizá-las-emos	apaulistanizar+V.ele.ACC.3.F.PL+FUT+1+PL
apaulistanizá-las-ia	apaulistanizar+V.ele.ACC.3.F.PL+COND+1+SG
apaulistanizá-las-ia	apaulistanizar+V.ele.ACC.3.F.PL+COND+3+SG
apaulistanizá-las-iam	apaulistanizar+V.ele.ACC.3.F.PL+COND+3+PL
apaulistanizá-las-íamos	apaulistanizar+V.ele.ACC.3.F.PL+COND+1+PL
apaulistanizá-las-ias	apaulistanizar+V.ele.ACC.3.F.PL+COND+2+SG
apaulistanizá-las-íeis	apaulistanizar+V.ele.ACC.3.F.PL+COND+2+PL
apaulistaniza-lhe	apaulistanizar+V.ele.DAT.3.SG+PRS+3+SG
apaulistaniza-lhes	apaulistanizar+V.ele.DAT.3.PL+PRS+3+SG
apaulistanizá-lo-á	apaulistanizar+V.ele.ACC.3.M.SG+FUT+3+SG
apaulistanizá-lo-ão	apaulistanizar+V.ele.ACC.3.M.SG+FUT+3+PL
apaulistanizá-lo	apaulistanizar+V.ele.ACC.3.M.SG+INF+1+SG
apaulistanizá-lo	apaulistanizar+V.ele.ACC.3.M.SG+INF+3+SG
apaulistaniza-lo	apaulistanizar+V.ele.ACC.3.M.SG+PRS+2+SG
apaulistanizá-lo	apaulistanizar+V.ele.ACC.3.M.SG+SBJF+1+SG
apaulistanizá-lo	apaulistanizar+V.ele.ACC.3.M.SG+SBJF+3+SG
apaulistanizá-lo-ás	apaulistanizar+V.ele.ACC.3.M.SG+FUT+2+SG
apaulistanizá-lo-ei	apaulistanizar+V.ele.ACC.3.M.SG+FUT+1+SG
apaulistanizá-lo-eis	apaulistanizar+V.ele.ACC.3.M.SG+FUT+2+PL
apaulistanizá-lo-emos	apaulistanizar+V.ele.ACC.3.M.SG+FUT+1+PL
apaulistanizá-lo-ia	apaulistanizar+V.ele.ACC.3.M.SG+COND+1+SG
apaulistanizá-lo-ia	apaulistanizar+V.ele.ACC.3.M.SG+COND+3+SG
apaulistanizá-lo-iam	apaulistanizar+V.ele.ACC.3.M.SG+COND+3+PL
apaulistanizá-lo-íamos	apaulistanizar+V.ele.ACC.3.M.SG+COND+1+PL
apaulistanizá-lo-ias	apaulistanizar+V.ele.ACC.3.M.SG+COND+2+SG
apaulistanizá-lo-íeis	apaulistanizar+V.ele.ACC.3.M.SG+COND+2+PL
apaulistanizá-los-á	apaulistanizar+V.ele.ACC.3.M.PL+FUT+3+SG
apaulistanizá-los-ão	apaulistanizar+V.ele.ACC.3.M.PL+FUT+3+PL
apaulistanizá-los	apaulistanizar+V.ele.ACC.3.M.PL+INF+1+SG
apaulistanizá-los	apaulistanizar+V.ele.ACC.3.M.PL+INF+3+SG
apaulistaniza-los	apaulistanizar+V.ele.ACC.3.M.PL+PRS+2+SG
apaulistanizá-los	apaulistanizar+V.ele.ACC.3.M.PL+SBJF+1+SG
apaulistanizá-los	apaulistanizar+V.ele.ACC.3.M.PL+SBJF+3+SG
apaulistanizá-los-ás	apaulistanizar+V.ele.ACC.3.M.PL+FUT+2+SG
apaulistanizá-los-ei	apaulistanizar+V.ele.ACC.3.M.PL+FUT+1+SG
apaulistanizá-los-eis	apaulistanizar+V.ele.ACC.3.M.PL+FUT+2+PL
apaulistanizá-los-emos	apaulistanizar+V.ele.ACC.3.M.PL+FUT+1+PL
apaulistanizá-los-ia	apaulistanizar+V.ele.ACC.3.M.PL+COND+1+SG
apaulistanizá-los-ia	apaulistanizar+V.ele.ACC.3.M.PL+COND+3+SG
apaulistanizá-los-iam	apaulistanizar+V.ele.ACC.3.M.PL+COND+3+PL
apaulistanizá-los-íamos	apaulistanizar+V.ele.ACC.3.M.PL+COND+1+PL
apaulistanizá-los-ias	apaulistanizar+V.ele.ACC.3.M.PL+COND+2+SG
apaulistanizá-los-íeis	apaulistanizar+V.ele.ACC.3.M.PL+COND+2+PL
apaulistaniza-me	apaulistanizar+V.eu.AD.1.SG+PRS+3+SG
apaulistanizam-lhe	apaulistanizar+V.ele.DAT.3.SG+PRS+3+PL
apaulistanizam-lhes	apaulistanizar+V.ele.DAT.3.PL+PRS+3+PL
apaulistanizam-me	apaulistanizar+V.eu.AD.1.SG+PRS+3+PL
apaulistanizam-na	apaulistanizar+V.ele.ACC.3.F.SG+PRS+3+PL
apaulistanizam-nas	apaulistanizar+V.ele.ACC.3.F.PL+PRS+3+PL
apaulistanizam-no	apaulistanizar+V.ele.ACC.3.M.SG+PRS+3+PL
apaulistanizam-nos	apaulistanizar+V.ele.ACC.3.M.PL+PRS+3+PL
apaulistanizam-nos	apaulistanizar+V.nós.AD.1.PL+PRS+3+PL
apaulistanizamo-la	apaulistanizar+V.ele.ACC.3.F.SG+PRF+1+PL
apaulistanizamo-la	apaulistanizar+V.ele.ACC.3.F.SG+PRS+1+PL
apaulistanizamo-las	apaulistanizar+V.ele.ACC.3.F.PL+PRF+1+PL
apaulistanizamo-las	apaulistanizar+V.ele.ACC.3.F.PL+PRS+1+PL
apaulistanizamo-lo	apaulistanizar+V.ele.ACC.3.M.SG+PRF+1+PL
apaulistanizamo-lo	apaulistanizar+V.ele.ACC.3.M.SG+PRS+1+PL
apaulistanizamo-los	apaulistanizar+V.ele.ACC.3.M.PL+PRF+1+PL
apaulistanizamo-los	apaulistanizar+V.ele.ACC.3.M.PL+PRS+1+PL
apaulistanizamo-nos	apaulistanizar+nós.AD.1.PL+PRF+1+PL
apaulistanizamo-nos	apaulistanizar+nós.AD.1.PL+PRS+1+PL
apaulistanizamos-lhe	apaulistanizar+V.ele.DAT.3.SG+PRF+1+PL
apaulistanizamos-lhe	apaulistanizar+V.ele.DAT.3.SG+PRS+1+PL
apaulistanizamos-lhes	apaulistanizar+V.ele.DAT.3.PL+PRF+1+PL
apaulistanizamos-lhes	apaulistanizar+V.ele.DAT.3.PL+PRS+1+PL
apaulistanizamos-me	apaulistanizar+V.eu.AD.1.SG+PRF+1+PL
apaulistanizamos-me	apaulistanizar+V.eu.AD.1.SG+PRS+1+PL
apaulistanizamos-te	apaulistanizar+V.tu.AD.2.SG+PRF+1+PL
apaulistanizamos-te	apaulistanizar+V.tu.AD.2.SG+PRS+1+PL
apaulistanizamos-vos	apaulistanizar+V.vós.AD.2.PL+PRF+1+PL
apaulistanizamos-vos	apaulistanizar+V.vós.AD.2.PL+PRS+1+PL
apaulistanizam-se	apaulistanizar+V.ele.REFL+PRS+3+PL
apaulistanizam-te	apaulistanizar+V.tu.AD.2.SG+PRS+3+PL
apaulistanizam-vos	apaulistanizar+V.vós.AD.2.PL+PRS+3+PL
apaulistanizando-a	apaulistanizar+V.ele.ACC.3.F.SG+GRD
apaulistanizando-as	apaulistanizar+V.ele.ACC.3.F.PL+GRD
apaulistanizando-lhe	apaulistanizar+V.ele.DAT.3.SG+GRD
apaulistanizando-lhes	apaulistanizar+V.ele.DAT.3.PL+GRD
apaulistanizando-me	apaulistanizar+V.eu.AD.1.SG+GRD
apaulistanizando-nos	apaulistanizar+nós.AD.1.PL+GRD
apaulistanizando-o	apaulistanizar+V.ele.ACC.3.M.SG+GRD
apaulistanizando-os	apaulistanizar+V.ele.ACC.3.M.PL+GRD
apaulistanizando-se	apaulistanizar+V.ele.REFL+GRD
apaulistanizando-te	apaulistanizar+V.tu.AD.2.SG+GRD
apaulistanizando-vos	apaulistanizar+V.vós.AD.2.PL+GRD
apaulistaniza-nos	apaulistanizar+nós.AD.1.PL+PRS+2+SG
apaulistaniza-nos	apaulistanizar+nós.AD.1.PL+PRS+3+SG
apaulistaniza-o	apaulistanizar+V.ele.ACC.3.M.SG+PRS+3+SG
apaulistaniza-os	apaulistanizar+V.ele.ACC.3.M.PL+PRS+3+SG
apaulistanizara-a	apaulistanizar+V.ele.ACC.3.F.SG+PQP+1+SG
apaulistanizara-a	apaulistanizar+V.ele.ACC.3.F.SG+PQP+3+SG
apaulistanizara-as	apaulistanizar+V.ele.ACC.3.F.PL+PQP+1+SG
apaulistanizara-as	apaulistanizar+V.ele.ACC.3.F.PL+PQP+3+SG
apaulistanizara-la	apaulistanizar+V.ele.ACC.3.F.SG+PQP+2+SG
apaulistanizara-las	apaulistanizar+V.ele.ACC.3.F.PL+PQP+2+SG
apaulistanizara-lhe	apaulistanizar+V.ele.DAT.3.SG+PQP+1+SG
apaulistanizara-lhe	apaulistanizar+V.ele.DAT.3.SG+PQP+3+SG
apaulistanizara-lhes	apaulistanizar+V.ele.DAT.3.PL+PQP+1+SG
apaulistanizara-lhes	apaulistanizar+V.ele.DAT.3.PL+PQP+3+SG
apaulistanizara-lo	apaulistanizar+V.ele.ACC.3.M.SG+PQP+2+SG
apaulistanizara-los	apaulistanizar+V.ele.ACC.3.M.PL+PQP+2+SG
apaulistanizara-me	apaulistanizar+V.eu.AD.1.SG+PQP+1+SG
apaulistanizara-me	apaulistanizar+V.eu.AD.1.SG+PQP+3+SG
apaulistanizaram-lhe	apaulistanizar+V.ele.DAT.3.SG+PQP+3+PL
apaulistanizaram-lhe	apaulistanizar+V.ele.DAT.3.SG+PRF+3+PL
apaulistanizaram-lhes	apaulistanizar+V.ele.DAT.3.PL+PQP+3+PL
apaulistanizaram-lhes	apaulistanizar+V.ele.DAT.3.PL+PRF+3+PL
apaulistanizaram-me	apaulistanizar+V.eu.AD.1.SG+PQP+3+PL
apaulistanizaram-me	apaulistanizar+V.eu.AD.1.SG+PRF+3+PL
apaulistanizaram-na	apaulistanizar+V.ele.ACC.3.F.SG+PQP+3+PL
apaulistanizaram-na	apaulistanizar+V.ele.ACC.3.F.SG+PRF+3+PL
apaulistanizaram-nas	apaulistanizar+V.ele.ACC.3.F.PL+PQP+3+PL
apaulistanizaram-nas	apaulistanizar+V.ele.ACC.3.F.PL+PRF+3+PL
apaulistanizaram-no	apaulistanizar+V.ele.ACC.3.M.SG+PQP+3+PL
apaulistanizaram-no	apaulistanizar+V.ele.ACC.3.M.SG+PRF+3+PL
apaulistanizaram-nos	apaulistanizar+V.ele.ACC.3.M.PL+PQP+3+PL
apaulistanizaram-nos	apaulistanizar+V.ele.ACC.3.M.PL+PRF+3+PL
apaulistanizaram-nos	apaulistanizar+V.nós.AD.1.PL+PQP+3+PL
apaulistanizaram-nos	apaulistanizar+V.nós.AD.1.PL+PRF+3+PL
apaulistanizáramo-la	apaulistanizar+V.ele.ACC.3.F.SG+PQP+1+PL
apaulistanizáramo-las	apaulistanizar+V.ele.ACC.3.F.PL+PQP+1+PL
apaulistanizáramo-lo	apaulistanizar+V.ele.ACC.3.M.SG+PQP+1+PL
apaulistanizáramo-los	apaulistanizar+V.ele.ACC.3.M.PL+PQP+1+PL
apaulistanizáramo-nos	apaulistanizar+nós.AD.1.PL+PQP+1+PL
apaulistanizáramos-lhe	apaulistanizar+V.ele.DAT.3.SG+PQP+1+PL
apaulistanizáramos-lhes	apaulistanizar+V.ele.DAT.3.PL+PQP+1+PL
apaulistanizáramos-me	apaulistanizar+V.eu.AD.1.SG+PQP+1+PL
apaulistanizáramos-te	apaulistanizar+V.tu.AD.2.SG+PQP+1+PL
apaulistanizáramos-vos	apaulistanizar+V.vós.AD.2.PL+PQP+1+PL
apaulistanizaram-se	apaulistanizar+V.ele.REFL+PQP+3+PL
apaulistanizaram-se	apaulistanizar+V.ele.REFL+PRF+3+PL
apaulistanizaram-te	apaulistanizar+V.tu.AD.2.SG+PQP+3+PL
apaulistanizaram-te	apaulistanizar+V.tu.AD.2.SG+PRF+3+PL
apaulistanizaram-vos	apaulistanizar+V.vós.AD.2.PL+PQP+3+PL
apaulistanizaram-vos	apaulistanizar+V.vós.AD.2.PL+PRF+3+PL
apaulistanizara-nos	apaulistanizar+nós.AD.1.PL+PQP+1+SG
apaulistanizara-nos	apaulistanizar+nós.AD.1.PL+PQP+2+SG
apaulistanizara-nos	apaulistanizar+nós.AD.1.PL+PQP+3+SG
apaulistanizara-o	apaulistanizar+V.ele.ACC.3.M.SG+PQP+1+SG
apaulistanizara-o	apaulistanizar+V.ele.ACC.3.M.SG+PQP+3+SG
apaulistanizara-os	apaulistanizar+V.ele.ACC.3.M.PL+PQP+1+SG
apaulistanizara-os	apaulistanizar+V.ele.ACC.3.M.PL+PQP+3+SG
apaulistanizara-se	apaulistanizar+V.ele.REFL+PQP+1+SG
apaulistanizara-se	apaulistanizar+V.ele.REFL+PQP+3+SG
apaulistanizaras-lhe	apaulistanizar+V.ele.DAT.3.SG+PQP+2+SG
apaulistanizaras-lhes	apaulistanizar+V.ele.DAT.3.PL+PQP+2+SG
apaulistanizaras-me	apaulistanizar+V.eu.AD.1.SG+PQP+2+SG
apaulistanizaras-te	apaulistanizar+V.tu.AD.2.SG+PQP+2+SG
apaulistanizaras-vos	apaulistanizar+V.vós.AD.2.PL+PQP+2+SG
apaulistanizara-te	apaulistanizar+V.tu.AD.2.SG+PQP+1+SG
apaulistanizara-te	apaulistanizar+V.tu.AD.2.SG+PQP+3+SG
apaulistanizara-vos	apaulistanizar+V.vós.AD.2.PL+PQP+1+SG
apaulistanizara-vos	apaulistanizar+V.vós.AD.2.PL+PQP+3+SG
apaulistanizarde-la	apaulistanizar+V.ele.ACC.3.F.SG+INF+2+PL
apaulistanizarde-la	apaulistanizar+V.ele.ACC.3.F.SG+SBJF+2+PL
apaulistanizarde-las	apaulistanizar+V.ele.ACC.3.F.PL+INF+2+PL
apaulistanizarde-las	apaulistanizar+V.ele.ACC.3.F.PL+SBJF+2+PL
apaulistanizarde-lo	apaulistanizar+V.ele.ACC.3.M.SG+INF+2+PL
apaulistanizarde-lo	apaulistanizar+V.ele.ACC.3.M.SG+SBJF+2+PL
apaulistanizarde-los	apaulistanizar+V.ele.ACC.3.M.PL+INF+2+PL
apaulistanizarde-los	apaulistanizar+V.ele.ACC.3.M.PL+SBJF+2+PL
apaulistanizarde-nos	apaulistanizar+nós.AD.1.PL+INF+2+PL
apaulistanizarde-nos	apaulistanizar+nós.AD.1.PL+SBJF+2+PL
apaulistanizardes-lhe	apaulistanizar+V.ele.DAT.3.SG+INF+2+PL
apaulistanizardes-lhe	apaulistanizar+V.ele.DAT.3.SG+SBJF+2+PL
apaulistanizardes-lhes	apaulistanizar+V.ele.DAT.3.PL+INF+2+PL
apaulistanizardes-lhes	apaulistanizar+V.ele.DAT.3.PL+SBJF+2+PL
apaulistanizardes-me	apaulistanizar+V.eu.AD.1.SG+INF+2+PL
apaulistanizardes-me	apaulistanizar+V.eu.AD.1.SG+SBJF+2+PL
apaulistanizardes-te	apaulistanizar+V.tu.AD.2.SG+INF+2+PL
apaulistanizardes-te	apaulistanizar+V.tu.AD.2.SG+SBJF+2+PL
apaulistanizardes-vos	apaulistanizar+V.vós.AD.2.PL+INF+2+PL
apaulistanizardes-vos	apaulistanizar+V.vós.AD.2.PL+SBJF+2+PL
apaulistanizárei-la	apaulistanizar+V.ele.ACC.3.F.SG+PQP+2+PL
apaulistanizárei-las	apaulistanizar+V.ele.ACC.3.F.PL+PQP+2+PL
apaulistanizárei-lo	apaulistanizar+V.ele.ACC.3.M.SG+PQP+2+PL
apaulistanizárei-los	apaulistanizar+V.ele.ACC.3.M.PL+PQP+2+PL
apaulistanizárei-nos	apaulistanizar+nós.AD.1.PL+PQP+2+PL
apaulistanizáreis-lhe	apaulistanizar+V.ele.DAT.3.SG+PQP+2+PL
apaulistanizáreis-lhes	apaulistanizar+V.ele.DAT.3.PL+PQP+2+PL
apaulistanizáreis-me	apaulistanizar+V.eu.AD.1.SG+PQP+2+PL
apaulistanizáreis-te	apaulistanizar+V.tu.AD.2.SG+PQP+2+PL
apaulistanizáreis-vos	apaulistanizar+V.vós.AD.2.PL+PQP+2+PL
apaulistanizare-la	apaulistanizar+V.ele.ACC.3.F.SG+INF+2+SG
apaulistanizare-la	apaulistanizar+V.ele.ACC.3.F.SG+SBJF+2+SG
apaulistanizare-las	apaulistanizar+V.ele.ACC.3.F.PL+INF+2+SG
apaulistanizare-las	apaulistanizar+V.ele.ACC.3.F.PL+SBJF+2+SG
apaulistanizare-lo	apaulistanizar+V.ele.ACC.3.M.SG+INF+2+SG
apaulistanizare-lo	apaulistanizar+V.ele.ACC.3.M.SG+SBJF+2+SG
apaulistanizare-los	apaulistanizar+V.ele.ACC.3.M.PL+INF+2+SG
apaulistanizare-los	apaulistanizar+V.ele.ACC.3.M.PL+SBJF+2+SG
apaulistanizarem-lhe	apaulistanizar+V.ele.DAT.3.SG+INF+3+PL
apaulistanizarem-lhe	apaulistanizar+V.ele.DAT.3.SG+SBJF+3+PL
apaulistanizarem-lhes	apaulistanizar+V.ele.DAT.3.PL+INF+3+PL
apaulistanizarem-lhes	apaulistanizar+V.ele.DAT.3.PL+SBJF+3+PL
apaulistanizarem-me	apaulistanizar+V.eu.AD.1.SG+INF+3+PL
apaulistanizarem-me	apaulistanizar+V.eu.AD.1.SG+SBJF+3+PL
apaulistanizarem-na	apaulistanizar+V.ele.ACC.3.F.SG+INF+3+PL
apaulistanizarem-na	apaulistanizar+V.ele.ACC.3.F.SG+SBJF+3+PL
apaulistanizarem-nas	apaulistanizar+V.ele.ACC.3.F.PL+INF+3+PL
apaulistanizarem-nas	apaulistanizar+V.ele.ACC.3.F.PL+SBJF+3+PL
apaulistanizarem-no	apaulistanizar+V.ele.ACC.3.M.SG+INF+3+PL
apaulistanizarem-no	apaulistanizar+V.ele.ACC.3.M.SG+SBJF+3+PL
apaulistanizarem-nos	apaulistanizar+V.ele.ACC.3.M.PL+INF+3+PL
apaulistanizarem-nos	apaulistanizar+V.ele.ACC.3.M.PL+SBJF+3+PL
apaulistanizarem-nos	apaulistanizar+V.nós.AD.1.PL+INF+3+PL
apaulistanizarem-nos	apaulistanizar+V.nós.AD.1.PL+SBJF+3+PL
apaulistanizarem-se	apaulistanizar+V.ele.REFL+INF+3+PL
apaulistanizarem-se	apaulistanizar+V.ele.REFL+SBJF+3+PL
apaulistanizarem-te	apaulistanizar+V.tu.AD.2.SG+INF+3+PL
apaulistanizarem-te	apaulistanizar+V.tu.AD.2.SG+SBJF+3+PL
apaulistanizarem-vos	apaulistanizar+V.vós.AD.2.PL+INF+3+PL
apaulistanizarem-vos	apaulistanizar+V.vós.AD.2.PL+SBJF+3+PL
apaulistanizare-nos	apaulistanizar+nós.AD.1.PL+INF+2+SG
apaulistanizare-nos	apaulistanizar+nós.AD.1.PL+SBJF+2+SG
apaulistanizares-lhe	apaulistanizar+V.ele.DAT.3.SG+INF+2+SG
apaulistanizares-lhe	apaulistanizar+V.ele.DAT.3.SG+SBJF+2+SG
apaulistanizares-lhes	apaulistanizar+V.ele.DAT.3.PL+INF+2+SG
apaulistanizares-lhes	apaulistanizar+V.ele.DAT.3.PL+SBJF+2+SG
apaulistanizares-me	apaulistanizar+V.eu.AD.1.SG+INF+2+SG
apaulistanizares-me	apaulistanizar+V.eu.AD.1.SG+SBJF+2+SG
apaulistanizares-te	apaulistanizar+V.tu.AD.2.SG+INF+2+SG
apaulistanizares-te	apaulistanizar+V.tu.AD.2.SG+SBJF+2+SG
apaulistanizares-vos	apaulistanizar+V.vós.AD.2.PL+INF+2+SG
apaulistanizares-vos	apaulistanizar+V.vós.AD.2.PL+SBJF+2+SG
apaulistanizar-lhe-á	apaulistanizar+V.ele.DAT.3.SG+FUT+3+SG
apaulistanizar-lhe-ão	apaulistanizar+V.ele.DAT.3.SG+FUT+3+PL
apaulistanizar-lhe	apaulistanizar+V.ele.DAT.3.SG+INF
apaulistanizar-lhe	apaulistanizar+V.ele.DAT.3.SG+INF+1+SG
apaulistanizar-lhe	apaulistanizar+V.ele.DAT.3.SG+INF+3+SG
apaulistanizar-lhe	apaulistanizar+V.ele.DAT.3.SG+SBJF+1+SG
apaulistanizar-lhe	apaulistanizar+V.ele.DAT.3.SG+SBJF+3+SG
apaulistanizar-lhe-ás	apaulistanizar+V.ele.DAT.3.SG+FUT+2+SG
apaulistanizar-lhe-ei	apaulistanizar+V.ele.DAT.3.SG+FUT+1+SG
apaulistanizar-lhe-eis	apaulistanizar+V.ele.DAT.3.SG+FUT+2+PL
apaulistanizar-lhe-emos	apaulistanizar+V.ele.DAT.3.SG+FUT+1+PL
apaulistanizar-lhe-ia	apaulistanizar+V.ele.DAT.3.SG+COND+1+SG
apaulistanizar-lhe-ia	apaulistanizar+V.ele.DAT.3.SG+COND+3+SG
apaulistanizar-lhe-iam	apaulistanizar+V.ele.DAT.3.SG+COND+3+PL
apaulistanizar-lhe-íamos	apaulistanizar+V.ele.DAT.3.SG+COND+1+PL
apaulistanizar-lhe-ias	apaulistanizar+V.ele.DAT.3.SG+COND+2+SG
apaulistanizar-lhe-íeis	apaulistanizar+V.ele.DAT.3.SG+COND+2+PL
apaulistanizar-lhes-á	apaulistanizar+V.ele.DAT.3.PL+FUT+3+SG
apaulistanizar-lhes-ão	apaulistanizar+V.ele.DAT.3.PL+FUT+3+PL
apaulistanizar-lhes	apaulistanizar+V.ele.DAT.3.PL+INF
apaulistanizar-lhes	apaulistanizar+V.ele.DAT.3.PL+INF+1+SG
apaulistanizar-lhes	apaulistanizar+V.ele.DAT.3.PL+INF+3+SG
apaulistanizar-lhes	apaulistanizar+V.ele.DAT.3.PL+SBJF+1+SG
apaulistanizar-lhes	apaulistanizar+V.ele.DAT.3.PL+SBJF+3+SG
apaulistanizar-lhes-ás	apaulistanizar+V.ele.DAT.3.PL+FUT+2+SG
apaulistanizar-lhes-ei	apaulistanizar+V.ele.DAT.3.PL+FUT+1+SG
apaulistanizar-lhes-eis	apaulistanizar+V.ele.DAT.3.PL+FUT+2+PL
apaulistanizar-lhes-emos	apaulistanizar+V.ele.DAT.3.PL+FUT+1+PL
apaulistanizar-lhes-ia	apaulistanizar+V.ele.DAT.3.PL+COND+1+SG
apaulistanizar-lhes-ia	apaulistanizar+V.ele.DAT.3.PL+COND+3+SG
apaulistanizar-lhes-iam	apaulistanizar+V.ele.DAT.3.PL+COND+3+PL
apaulistanizar-lhes-íamos	apaulistanizar+V.ele.DAT.3.PL+COND+1+PL
apaulistanizar-lhes-ias	apaulistanizar+V.ele.DAT.3.PL+COND+2+SG
apaulistanizar-lhes-íeis	apaulistanizar+V.ele.DAT.3.PL+COND+2+PL
apaulistanizar-me-á	apaulistanizar+V.eu.AD.1.SG+FUT+3+SG
apaulistanizar-me-ão	apaulistanizar+V.eu.AD.1.SG+FUT+3+PL
apaulistanizar-me	apaulistanizar+V.eu.AD.1.SG+INF
apaulistanizar-me	apaulistanizar+V.eu.AD.1.SG+INF+1+SG
apaulistanizar-me	apaulistanizar+V.eu.AD.1.SG+INF+3+SG
apaulistanizar-me	apaulistanizar+V.eu.AD.1.SG+SBJF+1+SG
apaulistanizar-me	apaulistanizar+V.eu.AD.1.SG+SBJF+3+SG
apaulistanizar-me-ás	apaulistanizar+V.eu.AD.1.SG+FUT+2+SG
apaulistanizar-me-ei	apaulistanizar+V.eu.AD.1.SG+FUT+1+SG
apaulistanizar-me-eis	apaulistanizar+V.eu.AD.1.SG+FUT+2+PL
apaulistanizar-me-emos	apaulistanizar+V.eu.AD.1.SG+FUT+1+PL
apaulistanizar-me-ia	apaulistanizar+V.eu.AD.1.SG+COND+1+SG
apaulistanizar-me-ia	apaulistanizar+V.eu.AD.1.SG+COND+3+SG
apaulistanizar-me-iam	apaulistanizar+V.eu.AD.1.SG+COND+3+PL
apaulistanizar-me-íamos	apaulistanizar+V.eu.AD.1.SG+COND+1+PL
apaulistanizar-me-ias	apaulistanizar+V.eu.AD.1.SG+COND+2+SG
apaulistanizar-me-íeis	apaulistanizar+V.eu.AD.1.SG+COND+2+PL
apaulistanizarmo-la	apaulistanizar+V.ele.ACC.3.F.SG+INF+1+PL
apaulistanizarmo-la	apaulistanizar+V.ele.ACC.3.F.SG+SBJF+1+PL
apaulistanizarmo-las	apaulistanizar+V.ele.ACC.3.F.PL+INF+1+PL
apaulistanizarmo-las	apaulistanizar+V.ele.ACC.3.F.PL+SBJF+1+PL
apaulistanizarmo-lo	apaulistanizar+V.ele.ACC.3.M.SG+INF+1+PL
apaulistanizarmo-lo	apaulistanizar+V.ele.ACC.3.M.SG+SBJF+1+PL
apaulistanizarmo-los	apaulistanizar+V.ele.ACC.3.M.PL+INF+1+PL
apaulistanizarmo-los	apaulistanizar+V.ele.ACC.3.M.PL+SBJF+1+PL
apaulistanizarmo-nos	apaulistanizar+nós.AD.1.PL+INF+1+PL
apaulistanizarmo-nos	apaulistanizar+nós.AD.1.PL+SBJF+1+PL
apaulistanizarmos-lhe	apaulistanizar+V.ele.DAT.3.SG+INF+1+PL
apaulistanizarmos-lhe	apaulistanizar+V.ele.DAT.3.SG+SBJF+1+PL
apaulistanizarmos-lhes	apaulistanizar+V.ele.DAT.3.PL+INF+1+PL
apaulistanizarmos-lhes	apaulistanizar+V.ele.DAT.3.PL+SBJF+1+PL
apaulistanizarmos-me	apaulistanizar+V.eu.AD.1.SG+INF+1+PL
apaulistanizarmos-me	apaulistanizar+V.eu.AD.1.SG+SBJF+1+PL
apaulistanizarmos-te	apaulistanizar+V.tu.AD.2.SG+INF+1+PL
apaulistanizarmos-te	apaulistanizar+V.tu.AD.2.SG+SBJF+1+PL
apaulistanizarmos-vos	apaulistanizar+V.vós.AD.2.PL+INF+1+PL
apaulistanizarmos-vos	apaulistanizar+V.vós.AD.2.PL+SBJF+1+PL
apaulistanizar-nos-á	apaulistanizar+nós.AD.1.PL+FUT+3+SG
apaulistanizar-nos-ão	apaulistanizar+nós.AD.1.PL+FUT+3+PL
apaulistanizar-nos	apaulistanizar+nós.AD.1.PL+INF
apaulistanizar-nos	apaulistanizar+nós.AD.1.PL+INF+1+SG
apaulistanizar-nos	apaulistanizar+nós.AD.1.PL+INF+3+SG
apaulistanizar-nos	apaulistanizar+nós.AD.1.PL+SBJF+1+SG
apaulistanizar-nos	apaulistanizar+nós.AD.1.PL+SBJF+3+SG
apaulistanizar-nos-ás	apaulistanizar+nós.AD.1.PL+FUT+2+SG
apaulistanizar-nos-ei	apaulistanizar+nós.AD.1.PL+FUT+1+SG
apaulistanizar-nos-eis	apaulistanizar+nós.AD.1.PL+FUT+2+PL
apaulistanizar-nos-emos	apaulistanizar+nós.AD.1.PL+FUT+1+PL
apaulistanizar-nos-ia	apaulistanizar+nós.AD.1.PL+COND+1+SG
apaulistanizar-nos-ia	apaulistanizar+nós.AD.1.PL+COND+3+SG
apaulistanizar-nos-iam	apaulistanizar+nós.AD.1.PL+COND+3+PL
apaulistanizar-nos-íamos	apaulistanizar+nós.AD.1.PL+COND+1+PL
apaulistanizar-nos-ias	apaulistanizar+nós.AD.1.PL+COND+2+SG
apaulistanizar-nos-íeis	apaulistanizar+nós.AD.1.PL+COND+2+PL
apaulistanizar-se-á	apaulistanizar+V.ele.REFL+FUT+3+SG
apaulistanizar-se-ão	apaulistanizar+V.ele.REFL+FUT+3+PL
apaulistanizar-se	apaulistanizar+V.ele.REFL+INF
apaulistanizar-se	apaulistanizar+V.ele.REFL+INF+3+SG
apaulistanizar-se	apaulistanizar+V.ele.REFL+SBJF+3+SG
apaulistanizar-se-ia	apaulistanizar+V.ele.REFL+COND+3+SG
apaulistanizar-se-iam	apaulistanizar+V.ele.REFL+COND+3+PL
apaulistanizar-te-á	apaulistanizar+V.tu.AD.2.SG+FUT+3+SG
apaulistanizar-te-ão	apaulistanizar+V.tu.AD.2.SG+FUT+3+PL
apaulistanizar-te	apaulistanizar+V.tu.AD.2.SG+INF
apaulistanizar-te	apaulistanizar+V.tu.AD.2.SG+INF+1+SG
apaulistanizar-te	apaulistanizar+V.tu.AD.2.SG+INF+3+SG
apaulistanizar-te	apaulistanizar+V.tu.AD.2.SG+SBJF+1+SG
apaulistanizar-te	apaulistanizar+V.tu.AD.2.SG+SBJF+3+SG
apaulistanizar-te-ás	apaulistanizar+V.tu.AD.2.SG+FUT+2+SG
apaulistanizar-te-ei	apaulistanizar+V.tu.AD.2.SG+FUT+1+SG
apaulistanizar-te-eis	apaulistanizar+V.tu.AD.2.SG+FUT+2+PL
apaulistanizar-te-emos	apaulistanizar+V.tu.AD.2.SG+FUT+1+PL
apaulistanizar-te-ia	apaulistanizar+V.tu.AD.2.SG+COND+1+SG
apaulistanizar-te-ia	apaulistanizar+V.tu.AD.2.SG+COND+3+SG
apaulistanizar-te-iam	apaulistanizar+V.tu.AD.2.SG+COND+3+PL
apaulistanizar-te-íamos	apaulistanizar+V.tu.AD.2.SG+COND+1+PL
apaulistanizar-te-ias	apaulistanizar+V.tu.AD.2.SG+COND+2+SG
apaulistanizar-te-íeis	apaulistanizar+V.tu.AD.2.SG+COND+2+PL
apaulistanizar-vos-á	apaulistanizar+V.vós.AD.2.PL+FUT+3+SG
apaulistanizar-vos-ão	apaulistanizar+V.vós.AD.2.PL+FUT+3+PL
apaulistanizar-vos	apaulistanizar+V.vós.AD.2.PL+INF
apaulistanizar-vos	apaulistanizar+V.vós.AD.2.PL+INF+1+SG
apaulistanizar-vos	apaulistanizar+V.vós.AD.2.PL+INF+3+SG
apaulistanizar-vos	apaulistanizar+V.vós.AD.2.PL+SBJF+1+SG
apaulistanizar-vos	apaulistanizar+V.vós.AD.2.PL+SBJF+3+SG
apaulistanizar-vos-ás	apaulistanizar+V.vós.AD.2.PL+FUT+2+SG
apaulistanizar-vos-ei	apaulistanizar+V.vós.AD.2.PL+FUT+1+SG
apaulistanizar-vos-eis	apaulistanizar+V.vós.AD.2.PL+FUT+2+PL
apaulistanizar-vos-emos	apaulistanizar+V.vós.AD.2.PL+FUT+1+PL
apaulistanizar-vos-ia	apaulistanizar+V.vós.AD.2.PL+COND+1+SG
apaulistanizar-vos-ia	apaulistanizar+V.vós.AD.2.PL+COND+3+SG
apaulistanizar-vos-iam	apaulistanizar+V.vós.AD.2.PL+COND+3+PL
apaulistanizar-vos-íamos	apaulistanizar+V.vós.AD.2.PL+COND+1+PL
apaulistanizar-vos-ias	apaulistanizar+V.vós.AD.2.PL+COND+2+SG
apaulistanizar-vos-íeis	apaulistanizar+V.vós.AD.2.PL+COND+2+PL
apaulistaniza-se	apaulistanizar+V.ele.REFL+PRS+3+SG
apaulistanizas-lhe	apaulistanizar+V.ele.DAT.3.SG+PRS+2+SG
apaulistanizas-lhes	apaulistanizar+V.ele.DAT.3.PL+PRS+2+SG
apaulistanizas-me	apaulistanizar+V.eu.AD.1.SG+PRS+2+SG
apaulistanizaste-a	apaulistanizar+V.ele.ACC.3.F.SG+PRF+2+SG
apaulistanizas-te	apaulistanizar+V.tu.AD.2.SG+PRS+2+SG
apaulistanizaste-as	apaulistanizar+V.ele.ACC.3.F.PL+PRF+2+SG
apaulistanizaste-la	apaulistanizar+V.ele.ACC.3.F.SG+PRF+2+PL
apaulistanizaste-las	apaulistanizar+V.ele.ACC.3.F.PL+PRF+2+PL
apaulistanizaste-lhe	apaulistanizar+V.ele.DAT.3.SG+PRF+2+SG
apaulistanizaste-lhes	apaulistanizar+V.ele.DAT.3.PL+PRF+2+SG
apaulistanizaste-lo	apaulistanizar+V.ele.ACC.3.M.SG+PRF+2+PL
apaulistanizaste-los	apaulistanizar+V.ele.ACC.3.M.PL+PRF+2+PL
apaulistanizaste-me	apaulistanizar+V.eu.AD.1.SG+PRF+2+SG
apaulistanizaste-nos	apaulistanizar+nós.AD.1.PL+PRF+2+PL
apaulistanizaste-nos	apaulistanizar+nós.AD.1.PL+PRF+2+SG
apaulistanizaste-o	apaulistanizar+V.ele.ACC.3.M.SG+PRF+2+SG
apaulistanizaste-os	apaulistanizar+V.ele.ACC.3.M.PL+PRF+2+SG
apaulistanizastes-lhe	apaulistanizar+V.ele.DAT.3.SG+PRF+2+PL
apaulistanizastes-lhes	apaulistanizar+V.ele.DAT.3.PL+PRF+2+PL
apaulistanizastes-me	apaulistanizar+V.eu.AD.1.SG+PRF+2+PL
apaulistanizastes-te	apaulistanizar+V.tu.AD.2.SG+PRF+2+PL
apaulistanizastes-vos	apaulistanizar+V.vós.AD.2.PL+PRF+2+PL
apaulistanizaste-te	apaulistanizar+V.tu.AD.2.SG+PRF+2+SG
apaulistanizaste-vos	apaulistanizar+V.vós.AD.2.PL+PRF+2+SG
apaulistanizas-vos	apaulistanizar+V.vós.AD.2.PL+PRS+2+SG
apaulistaniza-te	apaulistanizar+V.tu.AD.2.SG+PRS+3+SG
apaulistanizava-a	apaulistanizar+V.ele.ACC.3.F.SG+IMPF+1+SG
apaulistanizava-a	apaulistanizar+V.ele.ACC.3.F.SG+IMPF+3+SG
apaulistanizava-as	apaulistanizar+V.ele.ACC.3.F.PL+IMPF+1+SG
apaulistanizava-as	apaulistanizar+V.ele.ACC.3.F.PL+IMPF+3+SG
apaulistanizava-la	apaulistanizar+V.ele.ACC.3.F.SG+IMPF+2+SG
apaulistanizava-las	apaulistanizar+V.ele.ACC.3.F.PL+IMPF+2+SG
apaulistanizava-lhe	apaulistanizar+V.ele.DAT.3.SG+IMPF+1+SG
apaulistanizava-lhe	apaulistanizar+V.ele.DAT.3.SG+IMPF+3+SG
apaulistanizava-lhes	apaulistanizar+V.ele.DAT.3.PL+IMPF+1+SG
apaulistanizava-lhes	apaulistanizar+V.ele.DAT.3.PL+IMPF+3+SG
apaulistanizava-lo	apaulistanizar+V.ele.ACC.3.M.SG+IMPF+2+SG
apaulistanizava-los	apaulistanizar+V.ele.ACC.3.M.PL+IMPF+2+SG
apaulistanizava-me	apaulistanizar+V.eu.AD.1.SG+IMPF+1+SG
apaulistanizava-me	apaulistanizar+V.eu.AD.1.SG+IMPF+3+SG
apaulistanizavam-lhe	apaulistanizar+V.ele.DAT.3.SG+IMPF+3+PL
apaulistanizavam-lhes	apaulistanizar+V.ele.DAT.3.PL+IMPF+3+PL
apaulistanizavam-me	apaulistanizar+V.eu.AD.1.SG+IMPF+3+PL
apaulistanizavam-na	apaulistanizar+V.ele.ACC.3.F.SG+IMPF+3+PL
apaulistanizavam-nas	apaulistanizar+V.ele.ACC.3.F.PL+IMPF+3+PL
apaulistanizavam-no	apaulistanizar+V.ele.ACC.3.M.SG+IMPF+3+PL
apaulistanizavam-nos	apaulistanizar+V.ele.ACC.3.M.PL+IMPF+3+PL
apaulistanizavam-nos	apaulistanizar+V.nós.AD.1.PL+IMPF+3+PL
apaulistanizávamo-la	apaulistanizar+V.ele.ACC.3.F.SG+IMPF+1+PL
apaulistanizávamo-las	apaulistanizar+V.ele.ACC.3.F.PL+IMPF+1+PL
apaulistanizávamo-lo	apaulistanizar+V.ele.ACC.3.M.SG+IMPF+1+PL
apaulistanizávamo-los	apaulistanizar+V.ele.ACC.3.M.PL+IMPF+1+PL
apaulistanizávamo-nos	apaulistanizar+nós.AD.1.PL+IMPF+1+PL
apaulistanizávamos-lhe	apaulistanizar+V.ele.DAT.3.SG+IMPF+1+PL
apaulistanizávamos-lhes	apaulistanizar+V.ele.DAT.3.PL+IMPF+1+PL
apaulistanizávamos-me	apaulistanizar+V.eu.AD.1.SG+IMPF+1+PL
apaulistanizávamos-te	apaulistanizar+V.tu.AD.2.SG+IMPF+1+PL
apaulistanizávamos-vos	apaulistanizar+V.vós.AD.2.PL+IMPF+1+PL
apaulistanizavam-se	apaulistanizar+V.ele.REFL+IMPF+3+PL
apaulistanizavam-te	apaulistanizar+V.tu.AD.2.SG+IMPF+3+PL
apaulistanizavam-vos	apaulistanizar+V.vós.AD.2.PL+IMPF+3+PL
apaulistanizava-nos	apaulistanizar+nós.AD.1.PL+IMPF+1+SG
apaulistanizava-nos	apaulistanizar+nós.AD.1.PL+IMPF+2+SG
apaulistanizava-nos	apaulistanizar+nós.AD.1.PL+IMPF+3+SG
apaulistanizava-o	apaulistanizar+V.ele.ACC.3.M.SG+IMPF+1+SG
apaulistanizava-o	apaulistanizar+V.ele.ACC.3.M.SG+IMPF+3+SG
apaulistanizava-os	apaulistanizar+V.ele.ACC.3.M.PL+IMPF+1+SG
apaulistanizava-os	apaulistanizar+V.ele.ACC.3.M.PL+IMPF+3+SG
apaulistanizava-se	apaulistanizar+V.ele.REFL+IMPF+1+SG
apaulistanizava-se	apaulistanizar+V.ele.REFL+IMPF+3+SG
apaulistanizavas-lhe	apaulistanizar+V.ele.DAT.3.SG+IMPF+2+SG
apaulistanizavas-lhes	apaulistanizar+V.ele.DAT.3.PL+IMPF+2+SG
apaulistanizavas-me	apaulistanizar+V.eu.AD.1.SG+IMPF+2+SG
apaulistanizavas-te	apaulistanizar+V.tu.AD.2.SG+IMPF+2+SG
apaulistanizavas-vos	apaulistanizar+V.vós.AD.2.PL+IMPF+2+SG
apaulistanizava-te	apaulistanizar+V.tu.AD.2.SG+IMPF+1+SG
apaulistanizava-te	apaulistanizar+V.tu.AD.2.SG+IMPF+3+SG
apaulistanizava-vos	apaulistanizar+V.vós.AD.2.PL+IMPF+1+SG
apaulistanizava-vos	apaulistanizar+V.vós.AD.2.PL+IMPF+3+SG
apaulistanizávei-la	apaulistanizar+V.ele.ACC.3.F.SG+IMPF+2+PL
apaulistanizávei-las	apaulistanizar+V.ele.ACC.3.F.PL+IMPF+2+PL
apaulistanizávei-lo	apaulistanizar+V.ele.ACC.3.M.SG+IMPF+2+PL
apaulistanizávei-los	apaulistanizar+V.ele.ACC.3.M.PL+IMPF+2+PL
apaulistanizávei-nos	apaulistanizar+nós.AD.1.PL+IMPF+2+PL
apaulistanizáveis-lhe	apaulistanizar+V.ele.DAT.3.SG+IMPF+2+PL
apaulistanizáveis-lhes	apaulistanizar+V.ele.DAT.3.PL+IMPF+2+PL
apaulistanizáveis-me	apaulistanizar+V.eu.AD.1.SG+IMPF+2+PL
apaulistanizáveis-te	apaulistanizar+V.tu.AD.2.SG+IMPF+2+PL
apaulistanizáveis-vos	apaulistanizar+V.vós.AD.2.PL+IMPF+2+PL
apaulistaniza-vos	apaulistanizar+V.vós.AD.2.PL+PRS+3+SG
apaulistanize-a	apaulistanizar+V.ele.ACC.3.F.SG+IMP+3+SG
apaulistanize-as	apaulistanizar+V.ele.ACC.3.F.PL+IMP+3+SG
apaulistanizei-a	apaulistanizar+V.ele.ACC.3.F.SG+PRF+1+SG
apaulistanizei-as	apaulistanizar+V.ele.ACC.3.F.PL+PRF+1+SG
apaulistanizei-lhe	apaulistanizar+V.ele.DAT.3.SG+PRF+1+SG
apaulistanizei-lhes	apaulistanizar+V.ele.DAT.3.PL+PRF+1+SG
apaulistanizei-me	apaulistanizar+V.eu.AD.1.SG+PRF+1+SG
apaulistanizei-nos	apaulistanizar+nós.AD.1.PL+PRF+1+SG
apaulistanizei-o	apaulistanizar+V.ele.ACC.3.M.SG+PRF+1+SG
apaulistanizei-os	apaulistanizar+V.ele.ACC.3.M.PL+PRF+1+SG
apaulistanizei-te	apaulistanizar+V.tu.AD.2.SG+PRF+1+SG
apaulistanizei-vos	apaulistanizar+V.vós.AD.2.PL+PRF+1+SG
apaulistanize-lhe	apaulistanizar+V.ele.DAT.3.SG+IMP+3+SG
apaulistanize-lhes	apaulistanizar+V.ele.DAT.3.PL+IMP+3+SG
apaulistanize-me	apaulistanizar+V.eu.AD.1.SG+IMP+3+SG
apaulistanizem-lhe	apaulistanizar+V.ele.DAT.3.SG+IMP+3+PL
apaulistanizem-lhes	apaulistanizar+V.ele.DAT.3.PL+IMP+3+PL
apaulistanizem-me	apaulistanizar+V.eu.AD.1.SG+IMP+3+PL
apaulistanizem-na	apaulistanizar+V.ele.ACC.3.F.SG+IMP+3+PL
apaulistanizem-nas	apaulistanizar+V.ele.ACC.3.F.PL+IMP+3+PL
apaulistanizem-no	apaulistanizar+V.ele.ACC.3.M.SG+IMP+3+PL
apaulistanizem-nos	apaulistanizar+V.ele.ACC.3.M.PL+IMP+3+PL
apaulistanizem-nos	apaulistanizar+V.nós.AD.1.PL+IMP+3+PL
apaulistanizemo-la	apaulistanizar+V.ele.ACC.3.F.SG+IMP+1+PL
apaulistanizemo-las	apaulistanizar+V.ele.ACC.3.F.PL+IMP+1+PL
apaulistanizemo-lo	apaulistanizar+V.ele.ACC.3.M.SG+IMP+1+PL
apaulistanizemo-los	apaulistanizar+V.ele.ACC.3.M.PL+IMP+1+PL
apaulistanizemo-nos	apaulistanizar+nós.AD.1.PL+IMP+1+PL
apaulistanizemos-lhe	apaulistanizar+V.ele.DAT.3.SG+IMP+1+PL
apaulistanizemos-lhes	apaulistanizar+V.ele.DAT.3.PL+IMP+1+PL
apaulistanizemos-me	apaulistanizar+V.eu.AD.1.SG+IMP+1+PL
apaulistanizemos-te	apaulistanizar+V.tu.AD.2.SG+IMP+1+PL
apaulistanizemos-vos	apaulistanizar+V.vós.AD.2.PL+IMP+1+PL
apaulistanizem-se	apaulistanizar+V.ele.REFL+IMP+3+PL
apaulistanizem-te	apaulistanizar+V.tu.AD.2.SG+IMP+3+PL
apaulistanizem-vos	apaulistanizar+V.vós.AD.2.PL+IMP+3+PL
apaulistanize-nos	apaulistanizar+nós.AD.1.PL+IMP+3+SG
apaulistanize-o	apaulistanizar+V.ele.ACC.3.M.SG+IMP+3+SG
apaulistanize-os	apaulistanizar+V.ele.ACC.3.M.PL+IMP+3+SG
apaulistanize-se	apaulistanizar+V.ele.REFL+IMP+3+SG
apaulistanize-te	apaulistanizar+V.tu.AD.2.SG+IMP+3+SG
apaulistanize-vos	apaulistanizar+V.vós.AD.2.PL+IMP+3+SG
apaulistanizo-a	apaulistanizar+V.ele.ACC.3.F.SG+PRS+1+SG
apaulistanizo-as	apaulistanizar+V.ele.ACC.3.F.PL+PRS+1+SG
apaulistanizo-lhe	apaulistanizar+V.ele.DAT.3.SG+PRS+1+SG
apaulistanizo-lhes	apaulistanizar+V.ele.DAT.3.PL+PRS+1+SG
apaulistanizo-me	apaulistanizar+V.eu.AD.1.SG+PRS+1+SG
apaulistanizo-nos	apaulistanizar+nós.AD.1.PL+PRS+1+SG
apaulistanizo-o	apaulistanizar+V.ele.ACC.3.M.SG+PRS+1+SG
apaulistanizo-os	apaulistanizar+V.ele.ACC.3.M.PL+PRS+1+SG
apaulistanizo-te	apaulistanizar+V.tu.AD.2.SG+PRS+1+SG
apaulistanizou-a	apaulistanizar+V.ele.ACC.3.F.SG+PRF+3+SG
apaulistanizou-as	apaulistanizar+V.ele.ACC.3.F.PL+PRF+3+SG
apaulistanizou-lhe	apaulistanizar+V.ele.DAT.3.SG+PRF+3+SG
apaulistanizou-lhes	apaulistanizar+V.ele.DAT.3.PL+PRF+3+SG
apaulistanizou-me	apaulistanizar+V.eu.AD.1.SG+PRF+3+SG
apaulistanizou-nos	apaulistanizar+nós.AD.1.PL+PRF+3+SG
apaulistanizou-o	apaulistanizar+V.ele.ACC.3.M.SG+PRF+3+SG
apaulistanizou-os	apaulistanizar+V.ele.ACC.3.M.PL+PRF+3+SG
apaulistanizou-se	apaulistanizar+V.ele.REFL+PRF+3+SG
apaulistanizou-te	apaulistanizar+V.tu.AD.2.SG+PRF+3+SG
apaulistanizou-vos	apaulistanizar+V.vós.AD.2.PL+PRF+3+SG
apaulistanizo-vos	apaulistanizar+V.vós.AD.2.PL+PRS+1+SG
apaulista-nos	apaulistar+nós.AD.1.PL+PRS+2+SG
apaulista-nos	apaulistar+nós.AD.1.PL+PRS+3+SG
apaulista-o	apaulistar+V.ele.ACC.3.M.SG+PRS+3+SG
apaulista-os	apaulistar+V.ele.ACC.3.M.PL+PRS+3+SG
apaulistara-a	apaulistar+V.ele.ACC.3.F.SG+PQP+1+SG
apaulistara-a	apaulistar+V.ele.ACC.3.F.SG+PQP+3+SG
apaulistara-as	apaulistar+V.ele.ACC.3.F.PL+PQP+1+SG
apaulistara-as	apaulistar+V.ele.ACC.3.F.PL+PQP+3+SG
apaulistara-la	apaulistar+V.ele.ACC.3.F.SG+PQP+2+SG
apaulistara-las	apaulistar+V.ele.ACC.3.F.PL+PQP+2+SG
apaulistara-lhe	apaulistar+V.ele.DAT.3.SG+PQP+1+SG
apaulistara-lhe	apaulistar+V.ele.DAT.3.SG+PQP+3+SG
apaulistara-lhes	apaulistar+V.ele.DAT.3.PL+PQP+1+SG
apaulistara-lhes	apaulistar+V.ele.DAT.3.PL+PQP+3+SG
apaulistara-lo	apaulistar+V.ele.ACC.3.M.SG+PQP+2+SG
apaulistara-los	apaulistar+V.ele.ACC.3.M.PL+PQP+2+SG
apaulistara-me	apaulistar+V.eu.AD.1.SG+PQP+1+SG
apaulistara-me	apaulistar+V.eu.AD.1.SG+PQP+3+SG
apaulistaram-lhe	apaulistar+V.ele.DAT.3.SG+PQP+3+PL
apaulistaram-lhe	apaulistar+V.ele.DAT.3.SG+PRF+3+PL
apaulistaram-lhes	apaulistar+V.ele.DAT.3.PL+PQP+3+PL
apaulistaram-lhes	apaulistar+V.ele.DAT.3.PL+PRF+3+PL
apaulistaram-me	apaulistar+V.eu.AD.1.SG+PQP+3+PL
apaulistaram-me	apaulistar+V.eu.AD.1.SG+PRF+3+PL
apaulistaram-na	apaulistar+V.ele.ACC.3.F.SG+PQP+3+PL
apaulistaram-na	apaulistar+V.ele.ACC.3.F.SG+PRF+3+PL
apaulistaram-nas	apaulistar+V.ele.ACC.3.F.PL+PQP+3+PL
apaulistaram-nas	apaulistar+V.ele.ACC.3.F.PL+PRF+3+PL
apaulistaram-no	apaulistar+V.ele.ACC.3.M.SG+PQP+3+PL
apaulistaram-no	apaulistar+V.ele.ACC.3.M.SG+PRF+3+PL
apaulistaram-nos	apaulistar+V.ele.ACC.3.M.PL+PQP+3+PL
apaulistaram-nos	apaulistar+V.ele.ACC.3.M.PL+PRF+3+PL
apaulistaram-nos	apaulistar+V.nós.AD.1.PL+PQP+3+PL
apaulistaram-nos	apaulistar+V.nós.AD.1.PL+PRF+3+PL
apaulistáramo-la	apaulistar+V.ele.ACC.3.F.SG+PQP+1+PL
apaulistáramo-las	apaulistar+V.ele.ACC.3.F.PL+PQP+1+PL
apaulistáramo-lo	apaulistar+V.ele.ACC.3.M.SG+PQP+1+PL
apaulistáramo-los	apaulistar+V.ele.ACC.3.M.PL+PQP+1+PL
apaulistáramo-nos	apaulistar+nós.AD.1.PL+PQP+1+PL
apaulistáramos-lhe	apaulistar+V.ele.DAT.3.SG+PQP+1+PL
apaulistáramos-lhes	apaulistar+V.ele.DAT.3.PL+PQP+1+PL
apaulistáramos-me	apaulistar+V.eu.AD.1.SG+PQP+1+PL
apaulistáramos-te	apaulistar+V.tu.AD.2.SG+PQP+1+PL
apaulistáramos-vos	apaulistar+V.vós.AD.2.PL+PQP+1+PL
apaulistaram-se	apaulistar+V.ele.REFL+PQP+3+PL
apaulistaram-se	apaulistar+V.ele.REFL+PRF+3+PL
apaulistaram-te	apaulistar+V.tu.AD.2.SG+PQP+3+PL
apaulistaram-te	apaulistar+V.tu.AD.2.SG+PRF+3+PL
apaulistaram-vos	apaulistar+V.vós.AD.2.PL+PQP+3+PL
apaulistaram-vos	apaulistar+V.vós.AD.2.PL+PRF+3+PL
apaulistara-nos	apaulistar+nós.AD.1.PL+PQP+1+SG
apaulistara-nos	apaulistar+nós.AD.1.PL+PQP+2+SG
apaulistara-nos	apaulistar+nós.AD.1.PL+PQP+3+SG
apaulistara-o	apaulistar+V.ele.ACC.3.M.SG+PQP+1+SG
apaulistara-o	apaulistar+V.ele.ACC.3.M.SG+PQP+3+SG
apaulistara-os	apaulistar+V.ele.ACC.3.M.PL+PQP+1+SG
apaulistara-os	apaulistar+V.ele.ACC.3.M.PL+PQP+3+SG
apaulistara-se	apaulistar+V.ele.REFL+PQP+1+SG
apaulistara-se	apaulistar+V.ele.REFL+PQP+3+SG
apaulistaras-lhe	apaulistar+V.ele.DAT.3.SG+PQP+2+SG
apaulistaras-lhes	apaulistar+V.ele.DAT.3.PL+PQP+2+SG
apaulistaras-me	apaulistar+V.eu.AD.1.SG+PQP+2+SG
apaulistaras-te	apaulistar+V.tu.AD.2.SG+PQP+2+SG
apaulistaras-vos	apaulistar+V.vós.AD.2.PL+PQP+2+SG
apaulistara-te	apaulistar+V.tu.AD.2.SG+PQP+1+SG
apaulistara-te	apaulistar+V.tu.AD.2.SG+PQP+3+SG
apaulistara-vos	apaulistar+V.vós.AD.2.PL+PQP+1+SG
apaulistara-vos	apaulistar+V.vós.AD.2.PL+PQP+3+SG
apaulistarde-la	apaulistar+V.ele.ACC.3.F.SG+INF+2+PL
apaulistarde-la	apaulistar+V.ele.ACC.3.F.SG+SBJF+2+PL
apaulistarde-las	apaulistar+V.ele.ACC.3.F.PL+INF+2+PL
apaulistarde-las	apaulistar+V.ele.ACC.3.F.PL+SBJF+2+PL
apaulistarde-lo	apaulistar+V.ele.ACC.3.M.SG+INF+2+PL
apaulistarde-lo	apaulistar+V.ele.ACC.3.M.SG+SBJF+2+PL
apaulistarde-los	apaulistar+V.ele.ACC.3.M.PL+INF+2+PL
apaulistarde-los	apaulistar+V.ele.ACC.3.M.PL+SBJF+2+PL
apaulistarde-nos	apaulistar+nós.AD.1.PL+INF+2+PL
apaulistarde-nos	apaulistar+nós.AD.1.PL+SBJF+2+PL
apaulistardes-lhe	apaulistar+V.ele.DAT.3.SG+INF+2+PL
apaulistardes-lhe	apaulistar+V.ele.DAT.3.SG+SBJF+2+PL
apaulistardes-lhes	apaulistar+V.ele.DAT.3.PL+INF+2+PL
apaulistardes-lhes	apaulistar+V.ele.DAT.3.PL+SBJF+2+PL
apaulistardes-me	apaulistar+V.eu.AD.1.SG+INF+2+PL
apaulistardes-me	apaulistar+V.eu.AD.1.SG+SBJF+2+PL
apaulistardes-te	apaulistar+V.tu.AD.2.SG+INF+2+PL
apaulistardes-te	apaulistar+V.tu.AD.2.SG+SBJF+2+PL
apaulistardes-vos	apaulistar+V.vós.AD.2.PL+INF+2+PL
apaulistardes-vos	apaulistar+V.vós.AD.2.PL+SBJF+2+PL
apaulistárei-la	apaulistar+V.ele.ACC.3.F.SG+PQP+2+PL
apaulistárei-las	apaulistar+V.ele.ACC.3.F.PL+PQP+2+PL
apaulistárei-lo	apaulistar+V.ele.ACC.3.M.SG+PQP+2+PL
apaulistárei-los	apaulistar+V.ele.ACC.3.M.PL+PQP+2+PL
apaulistárei-nos	apaulistar+nós.AD.1.PL+PQP+2+PL
apaulistáreis-lhe	apaulistar+V.ele.DAT.3.SG+PQP+2+PL
apaulistáreis-lhes	apaulistar+V.ele.DAT.3.PL+PQP+2+PL
apaulistáreis-me	apaulistar+V.eu.AD.1.SG+PQP+2+PL
apaulistáreis-te	apaulistar+V.tu.AD.2.SG+PQP+2+PL
apaulistáreis-vos	apaulistar+V.vós.AD.2.PL+PQP+2+PL
apaulistare-la	apaulistar+V.ele.ACC.3.F.SG+INF+2+SG
apaulistare-la	apaulistar+V.ele.ACC.3.F.SG+SBJF+2+SG
apaulistare-las	apaulistar+V.ele.ACC.3.F.PL+INF+2+SG
apaulistare-las	apaulistar+V.ele.ACC.3.F.PL+SBJF+2+SG
apaulistare-lo	apaulistar+V.ele.ACC.3.M.SG+INF+2+SG
apaulistare-lo	apaulistar+V.ele.ACC.3.M.SG+SBJF+2+SG
apaulistare-los	apaulistar+V.ele.ACC.3.M.PL+INF+2+SG
apaulistare-los	apaulistar+V.ele.ACC.3.M.PL+SBJF+2+SG
apaulistarem-lhe	apaulistar+V.ele.DAT.3.SG+INF+3+PL
apaulistarem-lhe	apaulistar+V.ele.DAT.3.SG+SBJF+3+PL
apaulistarem-lhes	apaulistar+V.ele.DAT.3.PL+INF+3+PL
apaulistarem-lhes	apaulistar+V.ele.DAT.3.PL+SBJF+3+PL
apaulistarem-me	apaulistar+V.eu.AD.1.SG+INF+3+PL
apaulistarem-me	apaulistar+V.eu.AD.1.SG+SBJF+3+PL
apaulistarem-na	apaulistar+V.ele.ACC.3.F.SG+INF+3+PL
apaulistarem-na	apaulistar+V.ele.ACC.3.F.SG+SBJF+3+PL
apaulistarem-nas	apaulistar+V.ele.ACC.3.F.PL+INF+3+PL
apaulistarem-nas	apaulistar+V.ele.ACC.3.F.PL+SBJF+3+PL
apaulistarem-no	apaulistar+V.ele.ACC.3.M.SG+INF+3+PL
apaulistarem-no	apaulistar+V.ele.ACC.3.M.SG+SBJF+3+PL
apaulistarem-nos	apaulistar+V.ele.ACC.3.M.PL+INF+3+PL
apaulistarem-nos	apaulistar+V.ele.ACC.3.M.PL+SBJF+3+PL
apaulistarem-nos	apaulistar+V.nós.AD.1.PL+INF+3+PL
apaulistarem-nos	apaulistar+V.nós.AD.1.PL+SBJF+3+PL
apaulistarem-se	apaulistar+V.ele.REFL+INF+3+PL
apaulistarem-se	apaulistar+V.ele.REFL+SBJF+3+PL
apaulistarem-te	apaulistar+V.tu.AD.2.SG+INF+3+PL
apaulistarem-te	apaulistar+V.tu.AD.2.SG+SBJF+3+PL
apaulistarem-vos	apaulistar+V.vós.AD.2.PL+INF+3+PL
apaulistarem-vos	apaulistar+V.vós.AD.2.PL+SBJF+3+PL
apaulistare-nos	apaulistar+nós.AD.1.PL+INF+2+SG
apaulistare-nos	apaulistar+nós.AD.1.PL+SBJF+2+SG
apaulistares-lhe	apaulistar+V.ele.DAT.3.SG+INF+2+SG
apaulistares-lhe	apaulistar+V.ele.DAT.3.SG+SBJF+2+SG
apaulistares-lhes	apaulistar+V.ele.DAT.3.PL+INF+2+SG
apaulistares-lhes	apaulistar+V.ele.DAT.3.PL+SBJF+2+SG
apaulistares-me	apaulistar+V.eu.AD.1.SG+INF+2+SG
apaulistares-me	apaulistar+V.eu.AD.1.SG+SBJF+2+SG
apaulistares-te	apaulistar+V.tu.AD.2.SG+INF+2+SG
apaulistares-te	apaulistar+V.tu.AD.2.SG+SBJF+2+SG
apaulistares-vos	apaulistar+V.vós.AD.2.PL+INF+2+SG
apaulistares-vos	apaulistar+V.vós.AD.2.PL+SBJF+2+SG
apaulistar-lhe-á	apaulistar+V.ele.DAT.3.SG+FUT+3+SG
apaulistar-lhe-ão	apaulistar+V.ele.DAT.3.SG+FUT+3+PL
apaulistar-lhe	apaulistar+V.ele.DAT.3.SG+INF
apaulistar-lhe	apaulistar+V.ele.DAT.3.SG+INF+1+SG
apaulistar-lhe	apaulistar+V.ele.DAT.3.SG+INF+3+SG
apaulistar-lhe	apaulistar+V.ele.DAT.3.SG+SBJF+1+SG
apaulistar-lhe	apaulistar+V.ele.DAT.3.SG+SBJF+3+SG
apaulistar-lhe-ás	apaulistar+V.ele.DAT.3.SG+FUT+2+SG
apaulistar-lhe-ei	apaulistar+V.ele.DAT.3.SG+FUT+1+SG
apaulistar-lhe-eis	apaulistar+V.ele.DAT.3.SG+FUT+2+PL
apaulistar-lhe-emos	apaulistar+V.ele.DAT.3.SG+FUT+1+PL
apaulistar-lhe-ia	apaulistar+V.ele.DAT.3.SG+COND+1+SG
apaulistar-lhe-ia	apaulistar+V.ele.DAT.3.SG+COND+3+SG
apaulistar-lhe-iam	apaulistar+V.ele.DAT.3.SG+COND+3+PL
apaulistar-lhe-íamos	apaulistar+V.ele.DAT.3.SG+COND+1+PL
apaulistar-lhe-ias	apaulistar+V.ele.DAT.3.SG+COND+2+SG
apaulistar-lhe-íeis	apaulistar+V.ele.DAT.3.SG+COND+2+PL
apaulistar-lhes-á	apaulistar+V.ele.DAT.3.PL+FUT+3+SG
apaulistar-lhes-ão	apaulistar+V.ele.DAT.3.PL+FUT+3+PL
apaulistar-lhes	apaulistar+V.ele.DAT.3.PL+INF
apaulistar-lhes	apaulistar+V.ele.DAT.3.PL+INF+1+SG
apaulistar-lhes	apaulistar+V.ele.DAT.3.PL+INF+3+SG
apaulistar-lhes	apaulistar+V.ele.DAT.3.PL+SBJF+1+SG
apaulistar-lhes	apaulistar+V.ele.DAT.3.PL+SBJF+3+SG
apaulistar-lhes-ás	apaulistar+V.ele.DAT.3.PL+FUT+2+SG
apaulistar-lhes-ei	apaulistar+V.ele.DAT.3.PL+FUT+1+SG
apaulistar-lhes-eis	apaulistar+V.ele.DAT.3.PL+FUT+2+PL
apaulistar-lhes-emos	apaulistar+V.ele.DAT.3.PL+FUT+1+PL
apaulistar-lhes-ia	apaulistar+V.ele.DAT.3.PL+COND+1+SG
apaulistar-lhes-ia	apaulistar+V.ele.DAT.3.PL+COND+3+SG
apaulistar-lhes-iam	apaulistar+V.ele.DAT.3.PL+COND+3+PL
apaulistar-lhes-íamos	apaulistar+V.ele.DAT.3.PL+COND+1+PL
apaulistar-lhes-ias	apaulistar+V.ele.DAT.3.PL+COND+2+SG
apaulistar-lhes-íeis	apaulistar+V.ele.DAT.3.PL+COND+2+PL
apaulistar-me-á	apaulistar+V.eu.AD.1.SG+FUT+3+SG
apaulistar-me-ão	apaulistar+V.eu.AD.1.SG+FUT+3+PL
apaulistar-me	apaulistar+V.eu.AD.1.SG+INF
apaulistar-me	apaulistar+V.eu.AD.1.SG+INF+1+SG
apaulistar-me	apaulistar+V.eu.AD.1.SG+INF+3+SG
apaulistar-me	apaulistar+V.eu.AD.1.SG+SBJF+1+SG
apaulistar-me	apaulistar+V.eu.AD.1.SG+SBJF+3+SG
apaulistar-me-ás	apaulistar+V.eu.AD.1.SG+FUT+2+SG
apaulistar-me-ei	apaulistar+V.eu.AD.1.SG+FUT+1+SG
apaulistar-me-eis	apaulistar+V.eu.AD.1.SG+FUT+2+PL
apaulistar-me-emos	apaulistar+V.eu.AD.1.SG+FUT+1+PL
apaulistar-me-ia	apaulistar+V.eu.AD.1.SG+COND+1+SG
apaulistar-me-ia	apaulistar+V.eu.AD.1.SG+COND+3+SG
apaulistar-me-iam	apaulistar+V.eu.AD.1.SG+COND+3+PL
apaulistar-me-íamos	apaulistar+V.eu.AD.1.SG+COND+1+PL
apaulistar-me-ias	apaulistar+V.eu.AD.1.SG+COND+2+SG
apaulistar-me-íeis	apaulistar+V.eu.AD.1.SG+COND+2+PL
apaulistarmo-la	apaulistar+V.ele.ACC.3.F.SG+INF+1+PL
apaulistarmo-la	apaulistar+V.ele.ACC.3.F.SG+SBJF+1+PL
apaulistarmo-las	apaulistar+V.ele.ACC.3.F.PL+INF+1+PL
apaulistarmo-las	apaulistar+V.ele.ACC.3.F.PL+SBJF+1+PL
apaulistarmo-lo	apaulistar+V.ele.ACC.3.M.SG+INF+1+PL
apaulistarmo-lo	apaulistar+V.ele.ACC.3.M.SG+SBJF+1+PL
apaulistarmo-los	apaulistar+V.ele.ACC.3.M.PL+INF+1+PL
apaulistarmo-los	apaulistar+V.ele.ACC.3.M.PL+SBJF+1+PL
apaulistarmo-nos	apaulistar+nós.AD.1.PL+INF+1+PL
apaulistarmo-nos	apaulistar+nós.AD.1.PL+SBJF+1+PL
apaulistarmos-lhe	apaulistar+V.ele.DAT.3.SG+INF+1+PL
apaulistarmos-lhe	apaulistar+V.ele.DAT.3.SG+SBJF+1+PL
apaulistarmos-lhes	apaulistar+V.ele.DAT.3.PL+INF+1+PL
apaulistarmos-lhes	apaulistar+V.ele.DAT.3.PL+SBJF+1+PL
apaulistarmos-me	apaulistar+V.eu.AD.1.SG+INF+1+PL
apaulistarmos-me	apaulistar+V.eu.AD.1.SG+SBJF+1+PL
apaulistarmos-te	apaulistar+V.tu.AD.2.SG+INF+1+PL
