austerizar-nos-iam	austerizar+nós.AD.1.PL+COND+3+PL
austerizar-nos-íamos	austerizar+nós.AD.1.PL+COND+1+PL
austerizar-nos-ias	austerizar+nós.AD.1.PL+COND+2+SG
austerizar-nos-íeis	austerizar+nós.AD.1.PL+COND+2+PL
austerizar-se-á	austerizar+V.ele.REFL+FUT+3+SG
austerizar-se-ão	austerizar+V.ele.REFL+FUT+3+PL
austerizar-se	austerizar+V.ele.REFL+INF
austerizar-se	austerizar+V.ele.REFL+INF+3+SG
austerizar-se	austerizar+V.ele.REFL+SBJF+3+SG
austerizar-se-ia	austerizar+V.ele.REFL+COND+3+SG
austerizar-se-iam	austerizar+V.ele.REFL+COND+3+PL
austerizar-te-á	austerizar+V.tu.AD.2.SG+FUT+3+SG
austerizar-te-ão	austerizar+V.tu.AD.2.SG+FUT+3+PL
austerizar-te-ás	austerizar+V.tu.AD.2.SG+FUT+2+SG
austerizar-te	austerizar+V.tu.AD.2.SG+INF
austerizar-te	austerizar+V.tu.AD.2.SG+INF+1+SG
austerizar-te	austerizar+V.tu.AD.2.SG+INF+3+SG
austerizar-te	austerizar+V.tu.AD.2.SG+SBJF+1+SG
austerizar-te	austerizar+V.tu.AD.2.SG+SBJF+3+SG
austerizar-te-ei	austerizar+V.tu.AD.2.SG+FUT+1+SG
austerizar-te-eis	austerizar+V.tu.AD.2.SG+FUT+2+PL
austerizar-te-emos	austerizar+V.tu.AD.2.SG+FUT+1+PL
austerizar-te-ia	austerizar+V.tu.AD.2.SG+COND+1+SG
austerizar-te-ia	austerizar+V.tu.AD.2.SG+COND+3+SG
austerizar-te-iam	austerizar+V.tu.AD.2.SG+COND+3+PL
austerizar-te-íamos	austerizar+V.tu.AD.2.SG+COND+1+PL
austerizar-te-ias	austerizar+V.tu.AD.2.SG+COND+2+SG
austerizar-te-íeis	austerizar+V.tu.AD.2.SG+COND+2+PL
austerizar-vos-á	austerizar+V.vós.AD.2.PL+FUT+3+SG
austerizar-vos-ão	austerizar+V.vós.AD.2.PL+FUT+3+PL
austerizar-vos-ás	austerizar+V.vós.AD.2.PL+FUT+2+SG
austerizar-vos	austerizar+V.vós.AD.2.PL+INF
austerizar-vos	austerizar+V.vós.AD.2.PL+INF+1+SG
austerizar-vos	austerizar+V.vós.AD.2.PL+INF+3+SG
austerizar-vos	austerizar+V.vós.AD.2.PL+SBJF+1+SG
austerizar-vos	austerizar+V.vós.AD.2.PL+SBJF+3+SG
austerizar-vos-ei	austerizar+V.vós.AD.2.PL+FUT+1+SG
austerizar-vos-eis	austerizar+V.vós.AD.2.PL+FUT+2+PL
austerizar-vos-emos	austerizar+V.vós.AD.2.PL+FUT+1+PL
austerizar-vos-ia	austerizar+V.vós.AD.2.PL+COND+1+SG
austerizar-vos-ia	austerizar+V.vós.AD.2.PL+COND+3+SG
austerizar-vos-iam	austerizar+V.vós.AD.2.PL+COND+3+PL
austerizar-vos-íamos	austerizar+V.vós.AD.2.PL+COND+1+PL
austerizar-vos-ias	austerizar+V.vós.AD.2.PL+COND+2+SG
austerizar-vos-íeis	austerizar+V.vós.AD.2.PL+COND+2+PL
austeriza-se	austerizar+V.ele.REFL+PRS+3+SG
austerizas-lhe	austerizar+V.ele.DAT.3.SG+PRS+2+SG
austerizas-lhes	austerizar+V.ele.DAT.3.PL+PRS+2+SG
austerizas-me	austerizar+V.eu.AD.1.SG+PRS+2+SG
austerizaste-a	austerizar+V.ele.ACC.3.F.SG+PRF+2+SG
austerizaste-as	austerizar+V.ele.ACC.3.F.PL+PRF+2+SG
austerizas-te	austerizar+V.tu.AD.2.SG+PRS+2+SG
austerizaste-la	austerizar+V.ele.ACC.3.F.SG+PRF+2+PL
austerizaste-las	austerizar+V.ele.ACC.3.F.PL+PRF+2+PL
austerizaste-lhe	austerizar+V.ele.DAT.3.SG+PRF+2+SG
austerizaste-lhes	austerizar+V.ele.DAT.3.PL+PRF+2+SG
austerizaste-lo	austerizar+V.ele.ACC.3.M.SG+PRF+2+PL
austerizaste-los	austerizar+V.ele.ACC.3.M.PL+PRF+2+PL
austerizaste-me	austerizar+V.eu.AD.1.SG+PRF+2+SG
austerizaste-nos	austerizar+nós.AD.1.PL+PRF+2+PL
austerizaste-nos	austerizar+nós.AD.1.PL+PRF+2+SG
austerizaste-o	austerizar+V.ele.ACC.3.M.SG+PRF+2+SG
austerizaste-os	austerizar+V.ele.ACC.3.M.PL+PRF+2+SG
austerizastes-lhe	austerizar+V.ele.DAT.3.SG+PRF+2+PL
austerizastes-lhes	austerizar+V.ele.DAT.3.PL+PRF+2+PL
austerizastes-me	austerizar+V.eu.AD.1.SG+PRF+2+PL
austerizastes-te	austerizar+V.tu.AD.2.SG+PRF+2+PL
austerizastes-vos	austerizar+V.vós.AD.2.PL+PRF+2+PL
austerizaste-te	austerizar+V.tu.AD.2.SG+PRF+2+SG
austerizaste-vos	austerizar+V.vós.AD.2.PL+PRF+2+SG
austerizas-vos	austerizar+V.vós.AD.2.PL+PRS+2+SG
austeriza-te	austerizar+V.tu.AD.2.SG+PRS+3+SG
austerizava-a	austerizar+V.ele.ACC.3.F.SG+IMPF+1+SG
austerizava-a	austerizar+V.ele.ACC.3.F.SG+IMPF+3+SG
austerizava-as	austerizar+V.ele.ACC.3.F.PL+IMPF+1+SG
austerizava-as	austerizar+V.ele.ACC.3.F.PL+IMPF+3+SG
austerizava-la	austerizar+V.ele.ACC.3.F.SG+IMPF+2+SG
austerizava-las	austerizar+V.ele.ACC.3.F.PL+IMPF+2+SG
austerizava-lhe	austerizar+V.ele.DAT.3.SG+IMPF+1+SG
austerizava-lhe	austerizar+V.ele.DAT.3.SG+IMPF+3+SG
austerizava-lhes	austerizar+V.ele.DAT.3.PL+IMPF+1+SG
austerizava-lhes	austerizar+V.ele.DAT.3.PL+IMPF+3+SG
austerizava-lo	austerizar+V.ele.ACC.3.M.SG+IMPF+2+SG
austerizava-los	austerizar+V.ele.ACC.3.M.PL+IMPF+2+SG
austerizava-me	austerizar+V.eu.AD.1.SG+IMPF+1+SG
austerizava-me	austerizar+V.eu.AD.1.SG+IMPF+3+SG
austerizavam-lhe	austerizar+V.ele.DAT.3.SG+IMPF+3+PL
austerizavam-lhes	austerizar+V.ele.DAT.3.PL+IMPF+3+PL
austerizavam-me	austerizar+V.eu.AD.1.SG+IMPF+3+PL
austerizavam-na	austerizar+V.ele.ACC.3.F.SG+IMPF+3+PL
austerizavam-nas	austerizar+V.ele.ACC.3.F.PL+IMPF+3+PL
austerizavam-no	austerizar+V.ele.ACC.3.M.SG+IMPF+3+PL
austerizavam-nos	austerizar+V.ele.ACC.3.M.PL+IMPF+3+PL
austerizavam-nos	austerizar+V.nós.AD.1.PL+IMPF+3+PL
austerizávamo-la	austerizar+V.ele.ACC.3.F.SG+IMPF+1+PL
austerizávamo-las	austerizar+V.ele.ACC.3.F.PL+IMPF+1+PL
austerizávamo-lo	austerizar+V.ele.ACC.3.M.SG+IMPF+1+PL
austerizávamo-los	austerizar+V.ele.ACC.3.M.PL+IMPF+1+PL
austerizávamo-nos	austerizar+nós.AD.1.PL+IMPF+1+PL
austerizávamos-lhe	austerizar+V.ele.DAT.3.SG+IMPF+1+PL
austerizávamos-lhes	austerizar+V.ele.DAT.3.PL+IMPF+1+PL
austerizávamos-me	austerizar+V.eu.AD.1.SG+IMPF+1+PL
austerizávamos-te	austerizar+V.tu.AD.2.SG+IMPF+1+PL
austerizávamos-vos	austerizar+V.vós.AD.2.PL+IMPF+1+PL
austerizavam-se	austerizar+V.ele.REFL+IMPF+3+PL
austerizavam-te	austerizar+V.tu.AD.2.SG+IMPF+3+PL
austerizavam-vos	austerizar+V.vós.AD.2.PL+IMPF+3+PL
austerizava-nos	austerizar+nós.AD.1.PL+IMPF+1+SG
austerizava-nos	austerizar+nós.AD.1.PL+IMPF+2+SG
austerizava-nos	austerizar+nós.AD.1.PL+IMPF+3+SG
austerizava-o	austerizar+V.ele.ACC.3.M.SG+IMPF+1+SG
austerizava-o	austerizar+V.ele.ACC.3.M.SG+IMPF+3+SG
austerizava-os	austerizar+V.ele.ACC.3.M.PL+IMPF+1+SG
austerizava-os	austerizar+V.ele.ACC.3.M.PL+IMPF+3+SG
austerizava-se	austerizar+V.ele.REFL+IMPF+1+SG
austerizava-se	austerizar+V.ele.REFL+IMPF+3+SG
austerizavas-lhe	austerizar+V.ele.DAT.3.SG+IMPF+2+SG
austerizavas-lhes	austerizar+V.ele.DAT.3.PL+IMPF+2+SG
austerizavas-me	austerizar+V.eu.AD.1.SG+IMPF+2+SG
austerizavas-te	austerizar+V.tu.AD.2.SG+IMPF+2+SG
austerizavas-vos	austerizar+V.vós.AD.2.PL+IMPF+2+SG
austerizava-te	austerizar+V.tu.AD.2.SG+IMPF+1+SG
austerizava-te	austerizar+V.tu.AD.2.SG+IMPF+3+SG
austerizava-vos	austerizar+V.vós.AD.2.PL+IMPF+1+SG
austerizava-vos	austerizar+V.vós.AD.2.PL+IMPF+3+SG
austerizávei-la	austerizar+V.ele.ACC.3.F.SG+IMPF+2+PL
austerizávei-las	austerizar+V.ele.ACC.3.F.PL+IMPF+2+PL
austerizávei-lo	austerizar+V.ele.ACC.3.M.SG+IMPF+2+PL
austerizávei-los	austerizar+V.ele.ACC.3.M.PL+IMPF+2+PL
austerizávei-nos	austerizar+nós.AD.1.PL+IMPF+2+PL
austerizáveis-lhe	austerizar+V.ele.DAT.3.SG+IMPF+2+PL
austerizáveis-lhes	austerizar+V.ele.DAT.3.PL+IMPF+2+PL
austerizáveis-me	austerizar+V.eu.AD.1.SG+IMPF+2+PL
austerizáveis-te	austerizar+V.tu.AD.2.SG+IMPF+2+PL
austerizáveis-vos	austerizar+V.vós.AD.2.PL+IMPF+2+PL
austeriza-vos	austerizar+V.vós.AD.2.PL+PRS+3+SG
austerize-a	austerizar+V.ele.ACC.3.F.SG+IMP+3+SG
austerize-as	austerizar+V.ele.ACC.3.F.PL+IMP+3+SG
austerizei-a	austerizar+V.ele.ACC.3.F.SG+PRF+1+SG
austerizei-as	austerizar+V.ele.ACC.3.F.PL+PRF+1+SG
austerizei-lhe	austerizar+V.ele.DAT.3.SG+PRF+1+SG
austerizei-lhes	austerizar+V.ele.DAT.3.PL+PRF+1+SG
austerizei-me	austerizar+V.eu.AD.1.SG+PRF+1+SG
austerizei-nos	austerizar+nós.AD.1.PL+PRF+1+SG
austerizei-o	austerizar+V.ele.ACC.3.M.SG+PRF+1+SG
austerizei-os	austerizar+V.ele.ACC.3.M.PL+PRF+1+SG
austerizei-te	austerizar+V.tu.AD.2.SG+PRF+1+SG
austerizei-vos	austerizar+V.vós.AD.2.PL+PRF+1+SG
austerize-lhe	austerizar+V.ele.DAT.3.SG+IMP+3+SG
austerize-lhes	austerizar+V.ele.DAT.3.PL+IMP+3+SG
austerize-me	austerizar+V.eu.AD.1.SG+IMP+3+SG
austerizem-lhe	austerizar+V.ele.DAT.3.SG+IMP+3+PL
austerizem-lhes	austerizar+V.ele.DAT.3.PL+IMP+3+PL
austerizem-me	austerizar+V.eu.AD.1.SG+IMP+3+PL
austerizem-na	austerizar+V.ele.ACC.3.F.SG+IMP+3+PL
austerizem-nas	austerizar+V.ele.ACC.3.F.PL+IMP+3+PL
austerizem-no	austerizar+V.ele.ACC.3.M.SG+IMP+3+PL
austerizem-nos	austerizar+V.ele.ACC.3.M.PL+IMP+3+PL
austerizem-nos	austerizar+V.nós.AD.1.PL+IMP+3+PL
austerizemo-la	austerizar+V.ele.ACC.3.F.SG+IMP+1+PL
austerizemo-las	austerizar+V.ele.ACC.3.F.PL+IMP+1+PL
austerizemo-lo	austerizar+V.ele.ACC.3.M.SG+IMP+1+PL
austerizemo-los	austerizar+V.ele.ACC.3.M.PL+IMP+1+PL
austerizemo-nos	austerizar+nós.AD.1.PL+IMP+1+PL
austerizemos-lhe	austerizar+V.ele.DAT.3.SG+IMP+1+PL
austerizemos-lhes	austerizar+V.ele.DAT.3.PL+IMP+1+PL
austerizemos-me	austerizar+V.eu.AD.1.SG+IMP+1+PL
austerizemos-te	austerizar+V.tu.AD.2.SG+IMP+1+PL
austerizemos-vos	austerizar+V.vós.AD.2.PL+IMP+1+PL
austerizem-se	austerizar+V.ele.REFL+IMP+3+PL
austerizem-te	austerizar+V.tu.AD.2.SG+IMP+3+PL
austerizem-vos	austerizar+V.vós.AD.2.PL+IMP+3+PL
austerize-nos	austerizar+nós.AD.1.PL+IMP+3+SG
austerize-o	austerizar+V.ele.ACC.3.M.SG+IMP+3+SG
austerize-os	austerizar+V.ele.ACC.3.M.PL+IMP+3+SG
austerize-se	austerizar+V.ele.REFL+IMP+3+SG
austerize-te	austerizar+V.tu.AD.2.SG+IMP+3+SG
austerize-vos	austerizar+V.vós.AD.2.PL+IMP+3+SG
austerizo-a	austerizar+V.ele.ACC.3.F.SG+PRS+1+SG
austerizo-as	austerizar+V.ele.ACC.3.F.PL+PRS+1+SG
austerizo-lhe	austerizar+V.ele.DAT.3.SG+PRS+1+SG
austerizo-lhes	austerizar+V.ele.DAT.3.PL+PRS+1+SG
austerizo-me	austerizar+V.eu.AD.1.SG+PRS+1+SG
austerizo-nos	austerizar+nós.AD.1.PL+PRS+1+SG
austerizo-o	austerizar+V.ele.ACC.3.M.SG+PRS+1+SG
austerizo-os	austerizar+V.ele.ACC.3.M.PL+PRS+1+SG
austerizo-te	austerizar+V.tu.AD.2.SG+PRS+1+SG
austerizou-a	austerizar+V.ele.ACC.3.F.SG+PRF+3+SG
austerizou-as	austerizar+V.ele.ACC.3.F.PL+PRF+3+SG
austerizou-lhe	austerizar+V.ele.DAT.3.SG+PRF+3+SG
austerizou-lhes	austerizar+V.ele.DAT.3.PL+PRF+3+SG
austerizou-me	austerizar+V.eu.AD.1.SG+PRF+3+SG
austerizou-nos	austerizar+nós.AD.1.PL+PRF+3+SG
austerizou-o	austerizar+V.ele.ACC.3.M.SG+PRF+3+SG
austerizou-os	austerizar+V.ele.ACC.3.M.PL+PRF+3+SG
austerizou-se	austerizar+V.ele.REFL+PRF+3+SG
austerizou-te	austerizar+V.tu.AD.2.SG+PRF+3+SG
austerizou-vos	austerizar+V.vós.AD.2.PL+PRF+3+SG
austerizo-vos	austerizar+V.vós.AD.2.PL+PRS+1+SG
auste-se	austar+V.ele.REFL+IMP+3+SG
auste-te	austar+V.tu.AD.2.SG+IMP+3+SG
auste-vos	austar+V.vós.AD.2.PL+IMP+3+SG
austo-a	austar+V.ele.ACC.3.F.SG+PRS+1+SG
austo-as	austar+V.ele.ACC.3.F.PL+PRS+1+SG
austo-lhe	austar+V.ele.DAT.3.SG+PRS+1+SG
austo-lhes	austar+V.ele.DAT.3.PL+PRS+1+SG
austo-me	austar+V.eu.AD.1.SG+PRS+1+SG
austo-nos	austar+nós.AD.1.PL+PRS+1+SG
austo-o	austar+V.ele.ACC.3.M.SG+PRS+1+SG
austo-os	austar+V.ele.ACC.3.M.PL+PRS+1+SG
austo-te	austar+V.tu.AD.2.SG+PRS+1+SG
austou-a	austar+V.ele.ACC.3.F.SG+PRF+3+SG
austou-as	austar+V.ele.ACC.3.F.PL+PRF+3+SG
austou-lhe	austar+V.ele.DAT.3.SG+PRF+3+SG
austou-lhes	austar+V.ele.DAT.3.PL+PRF+3+SG
austou-me	austar+V.eu.AD.1.SG+PRF+3+SG
austou-nos	austar+nós.AD.1.PL+PRF+3+SG
austou-o	austar+V.ele.ACC.3.M.SG+PRF+3+SG
austou-os	austar+V.ele.ACC.3.M.PL+PRF+3+SG
austou-se	austar+V.ele.REFL+PRF+3+SG
austou-te	austar+V.tu.AD.2.SG+PRF+3+SG
austou-vos	austar+V.vós.AD.2.PL+PRF+3+SG
austo-vos	austar+V.vós.AD.2.PL+PRS+1+SG
autentica-a	autenticar+V.ele.ACC.3.F.SG+PRS+3+SG
autentica-as	autenticar+V.ele.ACC.3.F.PL+PRS+3+SG
autenticai-la	autenticar+V.ele.ACC.3.F.SG+PRS+2+PL
autenticai-las	autenticar+V.ele.ACC.3.F.PL+PRS+2+PL
autenticai-lo	autenticar+V.ele.ACC.3.M.SG+PRS+2+PL
autenticai-los	autenticar+V.ele.ACC.3.M.PL+PRS+2+PL
autenticai-nos	autenticar+nós.AD.1.PL+PRS+2+PL
autenticais-lhe	autenticar+V.ele.DAT.3.SG+PRS+2+PL
autenticais-lhes	autenticar+V.ele.DAT.3.PL+PRS+2+PL
autenticais-me	autenticar+V.eu.AD.1.SG+PRS+2+PL
autenticais-te	autenticar+V.tu.AD.2.SG+PRS+2+PL
autenticais-vos	autenticar+V.vós.AD.2.PL+PRS+2+PL
autenticá-la-á	autenticar+V.ele.ACC.3.F.SG+FUT+3+SG
autenticá-la-ão	autenticar+V.ele.ACC.3.F.SG+FUT+3+PL
autenticá-la-ás	autenticar+V.ele.ACC.3.F.SG+FUT+2+SG
autenticá-la	autenticar+V.ele.ACC.3.F.SG+INF+1+SG
autenticá-la	autenticar+V.ele.ACC.3.F.SG+INF+3+SG
autentica-la	autenticar+V.ele.ACC.3.F.SG+PRS+2+SG
autenticá-la	autenticar+V.ele.ACC.3.F.SG+SBJF+1+SG
autenticá-la	autenticar+V.ele.ACC.3.F.SG+SBJF+3+SG
autenticá-la-ei	autenticar+V.ele.ACC.3.F.SG+FUT+1+SG
autenticá-la-eis	autenticar+V.ele.ACC.3.F.SG+FUT+2+PL
autenticá-la-emos	autenticar+V.ele.ACC.3.F.SG+FUT+1+PL
autenticá-la-ia	autenticar+V.ele.ACC.3.F.SG+COND+1+SG
autenticá-la-ia	autenticar+V.ele.ACC.3.F.SG+COND+3+SG
autenticá-la-iam	autenticar+V.ele.ACC.3.F.SG+COND+3+PL
autenticá-la-íamos	autenticar+V.ele.ACC.3.F.SG+COND+1+PL
autenticá-la-ias	autenticar+V.ele.ACC.3.F.SG+COND+2+SG
autenticá-la-íeis	autenticar+V.ele.ACC.3.F.SG+COND+2+PL
autenticá-las-á	autenticar+V.ele.ACC.3.F.PL+FUT+3+SG
autenticá-las-ão	autenticar+V.ele.ACC.3.F.PL+FUT+3+PL
autenticá-las-ás	autenticar+V.ele.ACC.3.F.PL+FUT+2+SG
autenticá-las	autenticar+V.ele.ACC.3.F.PL+INF+1+SG
autenticá-las	autenticar+V.ele.ACC.3.F.PL+INF+3+SG
autentica-las	autenticar+V.ele.ACC.3.F.PL+PRS+2+SG
autenticá-las	autenticar+V.ele.ACC.3.F.PL+SBJF+1+SG
autenticá-las	autenticar+V.ele.ACC.3.F.PL+SBJF+3+SG
autenticá-las-ei	autenticar+V.ele.ACC.3.F.PL+FUT+1+SG
autenticá-las-eis	autenticar+V.ele.ACC.3.F.PL+FUT+2+PL
autenticá-las-emos	autenticar+V.ele.ACC.3.F.PL+FUT+1+PL
autenticá-las-ia	autenticar+V.ele.ACC.3.F.PL+COND+1+SG
autenticá-las-ia	autenticar+V.ele.ACC.3.F.PL+COND+3+SG
autenticá-las-iam	autenticar+V.ele.ACC.3.F.PL+COND+3+PL
autenticá-las-íamos	autenticar+V.ele.ACC.3.F.PL+COND+1+PL
autenticá-las-ias	autenticar+V.ele.ACC.3.F.PL+COND+2+SG
autenticá-las-íeis	autenticar+V.ele.ACC.3.F.PL+COND+2+PL
autentica-lhe	autenticar+V.ele.DAT.3.SG+PRS+3+SG
autentica-lhes	autenticar+V.ele.DAT.3.PL+PRS+3+SG
autenticá-lo-á	autenticar+V.ele.ACC.3.M.SG+FUT+3+SG
autenticá-lo-ão	autenticar+V.ele.ACC.3.M.SG+FUT+3+PL
autenticá-lo-ás	autenticar+V.ele.ACC.3.M.SG+FUT+2+SG
autenticá-lo	autenticar+V.ele.ACC.3.M.SG+INF+1+SG
autenticá-lo	autenticar+V.ele.ACC.3.M.SG+INF+3+SG
autentica-lo	autenticar+V.ele.ACC.3.M.SG+PRS+2+SG
autenticá-lo	autenticar+V.ele.ACC.3.M.SG+SBJF+1+SG
autenticá-lo	autenticar+V.ele.ACC.3.M.SG+SBJF+3+SG
autenticá-lo-ei	autenticar+V.ele.ACC.3.M.SG+FUT+1+SG
autenticá-lo-eis	autenticar+V.ele.ACC.3.M.SG+FUT+2+PL
autenticá-lo-emos	autenticar+V.ele.ACC.3.M.SG+FUT+1+PL
autenticá-lo-ia	autenticar+V.ele.ACC.3.M.SG+COND+1+SG
autenticá-lo-ia	autenticar+V.ele.ACC.3.M.SG+COND+3+SG
autenticá-lo-iam	autenticar+V.ele.ACC.3.M.SG+COND+3+PL
autenticá-lo-íamos	autenticar+V.ele.ACC.3.M.SG+COND+1+PL
autenticá-lo-ias	autenticar+V.ele.ACC.3.M.SG+COND+2+SG
autenticá-lo-íeis	autenticar+V.ele.ACC.3.M.SG+COND+2+PL
autenticá-los-á	autenticar+V.ele.ACC.3.M.PL+FUT+3+SG
autenticá-los-ão	autenticar+V.ele.ACC.3.M.PL+FUT+3+PL
autenticá-los-ás	autenticar+V.ele.ACC.3.M.PL+FUT+2+SG
autenticá-los	autenticar+V.ele.ACC.3.M.PL+INF+1+SG
autenticá-los	autenticar+V.ele.ACC.3.M.PL+INF+3+SG
autentica-los	autenticar+V.ele.ACC.3.M.PL+PRS+2+SG
autenticá-los	autenticar+V.ele.ACC.3.M.PL+SBJF+1+SG
autenticá-los	autenticar+V.ele.ACC.3.M.PL+SBJF+3+SG
autenticá-los-ei	autenticar+V.ele.ACC.3.M.PL+FUT+1+SG
autenticá-los-eis	autenticar+V.ele.ACC.3.M.PL+FUT+2+PL
autenticá-los-emos	autenticar+V.ele.ACC.3.M.PL+FUT+1+PL
autenticá-los-ia	autenticar+V.ele.ACC.3.M.PL+COND+1+SG
autenticá-los-ia	autenticar+V.ele.ACC.3.M.PL+COND+3+SG
autenticá-los-iam	autenticar+V.ele.ACC.3.M.PL+COND+3+PL
autenticá-los-íamos	autenticar+V.ele.ACC.3.M.PL+COND+1+PL
autenticá-los-ias	autenticar+V.ele.ACC.3.M.PL+COND+2+SG
autenticá-los-íeis	autenticar+V.ele.ACC.3.M.PL+COND+2+PL
autentica-me	autenticar+V.eu.AD.1.SG+PRS+3+SG
autenticam-lhe	autenticar+V.ele.DAT.3.SG+PRS+3+PL
autenticam-lhes	autenticar+V.ele.DAT.3.PL+PRS+3+PL
autenticam-me	autenticar+V.eu.AD.1.SG+PRS+3+PL
autenticam-na	autenticar+V.ele.ACC.3.F.SG+PRS+3+PL
autenticam-nas	autenticar+V.ele.ACC.3.F.PL+PRS+3+PL
autenticam-no	autenticar+V.ele.ACC.3.M.SG+PRS+3+PL
autenticam-nos	autenticar+V.ele.ACC.3.M.PL+PRS+3+PL
autenticam-nos	autenticar+V.nós.AD.1.PL+PRS+3+PL
autenticamo-la	autenticar+V.ele.ACC.3.F.SG+PRF+1+PL
autenticamo-la	autenticar+V.ele.ACC.3.F.SG+PRS+1+PL
autenticamo-las	autenticar+V.ele.ACC.3.F.PL+PRF+1+PL
autenticamo-las	autenticar+V.ele.ACC.3.F.PL+PRS+1+PL
autenticamo-lo	autenticar+V.ele.ACC.3.M.SG+PRF+1+PL
autenticamo-lo	autenticar+V.ele.ACC.3.M.SG+PRS+1+PL
autenticamo-los	autenticar+V.ele.ACC.3.M.PL+PRF+1+PL
autenticamo-los	autenticar+V.ele.ACC.3.M.PL+PRS+1+PL
autenticamo-nos	autenticar+nós.AD.1.PL+PRF+1+PL
autenticamo-nos	autenticar+nós.AD.1.PL+PRS+1+PL
autenticamos-lhe	autenticar+V.ele.DAT.3.SG+PRF+1+PL
autenticamos-lhe	autenticar+V.ele.DAT.3.SG+PRS+1+PL
autenticamos-lhes	autenticar+V.ele.DAT.3.PL+PRF+1+PL
autenticamos-lhes	autenticar+V.ele.DAT.3.PL+PRS+1+PL
autenticamos-me	autenticar+V.eu.AD.1.SG+PRF+1+PL
autenticamos-me	autenticar+V.eu.AD.1.SG+PRS+1+PL
autenticamos-te	autenticar+V.tu.AD.2.SG+PRF+1+PL
autenticamos-te	autenticar+V.tu.AD.2.SG+PRS+1+PL
autenticamos-vos	autenticar+V.vós.AD.2.PL+PRF+1+PL
autenticamos-vos	autenticar+V.vós.AD.2.PL+PRS+1+PL
autenticam-se	autenticar+V.ele.REFL+PRS+3+PL
autenticam-te	autenticar+V.tu.AD.2.SG+PRS+3+PL
autenticam-vos	autenticar+V.vós.AD.2.PL+PRS+3+PL
autenticando-a	autenticar+V.ele.ACC.3.F.SG+GRD
autenticando-as	autenticar+V.ele.ACC.3.F.PL+GRD
autenticando-lhe	autenticar+V.ele.DAT.3.SG+GRD
autenticando-lhes	autenticar+V.ele.DAT.3.PL+GRD
autenticando-me	autenticar+V.eu.AD.1.SG+GRD
autenticando-nos	autenticar+nós.AD.1.PL+GRD
autenticando-o	autenticar+V.ele.ACC.3.M.SG+GRD
autenticando-os	autenticar+V.ele.ACC.3.M.PL+GRD
autenticando-se	autenticar+V.ele.REFL+GRD
autenticando-te	autenticar+V.tu.AD.2.SG+GRD
autenticando-vos	autenticar+V.vós.AD.2.PL+GRD
autentica-nos	autenticar+nós.AD.1.PL+PRS+2+SG
autentica-nos	autenticar+nós.AD.1.PL+PRS+3+SG
autentica-o	autenticar+V.ele.ACC.3.M.SG+PRS+3+SG
autentica-os	autenticar+V.ele.ACC.3.M.PL+PRS+3+SG
autenticara-a	autenticar+V.ele.ACC.3.F.SG+PQP+1+SG
autenticara-a	autenticar+V.ele.ACC.3.F.SG+PQP+3+SG
autenticara-as	autenticar+V.ele.ACC.3.F.PL+PQP+1+SG
autenticara-as	autenticar+V.ele.ACC.3.F.PL+PQP+3+SG
autenticara-la	autenticar+V.ele.ACC.3.F.SG+PQP+2+SG
autenticara-las	autenticar+V.ele.ACC.3.F.PL+PQP+2+SG
autenticara-lhe	autenticar+V.ele.DAT.3.SG+PQP+1+SG
autenticara-lhe	autenticar+V.ele.DAT.3.SG+PQP+3+SG
autenticara-lhes	autenticar+V.ele.DAT.3.PL+PQP+1+SG
autenticara-lhes	autenticar+V.ele.DAT.3.PL+PQP+3+SG
autenticara-lo	autenticar+V.ele.ACC.3.M.SG+PQP+2+SG
autenticara-los	autenticar+V.ele.ACC.3.M.PL+PQP+2+SG
autenticara-me	autenticar+V.eu.AD.1.SG+PQP+1+SG
autenticara-me	autenticar+V.eu.AD.1.SG+PQP+3+SG
autenticaram-lhe	autenticar+V.ele.DAT.3.SG+PQP+3+PL
autenticaram-lhe	autenticar+V.ele.DAT.3.SG+PRF+3+PL
autenticaram-lhes	autenticar+V.ele.DAT.3.PL+PQP+3+PL
autenticaram-lhes	autenticar+V.ele.DAT.3.PL+PRF+3+PL
autenticaram-me	autenticar+V.eu.AD.1.SG+PQP+3+PL
autenticaram-me	autenticar+V.eu.AD.1.SG+PRF+3+PL
autenticaram-na	autenticar+V.ele.ACC.3.F.SG+PQP+3+PL
autenticaram-na	autenticar+V.ele.ACC.3.F.SG+PRF+3+PL
autenticaram-nas	autenticar+V.ele.ACC.3.F.PL+PQP+3+PL
autenticaram-nas	autenticar+V.ele.ACC.3.F.PL+PRF+3+PL
autenticaram-no	autenticar+V.ele.ACC.3.M.SG+PQP+3+PL
autenticaram-no	autenticar+V.ele.ACC.3.M.SG+PRF+3+PL
autenticaram-nos	autenticar+V.ele.ACC.3.M.PL+PQP+3+PL
autenticaram-nos	autenticar+V.ele.ACC.3.M.PL+PRF+3+PL
autenticaram-nos	autenticar+V.nós.AD.1.PL+PQP+3+PL
autenticaram-nos	autenticar+V.nós.AD.1.PL+PRF+3+PL
autenticáramo-la	autenticar+V.ele.ACC.3.F.SG+PQP+1+PL
autenticáramo-las	autenticar+V.ele.ACC.3.F.PL+PQP+1+PL
autenticáramo-lo	autenticar+V.ele.ACC.3.M.SG+PQP+1+PL
autenticáramo-los	autenticar+V.ele.ACC.3.M.PL+PQP+1+PL
autenticáramo-nos	autenticar+nós.AD.1.PL+PQP+1+PL
autenticáramos-lhe	autenticar+V.ele.DAT.3.SG+PQP+1+PL
autenticáramos-lhes	autenticar+V.ele.DAT.3.PL+PQP+1+PL
autenticáramos-me	autenticar+V.eu.AD.1.SG+PQP+1+PL
autenticáramos-te	autenticar+V.tu.AD.2.SG+PQP+1+PL
autenticáramos-vos	autenticar+V.vós.AD.2.PL+PQP+1+PL
autenticaram-se	autenticar+V.ele.REFL+PQP+3+PL
autenticaram-se	autenticar+V.ele.REFL+PRF+3+PL
autenticaram-te	autenticar+V.tu.AD.2.SG+PQP+3+PL
autenticaram-te	autenticar+V.tu.AD.2.SG+PRF+3+PL
autenticaram-vos	autenticar+V.vós.AD.2.PL+PQP+3+PL
autenticaram-vos	autenticar+V.vós.AD.2.PL+PRF+3+PL
autenticara-nos	autenticar+nós.AD.1.PL+PQP+1+SG
autenticara-nos	autenticar+nós.AD.1.PL+PQP+2+SG
autenticara-nos	autenticar+nós.AD.1.PL+PQP+3+SG
autenticara-o	autenticar+V.ele.ACC.3.M.SG+PQP+1+SG
autenticara-o	autenticar+V.ele.ACC.3.M.SG+PQP+3+SG
autenticara-os	autenticar+V.ele.ACC.3.M.PL+PQP+1+SG
autenticara-os	autenticar+V.ele.ACC.3.M.PL+PQP+3+SG
autenticara-se	autenticar+V.ele.REFL+PQP+1+SG
autenticara-se	autenticar+V.ele.REFL+PQP+3+SG
autenticaras-lhe	autenticar+V.ele.DAT.3.SG+PQP+2+SG
autenticaras-lhes	autenticar+V.ele.DAT.3.PL+PQP+2+SG
autenticaras-me	autenticar+V.eu.AD.1.SG+PQP+2+SG
autenticaras-te	autenticar+V.tu.AD.2.SG+PQP+2+SG
autenticaras-vos	autenticar+V.vós.AD.2.PL+PQP+2+SG
autenticara-te	autenticar+V.tu.AD.2.SG+PQP+1+SG
autenticara-te	autenticar+V.tu.AD.2.SG+PQP+3+SG
autenticara-vos	autenticar+V.vós.AD.2.PL+PQP+1+SG
autenticara-vos	autenticar+V.vós.AD.2.PL+PQP+3+SG
autenticarde-la	autenticar+V.ele.ACC.3.F.SG+INF+2+PL
autenticarde-la	autenticar+V.ele.ACC.3.F.SG+SBJF+2+PL
autenticarde-las	autenticar+V.ele.ACC.3.F.PL+INF+2+PL
autenticarde-las	autenticar+V.ele.ACC.3.F.PL+SBJF+2+PL
autenticarde-lo	autenticar+V.ele.ACC.3.M.SG+INF+2+PL
autenticarde-lo	autenticar+V.ele.ACC.3.M.SG+SBJF+2+PL
autenticarde-los	autenticar+V.ele.ACC.3.M.PL+INF+2+PL
autenticarde-los	autenticar+V.ele.ACC.3.M.PL+SBJF+2+PL
autenticarde-nos	autenticar+nós.AD.1.PL+INF+2+PL
autenticarde-nos	autenticar+nós.AD.1.PL+SBJF+2+PL
autenticardes-lhe	autenticar+V.ele.DAT.3.SG+INF+2+PL
autenticardes-lhe	autenticar+V.ele.DAT.3.SG+SBJF+2+PL
autenticardes-lhes	autenticar+V.ele.DAT.3.PL+INF+2+PL
autenticardes-lhes	autenticar+V.ele.DAT.3.PL+SBJF+2+PL
autenticardes-me	autenticar+V.eu.AD.1.SG+INF+2+PL
autenticardes-me	autenticar+V.eu.AD.1.SG+SBJF+2+PL
autenticardes-te	autenticar+V.tu.AD.2.SG+INF+2+PL
autenticardes-te	autenticar+V.tu.AD.2.SG+SBJF+2+PL
autenticardes-vos	autenticar+V.vós.AD.2.PL+INF+2+PL
autenticardes-vos	autenticar+V.vós.AD.2.PL+SBJF+2+PL
autenticárei-la	autenticar+V.ele.ACC.3.F.SG+PQP+2+PL
autenticárei-las	autenticar+V.ele.ACC.3.F.PL+PQP+2+PL
autenticárei-lo	autenticar+V.ele.ACC.3.M.SG+PQP+2+PL
autenticárei-los	autenticar+V.ele.ACC.3.M.PL+PQP+2+PL
autenticárei-nos	autenticar+nós.AD.1.PL+PQP+2+PL
autenticáreis-lhe	autenticar+V.ele.DAT.3.SG+PQP+2+PL
autenticáreis-lhes	autenticar+V.ele.DAT.3.PL+PQP+2+PL
autenticáreis-me	autenticar+V.eu.AD.1.SG+PQP+2+PL
autenticáreis-te	autenticar+V.tu.AD.2.SG+PQP+2+PL
autenticáreis-vos	autenticar+V.vós.AD.2.PL+PQP+2+PL
autenticare-la	autenticar+V.ele.ACC.3.F.SG+INF+2+SG
autenticare-la	autenticar+V.ele.ACC.3.F.SG+SBJF+2+SG
autenticare-las	autenticar+V.ele.ACC.3.F.PL+INF+2+SG
autenticare-las	autenticar+V.ele.ACC.3.F.PL+SBJF+2+SG
autenticare-lo	autenticar+V.ele.ACC.3.M.SG+INF+2+SG
autenticare-lo	autenticar+V.ele.ACC.3.M.SG+SBJF+2+SG
autenticare-los	autenticar+V.ele.ACC.3.M.PL+INF+2+SG
autenticare-los	autenticar+V.ele.ACC.3.M.PL+SBJF+2+SG
autenticarem-lhe	autenticar+V.ele.DAT.3.SG+INF+3+PL
autenticarem-lhe	autenticar+V.ele.DAT.3.SG+SBJF+3+PL
autenticarem-lhes	autenticar+V.ele.DAT.3.PL+INF+3+PL
autenticarem-lhes	autenticar+V.ele.DAT.3.PL+SBJF+3+PL
autenticarem-me	autenticar+V.eu.AD.1.SG+INF+3+PL
autenticarem-me	autenticar+V.eu.AD.1.SG+SBJF+3+PL
autenticarem-na	autenticar+V.ele.ACC.3.F.SG+INF+3+PL
autenticarem-na	autenticar+V.ele.ACC.3.F.SG+SBJF+3+PL
autenticarem-nas	autenticar+V.ele.ACC.3.F.PL+INF+3+PL
autenticarem-nas	autenticar+V.ele.ACC.3.F.PL+SBJF+3+PL
autenticarem-no	autenticar+V.ele.ACC.3.M.SG+INF+3+PL
autenticarem-no	autenticar+V.ele.ACC.3.M.SG+SBJF+3+PL
autenticarem-nos	autenticar+V.ele.ACC.3.M.PL+INF+3+PL
autenticarem-nos	autenticar+V.ele.ACC.3.M.PL+SBJF+3+PL
autenticarem-nos	autenticar+V.nós.AD.1.PL+INF+3+PL
autenticarem-nos	autenticar+V.nós.AD.1.PL+SBJF+3+PL
autenticarem-se	autenticar+V.ele.REFL+INF+3+PL
autenticarem-se	autenticar+V.ele.REFL+SBJF+3+PL
autenticarem-te	autenticar+V.tu.AD.2.SG+INF+3+PL
autenticarem-te	autenticar+V.tu.AD.2.SG+SBJF+3+PL
autenticarem-vos	autenticar+V.vós.AD.2.PL+INF+3+PL
autenticarem-vos	autenticar+V.vós.AD.2.PL+SBJF+3+PL
autenticare-nos	autenticar+nós.AD.1.PL+INF+2+SG
autenticare-nos	autenticar+nós.AD.1.PL+SBJF+2+SG
autenticares-lhe	autenticar+V.ele.DAT.3.SG+INF+2+SG
autenticares-lhe	autenticar+V.ele.DAT.3.SG+SBJF+2+SG
autenticares-lhes	autenticar+V.ele.DAT.3.PL+INF+2+SG
autenticares-lhes	autenticar+V.ele.DAT.3.PL+SBJF+2+SG
autenticares-me	autenticar+V.eu.AD.1.SG+INF+2+SG
autenticares-me	autenticar+V.eu.AD.1.SG+SBJF+2+SG
autenticares-te	autenticar+V.tu.AD.2.SG+INF+2+SG
autenticares-te	autenticar+V.tu.AD.2.SG+SBJF+2+SG
autenticares-vos	autenticar+V.vós.AD.2.PL+INF+2+SG
autenticares-vos	autenticar+V.vós.AD.2.PL+SBJF+2+SG
autenticar-lhe-á	autenticar+V.ele.DAT.3.SG+FUT+3+SG
autenticar-lhe-ão	autenticar+V.ele.DAT.3.SG+FUT+3+PL
autenticar-lhe-ás	autenticar+V.ele.DAT.3.SG+FUT+2+SG
autenticar-lhe	autenticar+V.ele.DAT.3.SG+INF
autenticar-lhe	autenticar+V.ele.DAT.3.SG+INF+1+SG
autenticar-lhe	autenticar+V.ele.DAT.3.SG+INF+3+SG
autenticar-lhe	autenticar+V.ele.DAT.3.SG+SBJF+1+SG
autenticar-lhe	autenticar+V.ele.DAT.3.SG+SBJF+3+SG
autenticar-lhe-ei	autenticar+V.ele.DAT.3.SG+FUT+1+SG
autenticar-lhe-eis	autenticar+V.ele.DAT.3.SG+FUT+2+PL
autenticar-lhe-emos	autenticar+V.ele.DAT.3.SG+FUT+1+PL
autenticar-lhe-ia	autenticar+V.ele.DAT.3.SG+COND+1+SG
autenticar-lhe-ia	autenticar+V.ele.DAT.3.SG+COND+3+SG
autenticar-lhe-iam	autenticar+V.ele.DAT.3.SG+COND+3+PL
autenticar-lhe-íamos	autenticar+V.ele.DAT.3.SG+COND+1+PL
autenticar-lhe-ias	autenticar+V.ele.DAT.3.SG+COND+2+SG
autenticar-lhe-íeis	autenticar+V.ele.DAT.3.SG+COND+2+PL
autenticar-lhes-á	autenticar+V.ele.DAT.3.PL+FUT+3+SG
autenticar-lhes-ão	autenticar+V.ele.DAT.3.PL+FUT+3+PL
autenticar-lhes-ás	autenticar+V.ele.DAT.3.PL+FUT+2+SG
autenticar-lhes	autenticar+V.ele.DAT.3.PL+INF
autenticar-lhes	autenticar+V.ele.DAT.3.PL+INF+1+SG
autenticar-lhes	autenticar+V.ele.DAT.3.PL+INF+3+SG
autenticar-lhes	autenticar+V.ele.DAT.3.PL+SBJF+1+SG
autenticar-lhes	autenticar+V.ele.DAT.3.PL+SBJF+3+SG
autenticar-lhes-ei	autenticar+V.ele.DAT.3.PL+FUT+1+SG
autenticar-lhes-eis	autenticar+V.ele.DAT.3.PL+FUT+2+PL
autenticar-lhes-emos	autenticar+V.ele.DAT.3.PL+FUT+1+PL
autenticar-lhes-ia	autenticar+V.ele.DAT.3.PL+COND+1+SG
autenticar-lhes-ia	autenticar+V.ele.DAT.3.PL+COND+3+SG
autenticar-lhes-iam	autenticar+V.ele.DAT.3.PL+COND+3+PL
autenticar-lhes-íamos	autenticar+V.ele.DAT.3.PL+COND+1+PL
autenticar-lhes-ias	autenticar+V.ele.DAT.3.PL+COND+2+SG
autenticar-lhes-íeis	autenticar+V.ele.DAT.3.PL+COND+2+PL
autenticar-me-á	autenticar+V.eu.AD.1.SG+FUT+3+SG
autenticar-me-ão	autenticar+V.eu.AD.1.SG+FUT+3+PL
autenticar-me-ás	autenticar+V.eu.AD.1.SG+FUT+2+SG
autenticar-me	autenticar+V.eu.AD.1.SG+INF
autenticar-me	autenticar+V.eu.AD.1.SG+INF+1+SG
autenticar-me	autenticar+V.eu.AD.1.SG+INF+3+SG
autenticar-me	autenticar+V.eu.AD.1.SG+SBJF+1+SG
autenticar-me	autenticar+V.eu.AD.1.SG+SBJF+3+SG
autenticar-me-ei	autenticar+V.eu.AD.1.SG+FUT+1+SG
autenticar-me-eis	autenticar+V.eu.AD.1.SG+FUT+2+PL
autenticar-me-emos	autenticar+V.eu.AD.1.SG+FUT+1+PL
autenticar-me-ia	autenticar+V.eu.AD.1.SG+COND+1+SG
autenticar-me-ia	autenticar+V.eu.AD.1.SG+COND+3+SG
autenticar-me-iam	autenticar+V.eu.AD.1.SG+COND+3+PL
autenticar-me-íamos	autenticar+V.eu.AD.1.SG+COND+1+PL
autenticar-me-ias	autenticar+V.eu.AD.1.SG+COND+2+SG
autenticar-me-íeis	autenticar+V.eu.AD.1.SG+COND+2+PL
autenticarmo-la	autenticar+V.ele.ACC.3.F.SG+INF+1+PL
autenticarmo-la	autenticar+V.ele.ACC.3.F.SG+SBJF+1+PL
autenticarmo-las	autenticar+V.ele.ACC.3.F.PL+INF+1+PL
autenticarmo-las	autenticar+V.ele.ACC.3.F.PL+SBJF+1+PL
autenticarmo-lo	autenticar+V.ele.ACC.3.M.SG+INF+1+PL
autenticarmo-lo	autenticar+V.ele.ACC.3.M.SG+SBJF+1+PL
autenticarmo-los	autenticar+V.ele.ACC.3.M.PL+INF+1+PL
autenticarmo-los	autenticar+V.ele.ACC.3.M.PL+SBJF+1+PL
autenticarmo-nos	autenticar+nós.AD.1.PL+INF+1+PL
autenticarmo-nos	autenticar+nós.AD.1.PL+SBJF+1+PL
autenticarmos-lhe	autenticar+V.ele.DAT.3.SG+INF+1+PL
autenticarmos-lhe	autenticar+V.ele.DAT.3.SG+SBJF+1+PL
autenticarmos-lhes	autenticar+V.ele.DAT.3.PL+INF+1+PL
autenticarmos-lhes	autenticar+V.ele.DAT.3.PL+SBJF+1+PL
autenticarmos-me	autenticar+V.eu.AD.1.SG+INF+1+PL
autenticarmos-me	autenticar+V.eu.AD.1.SG+SBJF+1+PL
autenticarmos-te	autenticar+V.tu.AD.2.SG+INF+1+PL
autenticarmos-te	autenticar+V.tu.AD.2.SG+SBJF+1+PL
autenticarmos-vos	autenticar+V.vós.AD.2.PL+INF+1+PL
autenticarmos-vos	autenticar+V.vós.AD.2.PL+SBJF+1+PL
autenticar-nos-á	autenticar+nós.AD.1.PL+FUT+3+SG
autenticar-nos-ão	autenticar+nós.AD.1.PL+FUT+3+PL
autenticar-nos-ás	autenticar+nós.AD.1.PL+FUT+2+SG
autenticar-nos	autenticar+nós.AD.1.PL+INF
autenticar-nos	autenticar+nós.AD.1.PL+INF+1+SG
autenticar-nos	autenticar+nós.AD.1.PL+INF+3+SG
autenticar-nos	autenticar+nós.AD.1.PL+SBJF+1+SG
autenticar-nos	autenticar+nós.AD.1.PL+SBJF+3+SG
autenticar-nos-ei	autenticar+nós.AD.1.PL+FUT+1+SG
autenticar-nos-eis	autenticar+nós.AD.1.PL+FUT+2+PL
autenticar-nos-emos	autenticar+nós.AD.1.PL+FUT+1+PL
autenticar-nos-ia	autenticar+nós.AD.1.PL+COND+1+SG
autenticar-nos-ia	autenticar+nós.AD.1.PL+COND+3+SG
autenticar-nos-iam	autenticar+nós.AD.1.PL+COND+3+PL
autenticar-nos-íamos	autenticar+nós.AD.1.PL+COND+1+PL
autenticar-nos-ias	autenticar+nós.AD.1.PL+COND+2+SG
autenticar-nos-íeis	autenticar+nós.AD.1.PL+COND+2+PL
autenticar-se-á	autenticar+V.ele.REFL+FUT+3+SG
autenticar-se-ão	autenticar+V.ele.REFL+FUT+3+PL
autenticar-se	autenticar+V.ele.REFL+INF
autenticar-se	autenticar+V.ele.REFL+INF+3+SG
autenticar-se	autenticar+V.ele.REFL+SBJF+3+SG
autenticar-se-ia	autenticar+V.ele.REFL+COND+3+SG
autenticar-se-iam	autenticar+V.ele.REFL+COND+3+PL
autenticar-te-á	autenticar+V.tu.AD.2.SG+FUT+3+SG
autenticar-te-ão	autenticar+V.tu.AD.2.SG+FUT+3+PL
autenticar-te-ás	autenticar+V.tu.AD.2.SG+FUT+2+SG
autenticar-te	autenticar+V.tu.AD.2.SG+INF
autenticar-te	autenticar+V.tu.AD.2.SG+INF+1+SG
autenticar-te	autenticar+V.tu.AD.2.SG+INF+3+SG
autenticar-te	autenticar+V.tu.AD.2.SG+SBJF+1+SG
autenticar-te	autenticar+V.tu.AD.2.SG+SBJF+3+SG
autenticar-te-ei	autenticar+V.tu.AD.2.SG+FUT+1+SG
autenticar-te-eis	autenticar+V.tu.AD.2.SG+FUT+2+PL
autenticar-te-emos	autenticar+V.tu.AD.2.SG+FUT+1+PL
autenticar-te-ia	autenticar+V.tu.AD.2.SG+COND+1+SG
autenticar-te-ia	autenticar+V.tu.AD.2.SG+COND+3+SG
autenticar-te-iam	autenticar+V.tu.AD.2.SG+COND+3+PL
autenticar-te-íamos	autenticar+V.tu.AD.2.SG+COND+1+PL
autenticar-te-ias	autenticar+V.tu.AD.2.SG+COND+2+SG
autenticar-te-íeis	autenticar+V.tu.AD.2.SG+COND+2+PL
autenticar-vos-á	autenticar+V.vós.AD.2.PL+FUT+3+SG
autenticar-vos-ão	autenticar+V.vós.AD.2.PL+FUT+3+PL
autenticar-vos-ás	autenticar+V.vós.AD.2.PL+FUT+2+SG
autenticar-vos	autenticar+V.vós.AD.2.PL+INF
autenticar-vos	autenticar+V.vós.AD.2.PL+INF+1+SG
autenticar-vos	autenticar+V.vós.AD.2.PL+INF+3+SG
autenticar-vos	autenticar+V.vós.AD.2.PL+SBJF+1+SG
autenticar-vos	autenticar+V.vós.AD.2.PL+SBJF+3+SG
autenticar-vos-ei	autenticar+V.vós.AD.2.PL+FUT+1+SG
autenticar-vos-eis	autenticar+V.vós.AD.2.PL+FUT+2+PL
autenticar-vos-emos	autenticar+V.vós.AD.2.PL+FUT+1+PL
autenticar-vos-ia	autenticar+V.vós.AD.2.PL+COND+1+SG
autenticar-vos-ia	autenticar+V.vós.AD.2.PL+COND+3+SG
autenticar-vos-iam	autenticar+V.vós.AD.2.PL+COND+3+PL
autenticar-vos-íamos	autenticar+V.vós.AD.2.PL+COND+1+PL
autenticar-vos-ias	autenticar+V.vós.AD.2.PL+COND+2+SG
autenticar-vos-íeis	autenticar+V.vós.AD.2.PL+COND+2+PL
autentica-se	autenticar+V.ele.REFL+PRS+3+SG
autenticas-lhe	autenticar+V.ele.DAT.3.SG+PRS+2+SG
autenticas-lhes	autenticar+V.ele.DAT.3.PL+PRS+2+SG
autenticas-me	autenticar+V.eu.AD.1.SG+PRS+2+SG
autenticas-te	autenticar+V.tu.AD.2.SG+PRS+2+SG
autenticaste-la	autenticar+V.ele.ACC.3.F.SG+PRF+2+PL
autenticaste-las	autenticar+V.ele.ACC.3.F.PL+PRF+2+PL
autenticaste-lo	autenticar+V.ele.ACC.3.M.SG+PRF+2+PL
autenticaste-los	autenticar+V.ele.ACC.3.M.PL+PRF+2+PL
autenticaste-nos	autenticar+nós.AD.1.PL+PRF+2+PL
autenticastes-lhe	autenticar+V.ele.DAT.3.SG+PRF+2+PL
autenticastes-lhes	autenticar+V.ele.DAT.3.PL+PRF+2+PL
autenticastes-me	autenticar+V.eu.AD.1.SG+PRF+2+PL
autenticastes-te	autenticar+V.tu.AD.2.SG+PRF+2+PL
autenticastes-vos	autenticar+V.vós.AD.2.PL+PRF+2+PL
autenticas-vos	autenticar+V.vós.AD.2.PL+PRS+2+SG
autentica-te	autenticar+V.tu.AD.2.SG+PRS+3+SG
autenticava-a	autenticar+V.ele.ACC.3.F.SG+IMPF+1+SG
autenticava-a	autenticar+V.ele.ACC.3.F.SG+IMPF+3+SG
autenticava-as	autenticar+V.ele.ACC.3.F.PL+IMPF+1+SG
autenticava-as	autenticar+V.ele.ACC.3.F.PL+IMPF+3+SG
autenticava-la	autenticar+V.ele.ACC.3.F.SG+IMPF+2+SG
autenticava-las	autenticar+V.ele.ACC.3.F.PL+IMPF+2+SG
autenticava-lhe	autenticar+V.ele.DAT.3.SG+IMPF+1+SG
autenticava-lhe	autenticar+V.ele.DAT.3.SG+IMPF+3+SG
autenticava-lhes	autenticar+V.ele.DAT.3.PL+IMPF+1+SG
autenticava-lhes	autenticar+V.ele.DAT.3.PL+IMPF+3+SG
autenticava-lo	autenticar+V.ele.ACC.3.M.SG+IMPF+2+SG
autenticava-los	autenticar+V.ele.ACC.3.M.PL+IMPF+2+SG
autenticava-me	autenticar+V.eu.AD.1.SG+IMPF+1+SG
autenticava-me	autenticar+V.eu.AD.1.SG+IMPF+3+SG
autenticavam-lhe	autenticar+V.ele.DAT.3.SG+IMPF+3+PL
autenticavam-lhes	autenticar+V.ele.DAT.3.PL+IMPF+3+PL
autenticavam-me	autenticar+V.eu.AD.1.SG+IMPF+3+PL
autenticavam-na	autenticar+V.ele.ACC.3.F.SG+IMPF+3+PL
autenticavam-nas	autenticar+V.ele.ACC.3.F.PL+IMPF+3+PL
autenticavam-no	autenticar+V.ele.ACC.3.M.SG+IMPF+3+PL
autenticavam-nos	autenticar+V.ele.ACC.3.M.PL+IMPF+3+PL
autenticavam-nos	autenticar+V.nós.AD.1.PL+IMPF+3+PL
autenticávamo-la	autenticar+V.ele.ACC.3.F.SG+IMPF+1+PL
autenticávamo-las	autenticar+V.ele.ACC.3.F.PL+IMPF+1+PL
autenticávamo-lo	autenticar+V.ele.ACC.3.M.SG+IMPF+1+PL
autenticávamo-los	autenticar+V.ele.ACC.3.M.PL+IMPF+1+PL
autenticávamo-nos	autenticar+nós.AD.1.PL+IMPF+1+PL
autenticávamos-lhe	autenticar+V.ele.DAT.3.SG+IMPF+1+PL
autenticávamos-lhes	autenticar+V.ele.DAT.3.PL+IMPF+1+PL
autenticávamos-me	autenticar+V.eu.AD.1.SG+IMPF+1+PL
autenticávamos-te	autenticar+V.tu.AD.2.SG+IMPF+1+PL
autenticávamos-vos	autenticar+V.vós.AD.2.PL+IMPF+1+PL
autenticavam-se	autenticar+V.ele.REFL+IMPF+3+PL
autenticavam-te	autenticar+V.tu.AD.2.SG+IMPF+3+PL
autenticavam-vos	autenticar+V.vós.AD.2.PL+IMPF+3+PL
autenticava-nos	autenticar+nós.AD.1.PL+IMPF+1+SG
autenticava-nos	autenticar+nós.AD.1.PL+IMPF+2+SG
autenticava-nos	autenticar+nós.AD.1.PL+IMPF+3+SG
autenticava-o	autenticar+V.ele.ACC.3.M.SG+IMPF+1+SG
autenticava-o	autenticar+V.ele.ACC.3.M.SG+IMPF+3+SG
autenticava-os	autenticar+V.ele.ACC.3.M.PL+IMPF+1+SG
autenticava-os	autenticar+V.ele.ACC.3.M.PL+IMPF+3+SG
autenticava-se	autenticar+V.ele.REFL+IMPF+1+SG
autenticava-se	autenticar+V.ele.REFL+IMPF+3+SG
autenticavas-lhe	autenticar+V.ele.DAT.3.SG+IMPF+2+SG
autenticavas-lhes	autenticar+V.ele.DAT.3.PL+IMPF+2+SG
autenticavas-me	autenticar+V.eu.AD.1.SG+IMPF+2+SG
autenticavas-te	autenticar+V.tu.AD.2.SG+IMPF+2+SG
autenticavas-vos	autenticar+V.vós.AD.2.PL+IMPF+2+SG
autenticava-te	autenticar+V.tu.AD.2.SG+IMPF+1+SG
autenticava-te	autenticar+V.tu.AD.2.SG+IMPF+3+SG
autenticava-vos	autenticar+V.vós.AD.2.PL+IMPF+1+SG
autenticava-vos	autenticar+V.vós.AD.2.PL+IMPF+3+SG
autenticávei-la	autenticar+V.ele.ACC.3.F.SG+IMPF+2+PL
autenticávei-las	autenticar+V.ele.ACC.3.F.PL+IMPF+2+PL
autenticávei-lo	autenticar+V.ele.ACC.3.M.SG+IMPF+2+PL
autenticávei-los	autenticar+V.ele.ACC.3.M.PL+IMPF+2+PL
autenticávei-nos	autenticar+nós.AD.1.PL+IMPF+2+PL
autenticáveis-lhe	autenticar+V.ele.DAT.3.SG+IMPF+2+PL
autenticáveis-lhes	autenticar+V.ele.DAT.3.PL+IMPF+2+PL
autenticáveis-me	autenticar+V.eu.AD.1.SG+IMPF+2+PL
autenticáveis-te	autenticar+V.tu.AD.2.SG+IMPF+2+PL
autenticáveis-vos	autenticar+V.vós.AD.2.PL+IMPF+2+PL
autentica-vos	autenticar+V.vós.AD.2.PL+PRS+3+SG
autentico-a	autenticar+V.ele.ACC.3.F.SG+PRS+1+SG
autentico-as	autenticar+V.ele.ACC.3.F.PL+PRS+1+SG
autentico-lhe	autenticar+V.ele.DAT.3.SG+PRS+1+SG
autentico-lhes	autenticar+V.ele.DAT.3.PL+PRS+1+SG
autentico-me	autenticar+V.eu.AD.1.SG+PRS+1+SG
autentico-nos	autenticar+nós.AD.1.PL+PRS+1+SG
autentico-o	autenticar+V.ele.ACC.3.M.SG+PRS+1+SG
autentico-os	autenticar+V.ele.ACC.3.M.PL+PRS+1+SG
autentico-te	autenticar+V.tu.AD.2.SG+PRS+1+SG
autenticou-a	autenticar+V.ele.ACC.3.F.SG+PRF+3+SG
autenticou-as	autenticar+V.ele.ACC.3.F.PL+PRF+3+SG
autenticou-lhe	autenticar+V.ele.DAT.3.SG+PRF+3+SG
autenticou-lhes	autenticar+V.ele.DAT.3.PL+PRF+3+SG
autenticou-me	autenticar+V.eu.AD.1.SG+PRF+3+SG
autenticou-nos	autenticar+nós.AD.1.PL+PRF+3+SG
autenticou-o	autenticar+V.ele.ACC.3.M.SG+PRF+3+SG
autenticou-os	autenticar+V.ele.ACC.3.M.PL+PRF+3+SG
autenticou-se	autenticar+V.ele.REFL+PRF+3+SG
autenticou-te	autenticar+V.tu.AD.2.SG+PRF+3+SG
autenticou-vos	autenticar+V.vós.AD.2.PL+PRF+3+SG
autentico-vos	autenticar+V.vós.AD.2.PL+PRS+1+SG
autentifica-a	autentificar+V.ele.ACC.3.F.SG+PRS+3+SG
autentifica-as	autentificar+V.ele.ACC.3.F.PL+PRS+3+SG
autentificai-la	autentificar+V.ele.ACC.3.F.SG+PRS+2+PL
autentificai-las	autentificar+V.ele.ACC.3.F.PL+PRS+2+PL
autentificai-lo	autentificar+V.ele.ACC.3.M.SG+PRS+2+PL
autentificai-los	autentificar+V.ele.ACC.3.M.PL+PRS+2+PL
autentificai-nos	autentificar+nós.AD.1.PL+PRS+2+PL
autentificais-lhe	autentificar+V.ele.DAT.3.SG+PRS+2+PL
autentificais-lhes	autentificar+V.ele.DAT.3.PL+PRS+2+PL
autentificais-me	autentificar+V.eu.AD.1.SG+PRS+2+PL
autentificais-te	autentificar+V.tu.AD.2.SG+PRS+2+PL
autentificais-vos	autentificar+V.vós.AD.2.PL+PRS+2+PL
autentificá-la-á	autentificar+V.ele.ACC.3.F.SG+FUT+3+SG
autentificá-la-ão	autentificar+V.ele.ACC.3.F.SG+FUT+3+PL
autentificá-la-ás	autentificar+V.ele.ACC.3.F.SG+FUT+2+SG
autentificá-la	autentificar+V.ele.ACC.3.F.SG+INF+1+SG
autentificá-la	autentificar+V.ele.ACC.3.F.SG+INF+3+SG
autentifica-la	autentificar+V.ele.ACC.3.F.SG+PRS+2+SG
autentificá-la	autentificar+V.ele.ACC.3.F.SG+SBJF+1+SG
autentificá-la	autentificar+V.ele.ACC.3.F.SG+SBJF+3+SG
autentificá-la-ei	autentificar+V.ele.ACC.3.F.SG+FUT+1+SG
autentificá-la-eis	autentificar+V.ele.ACC.3.F.SG+FUT+2+PL
autentificá-la-emos	autentificar+V.ele.ACC.3.F.SG+FUT+1+PL
autentificá-la-ia	autentificar+V.ele.ACC.3.F.SG+COND+1+SG
autentificá-la-ia	autentificar+V.ele.ACC.3.F.SG+COND+3+SG
autentificá-la-iam	autentificar+V.ele.ACC.3.F.SG+COND+3+PL
autentificá-la-íamos	autentificar+V.ele.ACC.3.F.SG+COND+1+PL
autentificá-la-ias	autentificar+V.ele.ACC.3.F.SG+COND+2+SG
autentificá-la-íeis	autentificar+V.ele.ACC.3.F.SG+COND+2+PL
autentificá-las-á	autentificar+V.ele.ACC.3.F.PL+FUT+3+SG
autentificá-las-ão	autentificar+V.ele.ACC.3.F.PL+FUT+3+PL
autentificá-las-ás	autentificar+V.ele.ACC.3.F.PL+FUT+2+SG
autentificá-las	autentificar+V.ele.ACC.3.F.PL+INF+1+SG
autentificá-las	autentificar+V.ele.ACC.3.F.PL+INF+3+SG
autentifica-las	autentificar+V.ele.ACC.3.F.PL+PRS+2+SG
autentificá-las	autentificar+V.ele.ACC.3.F.PL+SBJF+1+SG
autentificá-las	autentificar+V.ele.ACC.3.F.PL+SBJF+3+SG
autentificá-las-ei	autentificar+V.ele.ACC.3.F.PL+FUT+1+SG
autentificá-las-eis	autentificar+V.ele.ACC.3.F.PL+FUT+2+PL
autentificá-las-emos	autentificar+V.ele.ACC.3.F.PL+FUT+1+PL
autentificá-las-ia	autentificar+V.ele.ACC.3.F.PL+COND+1+SG
autentificá-las-ia	autentificar+V.ele.ACC.3.F.PL+COND+3+SG
autentificá-las-iam	autentificar+V.ele.ACC.3.F.PL+COND+3+PL
autentificá-las-íamos	autentificar+V.ele.ACC.3.F.PL+COND+1+PL
autentificá-las-ias	autentificar+V.ele.ACC.3.F.PL+COND+2+SG
autentificá-las-íeis	autentificar+V.ele.ACC.3.F.PL+COND+2+PL
autentifica-lhe	autentificar+V.ele.DAT.3.SG+PRS+3+SG
autentifica-lhes	autentificar+V.ele.DAT.3.PL+PRS+3+SG
autentificá-lo-á	autentificar+V.ele.ACC.3.M.SG+FUT+3+SG
autentificá-lo-ão	autentificar+V.ele.ACC.3.M.SG+FUT+3+PL
autentificá-lo-ás	autentificar+V.ele.ACC.3.M.SG+FUT+2+SG
autentificá-lo	autentificar+V.ele.ACC.3.M.SG+INF+1+SG
autentificá-lo	autentificar+V.ele.ACC.3.M.SG+INF+3+SG
autentifica-lo	autentificar+V.ele.ACC.3.M.SG+PRS+2+SG
autentificá-lo	autentificar+V.ele.ACC.3.M.SG+SBJF+1+SG
autentificá-lo	autentificar+V.ele.ACC.3.M.SG+SBJF+3+SG
autentificá-lo-ei	autentificar+V.ele.ACC.3.M.SG+FUT+1+SG
autentificá-lo-eis	autentificar+V.ele.ACC.3.M.SG+FUT+2+PL
autentificá-lo-emos	autentificar+V.ele.ACC.3.M.SG+FUT+1+PL
autentificá-lo-ia	autentificar+V.ele.ACC.3.M.SG+COND+1+SG
autentificá-lo-ia	autentificar+V.ele.ACC.3.M.SG+COND+3+SG
autentificá-lo-iam	autentificar+V.ele.ACC.3.M.SG+COND+3+PL
autentificá-lo-íamos	autentificar+V.ele.ACC.3.M.SG+COND+1+PL
autentificá-lo-ias	autentificar+V.ele.ACC.3.M.SG+COND+2+SG
autentificá-lo-íeis	autentificar+V.ele.ACC.3.M.SG+COND+2+PL
autentificá-los-á	autentificar+V.ele.ACC.3.M.PL+FUT+3+SG
autentificá-los-ão	autentificar+V.ele.ACC.3.M.PL+FUT+3+PL
autentificá-los-ás	autentificar+V.ele.ACC.3.M.PL+FUT+2+SG
autentificá-los	autentificar+V.ele.ACC.3.M.PL+INF+1+SG
autentificá-los	autentificar+V.ele.ACC.3.M.PL+INF+3+SG
autentifica-los	autentificar+V.ele.ACC.3.M.PL+PRS+2+SG
autentificá-los	autentificar+V.ele.ACC.3.M.PL+SBJF+1+SG
autentificá-los	autentificar+V.ele.ACC.3.M.PL+SBJF+3+SG
autentificá-los-ei	autentificar+V.ele.ACC.3.M.PL+FUT+1+SG
autentificá-los-eis	autentificar+V.ele.ACC.3.M.PL+FUT+2+PL
autentificá-los-emos	autentificar+V.ele.ACC.3.M.PL+FUT+1+PL
autentificá-los-ia	autentificar+V.ele.ACC.3.M.PL+COND+1+SG
autentificá-los-ia	autentificar+V.ele.ACC.3.M.PL+COND+3+SG
autentificá-los-iam	autentificar+V.ele.ACC.3.M.PL+COND+3+PL
autentificá-los-íamos	autentificar+V.ele.ACC.3.M.PL+COND+1+PL
autentificá-los-ias	autentificar+V.ele.ACC.3.M.PL+COND+2+SG
autentificá-los-íeis	autentificar+V.ele.ACC.3.M.PL+COND+2+PL
autentifica-me	autentificar+V.eu.AD.1.SG+PRS+3+SG
autentificam-lhe	autentificar+V.ele.DAT.3.SG+PRS+3+PL
autentificam-lhes	autentificar+V.ele.DAT.3.PL+PRS+3+PL
autentificam-me	autentificar+V.eu.AD.1.SG+PRS+3+PL
autentificam-na	autentificar+V.ele.ACC.3.F.SG+PRS+3+PL
autentificam-nas	autentificar+V.ele.ACC.3.F.PL+PRS+3+PL
autentificam-no	autentificar+V.ele.ACC.3.M.SG+PRS+3+PL
autentificam-nos	autentificar+V.ele.ACC.3.M.PL+PRS+3+PL
autentificam-nos	autentificar+V.nós.AD.1.PL+PRS+3+PL
autentificamo-la	autentificar+V.ele.ACC.3.F.SG+PRF+1+PL
autentificamo-la	autentificar+V.ele.ACC.3.F.SG+PRS+1+PL
autentificamo-las	autentificar+V.ele.ACC.3.F.PL+PRF+1+PL
autentificamo-las	autentificar+V.ele.ACC.3.F.PL+PRS+1+PL
autentificamo-lo	autentificar+V.ele.ACC.3.M.SG+PRF+1+PL
autentificamo-lo	autentificar+V.ele.ACC.3.M.SG+PRS+1+PL
autentificamo-los	autentificar+V.ele.ACC.3.M.PL+PRF+1+PL
autentificamo-los	autentificar+V.ele.ACC.3.M.PL+PRS+1+PL
autentificamo-nos	autentificar+nós.AD.1.PL+PRF+1+PL
autentificamo-nos	autentificar+nós.AD.1.PL+PRS+1+PL
autentificamos-lhe	autentificar+V.ele.DAT.3.SG+PRF+1+PL
autentificamos-lhe	autentificar+V.ele.DAT.3.SG+PRS+1+PL
autentificamos-lhes	autentificar+V.ele.DAT.3.PL+PRF+1+PL
autentificamos-lhes	autentificar+V.ele.DAT.3.PL+PRS+1+PL
autentificamos-me	autentificar+V.eu.AD.1.SG+PRF+1+PL
autentificamos-me	autentificar+V.eu.AD.1.SG+PRS+1+PL
autentificamos-te	autentificar+V.tu.AD.2.SG+PRF+1+PL
autentificamos-te	autentificar+V.tu.AD.2.SG+PRS+1+PL
autentificamos-vos	autentificar+V.vós.AD.2.PL+PRF+1+PL
autentificamos-vos	autentificar+V.vós.AD.2.PL+PRS+1+PL
autentificam-se	autentificar+V.ele.REFL+PRS+3+PL
autentificam-te	autentificar+V.tu.AD.2.SG+PRS+3+PL
autentificam-vos	autentificar+V.vós.AD.2.PL+PRS+3+PL
autentificando-a	autentificar+V.ele.ACC.3.F.SG+GRD
autentificando-as	autentificar+V.ele.ACC.3.F.PL+GRD
autentificando-lhe	autentificar+V.ele.DAT.3.SG+GRD
autentificando-lhes	autentificar+V.ele.DAT.3.PL+GRD
autentificando-me	autentificar+V.eu.AD.1.SG+GRD
autentificando-nos	autentificar+nós.AD.1.PL+GRD
autentificando-o	autentificar+V.ele.ACC.3.M.SG+GRD
autentificando-os	autentificar+V.ele.ACC.3.M.PL+GRD
autentificando-se	autentificar+V.ele.REFL+GRD
autentificando-te	autentificar+V.tu.AD.2.SG+GRD
autentificando-vos	autentificar+V.vós.AD.2.PL+GRD
autentifica-nos	autentificar+nós.AD.1.PL+PRS+2+SG
autentifica-nos	autentificar+nós.AD.1.PL+PRS+3+SG
autentifica-o	autentificar+V.ele.ACC.3.M.SG+PRS+3+SG
autentifica-os	autentificar+V.ele.ACC.3.M.PL+PRS+3+SG
autentificara-a	autentificar+V.ele.ACC.3.F.SG+PQP+1+SG
autentificara-a	autentificar+V.ele.ACC.3.F.SG+PQP+3+SG
autentificara-as	autentificar+V.ele.ACC.3.F.PL+PQP+1+SG
autentificara-as	autentificar+V.ele.ACC.3.F.PL+PQP+3+SG
autentificara-la	autentificar+V.ele.ACC.3.F.SG+PQP+2+SG
autentificara-las	autentificar+V.ele.ACC.3.F.PL+PQP+2+SG
autentificara-lhe	autentificar+V.ele.DAT.3.SG+PQP+1+SG
autentificara-lhe	autentificar+V.ele.DAT.3.SG+PQP+3+SG
autentificara-lhes	autentificar+V.ele.DAT.3.PL+PQP+1+SG
autentificara-lhes	autentificar+V.ele.DAT.3.PL+PQP+3+SG
autentificara-lo	autentificar+V.ele.ACC.3.M.SG+PQP+2+SG
autentificara-los	autentificar+V.ele.ACC.3.M.PL+PQP+2+SG
autentificara-me	autentificar+V.eu.AD.1.SG+PQP+1+SG
autentificara-me	autentificar+V.eu.AD.1.SG+PQP+3+SG
autentificaram-lhe	autentificar+V.ele.DAT.3.SG+PQP+3+PL
autentificaram-lhe	autentificar+V.ele.DAT.3.SG+PRF+3+PL
autentificaram-lhes	autentificar+V.ele.DAT.3.PL+PQP+3+PL
autentificaram-lhes	autentificar+V.ele.DAT.3.PL+PRF+3+PL
autentificaram-me	autentificar+V.eu.AD.1.SG+PQP+3+PL
autentificaram-me	autentificar+V.eu.AD.1.SG+PRF+3+PL
autentificaram-na	autentificar+V.ele.ACC.3.F.SG+PQP+3+PL
autentificaram-na	autentificar+V.ele.ACC.3.F.SG+PRF+3+PL
autentificaram-nas	autentificar+V.ele.ACC.3.F.PL+PQP+3+PL
autentificaram-nas	autentificar+V.ele.ACC.3.F.PL+PRF+3+PL
autentificaram-no	autentificar+V.ele.ACC.3.M.SG+PQP+3+PL
autentificaram-no	autentificar+V.ele.ACC.3.M.SG+PRF+3+PL
autentificaram-nos	autentificar+V.ele.ACC.3.M.PL+PQP+3+PL
autentificaram-nos	autentificar+V.ele.ACC.3.M.PL+PRF+3+PL
autentificaram-nos	autentificar+V.nós.AD.1.PL+PQP+3+PL
autentificaram-nos	autentificar+V.nós.AD.1.PL+PRF+3+PL
autentificáramo-la	autentificar+V.ele.ACC.3.F.SG+PQP+1+PL
autentificáramo-las	autentificar+V.ele.ACC.3.F.PL+PQP+1+PL
autentificáramo-lo	autentificar+V.ele.ACC.3.M.SG+PQP+1+PL
autentificáramo-los	autentificar+V.ele.ACC.3.M.PL+PQP+1+PL
autentificáramo-nos	autentificar+nós.AD.1.PL+PQP+1+PL
autentificáramos-lhe	autentificar+V.ele.DAT.3.SG+PQP+1+PL
autentificáramos-lhes	autentificar+V.ele.DAT.3.PL+PQP+1+PL
autentificáramos-me	autentificar+V.eu.AD.1.SG+PQP+1+PL
autentificáramos-te	autentificar+V.tu.AD.2.SG+PQP+1+PL
autentificáramos-vos	autentificar+V.vós.AD.2.PL+PQP+1+PL
autentificaram-se	autentificar+V.ele.REFL+PQP+3+PL
autentificaram-se	autentificar+V.ele.REFL+PRF+3+PL
autentificaram-te	autentificar+V.tu.AD.2.SG+PQP+3+PL
autentificaram-te	autentificar+V.tu.AD.2.SG+PRF+3+PL
autentificaram-vos	autentificar+V.vós.AD.2.PL+PQP+3+PL
autentificaram-vos	autentificar+V.vós.AD.2.PL+PRF+3+PL
autentificara-nos	autentificar+nós.AD.1.PL+PQP+1+SG
autentificara-nos	autentificar+nós.AD.1.PL+PQP+2+SG
autentificara-nos	autentificar+nós.AD.1.PL+PQP+3+SG
autentificara-o	autentificar+V.ele.ACC.3.M.SG+PQP+1+SG
autentificara-o	autentificar+V.ele.ACC.3.M.SG+PQP+3+SG
autentificara-os	autentificar+V.ele.ACC.3.M.PL+PQP+1+SG
autentificara-os	autentificar+V.ele.ACC.3.M.PL+PQP+3+SG
autentificara-se	autentificar+V.ele.REFL+PQP+1+SG
autentificara-se	autentificar+V.ele.REFL+PQP+3+SG
autentificaras-lhe	autentificar+V.ele.DAT.3.SG+PQP+2+SG
autentificaras-lhes	autentificar+V.ele.DAT.3.PL+PQP+2+SG
autentificaras-me	autentificar+V.eu.AD.1.SG+PQP+2+SG
autentificaras-te	autentificar+V.tu.AD.2.SG+PQP+2+SG
autentificaras-vos	autentificar+V.vós.AD.2.PL+PQP+2+SG
autentificara-te	autentificar+V.tu.AD.2.SG+PQP+1+SG
autentificara-te	autentificar+V.tu.AD.2.SG+PQP+3+SG
autentificara-vos	autentificar+V.vós.AD.2.PL+PQP+1+SG
autentificara-vos	autentificar+V.vós.AD.2.PL+PQP+3+SG
autentificarde-la	autentificar+V.ele.ACC.3.F.SG+INF+2+PL
autentificarde-la	autentificar+V.ele.ACC.3.F.SG+SBJF+2+PL
autentificarde-las	autentificar+V.ele.ACC.3.F.PL+INF+2+PL
autentificarde-las	autentificar+V.ele.ACC.3.F.PL+SBJF+2+PL
autentificarde-lo	autentificar+V.ele.ACC.3.M.SG+INF+2+PL
autentificarde-lo	autentificar+V.ele.ACC.3.M.SG+SBJF+2+PL
autentificarde-los	autentificar+V.ele.ACC.3.M.PL+INF+2+PL
autentificarde-los	autentificar+V.ele.ACC.3.M.PL+SBJF+2+PL
autentificarde-nos	autentificar+nós.AD.1.PL+INF+2+PL
autentificarde-nos	autentificar+nós.AD.1.PL+SBJF+2+PL
autentificardes-lhe	autentificar+V.ele.DAT.3.SG+INF+2+PL
autentificardes-lhe	autentificar+V.ele.DAT.3.SG+SBJF+2+PL
autentificardes-lhes	autentificar+V.ele.DAT.3.PL+INF+2+PL
autentificardes-lhes	autentificar+V.ele.DAT.3.PL+SBJF+2+PL
autentificardes-me	autentificar+V.eu.AD.1.SG+INF+2+PL
autentificardes-me	autentificar+V.eu.AD.1.SG+SBJF+2+PL
autentificardes-te	autentificar+V.tu.AD.2.SG+INF+2+PL
autentificardes-te	autentificar+V.tu.AD.2.SG+SBJF+2+PL
autentificardes-vos	autentificar+V.vós.AD.2.PL+INF+2+PL
autentificardes-vos	autentificar+V.vós.AD.2.PL+SBJF+2+PL
autentificárei-la	autentificar+V.ele.ACC.3.F.SG+PQP+2+PL
autentificárei-las	autentificar+V.ele.ACC.3.F.PL+PQP+2+PL
autentificárei-lo	autentificar+V.ele.ACC.3.M.SG+PQP+2+PL
autentificárei-los	autentificar+V.ele.ACC.3.M.PL+PQP+2+PL
autentificárei-nos	autentificar+nós.AD.1.PL+PQP+2+PL
autentificáreis-lhe	autentificar+V.ele.DAT.3.SG+PQP+2+PL
autentificáreis-lhes	autentificar+V.ele.DAT.3.PL+PQP+2+PL
autentificáreis-me	autentificar+V.eu.AD.1.SG+PQP+2+PL
autentificáreis-te	autentificar+V.tu.AD.2.SG+PQP+2+PL
autentificáreis-vos	autentificar+V.vós.AD.2.PL+PQP+2+PL
autentificare-la	autentificar+V.ele.ACC.3.F.SG+INF+2+SG
autentificare-la	autentificar+V.ele.ACC.3.F.SG+SBJF+2+SG
autentificare-las	autentificar+V.ele.ACC.3.F.PL+INF+2+SG
autentificare-las	autentificar+V.ele.ACC.3.F.PL+SBJF+2+SG
autentificare-lo	autentificar+V.ele.ACC.3.M.SG+INF+2+SG
autentificare-lo	autentificar+V.ele.ACC.3.M.SG+SBJF+2+SG
autentificare-los	autentificar+V.ele.ACC.3.M.PL+INF+2+SG
autentificare-los	autentificar+V.ele.ACC.3.M.PL+SBJF+2+SG
autentificarem-lhe	autentificar+V.ele.DAT.3.SG+INF+3+PL
autentificarem-lhe	autentificar+V.ele.DAT.3.SG+SBJF+3+PL
autentificarem-lhes	autentificar+V.ele.DAT.3.PL+INF+3+PL
autentificarem-lhes	autentificar+V.ele.DAT.3.PL+SBJF+3+PL
autentificarem-me	autentificar+V.eu.AD.1.SG+INF+3+PL
autentificarem-me	autentificar+V.eu.AD.1.SG+SBJF+3+PL
autentificarem-na	autentificar+V.ele.ACC.3.F.SG+INF+3+PL
autentificarem-na	autentificar+V.ele.ACC.3.F.SG+SBJF+3+PL
autentificarem-nas	autentificar+V.ele.ACC.3.F.PL+INF+3+PL
autentificarem-nas	autentificar+V.ele.ACC.3.F.PL+SBJF+3+PL
autentificarem-no	autentificar+V.ele.ACC.3.M.SG+INF+3+PL
autentificarem-no	autentificar+V.ele.ACC.3.M.SG+SBJF+3+PL
autentificarem-nos	autentificar+V.ele.ACC.3.M.PL+INF+3+PL
autentificarem-nos	autentificar+V.ele.ACC.3.M.PL+SBJF+3+PL
autentificarem-nos	autentificar+V.nós.AD.1.PL+INF+3+PL
autentificarem-nos	autentificar+V.nós.AD.1.PL+SBJF+3+PL
autentificarem-se	autentificar+V.ele.REFL+INF+3+PL
autentificarem-se	autentificar+V.ele.REFL+SBJF+3+PL
autentificarem-te	autentificar+V.tu.AD.2.SG+INF+3+PL
autentificarem-te	autentificar+V.tu.AD.2.SG+SBJF+3+PL
autentificarem-vos	autentificar+V.vós.AD.2.PL+INF+3+PL
autentificarem-vos	autentificar+V.vós.AD.2.PL+SBJF+3+PL
autentificare-nos	autentificar+nós.AD.1.PL+INF+2+SG
autentificare-nos	autentificar+nós.AD.1.PL+SBJF+2+SG
autentificares-lhe	autentificar+V.ele.DAT.3.SG+INF+2+SG
autentificares-lhe	autentificar+V.ele.DAT.3.SG+SBJF+2+SG
autentificares-lhes	autentificar+V.ele.DAT.3.PL+INF+2+SG
autentificares-lhes	autentificar+V.ele.DAT.3.PL+SBJF+2+SG
autentificares-me	autentificar+V.eu.AD.1.SG+INF+2+SG
autentificares-me	autentificar+V.eu.AD.1.SG+SBJF+2+SG
autentificares-te	autentificar+V.tu.AD.2.SG+INF+2+SG
autentificares-te	autentificar+V.tu.AD.2.SG+SBJF+2+SG
autentificares-vos	autentificar+V.vós.AD.2.PL+INF+2+SG
autentificares-vos	autentificar+V.vós.AD.2.PL+SBJF+2+SG
autentificar-lhe-á	autentificar+V.ele.DAT.3.SG+FUT+3+SG
autentificar-lhe-ão	autentificar+V.ele.DAT.3.SG+FUT+3+PL
autentificar-lhe-ás	autentificar+V.ele.DAT.3.SG+FUT+2+SG
autentificar-lhe	autentificar+V.ele.DAT.3.SG+INF
autentificar-lhe	autentificar+V.ele.DAT.3.SG+INF+1+SG
autentificar-lhe	autentificar+V.ele.DAT.3.SG+INF+3+SG
autentificar-lhe	autentificar+V.ele.DAT.3.SG+SBJF+1+SG
autentificar-lhe	autentificar+V.ele.DAT.3.SG+SBJF+3+SG
autentificar-lhe-ei	autentificar+V.ele.DAT.3.SG+FUT+1+SG
autentificar-lhe-eis	autentificar+V.ele.DAT.3.SG+FUT+2+PL
autentificar-lhe-emos	autentificar+V.ele.DAT.3.SG+FUT+1+PL
autentificar-lhe-ia	autentificar+V.ele.DAT.3.SG+COND+1+SG
autentificar-lhe-ia	autentificar+V.ele.DAT.3.SG+COND+3+SG
autentificar-lhe-iam	autentificar+V.ele.DAT.3.SG+COND+3+PL
autentificar-lhe-íamos	autentificar+V.ele.DAT.3.SG+COND+1+PL
autentificar-lhe-ias	autentificar+V.ele.DAT.3.SG+COND+2+SG
