babatarmos-lhes	babatar+V.ele.DAT.3.PL+SBJF+1+PL
babatarmos-me	babatar+V.eu.AD.1.SG+INF+1+PL
babatarmos-me	babatar+V.eu.AD.1.SG+SBJF+1+PL
babatarmos-te	babatar+V.tu.AD.2.SG+INF+1+PL
babatarmos-te	babatar+V.tu.AD.2.SG+SBJF+1+PL
babatarmos-vos	babatar+V.vós.AD.2.PL+INF+1+PL
babatarmos-vos	babatar+V.vós.AD.2.PL+SBJF+1+PL
babatar-nos-á	babatar+nós.AD.1.PL+FUT+3+SG
babatar-nos-ão	babatar+nós.AD.1.PL+FUT+3+PL
babatar-nos-ás	babatar+nós.AD.1.PL+FUT+2+SG
babatar-nos	babatar+nós.AD.1.PL+INF
babatar-nos	babatar+nós.AD.1.PL+INF+1+SG
babatar-nos	babatar+nós.AD.1.PL+INF+3+SG
babatar-nos	babatar+nós.AD.1.PL+SBJF+1+SG
babatar-nos	babatar+nós.AD.1.PL+SBJF+3+SG
babatar-nos-ei	babatar+nós.AD.1.PL+FUT+1+SG
babatar-nos-eis	babatar+nós.AD.1.PL+FUT+2+PL
babatar-nos-emos	babatar+nós.AD.1.PL+FUT+1+PL
babatar-nos-ia	babatar+nós.AD.1.PL+COND+1+SG
babatar-nos-ia	babatar+nós.AD.1.PL+COND+3+SG
babatar-nos-iam	babatar+nós.AD.1.PL+COND+3+PL
babatar-nos-íamos	babatar+nós.AD.1.PL+COND+1+PL
babatar-nos-ias	babatar+nós.AD.1.PL+COND+2+SG
babatar-nos-íeis	babatar+nós.AD.1.PL+COND+2+PL
babatar-se-á	babatar+V.ele.REFL+FUT+3+SG
babatar-se-ão	babatar+V.ele.REFL+FUT+3+PL
babatar-se	babatar+V.ele.REFL+INF
babatar-se	babatar+V.ele.REFL+INF+3+SG
babatar-se	babatar+V.ele.REFL+SBJF+3+SG
babatar-se-ia	babatar+V.ele.REFL+COND+3+SG
babatar-se-iam	babatar+V.ele.REFL+COND+3+PL
babatar-te-á	babatar+V.tu.AD.2.SG+FUT+3+SG
babatar-te-ão	babatar+V.tu.AD.2.SG+FUT+3+PL
babatar-te-ás	babatar+V.tu.AD.2.SG+FUT+2+SG
babatar-te	babatar+V.tu.AD.2.SG+INF
babatar-te	babatar+V.tu.AD.2.SG+INF+1+SG
babatar-te	babatar+V.tu.AD.2.SG+INF+3+SG
babatar-te	babatar+V.tu.AD.2.SG+SBJF+1+SG
babatar-te	babatar+V.tu.AD.2.SG+SBJF+3+SG
babatar-te-ei	babatar+V.tu.AD.2.SG+FUT+1+SG
babatar-te-eis	babatar+V.tu.AD.2.SG+FUT+2+PL
babatar-te-emos	babatar+V.tu.AD.2.SG+FUT+1+PL
babatar-te-ia	babatar+V.tu.AD.2.SG+COND+1+SG
babatar-te-ia	babatar+V.tu.AD.2.SG+COND+3+SG
babatar-te-iam	babatar+V.tu.AD.2.SG+COND+3+PL
babatar-te-íamos	babatar+V.tu.AD.2.SG+COND+1+PL
babatar-te-ias	babatar+V.tu.AD.2.SG+COND+2+SG
babatar-te-íeis	babatar+V.tu.AD.2.SG+COND+2+PL
babatar-vos-á	babatar+V.vós.AD.2.PL+FUT+3+SG
babatar-vos-ão	babatar+V.vós.AD.2.PL+FUT+3+PL
babatar-vos-ás	babatar+V.vós.AD.2.PL+FUT+2+SG
babatar-vos	babatar+V.vós.AD.2.PL+INF
babatar-vos	babatar+V.vós.AD.2.PL+INF+1+SG
babatar-vos	babatar+V.vós.AD.2.PL+INF+3+SG
babatar-vos	babatar+V.vós.AD.2.PL+SBJF+1+SG
babatar-vos	babatar+V.vós.AD.2.PL+SBJF+3+SG
babatar-vos-ei	babatar+V.vós.AD.2.PL+FUT+1+SG
babatar-vos-eis	babatar+V.vós.AD.2.PL+FUT+2+PL
babatar-vos-emos	babatar+V.vós.AD.2.PL+FUT+1+PL
babatar-vos-ia	babatar+V.vós.AD.2.PL+COND+1+SG
babatar-vos-ia	babatar+V.vós.AD.2.PL+COND+3+SG
babatar-vos-iam	babatar+V.vós.AD.2.PL+COND+3+PL
babatar-vos-íamos	babatar+V.vós.AD.2.PL+COND+1+PL
babatar-vos-ias	babatar+V.vós.AD.2.PL+COND+2+SG
babatar-vos-íeis	babatar+V.vós.AD.2.PL+COND+2+PL
babata-se	babatar+V.ele.REFL+PRS+3+SG
babatas-lhe	babatar+V.ele.DAT.3.SG+PRS+2+SG
babatas-lhes	babatar+V.ele.DAT.3.PL+PRS+2+SG
babatas-me	babatar+V.eu.AD.1.SG+PRS+2+SG
babataste-a	babatar+V.ele.ACC.3.F.SG+PRF+2+SG
babataste-as	babatar+V.ele.ACC.3.F.PL+PRF+2+SG
babatas-te	babatar+V.tu.AD.2.SG+PRS+2+SG
babataste-la	babatar+V.ele.ACC.3.F.SG+PRF+2+PL
babataste-las	babatar+V.ele.ACC.3.F.PL+PRF+2+PL
babataste-lhe	babatar+V.ele.DAT.3.SG+PRF+2+SG
babataste-lhes	babatar+V.ele.DAT.3.PL+PRF+2+SG
babataste-lo	babatar+V.ele.ACC.3.M.SG+PRF+2+PL
babataste-los	babatar+V.ele.ACC.3.M.PL+PRF+2+PL
babataste-me	babatar+V.eu.AD.1.SG+PRF+2+SG
babataste-nos	babatar+nós.AD.1.PL+PRF+2+PL
babataste-nos	babatar+nós.AD.1.PL+PRF+2+SG
babataste-o	babatar+V.ele.ACC.3.M.SG+PRF+2+SG
babataste-os	babatar+V.ele.ACC.3.M.PL+PRF+2+SG
babatastes-lhe	babatar+V.ele.DAT.3.SG+PRF+2+PL
babatastes-lhes	babatar+V.ele.DAT.3.PL+PRF+2+PL
babatastes-me	babatar+V.eu.AD.1.SG+PRF+2+PL
babatastes-te	babatar+V.tu.AD.2.SG+PRF+2+PL
babatastes-vos	babatar+V.vós.AD.2.PL+PRF+2+PL
babataste-te	babatar+V.tu.AD.2.SG+PRF+2+SG
babataste-vos	babatar+V.vós.AD.2.PL+PRF+2+SG
babatas-vos	babatar+V.vós.AD.2.PL+PRS+2+SG
babata-te	babatar+V.tu.AD.2.SG+PRS+3+SG
babatava-a	babatar+V.ele.ACC.3.F.SG+IMPF+1+SG
babatava-a	babatar+V.ele.ACC.3.F.SG+IMPF+3+SG
babatava-as	babatar+V.ele.ACC.3.F.PL+IMPF+1+SG
babatava-as	babatar+V.ele.ACC.3.F.PL+IMPF+3+SG
babatava-la	babatar+V.ele.ACC.3.F.SG+IMPF+2+SG
babatava-las	babatar+V.ele.ACC.3.F.PL+IMPF+2+SG
babatava-lhe	babatar+V.ele.DAT.3.SG+IMPF+1+SG
babatava-lhe	babatar+V.ele.DAT.3.SG+IMPF+3+SG
babatava-lhes	babatar+V.ele.DAT.3.PL+IMPF+1+SG
babatava-lhes	babatar+V.ele.DAT.3.PL+IMPF+3+SG
babatava-lo	babatar+V.ele.ACC.3.M.SG+IMPF+2+SG
babatava-los	babatar+V.ele.ACC.3.M.PL+IMPF+2+SG
babatava-me	babatar+V.eu.AD.1.SG+IMPF+1+SG
babatava-me	babatar+V.eu.AD.1.SG+IMPF+3+SG
babatavam-lhe	babatar+V.ele.DAT.3.SG+IMPF+3+PL
babatavam-lhes	babatar+V.ele.DAT.3.PL+IMPF+3+PL
babatavam-me	babatar+V.eu.AD.1.SG+IMPF+3+PL
babatavam-na	babatar+V.ele.ACC.3.F.SG+IMPF+3+PL
babatavam-nas	babatar+V.ele.ACC.3.F.PL+IMPF+3+PL
babatavam-no	babatar+V.ele.ACC.3.M.SG+IMPF+3+PL
babatavam-nos	babatar+V.ele.ACC.3.M.PL+IMPF+3+PL
babatavam-nos	babatar+V.nós.AD.1.PL+IMPF+3+PL
babatávamo-la	babatar+V.ele.ACC.3.F.SG+IMPF+1+PL
babatávamo-las	babatar+V.ele.ACC.3.F.PL+IMPF+1+PL
babatávamo-lo	babatar+V.ele.ACC.3.M.SG+IMPF+1+PL
babatávamo-los	babatar+V.ele.ACC.3.M.PL+IMPF+1+PL
babatávamo-nos	babatar+nós.AD.1.PL+IMPF+1+PL
babatávamos-lhe	babatar+V.ele.DAT.3.SG+IMPF+1+PL
babatávamos-lhes	babatar+V.ele.DAT.3.PL+IMPF+1+PL
babatávamos-me	babatar+V.eu.AD.1.SG+IMPF+1+PL
babatávamos-te	babatar+V.tu.AD.2.SG+IMPF+1+PL
babatávamos-vos	babatar+V.vós.AD.2.PL+IMPF+1+PL
babatavam-se	babatar+V.ele.REFL+IMPF+3+PL
babatavam-te	babatar+V.tu.AD.2.SG+IMPF+3+PL
babatavam-vos	babatar+V.vós.AD.2.PL+IMPF+3+PL
babatava-nos	babatar+nós.AD.1.PL+IMPF+1+SG
babatava-nos	babatar+nós.AD.1.PL+IMPF+2+SG
babatava-nos	babatar+nós.AD.1.PL+IMPF+3+SG
babatava-o	babatar+V.ele.ACC.3.M.SG+IMPF+1+SG
babatava-o	babatar+V.ele.ACC.3.M.SG+IMPF+3+SG
babatava-os	babatar+V.ele.ACC.3.M.PL+IMPF+1+SG
babatava-os	babatar+V.ele.ACC.3.M.PL+IMPF+3+SG
babatava-se	babatar+V.ele.REFL+IMPF+1+SG
babatava-se	babatar+V.ele.REFL+IMPF+3+SG
babatavas-lhe	babatar+V.ele.DAT.3.SG+IMPF+2+SG
babatavas-lhes	babatar+V.ele.DAT.3.PL+IMPF+2+SG
babatavas-me	babatar+V.eu.AD.1.SG+IMPF+2+SG
babatavas-te	babatar+V.tu.AD.2.SG+IMPF+2+SG
babatavas-vos	babatar+V.vós.AD.2.PL+IMPF+2+SG
babatava-te	babatar+V.tu.AD.2.SG+IMPF+1+SG
babatava-te	babatar+V.tu.AD.2.SG+IMPF+3+SG
babatava-vos	babatar+V.vós.AD.2.PL+IMPF+1+SG
babatava-vos	babatar+V.vós.AD.2.PL+IMPF+3+SG
babatávei-la	babatar+V.ele.ACC.3.F.SG+IMPF+2+PL
babatávei-las	babatar+V.ele.ACC.3.F.PL+IMPF+2+PL
babatávei-lo	babatar+V.ele.ACC.3.M.SG+IMPF+2+PL
babatávei-los	babatar+V.ele.ACC.3.M.PL+IMPF+2+PL
babatávei-nos	babatar+nós.AD.1.PL+IMPF+2+PL
babatáveis-lhe	babatar+V.ele.DAT.3.SG+IMPF+2+PL
babatáveis-lhes	babatar+V.ele.DAT.3.PL+IMPF+2+PL
babatáveis-me	babatar+V.eu.AD.1.SG+IMPF+2+PL
babatáveis-te	babatar+V.tu.AD.2.SG+IMPF+2+PL
babatáveis-vos	babatar+V.vós.AD.2.PL+IMPF+2+PL
babata-vos	babatar+V.vós.AD.2.PL+PRS+3+SG
babate-a	babatar+V.ele.ACC.3.F.SG+IMP+3+SG
babate-as	babatar+V.ele.ACC.3.F.PL+IMP+3+SG
baba-te	babar+V.tu.AD.2.SG+PRS+3+SG
babatei-a	babatar+V.ele.ACC.3.F.SG+PRF+1+SG
babatei-as	babatar+V.ele.ACC.3.F.PL+PRF+1+SG
babatei-lhe	babatar+V.ele.DAT.3.SG+PRF+1+SG
babatei-lhes	babatar+V.ele.DAT.3.PL+PRF+1+SG
babatei-me	babatar+V.eu.AD.1.SG+PRF+1+SG
babatei-nos	babatar+nós.AD.1.PL+PRF+1+SG
babatei-o	babatar+V.ele.ACC.3.M.SG+PRF+1+SG
babatei-os	babatar+V.ele.ACC.3.M.PL+PRF+1+SG
babatei-te	babatar+V.tu.AD.2.SG+PRF+1+SG
babatei-vos	babatar+V.vós.AD.2.PL+PRF+1+SG
babate-lhe	babatar+V.ele.DAT.3.SG+IMP+3+SG
babate-lhes	babatar+V.ele.DAT.3.PL+IMP+3+SG
babate-me	babatar+V.eu.AD.1.SG+IMP+3+SG
babatem-lhe	babatar+V.ele.DAT.3.SG+IMP+3+PL
babatem-lhes	babatar+V.ele.DAT.3.PL+IMP+3+PL
babatem-me	babatar+V.eu.AD.1.SG+IMP+3+PL
babatem-na	babatar+V.ele.ACC.3.F.SG+IMP+3+PL
babatem-nas	babatar+V.ele.ACC.3.F.PL+IMP+3+PL
babatem-no	babatar+V.ele.ACC.3.M.SG+IMP+3+PL
babatem-nos	babatar+V.ele.ACC.3.M.PL+IMP+3+PL
babatem-nos	babatar+V.nós.AD.1.PL+IMP+3+PL
babatemo-la	babatar+V.ele.ACC.3.F.SG+IMP+1+PL
babatemo-las	babatar+V.ele.ACC.3.F.PL+IMP+1+PL
babatemo-lo	babatar+V.ele.ACC.3.M.SG+IMP+1+PL
babatemo-los	babatar+V.ele.ACC.3.M.PL+IMP+1+PL
babatemo-nos	babatar+nós.AD.1.PL+IMP+1+PL
babatemos-lhe	babatar+V.ele.DAT.3.SG+IMP+1+PL
babatemos-lhes	babatar+V.ele.DAT.3.PL+IMP+1+PL
babatemos-me	babatar+V.eu.AD.1.SG+IMP+1+PL
babatemos-te	babatar+V.tu.AD.2.SG+IMP+1+PL
babatemos-vos	babatar+V.vós.AD.2.PL+IMP+1+PL
babatem-se	babatar+V.ele.REFL+IMP+3+PL
babatem-te	babatar+V.tu.AD.2.SG+IMP+3+PL
babatem-vos	babatar+V.vós.AD.2.PL+IMP+3+PL
babate-nos	babatar+nós.AD.1.PL+IMP+3+SG
babate-o	babatar+V.ele.ACC.3.M.SG+IMP+3+SG
babate-os	babatar+V.ele.ACC.3.M.PL+IMP+3+SG
babate-se	babatar+V.ele.REFL+IMP+3+SG
babate-te	babatar+V.tu.AD.2.SG+IMP+3+SG
babate-vos	babatar+V.vós.AD.2.PL+IMP+3+SG
babato-a	babatar+V.ele.ACC.3.F.SG+PRS+1+SG
babato-as	babatar+V.ele.ACC.3.F.PL+PRS+1+SG
babato-lhe	babatar+V.ele.DAT.3.SG+PRS+1+SG
babato-lhes	babatar+V.ele.DAT.3.PL+PRS+1+SG
babato-me	babatar+V.eu.AD.1.SG+PRS+1+SG
babato-nos	babatar+nós.AD.1.PL+PRS+1+SG
babato-o	babatar+V.ele.ACC.3.M.SG+PRS+1+SG
babato-os	babatar+V.ele.ACC.3.M.PL+PRS+1+SG
babato-te	babatar+V.tu.AD.2.SG+PRS+1+SG
babatou-a	babatar+V.ele.ACC.3.F.SG+PRF+3+SG
babatou-as	babatar+V.ele.ACC.3.F.PL+PRF+3+SG
babatou-lhe	babatar+V.ele.DAT.3.SG+PRF+3+SG
babatou-lhes	babatar+V.ele.DAT.3.PL+PRF+3+SG
babatou-me	babatar+V.eu.AD.1.SG+PRF+3+SG
babatou-nos	babatar+nós.AD.1.PL+PRF+3+SG
babatou-o	babatar+V.ele.ACC.3.M.SG+PRF+3+SG
babatou-os	babatar+V.ele.ACC.3.M.PL+PRF+3+SG
babatou-se	babatar+V.ele.REFL+PRF+3+SG
babatou-te	babatar+V.tu.AD.2.SG+PRF+3+SG
babatou-vos	babatar+V.vós.AD.2.PL+PRF+3+SG
babato-vos	babatar+V.vós.AD.2.PL+PRS+1+SG
babava-a	babar+V.ele.ACC.3.F.SG+IMPF+1+SG
babava-a	babar+V.ele.ACC.3.F.SG+IMPF+3+SG
babava-as	babar+V.ele.ACC.3.F.PL+IMPF+1+SG
babava-as	babar+V.ele.ACC.3.F.PL+IMPF+3+SG
babava-la	babar+V.ele.ACC.3.F.SG+IMPF+2+SG
babava-las	babar+V.ele.ACC.3.F.PL+IMPF+2+SG
babava-lhe	babar+V.ele.DAT.3.SG+IMPF+1+SG
babava-lhe	babar+V.ele.DAT.3.SG+IMPF+3+SG
babava-lhes	babar+V.ele.DAT.3.PL+IMPF+1+SG
babava-lhes	babar+V.ele.DAT.3.PL+IMPF+3+SG
babava-lo	babar+V.ele.ACC.3.M.SG+IMPF+2+SG
babava-los	babar+V.ele.ACC.3.M.PL+IMPF+2+SG
babava-me	babar+V.eu.AD.1.SG+IMPF+1+SG
babava-me	babar+V.eu.AD.1.SG+IMPF+3+SG
babavam-lhe	babar+V.ele.DAT.3.SG+IMPF+3+PL
babavam-lhes	babar+V.ele.DAT.3.PL+IMPF+3+PL
babavam-me	babar+V.eu.AD.1.SG+IMPF+3+PL
babavam-na	babar+V.ele.ACC.3.F.SG+IMPF+3+PL
babavam-nas	babar+V.ele.ACC.3.F.PL+IMPF+3+PL
babavam-no	babar+V.ele.ACC.3.M.SG+IMPF+3+PL
babavam-nos	babar+V.ele.ACC.3.M.PL+IMPF+3+PL
babavam-nos	babar+V.nós.AD.1.PL+IMPF+3+PL
babávamo-la	babar+V.ele.ACC.3.F.SG+IMPF+1+PL
babávamo-las	babar+V.ele.ACC.3.F.PL+IMPF+1+PL
babávamo-lo	babar+V.ele.ACC.3.M.SG+IMPF+1+PL
babávamo-los	babar+V.ele.ACC.3.M.PL+IMPF+1+PL
babávamo-nos	babar+nós.AD.1.PL+IMPF+1+PL
babávamos-lhe	babar+V.ele.DAT.3.SG+IMPF+1+PL
babávamos-lhes	babar+V.ele.DAT.3.PL+IMPF+1+PL
babávamos-me	babar+V.eu.AD.1.SG+IMPF+1+PL
babávamos-te	babar+V.tu.AD.2.SG+IMPF+1+PL
babávamos-vos	babar+V.vós.AD.2.PL+IMPF+1+PL
babavam-se	babar+V.ele.REFL+IMPF+3+PL
babavam-te	babar+V.tu.AD.2.SG+IMPF+3+PL
babavam-vos	babar+V.vós.AD.2.PL+IMPF+3+PL
babava-nos	babar+nós.AD.1.PL+IMPF+1+SG
babava-nos	babar+nós.AD.1.PL+IMPF+2+SG
babava-nos	babar+nós.AD.1.PL+IMPF+3+SG
babava-o	babar+V.ele.ACC.3.M.SG+IMPF+1+SG
babava-o	babar+V.ele.ACC.3.M.SG+IMPF+3+SG
babava-os	babar+V.ele.ACC.3.M.PL+IMPF+1+SG
babava-os	babar+V.ele.ACC.3.M.PL+IMPF+3+SG
babava-se	babar+V.ele.REFL+IMPF+1+SG
babava-se	babar+V.ele.REFL+IMPF+3+SG
babavas-lhe	babar+V.ele.DAT.3.SG+IMPF+2+SG
babavas-lhes	babar+V.ele.DAT.3.PL+IMPF+2+SG
babavas-me	babar+V.eu.AD.1.SG+IMPF+2+SG
babavas-te	babar+V.tu.AD.2.SG+IMPF+2+SG
babavas-vos	babar+V.vós.AD.2.PL+IMPF+2+SG
babava-te	babar+V.tu.AD.2.SG+IMPF+1+SG
babava-te	babar+V.tu.AD.2.SG+IMPF+3+SG
babava-vos	babar+V.vós.AD.2.PL+IMPF+1+SG
babava-vos	babar+V.vós.AD.2.PL+IMPF+3+SG
babávei-la	babar+V.ele.ACC.3.F.SG+IMPF+2+PL
babávei-las	babar+V.ele.ACC.3.F.PL+IMPF+2+PL
babávei-lo	babar+V.ele.ACC.3.M.SG+IMPF+2+PL
babávei-los	babar+V.ele.ACC.3.M.PL+IMPF+2+PL
babávei-nos	babar+nós.AD.1.PL+IMPF+2+PL
babáveis-lhe	babar+V.ele.DAT.3.SG+IMPF+2+PL
babáveis-lhes	babar+V.ele.DAT.3.PL+IMPF+2+PL
babáveis-me	babar+V.eu.AD.1.SG+IMPF+2+PL
babáveis-te	babar+V.tu.AD.2.SG+IMPF+2+PL
babáveis-vos	babar+V.vós.AD.2.PL+IMPF+2+PL
baba-vos	babar+V.vós.AD.2.PL+PRS+3+SG
babe-a	babar+V.ele.ACC.3.F.SG+IMP+3+SG
babe-as	babar+V.ele.ACC.3.F.PL+IMP+3+SG
babei-a	babar+V.ele.ACC.3.F.SG+PRF+1+SG
babei-as	babar+V.ele.ACC.3.F.PL+PRF+1+SG
babei-lhe	babar+V.ele.DAT.3.SG+PRF+1+SG
babei-lhes	babar+V.ele.DAT.3.PL+PRF+1+SG
babei-me	babar+V.eu.AD.1.SG+PRF+1+SG
babei-nos	babar+nós.AD.1.PL+PRF+1+SG
babei-o	babar+V.ele.ACC.3.M.SG+PRF+1+SG
babei-os	babar+V.ele.ACC.3.M.PL+PRF+1+SG
babei-te	babar+V.tu.AD.2.SG+PRF+1+SG
babei-vos	babar+V.vós.AD.2.PL+PRF+1+SG
babe-lhe	babar+V.ele.DAT.3.SG+IMP+3+SG
babe-lhes	babar+V.ele.DAT.3.PL+IMP+3+SG
babe-me	babar+V.eu.AD.1.SG+IMP+3+SG
babem-lhe	babar+V.ele.DAT.3.SG+IMP+3+PL
babem-lhes	babar+V.ele.DAT.3.PL+IMP+3+PL
babem-me	babar+V.eu.AD.1.SG+IMP+3+PL
babem-na	babar+V.ele.ACC.3.F.SG+IMP+3+PL
babem-nas	babar+V.ele.ACC.3.F.PL+IMP+3+PL
babem-no	babar+V.ele.ACC.3.M.SG+IMP+3+PL
babem-nos	babar+V.ele.ACC.3.M.PL+IMP+3+PL
babem-nos	babar+V.nós.AD.1.PL+IMP+3+PL
babemo-la	babar+V.ele.ACC.3.F.SG+IMP+1+PL
babemo-las	babar+V.ele.ACC.3.F.PL+IMP+1+PL
babemo-lo	babar+V.ele.ACC.3.M.SG+IMP+1+PL
babemo-los	babar+V.ele.ACC.3.M.PL+IMP+1+PL
babemo-nos	babar+nós.AD.1.PL+IMP+1+PL
babemos-lhe	babar+V.ele.DAT.3.SG+IMP+1+PL
babemos-lhes	babar+V.ele.DAT.3.PL+IMP+1+PL
babemos-me	babar+V.eu.AD.1.SG+IMP+1+PL
babemos-te	babar+V.tu.AD.2.SG+IMP+1+PL
babemos-vos	babar+V.vós.AD.2.PL+IMP+1+PL
babem-se	babar+V.ele.REFL+IMP+3+PL
babem-te	babar+V.tu.AD.2.SG+IMP+3+PL
babem-vos	babar+V.vós.AD.2.PL+IMP+3+PL
babe-nos	babar+nós.AD.1.PL+IMP+3+SG
babe-o	babar+V.ele.ACC.3.M.SG+IMP+3+SG
babe-os	babar+V.ele.ACC.3.M.PL+IMP+3+SG
babe-se	babar+V.ele.REFL+IMP+3+SG
babe-te	babar+V.tu.AD.2.SG+IMP+3+SG
babe-vos	babar+V.vós.AD.2.PL+IMP+3+SG
babiloniza-a	babilonizar+V.ele.ACC.3.F.SG+PRS+3+SG
babiloniza-as	babilonizar+V.ele.ACC.3.F.PL+PRS+3+SG
babilonizai-la	babilonizar+V.ele.ACC.3.F.SG+PRS+2+PL
babilonizai-las	babilonizar+V.ele.ACC.3.F.PL+PRS+2+PL
babilonizai-lo	babilonizar+V.ele.ACC.3.M.SG+PRS+2+PL
babilonizai-los	babilonizar+V.ele.ACC.3.M.PL+PRS+2+PL
babilonizai-nos	babilonizar+nós.AD.1.PL+PRS+2+PL
babilonizais-lhe	babilonizar+V.ele.DAT.3.SG+PRS+2+PL
babilonizais-lhes	babilonizar+V.ele.DAT.3.PL+PRS+2+PL
babilonizais-me	babilonizar+V.eu.AD.1.SG+PRS+2+PL
babilonizais-te	babilonizar+V.tu.AD.2.SG+PRS+2+PL
babilonizais-vos	babilonizar+V.vós.AD.2.PL+PRS+2+PL
babilonizá-la-á	babilonizar+V.ele.ACC.3.F.SG+FUT+3+SG
babilonizá-la-ão	babilonizar+V.ele.ACC.3.F.SG+FUT+3+PL
babilonizá-la-ás	babilonizar+V.ele.ACC.3.F.SG+FUT+2+SG
babilonizá-la	babilonizar+V.ele.ACC.3.F.SG+INF+1+SG
babilonizá-la	babilonizar+V.ele.ACC.3.F.SG+INF+3+SG
babiloniza-la	babilonizar+V.ele.ACC.3.F.SG+PRS+2+SG
babilonizá-la	babilonizar+V.ele.ACC.3.F.SG+SBJF+1+SG
babilonizá-la	babilonizar+V.ele.ACC.3.F.SG+SBJF+3+SG
babilonizá-la-ei	babilonizar+V.ele.ACC.3.F.SG+FUT+1+SG
babilonizá-la-eis	babilonizar+V.ele.ACC.3.F.SG+FUT+2+PL
babilonizá-la-emos	babilonizar+V.ele.ACC.3.F.SG+FUT+1+PL
babilonizá-la-ia	babilonizar+V.ele.ACC.3.F.SG+COND+1+SG
babilonizá-la-ia	babilonizar+V.ele.ACC.3.F.SG+COND+3+SG
babilonizá-la-iam	babilonizar+V.ele.ACC.3.F.SG+COND+3+PL
babilonizá-la-íamos	babilonizar+V.ele.ACC.3.F.SG+COND+1+PL
babilonizá-la-ias	babilonizar+V.ele.ACC.3.F.SG+COND+2+SG
babilonizá-la-íeis	babilonizar+V.ele.ACC.3.F.SG+COND+2+PL
babilonizá-las-á	babilonizar+V.ele.ACC.3.F.PL+FUT+3+SG
babilonizá-las-ão	babilonizar+V.ele.ACC.3.F.PL+FUT+3+PL
babilonizá-las-ás	babilonizar+V.ele.ACC.3.F.PL+FUT+2+SG
babilonizá-las	babilonizar+V.ele.ACC.3.F.PL+INF+1+SG
babilonizá-las	babilonizar+V.ele.ACC.3.F.PL+INF+3+SG
babiloniza-las	babilonizar+V.ele.ACC.3.F.PL+PRS+2+SG
babilonizá-las	babilonizar+V.ele.ACC.3.F.PL+SBJF+1+SG
babilonizá-las	babilonizar+V.ele.ACC.3.F.PL+SBJF+3+SG
babilonizá-las-ei	babilonizar+V.ele.ACC.3.F.PL+FUT+1+SG
babilonizá-las-eis	babilonizar+V.ele.ACC.3.F.PL+FUT+2+PL
babilonizá-las-emos	babilonizar+V.ele.ACC.3.F.PL+FUT+1+PL
babilonizá-las-ia	babilonizar+V.ele.ACC.3.F.PL+COND+1+SG
babilonizá-las-ia	babilonizar+V.ele.ACC.3.F.PL+COND+3+SG
babilonizá-las-iam	babilonizar+V.ele.ACC.3.F.PL+COND+3+PL
babilonizá-las-íamos	babilonizar+V.ele.ACC.3.F.PL+COND+1+PL
babilonizá-las-ias	babilonizar+V.ele.ACC.3.F.PL+COND+2+SG
babilonizá-las-íeis	babilonizar+V.ele.ACC.3.F.PL+COND+2+PL
babiloniza-lhe	babilonizar+V.ele.DAT.3.SG+PRS+3+SG
babiloniza-lhes	babilonizar+V.ele.DAT.3.PL+PRS+3+SG
babilonizá-lo-á	babilonizar+V.ele.ACC.3.M.SG+FUT+3+SG
babilonizá-lo-ão	babilonizar+V.ele.ACC.3.M.SG+FUT+3+PL
babilonizá-lo-ás	babilonizar+V.ele.ACC.3.M.SG+FUT+2+SG
babilonizá-lo	babilonizar+V.ele.ACC.3.M.SG+INF+1+SG
babilonizá-lo	babilonizar+V.ele.ACC.3.M.SG+INF+3+SG
babiloniza-lo	babilonizar+V.ele.ACC.3.M.SG+PRS+2+SG
babilonizá-lo	babilonizar+V.ele.ACC.3.M.SG+SBJF+1+SG
babilonizá-lo	babilonizar+V.ele.ACC.3.M.SG+SBJF+3+SG
babilonizá-lo-ei	babilonizar+V.ele.ACC.3.M.SG+FUT+1+SG
babilonizá-lo-eis	babilonizar+V.ele.ACC.3.M.SG+FUT+2+PL
babilonizá-lo-emos	babilonizar+V.ele.ACC.3.M.SG+FUT+1+PL
babilonizá-lo-ia	babilonizar+V.ele.ACC.3.M.SG+COND+1+SG
babilonizá-lo-ia	babilonizar+V.ele.ACC.3.M.SG+COND+3+SG
babilonizá-lo-iam	babilonizar+V.ele.ACC.3.M.SG+COND+3+PL
babilonizá-lo-íamos	babilonizar+V.ele.ACC.3.M.SG+COND+1+PL
babilonizá-lo-ias	babilonizar+V.ele.ACC.3.M.SG+COND+2+SG
babilonizá-lo-íeis	babilonizar+V.ele.ACC.3.M.SG+COND+2+PL
babilonizá-los-á	babilonizar+V.ele.ACC.3.M.PL+FUT+3+SG
babilonizá-los-ão	babilonizar+V.ele.ACC.3.M.PL+FUT+3+PL
babilonizá-los-ás	babilonizar+V.ele.ACC.3.M.PL+FUT+2+SG
babilonizá-los	babilonizar+V.ele.ACC.3.M.PL+INF+1+SG
babilonizá-los	babilonizar+V.ele.ACC.3.M.PL+INF+3+SG
babiloniza-los	babilonizar+V.ele.ACC.3.M.PL+PRS+2+SG
babilonizá-los	babilonizar+V.ele.ACC.3.M.PL+SBJF+1+SG
babilonizá-los	babilonizar+V.ele.ACC.3.M.PL+SBJF+3+SG
babilonizá-los-ei	babilonizar+V.ele.ACC.3.M.PL+FUT+1+SG
babilonizá-los-eis	babilonizar+V.ele.ACC.3.M.PL+FUT+2+PL
babilonizá-los-emos	babilonizar+V.ele.ACC.3.M.PL+FUT+1+PL
babilonizá-los-ia	babilonizar+V.ele.ACC.3.M.PL+COND+1+SG
babilonizá-los-ia	babilonizar+V.ele.ACC.3.M.PL+COND+3+SG
babilonizá-los-iam	babilonizar+V.ele.ACC.3.M.PL+COND+3+PL
babilonizá-los-íamos	babilonizar+V.ele.ACC.3.M.PL+COND+1+PL
babilonizá-los-ias	babilonizar+V.ele.ACC.3.M.PL+COND+2+SG
babilonizá-los-íeis	babilonizar+V.ele.ACC.3.M.PL+COND+2+PL
babiloniza-me	babilonizar+V.eu.AD.1.SG+PRS+3+SG
babilonizam-lhe	babilonizar+V.ele.DAT.3.SG+PRS+3+PL
babilonizam-lhes	babilonizar+V.ele.DAT.3.PL+PRS+3+PL
babilonizam-me	babilonizar+V.eu.AD.1.SG+PRS+3+PL
babilonizam-na	babilonizar+V.ele.ACC.3.F.SG+PRS+3+PL
babilonizam-nas	babilonizar+V.ele.ACC.3.F.PL+PRS+3+PL
babilonizam-no	babilonizar+V.ele.ACC.3.M.SG+PRS+3+PL
babilonizam-nos	babilonizar+V.ele.ACC.3.M.PL+PRS+3+PL
babilonizam-nos	babilonizar+V.nós.AD.1.PL+PRS+3+PL
babilonizamo-la	babilonizar+V.ele.ACC.3.F.SG+PRF+1+PL
babilonizamo-la	babilonizar+V.ele.ACC.3.F.SG+PRS+1+PL
babilonizamo-las	babilonizar+V.ele.ACC.3.F.PL+PRF+1+PL
babilonizamo-las	babilonizar+V.ele.ACC.3.F.PL+PRS+1+PL
babilonizamo-lo	babilonizar+V.ele.ACC.3.M.SG+PRF+1+PL
babilonizamo-lo	babilonizar+V.ele.ACC.3.M.SG+PRS+1+PL
babilonizamo-los	babilonizar+V.ele.ACC.3.M.PL+PRF+1+PL
babilonizamo-los	babilonizar+V.ele.ACC.3.M.PL+PRS+1+PL
babilonizamo-nos	babilonizar+nós.AD.1.PL+PRF+1+PL
babilonizamo-nos	babilonizar+nós.AD.1.PL+PRS+1+PL
babilonizamos-lhe	babilonizar+V.ele.DAT.3.SG+PRF+1+PL
babilonizamos-lhe	babilonizar+V.ele.DAT.3.SG+PRS+1+PL
babilonizamos-lhes	babilonizar+V.ele.DAT.3.PL+PRF+1+PL
babilonizamos-lhes	babilonizar+V.ele.DAT.3.PL+PRS+1+PL
babilonizamos-me	babilonizar+V.eu.AD.1.SG+PRF+1+PL
babilonizamos-me	babilonizar+V.eu.AD.1.SG+PRS+1+PL
babilonizamos-te	babilonizar+V.tu.AD.2.SG+PRF+1+PL
babilonizamos-te	babilonizar+V.tu.AD.2.SG+PRS+1+PL
babilonizamos-vos	babilonizar+V.vós.AD.2.PL+PRF+1+PL
babilonizamos-vos	babilonizar+V.vós.AD.2.PL+PRS+1+PL
babilonizam-se	babilonizar+V.ele.REFL+PRS+3+PL
babilonizam-te	babilonizar+V.tu.AD.2.SG+PRS+3+PL
babilonizam-vos	babilonizar+V.vós.AD.2.PL+PRS+3+PL
babilonizando-a	babilonizar+V.ele.ACC.3.F.SG+GRD
babilonizando-as	babilonizar+V.ele.ACC.3.F.PL+GRD
babilonizando-lhe	babilonizar+V.ele.DAT.3.SG+GRD
babilonizando-lhes	babilonizar+V.ele.DAT.3.PL+GRD
babilonizando-me	babilonizar+V.eu.AD.1.SG+GRD
babilonizando-nos	babilonizar+nós.AD.1.PL+GRD
babilonizando-o	babilonizar+V.ele.ACC.3.M.SG+GRD
babilonizando-os	babilonizar+V.ele.ACC.3.M.PL+GRD
babilonizando-se	babilonizar+V.ele.REFL+GRD
babilonizando-te	babilonizar+V.tu.AD.2.SG+GRD
babilonizando-vos	babilonizar+V.vós.AD.2.PL+GRD
babiloniza-nos	babilonizar+nós.AD.1.PL+PRS+2+SG
babiloniza-nos	babilonizar+nós.AD.1.PL+PRS+3+SG
babiloniza-o	babilonizar+V.ele.ACC.3.M.SG+PRS+3+SG
babiloniza-os	babilonizar+V.ele.ACC.3.M.PL+PRS+3+SG
babilonizara-a	babilonizar+V.ele.ACC.3.F.SG+PQP+1+SG
babilonizara-a	babilonizar+V.ele.ACC.3.F.SG+PQP+3+SG
babilonizara-as	babilonizar+V.ele.ACC.3.F.PL+PQP+1+SG
babilonizara-as	babilonizar+V.ele.ACC.3.F.PL+PQP+3+SG
babilonizara-la	babilonizar+V.ele.ACC.3.F.SG+PQP+2+SG
babilonizara-las	babilonizar+V.ele.ACC.3.F.PL+PQP+2+SG
babilonizara-lhe	babilonizar+V.ele.DAT.3.SG+PQP+1+SG
babilonizara-lhe	babilonizar+V.ele.DAT.3.SG+PQP+3+SG
babilonizara-lhes	babilonizar+V.ele.DAT.3.PL+PQP+1+SG
babilonizara-lhes	babilonizar+V.ele.DAT.3.PL+PQP+3+SG
babilonizara-lo	babilonizar+V.ele.ACC.3.M.SG+PQP+2+SG
babilonizara-los	babilonizar+V.ele.ACC.3.M.PL+PQP+2+SG
babilonizara-me	babilonizar+V.eu.AD.1.SG+PQP+1+SG
babilonizara-me	babilonizar+V.eu.AD.1.SG+PQP+3+SG
babilonizaram-lhe	babilonizar+V.ele.DAT.3.SG+PQP+3+PL
babilonizaram-lhe	babilonizar+V.ele.DAT.3.SG+PRF+3+PL
babilonizaram-lhes	babilonizar+V.ele.DAT.3.PL+PQP+3+PL
babilonizaram-lhes	babilonizar+V.ele.DAT.3.PL+PRF+3+PL
babilonizaram-me	babilonizar+V.eu.AD.1.SG+PQP+3+PL
babilonizaram-me	babilonizar+V.eu.AD.1.SG+PRF+3+PL
babilonizaram-na	babilonizar+V.ele.ACC.3.F.SG+PQP+3+PL
babilonizaram-na	babilonizar+V.ele.ACC.3.F.SG+PRF+3+PL
babilonizaram-nas	babilonizar+V.ele.ACC.3.F.PL+PQP+3+PL
babilonizaram-nas	babilonizar+V.ele.ACC.3.F.PL+PRF+3+PL
babilonizaram-no	babilonizar+V.ele.ACC.3.M.SG+PQP+3+PL
babilonizaram-no	babilonizar+V.ele.ACC.3.M.SG+PRF+3+PL
babilonizaram-nos	babilonizar+V.ele.ACC.3.M.PL+PQP+3+PL
babilonizaram-nos	babilonizar+V.ele.ACC.3.M.PL+PRF+3+PL
babilonizaram-nos	babilonizar+V.nós.AD.1.PL+PQP+3+PL
babilonizaram-nos	babilonizar+V.nós.AD.1.PL+PRF+3+PL
babilonizáramo-la	babilonizar+V.ele.ACC.3.F.SG+PQP+1+PL
babilonizáramo-las	babilonizar+V.ele.ACC.3.F.PL+PQP+1+PL
babilonizáramo-lo	babilonizar+V.ele.ACC.3.M.SG+PQP+1+PL
babilonizáramo-los	babilonizar+V.ele.ACC.3.M.PL+PQP+1+PL
babilonizáramo-nos	babilonizar+nós.AD.1.PL+PQP+1+PL
babilonizáramos-lhe	babilonizar+V.ele.DAT.3.SG+PQP+1+PL
babilonizáramos-lhes	babilonizar+V.ele.DAT.3.PL+PQP+1+PL
babilonizáramos-me	babilonizar+V.eu.AD.1.SG+PQP+1+PL
babilonizáramos-te	babilonizar+V.tu.AD.2.SG+PQP+1+PL
babilonizáramos-vos	babilonizar+V.vós.AD.2.PL+PQP+1+PL
babilonizaram-se	babilonizar+V.ele.REFL+PQP+3+PL
babilonizaram-se	babilonizar+V.ele.REFL+PRF+3+PL
babilonizaram-te	babilonizar+V.tu.AD.2.SG+PQP+3+PL
babilonizaram-te	babilonizar+V.tu.AD.2.SG+PRF+3+PL
babilonizaram-vos	babilonizar+V.vós.AD.2.PL+PQP+3+PL
babilonizaram-vos	babilonizar+V.vós.AD.2.PL+PRF+3+PL
babilonizara-nos	babilonizar+nós.AD.1.PL+PQP+1+SG
babilonizara-nos	babilonizar+nós.AD.1.PL+PQP+2+SG
babilonizara-nos	babilonizar+nós.AD.1.PL+PQP+3+SG
babilonizara-o	babilonizar+V.ele.ACC.3.M.SG+PQP+1+SG
babilonizara-o	babilonizar+V.ele.ACC.3.M.SG+PQP+3+SG
babilonizara-os	babilonizar+V.ele.ACC.3.M.PL+PQP+1+SG
babilonizara-os	babilonizar+V.ele.ACC.3.M.PL+PQP+3+SG
babilonizara-se	babilonizar+V.ele.REFL+PQP+1+SG
babilonizara-se	babilonizar+V.ele.REFL+PQP+3+SG
babilonizaras-lhe	babilonizar+V.ele.DAT.3.SG+PQP+2+SG
babilonizaras-lhes	babilonizar+V.ele.DAT.3.PL+PQP+2+SG
babilonizaras-me	babilonizar+V.eu.AD.1.SG+PQP+2+SG
babilonizaras-te	babilonizar+V.tu.AD.2.SG+PQP+2+SG
babilonizaras-vos	babilonizar+V.vós.AD.2.PL+PQP+2+SG
babilonizara-te	babilonizar+V.tu.AD.2.SG+PQP+1+SG
babilonizara-te	babilonizar+V.tu.AD.2.SG+PQP+3+SG
babilonizara-vos	babilonizar+V.vós.AD.2.PL+PQP+1+SG
babilonizara-vos	babilonizar+V.vós.AD.2.PL+PQP+3+SG
babilonizarde-la	babilonizar+V.ele.ACC.3.F.SG+INF+2+PL
babilonizarde-la	babilonizar+V.ele.ACC.3.F.SG+SBJF+2+PL
babilonizarde-las	babilonizar+V.ele.ACC.3.F.PL+INF+2+PL
babilonizarde-las	babilonizar+V.ele.ACC.3.F.PL+SBJF+2+PL
babilonizarde-lo	babilonizar+V.ele.ACC.3.M.SG+INF+2+PL
babilonizarde-lo	babilonizar+V.ele.ACC.3.M.SG+SBJF+2+PL
babilonizarde-los	babilonizar+V.ele.ACC.3.M.PL+INF+2+PL
babilonizarde-los	babilonizar+V.ele.ACC.3.M.PL+SBJF+2+PL
babilonizarde-nos	babilonizar+nós.AD.1.PL+INF+2+PL
babilonizarde-nos	babilonizar+nós.AD.1.PL+SBJF+2+PL
babilonizardes-lhe	babilonizar+V.ele.DAT.3.SG+INF+2+PL
babilonizardes-lhe	babilonizar+V.ele.DAT.3.SG+SBJF+2+PL
babilonizardes-lhes	babilonizar+V.ele.DAT.3.PL+INF+2+PL
babilonizardes-lhes	babilonizar+V.ele.DAT.3.PL+SBJF+2+PL
babilonizardes-me	babilonizar+V.eu.AD.1.SG+INF+2+PL
babilonizardes-me	babilonizar+V.eu.AD.1.SG+SBJF+2+PL
babilonizardes-te	babilonizar+V.tu.AD.2.SG+INF+2+PL
babilonizardes-te	babilonizar+V.tu.AD.2.SG+SBJF+2+PL
babilonizardes-vos	babilonizar+V.vós.AD.2.PL+INF+2+PL
babilonizardes-vos	babilonizar+V.vós.AD.2.PL+SBJF+2+PL
babilonizárei-la	babilonizar+V.ele.ACC.3.F.SG+PQP+2+PL
babilonizárei-las	babilonizar+V.ele.ACC.3.F.PL+PQP+2+PL
babilonizárei-lo	babilonizar+V.ele.ACC.3.M.SG+PQP+2+PL
babilonizárei-los	babilonizar+V.ele.ACC.3.M.PL+PQP+2+PL
babilonizárei-nos	babilonizar+nós.AD.1.PL+PQP+2+PL
babilonizáreis-lhe	babilonizar+V.ele.DAT.3.SG+PQP+2+PL
babilonizáreis-lhes	babilonizar+V.ele.DAT.3.PL+PQP+2+PL
babilonizáreis-me	babilonizar+V.eu.AD.1.SG+PQP+2+PL
babilonizáreis-te	babilonizar+V.tu.AD.2.SG+PQP+2+PL
babilonizáreis-vos	babilonizar+V.vós.AD.2.PL+PQP+2+PL
babilonizare-la	babilonizar+V.ele.ACC.3.F.SG+INF+2+SG
babilonizare-la	babilonizar+V.ele.ACC.3.F.SG+SBJF+2+SG
babilonizare-las	babilonizar+V.ele.ACC.3.F.PL+INF+2+SG
babilonizare-las	babilonizar+V.ele.ACC.3.F.PL+SBJF+2+SG
babilonizare-lo	babilonizar+V.ele.ACC.3.M.SG+INF+2+SG
babilonizare-lo	babilonizar+V.ele.ACC.3.M.SG+SBJF+2+SG
babilonizare-los	babilonizar+V.ele.ACC.3.M.PL+INF+2+SG
babilonizare-los	babilonizar+V.ele.ACC.3.M.PL+SBJF+2+SG
babilonizarem-lhe	babilonizar+V.ele.DAT.3.SG+INF+3+PL
babilonizarem-lhe	babilonizar+V.ele.DAT.3.SG+SBJF+3+PL
babilonizarem-lhes	babilonizar+V.ele.DAT.3.PL+INF+3+PL
babilonizarem-lhes	babilonizar+V.ele.DAT.3.PL+SBJF+3+PL
babilonizarem-me	babilonizar+V.eu.AD.1.SG+INF+3+PL
babilonizarem-me	babilonizar+V.eu.AD.1.SG+SBJF+3+PL
babilonizarem-na	babilonizar+V.ele.ACC.3.F.SG+INF+3+PL
babilonizarem-na	babilonizar+V.ele.ACC.3.F.SG+SBJF+3+PL
babilonizarem-nas	babilonizar+V.ele.ACC.3.F.PL+INF+3+PL
babilonizarem-nas	babilonizar+V.ele.ACC.3.F.PL+SBJF+3+PL
babilonizarem-no	babilonizar+V.ele.ACC.3.M.SG+INF+3+PL
babilonizarem-no	babilonizar+V.ele.ACC.3.M.SG+SBJF+3+PL
babilonizarem-nos	babilonizar+V.ele.ACC.3.M.PL+INF+3+PL
babilonizarem-nos	babilonizar+V.ele.ACC.3.M.PL+SBJF+3+PL
babilonizarem-nos	babilonizar+V.nós.AD.1.PL+INF+3+PL
babilonizarem-nos	babilonizar+V.nós.AD.1.PL+SBJF+3+PL
babilonizarem-se	babilonizar+V.ele.REFL+INF+3+PL
babilonizarem-se	babilonizar+V.ele.REFL+SBJF+3+PL
babilonizarem-te	babilonizar+V.tu.AD.2.SG+INF+3+PL
babilonizarem-te	babilonizar+V.tu.AD.2.SG+SBJF+3+PL
babilonizarem-vos	babilonizar+V.vós.AD.2.PL+INF+3+PL
babilonizarem-vos	babilonizar+V.vós.AD.2.PL+SBJF+3+PL
babilonizare-nos	babilonizar+nós.AD.1.PL+INF+2+SG
babilonizare-nos	babilonizar+nós.AD.1.PL+SBJF+2+SG
babilonizares-lhe	babilonizar+V.ele.DAT.3.SG+INF+2+SG
babilonizares-lhe	babilonizar+V.ele.DAT.3.SG+SBJF+2+SG
babilonizares-lhes	babilonizar+V.ele.DAT.3.PL+INF+2+SG
babilonizares-lhes	babilonizar+V.ele.DAT.3.PL+SBJF+2+SG
babilonizares-me	babilonizar+V.eu.AD.1.SG+INF+2+SG
babilonizares-me	babilonizar+V.eu.AD.1.SG+SBJF+2+SG
babilonizares-te	babilonizar+V.tu.AD.2.SG+INF+2+SG
babilonizares-te	babilonizar+V.tu.AD.2.SG+SBJF+2+SG
babilonizares-vos	babilonizar+V.vós.AD.2.PL+INF+2+SG
babilonizares-vos	babilonizar+V.vós.AD.2.PL+SBJF+2+SG
babilonizar-lhe-á	babilonizar+V.ele.DAT.3.SG+FUT+3+SG
babilonizar-lhe-ão	babilonizar+V.ele.DAT.3.SG+FUT+3+PL
babilonizar-lhe-ás	babilonizar+V.ele.DAT.3.SG+FUT+2+SG
babilonizar-lhe	babilonizar+V.ele.DAT.3.SG+INF
babilonizar-lhe	babilonizar+V.ele.DAT.3.SG+INF+1+SG
babilonizar-lhe	babilonizar+V.ele.DAT.3.SG+INF+3+SG
babilonizar-lhe	babilonizar+V.ele.DAT.3.SG+SBJF+1+SG
babilonizar-lhe	babilonizar+V.ele.DAT.3.SG+SBJF+3+SG
babilonizar-lhe-ei	babilonizar+V.ele.DAT.3.SG+FUT+1+SG
babilonizar-lhe-eis	babilonizar+V.ele.DAT.3.SG+FUT+2+PL
babilonizar-lhe-emos	babilonizar+V.ele.DAT.3.SG+FUT+1+PL
babilonizar-lhe-ia	babilonizar+V.ele.DAT.3.SG+COND+1+SG
babilonizar-lhe-ia	babilonizar+V.ele.DAT.3.SG+COND+3+SG
babilonizar-lhe-iam	babilonizar+V.ele.DAT.3.SG+COND+3+PL
babilonizar-lhe-íamos	babilonizar+V.ele.DAT.3.SG+COND+1+PL
babilonizar-lhe-ias	babilonizar+V.ele.DAT.3.SG+COND+2+SG
babilonizar-lhe-íeis	babilonizar+V.ele.DAT.3.SG+COND+2+PL
babilonizar-lhes-á	babilonizar+V.ele.DAT.3.PL+FUT+3+SG
babilonizar-lhes-ão	babilonizar+V.ele.DAT.3.PL+FUT+3+PL
babilonizar-lhes-ás	babilonizar+V.ele.DAT.3.PL+FUT+2+SG
babilonizar-lhes	babilonizar+V.ele.DAT.3.PL+INF
babilonizar-lhes	babilonizar+V.ele.DAT.3.PL+INF+1+SG
babilonizar-lhes	babilonizar+V.ele.DAT.3.PL+INF+3+SG
babilonizar-lhes	babilonizar+V.ele.DAT.3.PL+SBJF+1+SG
babilonizar-lhes	babilonizar+V.ele.DAT.3.PL+SBJF+3+SG
babilonizar-lhes-ei	babilonizar+V.ele.DAT.3.PL+FUT+1+SG
babilonizar-lhes-eis	babilonizar+V.ele.DAT.3.PL+FUT+2+PL
babilonizar-lhes-emos	babilonizar+V.ele.DAT.3.PL+FUT+1+PL
babilonizar-lhes-ia	babilonizar+V.ele.DAT.3.PL+COND+1+SG
babilonizar-lhes-ia	babilonizar+V.ele.DAT.3.PL+COND+3+SG
babilonizar-lhes-iam	babilonizar+V.ele.DAT.3.PL+COND+3+PL
babilonizar-lhes-íamos	babilonizar+V.ele.DAT.3.PL+COND+1+PL
babilonizar-lhes-ias	babilonizar+V.ele.DAT.3.PL+COND+2+SG
babilonizar-lhes-íeis	babilonizar+V.ele.DAT.3.PL+COND+2+PL
babilonizar-me-á	babilonizar+V.eu.AD.1.SG+FUT+3+SG
babilonizar-me-ão	babilonizar+V.eu.AD.1.SG+FUT+3+PL
babilonizar-me-ás	babilonizar+V.eu.AD.1.SG+FUT+2+SG
babilonizar-me	babilonizar+V.eu.AD.1.SG+INF
babilonizar-me	babilonizar+V.eu.AD.1.SG+INF+1+SG
babilonizar-me	babilonizar+V.eu.AD.1.SG+INF+3+SG
babilonizar-me	babilonizar+V.eu.AD.1.SG+SBJF+1+SG
babilonizar-me	babilonizar+V.eu.AD.1.SG+SBJF+3+SG
babilonizar-me-ei	babilonizar+V.eu.AD.1.SG+FUT+1+SG
babilonizar-me-eis	babilonizar+V.eu.AD.1.SG+FUT+2+PL
babilonizar-me-emos	babilonizar+V.eu.AD.1.SG+FUT+1+PL
babilonizar-me-ia	babilonizar+V.eu.AD.1.SG+COND+1+SG
babilonizar-me-ia	babilonizar+V.eu.AD.1.SG+COND+3+SG
babilonizar-me-iam	babilonizar+V.eu.AD.1.SG+COND+3+PL
babilonizar-me-íamos	babilonizar+V.eu.AD.1.SG+COND+1+PL
babilonizar-me-ias	babilonizar+V.eu.AD.1.SG+COND+2+SG
babilonizar-me-íeis	babilonizar+V.eu.AD.1.SG+COND+2+PL
babilonizarmo-la	babilonizar+V.ele.ACC.3.F.SG+INF+1+PL
babilonizarmo-la	babilonizar+V.ele.ACC.3.F.SG+SBJF+1+PL
babilonizarmo-las	babilonizar+V.ele.ACC.3.F.PL+INF+1+PL
babilonizarmo-las	babilonizar+V.ele.ACC.3.F.PL+SBJF+1+PL
babilonizarmo-lo	babilonizar+V.ele.ACC.3.M.SG+INF+1+PL
babilonizarmo-lo	babilonizar+V.ele.ACC.3.M.SG+SBJF+1+PL
babilonizarmo-los	babilonizar+V.ele.ACC.3.M.PL+INF+1+PL
babilonizarmo-los	babilonizar+V.ele.ACC.3.M.PL+SBJF+1+PL
babilonizarmo-nos	babilonizar+nós.AD.1.PL+INF+1+PL
babilonizarmo-nos	babilonizar+nós.AD.1.PL+SBJF+1+PL
babilonizarmos-lhe	babilonizar+V.ele.DAT.3.SG+INF+1+PL
babilonizarmos-lhe	babilonizar+V.ele.DAT.3.SG+SBJF+1+PL
babilonizarmos-lhes	babilonizar+V.ele.DAT.3.PL+INF+1+PL
babilonizarmos-lhes	babilonizar+V.ele.DAT.3.PL+SBJF+1+PL
babilonizarmos-me	babilonizar+V.eu.AD.1.SG+INF+1+PL
babilonizarmos-me	babilonizar+V.eu.AD.1.SG+SBJF+1+PL
babilonizarmos-te	babilonizar+V.tu.AD.2.SG+INF+1+PL
babilonizarmos-te	babilonizar+V.tu.AD.2.SG+SBJF+1+PL
babilonizarmos-vos	babilonizar+V.vós.AD.2.PL+INF+1+PL
babilonizarmos-vos	babilonizar+V.vós.AD.2.PL+SBJF+1+PL
babilonizar-nos-á	babilonizar+nós.AD.1.PL+FUT+3+SG
babilonizar-nos-ão	babilonizar+nós.AD.1.PL+FUT+3+PL
babilonizar-nos-ás	babilonizar+nós.AD.1.PL+FUT+2+SG
babilonizar-nos	babilonizar+nós.AD.1.PL+INF
babilonizar-nos	babilonizar+nós.AD.1.PL+INF+1+SG
babilonizar-nos	babilonizar+nós.AD.1.PL+INF+3+SG
babilonizar-nos	babilonizar+nós.AD.1.PL+SBJF+1+SG
babilonizar-nos	babilonizar+nós.AD.1.PL+SBJF+3+SG
babilonizar-nos-ei	babilonizar+nós.AD.1.PL+FUT+1+SG
babilonizar-nos-eis	babilonizar+nós.AD.1.PL+FUT+2+PL
babilonizar-nos-emos	babilonizar+nós.AD.1.PL+FUT+1+PL
babilonizar-nos-ia	babilonizar+nós.AD.1.PL+COND+1+SG
babilonizar-nos-ia	babilonizar+nós.AD.1.PL+COND+3+SG
babilonizar-nos-iam	babilonizar+nós.AD.1.PL+COND+3+PL
babilonizar-nos-íamos	babilonizar+nós.AD.1.PL+COND+1+PL
babilonizar-nos-ias	babilonizar+nós.AD.1.PL+COND+2+SG
babilonizar-nos-íeis	babilonizar+nós.AD.1.PL+COND+2+PL
babilonizar-se-á	babilonizar+V.ele.REFL+FUT+3+SG
babilonizar-se-ão	babilonizar+V.ele.REFL+FUT+3+PL
babilonizar-se	babilonizar+V.ele.REFL+INF
babilonizar-se	babilonizar+V.ele.REFL+INF+3+SG
babilonizar-se	babilonizar+V.ele.REFL+SBJF+3+SG
babilonizar-se-ia	babilonizar+V.ele.REFL+COND+3+SG
babilonizar-se-iam	babilonizar+V.ele.REFL+COND+3+PL
babilonizar-te-á	babilonizar+V.tu.AD.2.SG+FUT+3+SG
babilonizar-te-ão	babilonizar+V.tu.AD.2.SG+FUT+3+PL
babilonizar-te-ás	babilonizar+V.tu.AD.2.SG+FUT+2+SG
babilonizar-te	babilonizar+V.tu.AD.2.SG+INF
babilonizar-te	babilonizar+V.tu.AD.2.SG+INF+1+SG
babilonizar-te	babilonizar+V.tu.AD.2.SG+INF+3+SG
babilonizar-te	babilonizar+V.tu.AD.2.SG+SBJF+1+SG
babilonizar-te	babilonizar+V.tu.AD.2.SG+SBJF+3+SG
babilonizar-te-ei	babilonizar+V.tu.AD.2.SG+FUT+1+SG
babilonizar-te-eis	babilonizar+V.tu.AD.2.SG+FUT+2+PL
babilonizar-te-emos	babilonizar+V.tu.AD.2.SG+FUT+1+PL
babilonizar-te-ia	babilonizar+V.tu.AD.2.SG+COND+1+SG
babilonizar-te-ia	babilonizar+V.tu.AD.2.SG+COND+3+SG
babilonizar-te-iam	babilonizar+V.tu.AD.2.SG+COND+3+PL
babilonizar-te-íamos	babilonizar+V.tu.AD.2.SG+COND+1+PL
babilonizar-te-ias	babilonizar+V.tu.AD.2.SG+COND+2+SG
babilonizar-te-íeis	babilonizar+V.tu.AD.2.SG+COND+2+PL
babilonizar-vos-á	babilonizar+V.vós.AD.2.PL+FUT+3+SG
babilonizar-vos-ão	babilonizar+V.vós.AD.2.PL+FUT+3+PL
babilonizar-vos-ás	babilonizar+V.vós.AD.2.PL+FUT+2+SG
babilonizar-vos	babilonizar+V.vós.AD.2.PL+INF
babilonizar-vos	babilonizar+V.vós.AD.2.PL+INF+1+SG
babilonizar-vos	babilonizar+V.vós.AD.2.PL+INF+3+SG
babilonizar-vos	babilonizar+V.vós.AD.2.PL+SBJF+1+SG
babilonizar-vos	babilonizar+V.vós.AD.2.PL+SBJF+3+SG
babilonizar-vos-ei	babilonizar+V.vós.AD.2.PL+FUT+1+SG
babilonizar-vos-eis	babilonizar+V.vós.AD.2.PL+FUT+2+PL
babilonizar-vos-emos	babilonizar+V.vós.AD.2.PL+FUT+1+PL
babilonizar-vos-ia	babilonizar+V.vós.AD.2.PL+COND+1+SG
babilonizar-vos-ia	babilonizar+V.vós.AD.2.PL+COND+3+SG
babilonizar-vos-iam	babilonizar+V.vós.AD.2.PL+COND+3+PL
babilonizar-vos-íamos	babilonizar+V.vós.AD.2.PL+COND+1+PL
babilonizar-vos-ias	babilonizar+V.vós.AD.2.PL+COND+2+SG
babilonizar-vos-íeis	babilonizar+V.vós.AD.2.PL+COND+2+PL
babiloniza-se	babilonizar+V.ele.REFL+PRS+3+SG
babilonizas-lhe	babilonizar+V.ele.DAT.3.SG+PRS+2+SG
babilonizas-lhes	babilonizar+V.ele.DAT.3.PL+PRS+2+SG
babilonizas-me	babilonizar+V.eu.AD.1.SG+PRS+2+SG
babilonizaste-a	babilonizar+V.ele.ACC.3.F.SG+PRF+2+SG
babilonizaste-as	babilonizar+V.ele.ACC.3.F.PL+PRF+2+SG
babilonizas-te	babilonizar+V.tu.AD.2.SG+PRS+2+SG
babilonizaste-la	babilonizar+V.ele.ACC.3.F.SG+PRF+2+PL
babilonizaste-las	babilonizar+V.ele.ACC.3.F.PL+PRF+2+PL
babilonizaste-lhe	babilonizar+V.ele.DAT.3.SG+PRF+2+SG
babilonizaste-lhes	babilonizar+V.ele.DAT.3.PL+PRF+2+SG
babilonizaste-lo	babilonizar+V.ele.ACC.3.M.SG+PRF+2+PL
babilonizaste-los	babilonizar+V.ele.ACC.3.M.PL+PRF+2+PL
babilonizaste-me	babilonizar+V.eu.AD.1.SG+PRF+2+SG
babilonizaste-nos	babilonizar+nós.AD.1.PL+PRF+2+PL
babilonizaste-nos	babilonizar+nós.AD.1.PL+PRF+2+SG
babilonizaste-o	babilonizar+V.ele.ACC.3.M.SG+PRF+2+SG
babilonizaste-os	babilonizar+V.ele.ACC.3.M.PL+PRF+2+SG
babilonizastes-lhe	babilonizar+V.ele.DAT.3.SG+PRF+2+PL
babilonizastes-lhes	babilonizar+V.ele.DAT.3.PL+PRF+2+PL
babilonizastes-me	babilonizar+V.eu.AD.1.SG+PRF+2+PL
babilonizastes-te	babilonizar+V.tu.AD.2.SG+PRF+2+PL
babilonizastes-vos	babilonizar+V.vós.AD.2.PL+PRF+2+PL
babilonizaste-te	babilonizar+V.tu.AD.2.SG+PRF+2+SG
babilonizaste-vos	babilonizar+V.vós.AD.2.PL+PRF+2+SG
babilonizas-vos	babilonizar+V.vós.AD.2.PL+PRS+2+SG
babiloniza-te	babilonizar+V.tu.AD.2.SG+PRS+3+SG
babilonizava-a	babilonizar+V.ele.ACC.3.F.SG+IMPF+1+SG
babilonizava-a	babilonizar+V.ele.ACC.3.F.SG+IMPF+3+SG
babilonizava-as	babilonizar+V.ele.ACC.3.F.PL+IMPF+1+SG
babilonizava-as	babilonizar+V.ele.ACC.3.F.PL+IMPF+3+SG
babilonizava-la	babilonizar+V.ele.ACC.3.F.SG+IMPF+2+SG
babilonizava-las	babilonizar+V.ele.ACC.3.F.PL+IMPF+2+SG
babilonizava-lhe	babilonizar+V.ele.DAT.3.SG+IMPF+1+SG
babilonizava-lhe	babilonizar+V.ele.DAT.3.SG+IMPF+3+SG
babilonizava-lhes	babilonizar+V.ele.DAT.3.PL+IMPF+1+SG
babilonizava-lhes	babilonizar+V.ele.DAT.3.PL+IMPF+3+SG
babilonizava-lo	babilonizar+V.ele.ACC.3.M.SG+IMPF+2+SG
babilonizava-los	babilonizar+V.ele.ACC.3.M.PL+IMPF+2+SG
babilonizava-me	babilonizar+V.eu.AD.1.SG+IMPF+1+SG
babilonizava-me	babilonizar+V.eu.AD.1.SG+IMPF+3+SG
babilonizavam-lhe	babilonizar+V.ele.DAT.3.SG+IMPF+3+PL
babilonizavam-lhes	babilonizar+V.ele.DAT.3.PL+IMPF+3+PL
babilonizavam-me	babilonizar+V.eu.AD.1.SG+IMPF+3+PL
babilonizavam-na	babilonizar+V.ele.ACC.3.F.SG+IMPF+3+PL
babilonizavam-nas	babilonizar+V.ele.ACC.3.F.PL+IMPF+3+PL
babilonizavam-no	babilonizar+V.ele.ACC.3.M.SG+IMPF+3+PL
babilonizavam-nos	babilonizar+V.ele.ACC.3.M.PL+IMPF+3+PL
babilonizavam-nos	babilonizar+V.nós.AD.1.PL+IMPF+3+PL
babilonizávamo-la	babilonizar+V.ele.ACC.3.F.SG+IMPF+1+PL
babilonizávamo-las	babilonizar+V.ele.ACC.3.F.PL+IMPF+1+PL
babilonizávamo-lo	babilonizar+V.ele.ACC.3.M.SG+IMPF+1+PL
babilonizávamo-los	babilonizar+V.ele.ACC.3.M.PL+IMPF+1+PL
babilonizávamo-nos	babilonizar+nós.AD.1.PL+IMPF+1+PL
babilonizávamos-lhe	babilonizar+V.ele.DAT.3.SG+IMPF+1+PL
babilonizávamos-lhes	babilonizar+V.ele.DAT.3.PL+IMPF+1+PL
babilonizávamos-me	babilonizar+V.eu.AD.1.SG+IMPF+1+PL
babilonizávamos-te	babilonizar+V.tu.AD.2.SG+IMPF+1+PL
babilonizávamos-vos	babilonizar+V.vós.AD.2.PL+IMPF+1+PL
babilonizavam-se	babilonizar+V.ele.REFL+IMPF+3+PL
babilonizavam-te	babilonizar+V.tu.AD.2.SG+IMPF+3+PL
babilonizavam-vos	babilonizar+V.vós.AD.2.PL+IMPF+3+PL
babilonizava-nos	babilonizar+nós.AD.1.PL+IMPF+1+SG
babilonizava-nos	babilonizar+nós.AD.1.PL+IMPF+2+SG
babilonizava-nos	babilonizar+nós.AD.1.PL+IMPF+3+SG
babilonizava-o	babilonizar+V.ele.ACC.3.M.SG+IMPF+1+SG
babilonizava-o	babilonizar+V.ele.ACC.3.M.SG+IMPF+3+SG
babilonizava-os	babilonizar+V.ele.ACC.3.M.PL+IMPF+1+SG
babilonizava-os	babilonizar+V.ele.ACC.3.M.PL+IMPF+3+SG
babilonizava-se	babilonizar+V.ele.REFL+IMPF+1+SG
babilonizava-se	babilonizar+V.ele.REFL+IMPF+3+SG
babilonizavas-lhe	babilonizar+V.ele.DAT.3.SG+IMPF+2+SG
babilonizavas-lhes	babilonizar+V.ele.DAT.3.PL+IMPF+2+SG
babilonizavas-me	babilonizar+V.eu.AD.1.SG+IMPF+2+SG
babilonizavas-te	babilonizar+V.tu.AD.2.SG+IMPF+2+SG
babilonizavas-vos	babilonizar+V.vós.AD.2.PL+IMPF+2+SG
babilonizava-te	babilonizar+V.tu.AD.2.SG+IMPF+1+SG
babilonizava-te	babilonizar+V.tu.AD.2.SG+IMPF+3+SG
babilonizava-vos	babilonizar+V.vós.AD.2.PL+IMPF+1+SG
babilonizava-vos	babilonizar+V.vós.AD.2.PL+IMPF+3+SG
babilonizávei-la	babilonizar+V.ele.ACC.3.F.SG+IMPF+2+PL
babilonizávei-las	babilonizar+V.ele.ACC.3.F.PL+IMPF+2+PL
babilonizávei-lo	babilonizar+V.ele.ACC.3.M.SG+IMPF+2+PL
babilonizávei-los	babilonizar+V.ele.ACC.3.M.PL+IMPF+2+PL
babilonizávei-nos	babilonizar+nós.AD.1.PL+IMPF+2+PL
babilonizáveis-lhe	babilonizar+V.ele.DAT.3.SG+IMPF+2+PL
babilonizáveis-lhes	babilonizar+V.ele.DAT.3.PL+IMPF+2+PL
babilonizáveis-me	babilonizar+V.eu.AD.1.SG+IMPF+2+PL
babilonizáveis-te	babilonizar+V.tu.AD.2.SG+IMPF+2+PL
babilonizáveis-vos	babilonizar+V.vós.AD.2.PL+IMPF+2+PL
babiloniza-vos	babilonizar+V.vós.AD.2.PL+PRS+3+SG
babilonize-a	babilonizar+V.ele.ACC.3.F.SG+IMP+3+SG
babilonize-as	babilonizar+V.ele.ACC.3.F.PL+IMP+3+SG
babilonizei-a	babilonizar+V.ele.ACC.3.F.SG+PRF+1+SG
babilonizei-as	babilonizar+V.ele.ACC.3.F.PL+PRF+1+SG
babilonizei-lhe	babilonizar+V.ele.DAT.3.SG+PRF+1+SG
babilonizei-lhes	babilonizar+V.ele.DAT.3.PL+PRF+1+SG
babilonizei-me	babilonizar+V.eu.AD.1.SG+PRF+1+SG
babilonizei-nos	babilonizar+nós.AD.1.PL+PRF+1+SG
babilonizei-o	babilonizar+V.ele.ACC.3.M.SG+PRF+1+SG
babilonizei-os	babilonizar+V.ele.ACC.3.M.PL+PRF+1+SG
babilonizei-te	babilonizar+V.tu.AD.2.SG+PRF+1+SG
babilonizei-vos	babilonizar+V.vós.AD.2.PL+PRF+1+SG
babilonize-lhe	babilonizar+V.ele.DAT.3.SG+IMP+3+SG
babilonize-lhes	babilonizar+V.ele.DAT.3.PL+IMP+3+SG
babilonize-me	babilonizar+V.eu.AD.1.SG+IMP+3+SG
babilonizem-lhe	babilonizar+V.ele.DAT.3.SG+IMP+3+PL
babilonizem-lhes	babilonizar+V.ele.DAT.3.PL+IMP+3+PL
babilonizem-me	babilonizar+V.eu.AD.1.SG+IMP+3+PL
babilonizem-na	babilonizar+V.ele.ACC.3.F.SG+IMP+3+PL
babilonizem-nas	babilonizar+V.ele.ACC.3.F.PL+IMP+3+PL
babilonizem-no	babilonizar+V.ele.ACC.3.M.SG+IMP+3+PL
babilonizem-nos	babilonizar+V.ele.ACC.3.M.PL+IMP+3+PL
babilonizem-nos	babilonizar+V.nós.AD.1.PL+IMP+3+PL
babilonizemo-la	babilonizar+V.ele.ACC.3.F.SG+IMP+1+PL
babilonizemo-las	babilonizar+V.ele.ACC.3.F.PL+IMP+1+PL
babilonizemo-lo	babilonizar+V.ele.ACC.3.M.SG+IMP+1+PL
babilonizemo-los	babilonizar+V.ele.ACC.3.M.PL+IMP+1+PL
babilonizemo-nos	babilonizar+nós.AD.1.PL+IMP+1+PL
babilonizemos-lhe	babilonizar+V.ele.DAT.3.SG+IMP+1+PL
babilonizemos-lhes	babilonizar+V.ele.DAT.3.PL+IMP+1+PL
babilonizemos-me	babilonizar+V.eu.AD.1.SG+IMP+1+PL
babilonizemos-te	babilonizar+V.tu.AD.2.SG+IMP+1+PL
babilonizemos-vos	babilonizar+V.vós.AD.2.PL+IMP+1+PL
babilonizem-se	babilonizar+V.ele.REFL+IMP+3+PL
babilonizem-te	babilonizar+V.tu.AD.2.SG+IMP+3+PL
babilonizem-vos	babilonizar+V.vós.AD.2.PL+IMP+3+PL
babilonize-nos	babilonizar+nós.AD.1.PL+IMP+3+SG
babilonize-o	babilonizar+V.ele.ACC.3.M.SG+IMP+3+SG
babilonize-os	babilonizar+V.ele.ACC.3.M.PL+IMP+3+SG
babilonize-se	babilonizar+V.ele.REFL+IMP+3+SG
babilonize-te	babilonizar+V.tu.AD.2.SG+IMP+3+SG
babilonize-vos	babilonizar+V.vós.AD.2.PL+IMP+3+SG
babilonizo-a	babilonizar+V.ele.ACC.3.F.SG+PRS+1+SG
babilonizo-as	babilonizar+V.ele.ACC.3.F.PL+PRS+1+SG
babilonizo-lhe	babilonizar+V.ele.DAT.3.SG+PRS+1+SG
babilonizo-lhes	babilonizar+V.ele.DAT.3.PL+PRS+1+SG
babilonizo-me	babilonizar+V.eu.AD.1.SG+PRS+1+SG
babilonizo-nos	babilonizar+nós.AD.1.PL+PRS+1+SG
babilonizo-o	babilonizar+V.ele.ACC.3.M.SG+PRS+1+SG
babilonizo-os	babilonizar+V.ele.ACC.3.M.PL+PRS+1+SG
babilonizo-te	babilonizar+V.tu.AD.2.SG+PRS+1+SG
babilonizou-a	babilonizar+V.ele.ACC.3.F.SG+PRF+3+SG
babilonizou-as	babilonizar+V.ele.ACC.3.F.PL+PRF+3+SG
babilonizou-lhe	babilonizar+V.ele.DAT.3.SG+PRF+3+SG
babilonizou-lhes	babilonizar+V.ele.DAT.3.PL+PRF+3+SG
babilonizou-me	babilonizar+V.eu.AD.1.SG+PRF+3+SG
babilonizou-nos	babilonizar+nós.AD.1.PL+PRF+3+SG
babilonizou-o	babilonizar+V.ele.ACC.3.M.SG+PRF+3+SG
babilonizou-os	babilonizar+V.ele.ACC.3.M.PL+PRF+3+SG
babilonizou-se	babilonizar+V.ele.REFL+PRF+3+SG
babilonizou-te	babilonizar+V.tu.AD.2.SG+PRF+3+SG
babilonizou-vos	babilonizar+V.vós.AD.2.PL+PRF+3+SG
babilonizo-vos	babilonizar+V.vós.AD.2.PL+PRS+1+SG
babo-a	babar+V.ele.ACC.3.F.SG+PRS+1+SG
babo-as	babar+V.ele.ACC.3.F.PL+PRS+1+SG
babo-lhe	babar+V.ele.DAT.3.SG+PRS+1+SG
babo-lhes	babar+V.ele.DAT.3.PL+PRS+1+SG
babo-me	babar+V.eu.AD.1.SG+PRS+1+SG
babo-nos	babar+nós.AD.1.PL+PRS+1+SG
babo-o	babar+V.ele.ACC.3.M.SG+PRS+1+SG
babo-os	babar+V.ele.ACC.3.M.PL+PRS+1+SG
babo-te	babar+V.tu.AD.2.SG+PRS+1+SG
babou-a	babar+V.ele.ACC.3.F.SG+PRF+3+SG
babou-as	babar+V.ele.ACC.3.F.PL+PRF+3+SG
babou-lhe	babar+V.ele.DAT.3.SG+PRF+3+SG
babou-lhes	babar+V.ele.DAT.3.PL+PRF+3+SG
babou-me	babar+V.eu.AD.1.SG+PRF+3+SG
babou-nos	babar+nós.AD.1.PL+PRF+3+SG
babou-o	babar+V.ele.ACC.3.M.SG+PRF+3+SG
babou-os	babar+V.ele.ACC.3.M.PL+PRF+3+SG
babou-se	babar+V.ele.REFL+PRF+3+SG
babou-te	babar+V.tu.AD.2.SG+PRF+3+SG
babou-vos	babar+V.vós.AD.2.PL+PRF+3+SG
babo-vos	babar+V.vós.AD.2.PL+PRS+1+SG
babuja-a	babujar+V.ele.ACC.3.F.SG+PRS+3+SG
babuja-as	babujar+V.ele.ACC.3.F.PL+PRS+3+SG
babujai-la	babujar+V.ele.ACC.3.F.SG+PRS+2+PL
babujai-las	babujar+V.ele.ACC.3.F.PL+PRS+2+PL
babujai-lo	babujar+V.ele.ACC.3.M.SG+PRS+2+PL
babujai-los	babujar+V.ele.ACC.3.M.PL+PRS+2+PL
babujai-nos	babujar+nós.AD.1.PL+PRS+2+PL
babujais-lhe	babujar+V.ele.DAT.3.SG+PRS+2+PL
babujais-lhes	babujar+V.ele.DAT.3.PL+PRS+2+PL
babujais-me	babujar+V.eu.AD.1.SG+PRS+2+PL
babujais-te	babujar+V.tu.AD.2.SG+PRS+2+PL
babujais-vos	babujar+V.vós.AD.2.PL+PRS+2+PL
babujá-la-á	babujar+V.ele.ACC.3.F.SG+FUT+3+SG
babujá-la-ão	babujar+V.ele.ACC.3.F.SG+FUT+3+PL
babujá-la-ás	babujar+V.ele.ACC.3.F.SG+FUT+2+SG
babujá-la	babujar+V.ele.ACC.3.F.SG+INF+1+SG
babujá-la	babujar+V.ele.ACC.3.F.SG+INF+3+SG
babuja-la	babujar+V.ele.ACC.3.F.SG+PRS+2+SG
babujá-la	babujar+V.ele.ACC.3.F.SG+SBJF+1+SG
babujá-la	babujar+V.ele.ACC.3.F.SG+SBJF+3+SG
babujá-la-ei	babujar+V.ele.ACC.3.F.SG+FUT+1+SG
babujá-la-eis	babujar+V.ele.ACC.3.F.SG+FUT+2+PL
babujá-la-emos	babujar+V.ele.ACC.3.F.SG+FUT+1+PL
babujá-la-ia	babujar+V.ele.ACC.3.F.SG+COND+1+SG
babujá-la-ia	babujar+V.ele.ACC.3.F.SG+COND+3+SG
babujá-la-iam	babujar+V.ele.ACC.3.F.SG+COND+3+PL
babujá-la-íamos	babujar+V.ele.ACC.3.F.SG+COND+1+PL
babujá-la-ias	babujar+V.ele.ACC.3.F.SG+COND+2+SG
babujá-la-íeis	babujar+V.ele.ACC.3.F.SG+COND+2+PL
babujá-las-á	babujar+V.ele.ACC.3.F.PL+FUT+3+SG
babujá-las-ão	babujar+V.ele.ACC.3.F.PL+FUT+3+PL
babujá-las-ás	babujar+V.ele.ACC.3.F.PL+FUT+2+SG
babujá-las	babujar+V.ele.ACC.3.F.PL+INF+1+SG
babujá-las	babujar+V.ele.ACC.3.F.PL+INF+3+SG
babuja-las	babujar+V.ele.ACC.3.F.PL+PRS+2+SG
babujá-las	babujar+V.ele.ACC.3.F.PL+SBJF+1+SG
babujá-las	babujar+V.ele.ACC.3.F.PL+SBJF+3+SG
babujá-las-ei	babujar+V.ele.ACC.3.F.PL+FUT+1+SG
babujá-las-eis	babujar+V.ele.ACC.3.F.PL+FUT+2+PL
babujá-las-emos	babujar+V.ele.ACC.3.F.PL+FUT+1+PL
babujá-las-ia	babujar+V.ele.ACC.3.F.PL+COND+1+SG
babujá-las-ia	babujar+V.ele.ACC.3.F.PL+COND+3+SG
babujá-las-iam	babujar+V.ele.ACC.3.F.PL+COND+3+PL
babujá-las-íamos	babujar+V.ele.ACC.3.F.PL+COND+1+PL
babujá-las-ias	babujar+V.ele.ACC.3.F.PL+COND+2+SG
babujá-las-íeis	babujar+V.ele.ACC.3.F.PL+COND+2+PL
babuja-lhe	babujar+V.ele.DAT.3.SG+PRS+3+SG
babuja-lhes	babujar+V.ele.DAT.3.PL+PRS+3+SG
babujá-lo-á	babujar+V.ele.ACC.3.M.SG+FUT+3+SG
babujá-lo-ão	babujar+V.ele.ACC.3.M.SG+FUT+3+PL
babujá-lo-ás	babujar+V.ele.ACC.3.M.SG+FUT+2+SG
babujá-lo	babujar+V.ele.ACC.3.M.SG+INF+1+SG
babujá-lo	babujar+V.ele.ACC.3.M.SG+INF+3+SG
babuja-lo	babujar+V.ele.ACC.3.M.SG+PRS+2+SG
babujá-lo	babujar+V.ele.ACC.3.M.SG+SBJF+1+SG
babujá-lo	babujar+V.ele.ACC.3.M.SG+SBJF+3+SG
babujá-lo-ei	babujar+V.ele.ACC.3.M.SG+FUT+1+SG
babujá-lo-eis	babujar+V.ele.ACC.3.M.SG+FUT+2+PL
babujá-lo-emos	babujar+V.ele.ACC.3.M.SG+FUT+1+PL
babujá-lo-ia	babujar+V.ele.ACC.3.M.SG+COND+1+SG
babujá-lo-ia	babujar+V.ele.ACC.3.M.SG+COND+3+SG
babujá-lo-iam	babujar+V.ele.ACC.3.M.SG+COND+3+PL
babujá-lo-íamos	babujar+V.ele.ACC.3.M.SG+COND+1+PL
babujá-lo-ias	babujar+V.ele.ACC.3.M.SG+COND+2+SG
babujá-lo-íeis	babujar+V.ele.ACC.3.M.SG+COND+2+PL
babujá-los-á	babujar+V.ele.ACC.3.M.PL+FUT+3+SG
babujá-los-ão	babujar+V.ele.ACC.3.M.PL+FUT+3+PL
babujá-los-ás	babujar+V.ele.ACC.3.M.PL+FUT+2+SG
babujá-los	babujar+V.ele.ACC.3.M.PL+INF+1+SG
babujá-los	babujar+V.ele.ACC.3.M.PL+INF+3+SG
babuja-los	babujar+V.ele.ACC.3.M.PL+PRS+2+SG
babujá-los	babujar+V.ele.ACC.3.M.PL+SBJF+1+SG
babujá-los	babujar+V.ele.ACC.3.M.PL+SBJF+3+SG
babujá-los-ei	babujar+V.ele.ACC.3.M.PL+FUT+1+SG
babujá-los-eis	babujar+V.ele.ACC.3.M.PL+FUT+2+PL
babujá-los-emos	babujar+V.ele.ACC.3.M.PL+FUT+1+PL
babujá-los-ia	babujar+V.ele.ACC.3.M.PL+COND+1+SG
babujá-los-ia	babujar+V.ele.ACC.3.M.PL+COND+3+SG
babujá-los-iam	babujar+V.ele.ACC.3.M.PL+COND+3+PL
babujá-los-íamos	babujar+V.ele.ACC.3.M.PL+COND+1+PL
babujá-los-ias	babujar+V.ele.ACC.3.M.PL+COND+2+SG
babujá-los-íeis	babujar+V.ele.ACC.3.M.PL+COND+2+PL
babuja-me	babujar+V.eu.AD.1.SG+PRS+3+SG
babujam-lhe	babujar+V.ele.DAT.3.SG+PRS+3+PL
babujam-lhes	babujar+V.ele.DAT.3.PL+PRS+3+PL
babujam-me	babujar+V.eu.AD.1.SG+PRS+3+PL
babujam-na	babujar+V.ele.ACC.3.F.SG+PRS+3+PL
babujam-nas	babujar+V.ele.ACC.3.F.PL+PRS+3+PL
babujam-no	babujar+V.ele.ACC.3.M.SG+PRS+3+PL
babujam-nos	babujar+V.ele.ACC.3.M.PL+PRS+3+PL
babujam-nos	babujar+V.nós.AD.1.PL+PRS+3+PL
babujamo-la	babujar+V.ele.ACC.3.F.SG+PRF+1+PL
babujamo-la	babujar+V.ele.ACC.3.F.SG+PRS+1+PL
babujamo-las	babujar+V.ele.ACC.3.F.PL+PRF+1+PL
babujamo-las	babujar+V.ele.ACC.3.F.PL+PRS+1+PL
babujamo-lo	babujar+V.ele.ACC.3.M.SG+PRF+1+PL
babujamo-lo	babujar+V.ele.ACC.3.M.SG+PRS+1+PL
babujamo-los	babujar+V.ele.ACC.3.M.PL+PRF+1+PL
babujamo-los	babujar+V.ele.ACC.3.M.PL+PRS+1+PL
babujamo-nos	babujar+nós.AD.1.PL+PRF+1+PL
babujamo-nos	babujar+nós.AD.1.PL+PRS+1+PL
babujamos-lhe	babujar+V.ele.DAT.3.SG+PRF+1+PL
babujamos-lhe	babujar+V.ele.DAT.3.SG+PRS+1+PL
babujamos-lhes	babujar+V.ele.DAT.3.PL+PRF+1+PL
babujamos-lhes	babujar+V.ele.DAT.3.PL+PRS+1+PL
