beatificar-me-ia	beatificar+V.eu.AD.1.SG+COND+1+SG
beatificar-me-ia	beatificar+V.eu.AD.1.SG+COND+3+SG
beatificar-me-iam	beatificar+V.eu.AD.1.SG+COND+3+PL
beatificar-me-íamos	beatificar+V.eu.AD.1.SG+COND+1+PL
beatificar-me-ias	beatificar+V.eu.AD.1.SG+COND+2+SG
beatificar-me-íeis	beatificar+V.eu.AD.1.SG+COND+2+PL
beatificarmo-la	beatificar+V.ele.ACC.3.F.SG+INF+1+PL
beatificarmo-la	beatificar+V.ele.ACC.3.F.SG+SBJF+1+PL
beatificarmo-las	beatificar+V.ele.ACC.3.F.PL+INF+1+PL
beatificarmo-las	beatificar+V.ele.ACC.3.F.PL+SBJF+1+PL
beatificarmo-lo	beatificar+V.ele.ACC.3.M.SG+INF+1+PL
beatificarmo-lo	beatificar+V.ele.ACC.3.M.SG+SBJF+1+PL
beatificarmo-los	beatificar+V.ele.ACC.3.M.PL+INF+1+PL
beatificarmo-los	beatificar+V.ele.ACC.3.M.PL+SBJF+1+PL
beatificarmo-nos	beatificar+nós.AD.1.PL+INF+1+PL
beatificarmo-nos	beatificar+nós.AD.1.PL+SBJF+1+PL
beatificarmos-lhe	beatificar+V.ele.DAT.3.SG+INF+1+PL
beatificarmos-lhe	beatificar+V.ele.DAT.3.SG+SBJF+1+PL
beatificarmos-lhes	beatificar+V.ele.DAT.3.PL+INF+1+PL
beatificarmos-lhes	beatificar+V.ele.DAT.3.PL+SBJF+1+PL
beatificarmos-me	beatificar+V.eu.AD.1.SG+INF+1+PL
beatificarmos-me	beatificar+V.eu.AD.1.SG+SBJF+1+PL
beatificarmos-te	beatificar+V.tu.AD.2.SG+INF+1+PL
beatificarmos-te	beatificar+V.tu.AD.2.SG+SBJF+1+PL
beatificarmos-vos	beatificar+V.vós.AD.2.PL+INF+1+PL
beatificarmos-vos	beatificar+V.vós.AD.2.PL+SBJF+1+PL
beatificar-nos-á	beatificar+nós.AD.1.PL+FUT+3+SG
beatificar-nos-ão	beatificar+nós.AD.1.PL+FUT+3+PL
beatificar-nos-ás	beatificar+nós.AD.1.PL+FUT+2+SG
beatificar-nos	beatificar+nós.AD.1.PL+INF
beatificar-nos	beatificar+nós.AD.1.PL+INF+1+SG
beatificar-nos	beatificar+nós.AD.1.PL+INF+3+SG
beatificar-nos	beatificar+nós.AD.1.PL+SBJF+1+SG
beatificar-nos	beatificar+nós.AD.1.PL+SBJF+3+SG
beatificar-nos-ei	beatificar+nós.AD.1.PL+FUT+1+SG
beatificar-nos-eis	beatificar+nós.AD.1.PL+FUT+2+PL
beatificar-nos-emos	beatificar+nós.AD.1.PL+FUT+1+PL
beatificar-nos-ia	beatificar+nós.AD.1.PL+COND+1+SG
beatificar-nos-ia	beatificar+nós.AD.1.PL+COND+3+SG
beatificar-nos-iam	beatificar+nós.AD.1.PL+COND+3+PL
beatificar-nos-íamos	beatificar+nós.AD.1.PL+COND+1+PL
beatificar-nos-ias	beatificar+nós.AD.1.PL+COND+2+SG
beatificar-nos-íeis	beatificar+nós.AD.1.PL+COND+2+PL
beatificar-se-á	beatificar+V.ele.REFL+FUT+3+SG
beatificar-se-ão	beatificar+V.ele.REFL+FUT+3+PL
beatificar-se	beatificar+V.ele.REFL+INF
beatificar-se	beatificar+V.ele.REFL+INF+3+SG
beatificar-se	beatificar+V.ele.REFL+SBJF+3+SG
beatificar-se-ia	beatificar+V.ele.REFL+COND+3+SG
beatificar-se-iam	beatificar+V.ele.REFL+COND+3+PL
beatificar-te-á	beatificar+V.tu.AD.2.SG+FUT+3+SG
beatificar-te-ão	beatificar+V.tu.AD.2.SG+FUT+3+PL
beatificar-te-ás	beatificar+V.tu.AD.2.SG+FUT+2+SG
beatificar-te	beatificar+V.tu.AD.2.SG+INF
beatificar-te	beatificar+V.tu.AD.2.SG+INF+1+SG
beatificar-te	beatificar+V.tu.AD.2.SG+INF+3+SG
beatificar-te	beatificar+V.tu.AD.2.SG+SBJF+1+SG
beatificar-te	beatificar+V.tu.AD.2.SG+SBJF+3+SG
beatificar-te-ei	beatificar+V.tu.AD.2.SG+FUT+1+SG
beatificar-te-eis	beatificar+V.tu.AD.2.SG+FUT+2+PL
beatificar-te-emos	beatificar+V.tu.AD.2.SG+FUT+1+PL
beatificar-te-ia	beatificar+V.tu.AD.2.SG+COND+1+SG
beatificar-te-ia	beatificar+V.tu.AD.2.SG+COND+3+SG
beatificar-te-iam	beatificar+V.tu.AD.2.SG+COND+3+PL
beatificar-te-íamos	beatificar+V.tu.AD.2.SG+COND+1+PL
beatificar-te-ias	beatificar+V.tu.AD.2.SG+COND+2+SG
beatificar-te-íeis	beatificar+V.tu.AD.2.SG+COND+2+PL
beatificar-vos-á	beatificar+V.vós.AD.2.PL+FUT+3+SG
beatificar-vos-ão	beatificar+V.vós.AD.2.PL+FUT+3+PL
beatificar-vos-ás	beatificar+V.vós.AD.2.PL+FUT+2+SG
beatificar-vos	beatificar+V.vós.AD.2.PL+INF
beatificar-vos	beatificar+V.vós.AD.2.PL+INF+1+SG
beatificar-vos	beatificar+V.vós.AD.2.PL+INF+3+SG
beatificar-vos	beatificar+V.vós.AD.2.PL+SBJF+1+SG
beatificar-vos	beatificar+V.vós.AD.2.PL+SBJF+3+SG
beatificar-vos-ei	beatificar+V.vós.AD.2.PL+FUT+1+SG
beatificar-vos-eis	beatificar+V.vós.AD.2.PL+FUT+2+PL
beatificar-vos-emos	beatificar+V.vós.AD.2.PL+FUT+1+PL
beatificar-vos-ia	beatificar+V.vós.AD.2.PL+COND+1+SG
beatificar-vos-ia	beatificar+V.vós.AD.2.PL+COND+3+SG
beatificar-vos-iam	beatificar+V.vós.AD.2.PL+COND+3+PL
beatificar-vos-íamos	beatificar+V.vós.AD.2.PL+COND+1+PL
beatificar-vos-ias	beatificar+V.vós.AD.2.PL+COND+2+SG
beatificar-vos-íeis	beatificar+V.vós.AD.2.PL+COND+2+PL
beatifica-se	beatificar+V.ele.REFL+PRS+3+SG
beatificas-lhe	beatificar+V.ele.DAT.3.SG+PRS+2+SG
beatificas-lhes	beatificar+V.ele.DAT.3.PL+PRS+2+SG
beatificas-me	beatificar+V.eu.AD.1.SG+PRS+2+SG
beatificas-te	beatificar+V.tu.AD.2.SG+PRS+2+SG
beatificaste-la	beatificar+V.ele.ACC.3.F.SG+PRF+2+PL
beatificaste-las	beatificar+V.ele.ACC.3.F.PL+PRF+2+PL
beatificaste-lo	beatificar+V.ele.ACC.3.M.SG+PRF+2+PL
beatificaste-los	beatificar+V.ele.ACC.3.M.PL+PRF+2+PL
beatificaste-nos	beatificar+nós.AD.1.PL+PRF+2+PL
beatificastes-lhe	beatificar+V.ele.DAT.3.SG+PRF+2+PL
beatificastes-lhes	beatificar+V.ele.DAT.3.PL+PRF+2+PL
beatificastes-me	beatificar+V.eu.AD.1.SG+PRF+2+PL
beatificastes-te	beatificar+V.tu.AD.2.SG+PRF+2+PL
beatificastes-vos	beatificar+V.vós.AD.2.PL+PRF+2+PL
beatificas-vos	beatificar+V.vós.AD.2.PL+PRS+2+SG
beatifica-te	beatificar+V.tu.AD.2.SG+PRS+3+SG
beatificava-a	beatificar+V.ele.ACC.3.F.SG+IMPF+1+SG
beatificava-a	beatificar+V.ele.ACC.3.F.SG+IMPF+3+SG
beatificava-as	beatificar+V.ele.ACC.3.F.PL+IMPF+1+SG
beatificava-as	beatificar+V.ele.ACC.3.F.PL+IMPF+3+SG
beatificava-la	beatificar+V.ele.ACC.3.F.SG+IMPF+2+SG
beatificava-las	beatificar+V.ele.ACC.3.F.PL+IMPF+2+SG
beatificava-lhe	beatificar+V.ele.DAT.3.SG+IMPF+1+SG
beatificava-lhe	beatificar+V.ele.DAT.3.SG+IMPF+3+SG
beatificava-lhes	beatificar+V.ele.DAT.3.PL+IMPF+1+SG
beatificava-lhes	beatificar+V.ele.DAT.3.PL+IMPF+3+SG
beatificava-lo	beatificar+V.ele.ACC.3.M.SG+IMPF+2+SG
beatificava-los	beatificar+V.ele.ACC.3.M.PL+IMPF+2+SG
beatificava-me	beatificar+V.eu.AD.1.SG+IMPF+1+SG
beatificava-me	beatificar+V.eu.AD.1.SG+IMPF+3+SG
beatificavam-lhe	beatificar+V.ele.DAT.3.SG+IMPF+3+PL
beatificavam-lhes	beatificar+V.ele.DAT.3.PL+IMPF+3+PL
beatificavam-me	beatificar+V.eu.AD.1.SG+IMPF+3+PL
beatificavam-na	beatificar+V.ele.ACC.3.F.SG+IMPF+3+PL
beatificavam-nas	beatificar+V.ele.ACC.3.F.PL+IMPF+3+PL
beatificavam-no	beatificar+V.ele.ACC.3.M.SG+IMPF+3+PL
beatificavam-nos	beatificar+V.ele.ACC.3.M.PL+IMPF+3+PL
beatificavam-nos	beatificar+V.nós.AD.1.PL+IMPF+3+PL
beatificávamo-la	beatificar+V.ele.ACC.3.F.SG+IMPF+1+PL
beatificávamo-las	beatificar+V.ele.ACC.3.F.PL+IMPF+1+PL
beatificávamo-lo	beatificar+V.ele.ACC.3.M.SG+IMPF+1+PL
beatificávamo-los	beatificar+V.ele.ACC.3.M.PL+IMPF+1+PL
beatificávamo-nos	beatificar+nós.AD.1.PL+IMPF+1+PL
beatificávamos-lhe	beatificar+V.ele.DAT.3.SG+IMPF+1+PL
beatificávamos-lhes	beatificar+V.ele.DAT.3.PL+IMPF+1+PL
beatificávamos-me	beatificar+V.eu.AD.1.SG+IMPF+1+PL
beatificávamos-te	beatificar+V.tu.AD.2.SG+IMPF+1+PL
beatificávamos-vos	beatificar+V.vós.AD.2.PL+IMPF+1+PL
beatificavam-se	beatificar+V.ele.REFL+IMPF+3+PL
beatificavam-te	beatificar+V.tu.AD.2.SG+IMPF+3+PL
beatificavam-vos	beatificar+V.vós.AD.2.PL+IMPF+3+PL
beatificava-nos	beatificar+nós.AD.1.PL+IMPF+1+SG
beatificava-nos	beatificar+nós.AD.1.PL+IMPF+2+SG
beatificava-nos	beatificar+nós.AD.1.PL+IMPF+3+SG
beatificava-o	beatificar+V.ele.ACC.3.M.SG+IMPF+1+SG
beatificava-o	beatificar+V.ele.ACC.3.M.SG+IMPF+3+SG
beatificava-os	beatificar+V.ele.ACC.3.M.PL+IMPF+1+SG
beatificava-os	beatificar+V.ele.ACC.3.M.PL+IMPF+3+SG
beatificava-se	beatificar+V.ele.REFL+IMPF+1+SG
beatificava-se	beatificar+V.ele.REFL+IMPF+3+SG
beatificavas-lhe	beatificar+V.ele.DAT.3.SG+IMPF+2+SG
beatificavas-lhes	beatificar+V.ele.DAT.3.PL+IMPF+2+SG
beatificavas-me	beatificar+V.eu.AD.1.SG+IMPF+2+SG
beatificavas-te	beatificar+V.tu.AD.2.SG+IMPF+2+SG
beatificavas-vos	beatificar+V.vós.AD.2.PL+IMPF+2+SG
beatificava-te	beatificar+V.tu.AD.2.SG+IMPF+1+SG
beatificava-te	beatificar+V.tu.AD.2.SG+IMPF+3+SG
beatificava-vos	beatificar+V.vós.AD.2.PL+IMPF+1+SG
beatificava-vos	beatificar+V.vós.AD.2.PL+IMPF+3+SG
beatificávei-la	beatificar+V.ele.ACC.3.F.SG+IMPF+2+PL
beatificávei-las	beatificar+V.ele.ACC.3.F.PL+IMPF+2+PL
beatificávei-lo	beatificar+V.ele.ACC.3.M.SG+IMPF+2+PL
beatificávei-los	beatificar+V.ele.ACC.3.M.PL+IMPF+2+PL
beatificávei-nos	beatificar+nós.AD.1.PL+IMPF+2+PL
beatificáveis-lhe	beatificar+V.ele.DAT.3.SG+IMPF+2+PL
beatificáveis-lhes	beatificar+V.ele.DAT.3.PL+IMPF+2+PL
beatificáveis-me	beatificar+V.eu.AD.1.SG+IMPF+2+PL
beatificáveis-te	beatificar+V.tu.AD.2.SG+IMPF+2+PL
beatificáveis-vos	beatificar+V.vós.AD.2.PL+IMPF+2+PL
beatifica-vos	beatificar+V.vós.AD.2.PL+PRS+3+SG
beatifico-a	beatificar+V.ele.ACC.3.F.SG+PRS+1+SG
beatifico-as	beatificar+V.ele.ACC.3.F.PL+PRS+1+SG
beatifico-lhe	beatificar+V.ele.DAT.3.SG+PRS+1+SG
beatifico-lhes	beatificar+V.ele.DAT.3.PL+PRS+1+SG
beatifico-me	beatificar+V.eu.AD.1.SG+PRS+1+SG
beatifico-nos	beatificar+nós.AD.1.PL+PRS+1+SG
beatifico-o	beatificar+V.ele.ACC.3.M.SG+PRS+1+SG
beatifico-os	beatificar+V.ele.ACC.3.M.PL+PRS+1+SG
beatifico-te	beatificar+V.tu.AD.2.SG+PRS+1+SG
beatificou-a	beatificar+V.ele.ACC.3.F.SG+PRF+3+SG
beatificou-as	beatificar+V.ele.ACC.3.F.PL+PRF+3+SG
beatificou-lhe	beatificar+V.ele.DAT.3.SG+PRF+3+SG
beatificou-lhes	beatificar+V.ele.DAT.3.PL+PRF+3+SG
beatificou-me	beatificar+V.eu.AD.1.SG+PRF+3+SG
beatificou-nos	beatificar+nós.AD.1.PL+PRF+3+SG
beatificou-o	beatificar+V.ele.ACC.3.M.SG+PRF+3+SG
beatificou-os	beatificar+V.ele.ACC.3.M.PL+PRF+3+SG
beatificou-se	beatificar+V.ele.REFL+PRF+3+SG
beatificou-te	beatificar+V.tu.AD.2.SG+PRF+3+SG
beatificou-vos	beatificar+V.vós.AD.2.PL+PRF+3+SG
beatifico-vos	beatificar+V.vós.AD.2.PL+PRS+1+SG
beatifique-a	beatificar+V.ele.ACC.3.F.SG+IMP+3+SG
beatifique-as	beatificar+V.ele.ACC.3.F.PL+IMP+3+SG
beatifiquei-a	beatificar+V.ele.ACC.3.F.SG+PRF+1+SG
beatifiquei-as	beatificar+V.ele.ACC.3.F.PL+PRF+1+SG
beatifiquei-lhe	beatificar+V.ele.DAT.3.SG+PRF+1+SG
beatifiquei-lhes	beatificar+V.ele.DAT.3.PL+PRF+1+SG
beatifiquei-me	beatificar+V.eu.AD.1.SG+PRF+1+SG
beatifiquei-nos	beatificar+nós.AD.1.PL+PRF+1+SG
beatifiquei-o	beatificar+V.ele.ACC.3.M.SG+PRF+1+SG
beatifiquei-os	beatificar+V.ele.ACC.3.M.PL+PRF+1+SG
beatifiquei-te	beatificar+V.tu.AD.2.SG+PRF+1+SG
beatifiquei-vos	beatificar+V.vós.AD.2.PL+PRF+1+SG
beatifique-lhe	beatificar+V.ele.DAT.3.SG+IMP+3+SG
beatifique-lhes	beatificar+V.ele.DAT.3.PL+IMP+3+SG
beatifique-me	beatificar+V.eu.AD.1.SG+IMP+3+SG
beatifiquem-lhe	beatificar+V.ele.DAT.3.SG+IMP+3+PL
beatifiquem-lhes	beatificar+V.ele.DAT.3.PL+IMP+3+PL
beatifiquem-me	beatificar+V.eu.AD.1.SG+IMP+3+PL
beatifiquem-na	beatificar+V.ele.ACC.3.F.SG+IMP+3+PL
beatifiquem-nas	beatificar+V.ele.ACC.3.F.PL+IMP+3+PL
beatifiquem-no	beatificar+V.ele.ACC.3.M.SG+IMP+3+PL
beatifiquem-nos	beatificar+V.ele.ACC.3.M.PL+IMP+3+PL
beatifiquem-nos	beatificar+V.nós.AD.1.PL+IMP+3+PL
beatifiquemo-la	beatificar+V.ele.ACC.3.F.SG+IMP+1+PL
beatifiquemo-las	beatificar+V.ele.ACC.3.F.PL+IMP+1+PL
beatifiquemo-lo	beatificar+V.ele.ACC.3.M.SG+IMP+1+PL
beatifiquemo-los	beatificar+V.ele.ACC.3.M.PL+IMP+1+PL
beatifiquemo-nos	beatificar+nós.AD.1.PL+IMP+1+PL
beatifiquemos-lhe	beatificar+V.ele.DAT.3.SG+IMP+1+PL
beatifiquemos-lhes	beatificar+V.ele.DAT.3.PL+IMP+1+PL
beatifiquemos-me	beatificar+V.eu.AD.1.SG+IMP+1+PL
beatifiquemos-te	beatificar+V.tu.AD.2.SG+IMP+1+PL
beatifiquemos-vos	beatificar+V.vós.AD.2.PL+IMP+1+PL
beatifiquem-se	beatificar+V.ele.REFL+IMP+3+PL
beatifiquem-te	beatificar+V.tu.AD.2.SG+IMP+3+PL
beatifiquem-vos	beatificar+V.vós.AD.2.PL+IMP+3+PL
beatifique-nos	beatificar+nós.AD.1.PL+IMP+3+SG
beatifique-o	beatificar+V.ele.ACC.3.M.SG+IMP+3+SG
beatifique-os	beatificar+V.ele.ACC.3.M.PL+IMP+3+SG
beatifique-se	beatificar+V.ele.REFL+IMP+3+SG
beatifique-te	beatificar+V.tu.AD.2.SG+IMP+3+SG
beatifique-vos	beatificar+V.vós.AD.2.PL+IMP+3+SG
beba-a	beber+V.ele.ACC.3.F.SG+IMP+3+SG
beba-as	beber+V.ele.ACC.3.F.PL+IMP+3+SG
beba-lhe	beber+V.ele.DAT.3.SG+IMP+3+SG
beba-lhes	beber+V.ele.DAT.3.PL+IMP+3+SG
beba-me	beber+V.eu.AD.1.SG+IMP+3+SG
bebam-lhe	beber+V.ele.DAT.3.SG+IMP+3+PL
bebam-lhes	beber+V.ele.DAT.3.PL+IMP+3+PL
bebam-me	beber+V.eu.AD.1.SG+IMP+3+PL
bebam-na	beber+V.ele.ACC.3.F.SG+IMP+3+PL
bebam-nas	beber+V.ele.ACC.3.F.PL+IMP+3+PL
bebam-no	beber+V.ele.ACC.3.M.SG+IMP+3+PL
bebam-nos	beber+V.ele.ACC.3.M.PL+IMP+3+PL
bebam-nos	beber+V.nós.AD.1.PL+IMP+3+PL
bebamo-la	beber+V.ele.ACC.3.F.SG+IMP+1+PL
bebamo-las	beber+V.ele.ACC.3.F.PL+IMP+1+PL
bebamo-lo	beber+V.ele.ACC.3.M.SG+IMP+1+PL
bebamo-los	beber+V.ele.ACC.3.M.PL+IMP+1+PL
bebamo-nos	beber+nós.AD.1.PL+IMP+1+PL
bebamos-lhe	beber+V.ele.DAT.3.SG+IMP+1+PL
bebamos-lhes	beber+V.ele.DAT.3.PL+IMP+1+PL
bebamos-me	beber+V.eu.AD.1.SG+IMP+1+PL
bebamos-te	beber+V.tu.AD.2.SG+IMP+1+PL
bebamos-vos	beber+V.vós.AD.2.PL+IMP+1+PL
bebam-se	beber+V.ele.REFL+IMP+3+PL
bebam-te	beber+V.tu.AD.2.SG+IMP+3+PL
bebam-vos	beber+V.vós.AD.2.PL+IMP+3+PL
beba-nos	beber+nós.AD.1.PL+IMP+3+SG
beba-o	beber+V.ele.ACC.3.M.SG+IMP+3+SG
beba-os	beber+V.ele.ACC.3.M.PL+IMP+3+SG
beba-se	beber+V.ele.REFL+IMP+3+SG
beba-te	beber+V.tu.AD.2.SG+IMP+3+SG
beba-vos	beber+V.vós.AD.2.PL+IMP+3+SG
bebe-a	beber+V.ele.ACC.3.F.SG+PRS+3+SG
bebe-as	beber+V.ele.ACC.3.F.PL+PRS+3+SG
bebei-la	beber+V.ele.ACC.3.F.SG+PRS+2+PL
bebei-las	beber+V.ele.ACC.3.F.PL+PRS+2+PL
bebei-lo	beber+V.ele.ACC.3.M.SG+PRS+2+PL
bebei-los	beber+V.ele.ACC.3.M.PL+PRS+2+PL
bebei-nos	beber+nós.AD.1.PL+PRS+2+PL
bebeis-lhe	beber+V.ele.DAT.3.SG+PRS+2+PL
bebeis-lhes	beber+V.ele.DAT.3.PL+PRS+2+PL
bebeis-me	beber+V.eu.AD.1.SG+PRS+2+PL
bebeis-te	beber+V.tu.AD.2.SG+PRS+2+PL
bebeis-vos	beber+V.vós.AD.2.PL+PRS+2+PL
bebê-la-á	beber+V.ele.ACC.3.F.SG+FUT+3+SG
bebê-la-ão	beber+V.ele.ACC.3.F.SG+FUT+3+PL
bebê-la-ás	beber+V.ele.ACC.3.F.SG+FUT+2+SG
bebê-la	beber+V.ele.ACC.3.F.SG+INF
bebê-la	beber+V.ele.ACC.3.F.SG+INF+1+SG
bebê-la	beber+V.ele.ACC.3.F.SG+INF+3+SG
bebe-la	beber+V.ele.ACC.3.F.SG+PRS+2+SG
bebê-la	beber+V.ele.ACC.3.F.SG+SBJF+1+SG
bebê-la	beber+V.ele.ACC.3.F.SG+SBJF+3+SG
bebê-la-ei	beber+V.ele.ACC.3.F.SG+FUT+1+SG
bebê-la-eis	beber+V.ele.ACC.3.F.SG+FUT+2+PL
bebê-la-emos	beber+V.ele.ACC.3.F.SG+FUT+1+PL
bebê-la-ia	beber+V.ele.ACC.3.F.SG+COND+1+SG
bebê-la-ia	beber+V.ele.ACC.3.F.SG+COND+3+SG
bebê-la-iam	beber+V.ele.ACC.3.F.SG+COND+3+PL
bebê-la-íamos	beber+V.ele.ACC.3.F.SG+COND+1+PL
bebê-la-ias	beber+V.ele.ACC.3.F.SG+COND+2+SG
bebê-la-íeis	beber+V.ele.ACC.3.F.SG+COND+2+PL
bebê-las-á	beber+V.ele.ACC.3.F.PL+FUT+3+SG
bebê-las-ão	beber+V.ele.ACC.3.F.PL+FUT+3+PL
bebê-las-ás	beber+V.ele.ACC.3.F.PL+FUT+2+SG
bebê-las	beber+V.ele.ACC.3.F.PL+INF
bebê-las	beber+V.ele.ACC.3.F.PL+INF+1+SG
bebê-las	beber+V.ele.ACC.3.F.PL+INF+3+SG
bebe-las	beber+V.ele.ACC.3.F.PL+PRS+2+SG
bebê-las	beber+V.ele.ACC.3.F.PL+SBJF+1+SG
bebê-las	beber+V.ele.ACC.3.F.PL+SBJF+3+SG
bebê-las-ei	beber+V.ele.ACC.3.F.PL+FUT+1+SG
bebê-las-eis	beber+V.ele.ACC.3.F.PL+FUT+2+PL
bebê-las-emos	beber+V.ele.ACC.3.F.PL+FUT+1+PL
bebê-las-ia	beber+V.ele.ACC.3.F.PL+COND+1+SG
bebê-las-ia	beber+V.ele.ACC.3.F.PL+COND+3+SG
bebê-las-iam	beber+V.ele.ACC.3.F.PL+COND+3+PL
bebê-las-íamos	beber+V.ele.ACC.3.F.PL+COND+1+PL
bebê-las-ias	beber+V.ele.ACC.3.F.PL+COND+2+SG
bebê-las-íeis	beber+V.ele.ACC.3.F.PL+COND+2+PL
bebe-lhe	beber+V.ele.DAT.3.SG+PRS+3+SG
bebe-lhes	beber+V.ele.DAT.3.PL+PRS+3+SG
bebê-lo-á	beber+V.ele.ACC.3.M.SG+FUT+3+SG
bebê-lo-ão	beber+V.ele.ACC.3.M.SG+FUT+3+PL
bebê-lo-ás	beber+V.ele.ACC.3.M.SG+FUT+2+SG
bebê-lo	beber+V.ele.ACC.3.M.SG+INF
bebê-lo	beber+V.ele.ACC.3.M.SG+INF+1+SG
bebê-lo	beber+V.ele.ACC.3.M.SG+INF+3+SG
bebe-lo	beber+V.ele.ACC.3.M.SG+PRS+2+SG
bebê-lo	beber+V.ele.ACC.3.M.SG+SBJF+1+SG
bebê-lo	beber+V.ele.ACC.3.M.SG+SBJF+3+SG
bebê-lo-ei	beber+V.ele.ACC.3.M.SG+FUT+1+SG
bebê-lo-eis	beber+V.ele.ACC.3.M.SG+FUT+2+PL
bebê-lo-emos	beber+V.ele.ACC.3.M.SG+FUT+1+PL
bebê-lo-ia	beber+V.ele.ACC.3.M.SG+COND+1+SG
bebê-lo-ia	beber+V.ele.ACC.3.M.SG+COND+3+SG
bebê-lo-iam	beber+V.ele.ACC.3.M.SG+COND+3+PL
bebê-lo-íamos	beber+V.ele.ACC.3.M.SG+COND+1+PL
bebê-lo-ias	beber+V.ele.ACC.3.M.SG+COND+2+SG
bebê-lo-íeis	beber+V.ele.ACC.3.M.SG+COND+2+PL
bebê-los-á	beber+V.ele.ACC.3.M.PL+FUT+3+SG
bebê-los-ão	beber+V.ele.ACC.3.M.PL+FUT+3+PL
bebê-los-ás	beber+V.ele.ACC.3.M.PL+FUT+2+SG
bebê-los	beber+V.ele.ACC.3.M.PL+INF
bebê-los	beber+V.ele.ACC.3.M.PL+INF+1+SG
bebê-los	beber+V.ele.ACC.3.M.PL+INF+3+SG
bebe-los	beber+V.ele.ACC.3.M.PL+PRS+2+SG
bebê-los	beber+V.ele.ACC.3.M.PL+SBJF+1+SG
bebê-los	beber+V.ele.ACC.3.M.PL+SBJF+3+SG
bebê-los-ei	beber+V.ele.ACC.3.M.PL+FUT+1+SG
bebê-los-eis	beber+V.ele.ACC.3.M.PL+FUT+2+PL
bebê-los-emos	beber+V.ele.ACC.3.M.PL+FUT+1+PL
bebê-los-ia	beber+V.ele.ACC.3.M.PL+COND+1+SG
bebê-los-ia	beber+V.ele.ACC.3.M.PL+COND+3+SG
bebê-los-iam	beber+V.ele.ACC.3.M.PL+COND+3+PL
bebê-los-íamos	beber+V.ele.ACC.3.M.PL+COND+1+PL
bebê-los-ias	beber+V.ele.ACC.3.M.PL+COND+2+SG
bebê-los-íeis	beber+V.ele.ACC.3.M.PL+COND+2+PL
bebe-me	beber+V.eu.AD.1.SG+PRS+3+SG
bebem-lhe	beber+V.ele.DAT.3.SG+PRS+3+PL
bebem-lhes	beber+V.ele.DAT.3.PL+PRS+3+PL
bebem-me	beber+V.eu.AD.1.SG+PRS+3+PL
bebem-na	beber+V.ele.ACC.3.F.SG+PRS+3+PL
bebem-nas	beber+V.ele.ACC.3.F.PL+PRS+3+PL
bebem-no	beber+V.ele.ACC.3.M.SG+PRS+3+PL
bebem-nos	beber+V.ele.ACC.3.M.PL+PRS+3+PL
bebem-nos	beber+V.nós.AD.1.PL+PRS+3+PL
bebemo-la	beber+V.ele.ACC.3.F.SG+PRF+1+PL
bebemo-la	beber+V.ele.ACC.3.F.SG+PRS+1+PL
bebemo-las	beber+V.ele.ACC.3.F.PL+PRF+1+PL
bebemo-las	beber+V.ele.ACC.3.F.PL+PRS+1+PL
bebemo-lo	beber+V.ele.ACC.3.M.SG+PRF+1+PL
bebemo-lo	beber+V.ele.ACC.3.M.SG+PRS+1+PL
bebemo-los	beber+V.ele.ACC.3.M.PL+PRF+1+PL
bebemo-los	beber+V.ele.ACC.3.M.PL+PRS+1+PL
bebemo-nos	beber+nós.AD.1.PL+PRF+1+PL
bebemo-nos	beber+nós.AD.1.PL+PRS+1+PL
bebemos-lhe	beber+V.ele.DAT.3.SG+PRF+1+PL
bebemos-lhe	beber+V.ele.DAT.3.SG+PRS+1+PL
bebemos-lhes	beber+V.ele.DAT.3.PL+PRF+1+PL
bebemos-lhes	beber+V.ele.DAT.3.PL+PRS+1+PL
bebemos-me	beber+V.eu.AD.1.SG+PRF+1+PL
bebemos-me	beber+V.eu.AD.1.SG+PRS+1+PL
bebemos-te	beber+V.tu.AD.2.SG+PRF+1+PL
bebemos-te	beber+V.tu.AD.2.SG+PRS+1+PL
bebemos-vos	beber+V.vós.AD.2.PL+PRF+1+PL
bebemos-vos	beber+V.vós.AD.2.PL+PRS+1+PL
bebem-se	beber+V.ele.REFL+PRS+3+PL
bebem-te	beber+V.tu.AD.2.SG+PRS+3+PL
bebem-vos	beber+V.vós.AD.2.PL+PRS+3+PL
bebendo-a	beber+V.ele.ACC.3.F.SG+GRD
bebendo-as	beber+V.ele.ACC.3.F.PL+GRD
bebendo-lhe	beber+V.ele.DAT.3.SG+GRD
bebendo-lhes	beber+V.ele.DAT.3.PL+GRD
bebendo-me	beber+V.eu.AD.1.SG+GRD
bebendo-nos	beber+nós.AD.1.PL+GRD
bebendo-o	beber+V.ele.ACC.3.M.SG+GRD
bebendo-os	beber+V.ele.ACC.3.M.PL+GRD
bebendo-se	beber+V.ele.REFL+GRD
bebendo-te	beber+V.tu.AD.2.SG+GRD
bebendo-vos	beber+V.vós.AD.2.PL+GRD
bebe-nos	beber+nós.AD.1.PL+PRS+2+SG
bebe-nos	beber+nós.AD.1.PL+PRS+3+SG
bebe-o	beber+V.ele.ACC.3.M.SG+PRS+3+SG
bebe-os	beber+V.ele.ACC.3.M.PL+PRS+3+SG
bebera-a	beberar+V.ele.ACC.3.F.SG+PRS+3+SG
bebera-a	beber+V.ele.ACC.3.F.SG+PQP+1+SG
bebera-a	beber+V.ele.ACC.3.F.SG+PQP+3+SG
bebera-as	beberar+V.ele.ACC.3.F.PL+PRS+3+SG
bebera-as	beber+V.ele.ACC.3.F.PL+PQP+1+SG
bebera-as	beber+V.ele.ACC.3.F.PL+PQP+3+SG
beberai-la	beberar+V.ele.ACC.3.F.SG+PRS+2+PL
beberai-las	beberar+V.ele.ACC.3.F.PL+PRS+2+PL
beberai-lo	beberar+V.ele.ACC.3.M.SG+PRS+2+PL
beberai-los	beberar+V.ele.ACC.3.M.PL+PRS+2+PL
beberai-nos	beberar+nós.AD.1.PL+PRS+2+PL
beberais-lhe	beberar+V.ele.DAT.3.SG+PRS+2+PL
beberais-lhes	beberar+V.ele.DAT.3.PL+PRS+2+PL
beberais-me	beberar+V.eu.AD.1.SG+PRS+2+PL
beberais-te	beberar+V.tu.AD.2.SG+PRS+2+PL
beberais-vos	beberar+V.vós.AD.2.PL+PRS+2+PL
beberá-la-á	beberar+V.ele.ACC.3.F.SG+FUT+3+SG
beberá-la-ão	beberar+V.ele.ACC.3.F.SG+FUT+3+PL
beberá-la-ás	beberar+V.ele.ACC.3.F.SG+FUT+2+SG
beberá-la	beberar+V.ele.ACC.3.F.SG+INF+1+SG
beberá-la	beberar+V.ele.ACC.3.F.SG+INF+3+SG
bebera-la	beberar+V.ele.ACC.3.F.SG+PRS+2+SG
beberá-la	beberar+V.ele.ACC.3.F.SG+SBJF+1+SG
beberá-la	beberar+V.ele.ACC.3.F.SG+SBJF+3+SG
bebera-la	beber+V.ele.ACC.3.F.SG+PQP+2+SG
beberá-la-ei	beberar+V.ele.ACC.3.F.SG+FUT+1+SG
beberá-la-eis	beberar+V.ele.ACC.3.F.SG+FUT+2+PL
beberá-la-emos	beberar+V.ele.ACC.3.F.SG+FUT+1+PL
beberá-la-ia	beberar+V.ele.ACC.3.F.SG+COND+1+SG
beberá-la-ia	beberar+V.ele.ACC.3.F.SG+COND+3+SG
beberá-la-iam	beberar+V.ele.ACC.3.F.SG+COND+3+PL
beberá-la-íamos	beberar+V.ele.ACC.3.F.SG+COND+1+PL
beberá-la-ias	beberar+V.ele.ACC.3.F.SG+COND+2+SG
beberá-la-íeis	beberar+V.ele.ACC.3.F.SG+COND+2+PL
beberá-las-á	beberar+V.ele.ACC.3.F.PL+FUT+3+SG
beberá-las-ão	beberar+V.ele.ACC.3.F.PL+FUT+3+PL
beberá-las-ás	beberar+V.ele.ACC.3.F.PL+FUT+2+SG
beberá-las	beberar+V.ele.ACC.3.F.PL+INF+1+SG
beberá-las	beberar+V.ele.ACC.3.F.PL+INF+3+SG
bebera-las	beberar+V.ele.ACC.3.F.PL+PRS+2+SG
beberá-las	beberar+V.ele.ACC.3.F.PL+SBJF+1+SG
beberá-las	beberar+V.ele.ACC.3.F.PL+SBJF+3+SG
bebera-las	beber+V.ele.ACC.3.F.PL+PQP+2+SG
beberá-las-ei	beberar+V.ele.ACC.3.F.PL+FUT+1+SG
beberá-las-eis	beberar+V.ele.ACC.3.F.PL+FUT+2+PL
beberá-las-emos	beberar+V.ele.ACC.3.F.PL+FUT+1+PL
beberá-las-ia	beberar+V.ele.ACC.3.F.PL+COND+1+SG
beberá-las-ia	beberar+V.ele.ACC.3.F.PL+COND+3+SG
beberá-las-iam	beberar+V.ele.ACC.3.F.PL+COND+3+PL
beberá-las-íamos	beberar+V.ele.ACC.3.F.PL+COND+1+PL
beberá-las-ias	beberar+V.ele.ACC.3.F.PL+COND+2+SG
beberá-las-íeis	beberar+V.ele.ACC.3.F.PL+COND+2+PL
bebera-lhe	beberar+V.ele.DAT.3.SG+PRS+3+SG
bebera-lhe	beber+V.ele.DAT.3.SG+PQP+1+SG
bebera-lhe	beber+V.ele.DAT.3.SG+PQP+3+SG
bebera-lhes	beberar+V.ele.DAT.3.PL+PRS+3+SG
bebera-lhes	beber+V.ele.DAT.3.PL+PQP+1+SG
bebera-lhes	beber+V.ele.DAT.3.PL+PQP+3+SG
beberá-lo-á	beberar+V.ele.ACC.3.M.SG+FUT+3+SG
beberá-lo-ão	beberar+V.ele.ACC.3.M.SG+FUT+3+PL
beberá-lo-ás	beberar+V.ele.ACC.3.M.SG+FUT+2+SG
beberá-lo	beberar+V.ele.ACC.3.M.SG+INF+1+SG
beberá-lo	beberar+V.ele.ACC.3.M.SG+INF+3+SG
bebera-lo	beberar+V.ele.ACC.3.M.SG+PRS+2+SG
beberá-lo	beberar+V.ele.ACC.3.M.SG+SBJF+1+SG
beberá-lo	beberar+V.ele.ACC.3.M.SG+SBJF+3+SG
bebera-lo	beber+V.ele.ACC.3.M.SG+PQP+2+SG
beberá-lo-ei	beberar+V.ele.ACC.3.M.SG+FUT+1+SG
beberá-lo-eis	beberar+V.ele.ACC.3.M.SG+FUT+2+PL
beberá-lo-emos	beberar+V.ele.ACC.3.M.SG+FUT+1+PL
beberá-lo-ia	beberar+V.ele.ACC.3.M.SG+COND+1+SG
beberá-lo-ia	beberar+V.ele.ACC.3.M.SG+COND+3+SG
beberá-lo-iam	beberar+V.ele.ACC.3.M.SG+COND+3+PL
beberá-lo-íamos	beberar+V.ele.ACC.3.M.SG+COND+1+PL
beberá-lo-ias	beberar+V.ele.ACC.3.M.SG+COND+2+SG
beberá-lo-íeis	beberar+V.ele.ACC.3.M.SG+COND+2+PL
beberá-los-á	beberar+V.ele.ACC.3.M.PL+FUT+3+SG
beberá-los-ão	beberar+V.ele.ACC.3.M.PL+FUT+3+PL
beberá-los-ás	beberar+V.ele.ACC.3.M.PL+FUT+2+SG
beberá-los	beberar+V.ele.ACC.3.M.PL+INF+1+SG
beberá-los	beberar+V.ele.ACC.3.M.PL+INF+3+SG
bebera-los	beberar+V.ele.ACC.3.M.PL+PRS+2+SG
beberá-los	beberar+V.ele.ACC.3.M.PL+SBJF+1+SG
beberá-los	beberar+V.ele.ACC.3.M.PL+SBJF+3+SG
bebera-los	beber+V.ele.ACC.3.M.PL+PQP+2+SG
beberá-los-ei	beberar+V.ele.ACC.3.M.PL+FUT+1+SG
beberá-los-eis	beberar+V.ele.ACC.3.M.PL+FUT+2+PL
beberá-los-emos	beberar+V.ele.ACC.3.M.PL+FUT+1+PL
beberá-los-ia	beberar+V.ele.ACC.3.M.PL+COND+1+SG
beberá-los-ia	beberar+V.ele.ACC.3.M.PL+COND+3+SG
beberá-los-iam	beberar+V.ele.ACC.3.M.PL+COND+3+PL
beberá-los-íamos	beberar+V.ele.ACC.3.M.PL+COND+1+PL
beberá-los-ias	beberar+V.ele.ACC.3.M.PL+COND+2+SG
beberá-los-íeis	beberar+V.ele.ACC.3.M.PL+COND+2+PL
bebera-me	beberar+V.eu.AD.1.SG+PRS+3+SG
bebera-me	beber+V.eu.AD.1.SG+PQP+1+SG
bebera-me	beber+V.eu.AD.1.SG+PQP+3+SG
beberam-lhe	beberar+V.ele.DAT.3.SG+PRS+3+PL
beberam-lhe	beber+V.ele.DAT.3.SG+PQP+3+PL
beberam-lhe	beber+V.ele.DAT.3.SG+PRF+3+PL
beberam-lhes	beberar+V.ele.DAT.3.PL+PRS+3+PL
beberam-lhes	beber+V.ele.DAT.3.PL+PQP+3+PL
beberam-lhes	beber+V.ele.DAT.3.PL+PRF+3+PL
beberam-me	beberar+V.eu.AD.1.SG+PRS+3+PL
beberam-me	beber+V.eu.AD.1.SG+PQP+3+PL
beberam-me	beber+V.eu.AD.1.SG+PRF+3+PL
beberam-na	beberar+V.ele.ACC.3.F.SG+PRS+3+PL
beberam-na	beber+V.ele.ACC.3.F.SG+PQP+3+PL
beberam-na	beber+V.ele.ACC.3.F.SG+PRF+3+PL
beberam-nas	beberar+V.ele.ACC.3.F.PL+PRS+3+PL
beberam-nas	beber+V.ele.ACC.3.F.PL+PQP+3+PL
beberam-nas	beber+V.ele.ACC.3.F.PL+PRF+3+PL
beberam-no	beberar+V.ele.ACC.3.M.SG+PRS+3+PL
beberam-no	beber+V.ele.ACC.3.M.SG+PQP+3+PL
beberam-no	beber+V.ele.ACC.3.M.SG+PRF+3+PL
beberam-nos	beberar+V.ele.ACC.3.M.PL+PRS+3+PL
beberam-nos	beberar+V.nós.AD.1.PL+PRS+3+PL
beberam-nos	beber+V.ele.ACC.3.M.PL+PQP+3+PL
beberam-nos	beber+V.ele.ACC.3.M.PL+PRF+3+PL
beberam-nos	beber+V.nós.AD.1.PL+PQP+3+PL
beberam-nos	beber+V.nós.AD.1.PL+PRF+3+PL
beberamo-la	beberar+V.ele.ACC.3.F.SG+PRF+1+PL
beberamo-la	beberar+V.ele.ACC.3.F.SG+PRS+1+PL
bebêramo-la	beber+V.ele.ACC.3.F.SG+PQP+1+PL
beberamo-las	beberar+V.ele.ACC.3.F.PL+PRF+1+PL
beberamo-las	beberar+V.ele.ACC.3.F.PL+PRS+1+PL
bebêramo-las	beber+V.ele.ACC.3.F.PL+PQP+1+PL
beberamo-lo	beberar+V.ele.ACC.3.M.SG+PRF+1+PL
beberamo-lo	beberar+V.ele.ACC.3.M.SG+PRS+1+PL
bebêramo-lo	beber+V.ele.ACC.3.M.SG+PQP+1+PL
beberamo-los	beberar+V.ele.ACC.3.M.PL+PRF+1+PL
beberamo-los	beberar+V.ele.ACC.3.M.PL+PRS+1+PL
bebêramo-los	beber+V.ele.ACC.3.M.PL+PQP+1+PL
beberamo-nos	beberar+nós.AD.1.PL+PRF+1+PL
beberamo-nos	beberar+nós.AD.1.PL+PRS+1+PL
bebêramo-nos	beber+nós.AD.1.PL+PQP+1+PL
beberamos-lhe	beberar+V.ele.DAT.3.SG+PRF+1+PL
beberamos-lhe	beberar+V.ele.DAT.3.SG+PRS+1+PL
bebêramos-lhe	beber+V.ele.DAT.3.SG+PQP+1+PL
beberamos-lhes	beberar+V.ele.DAT.3.PL+PRF+1+PL
beberamos-lhes	beberar+V.ele.DAT.3.PL+PRS+1+PL
bebêramos-lhes	beber+V.ele.DAT.3.PL+PQP+1+PL
beberamos-me	beberar+V.eu.AD.1.SG+PRF+1+PL
beberamos-me	beberar+V.eu.AD.1.SG+PRS+1+PL
bebêramos-me	beber+V.eu.AD.1.SG+PQP+1+PL
beberamos-te	beberar+V.tu.AD.2.SG+PRF+1+PL
beberamos-te	beberar+V.tu.AD.2.SG+PRS+1+PL
bebêramos-te	beber+V.tu.AD.2.SG+PQP+1+PL
beberamos-vos	beberar+V.vós.AD.2.PL+PRF+1+PL
beberamos-vos	beberar+V.vós.AD.2.PL+PRS+1+PL
bebêramos-vos	beber+V.vós.AD.2.PL+PQP+1+PL
beberam-se	beberar+V.ele.REFL+PRS+3+PL
beberam-se	beber+V.ele.REFL+PQP+3+PL
beberam-se	beber+V.ele.REFL+PRF+3+PL
beberam-te	beberar+V.tu.AD.2.SG+PRS+3+PL
beberam-te	beber+V.tu.AD.2.SG+PQP+3+PL
beberam-te	beber+V.tu.AD.2.SG+PRF+3+PL
beberam-vos	beberar+V.vós.AD.2.PL+PRS+3+PL
beberam-vos	beber+V.vós.AD.2.PL+PQP+3+PL
beberam-vos	beber+V.vós.AD.2.PL+PRF+3+PL
beberando-a	beberar+V.ele.ACC.3.F.SG+GRD
beberando-as	beberar+V.ele.ACC.3.F.PL+GRD
beberando-lhe	beberar+V.ele.DAT.3.SG+GRD
beberando-lhes	beberar+V.ele.DAT.3.PL+GRD
beberando-me	beberar+V.eu.AD.1.SG+GRD
beberando-nos	beberar+nós.AD.1.PL+GRD
beberando-o	beberar+V.ele.ACC.3.M.SG+GRD
beberando-os	beberar+V.ele.ACC.3.M.PL+GRD
beberando-se	beberar+V.ele.REFL+GRD
beberando-te	beberar+V.tu.AD.2.SG+GRD
beberando-vos	beberar+V.vós.AD.2.PL+GRD
bebera-nos	beberar+nós.AD.1.PL+PRS+2+SG
bebera-nos	beberar+nós.AD.1.PL+PRS+3+SG
bebera-nos	beber+nós.AD.1.PL+PQP+1+SG
bebera-nos	beber+nós.AD.1.PL+PQP+2+SG
bebera-nos	beber+nós.AD.1.PL+PQP+3+SG
bebera-o	beberar+V.ele.ACC.3.M.SG+PRS+3+SG
bebera-o	beber+V.ele.ACC.3.M.SG+PQP+1+SG
bebera-o	beber+V.ele.ACC.3.M.SG+PQP+3+SG
bebera-os	beberar+V.ele.ACC.3.M.PL+PRS+3+SG
bebera-os	beber+V.ele.ACC.3.M.PL+PQP+1+SG
bebera-os	beber+V.ele.ACC.3.M.PL+PQP+3+SG
beberara-a	beberar+V.ele.ACC.3.F.SG+PQP+1+SG
beberara-a	beberar+V.ele.ACC.3.F.SG+PQP+3+SG
beberara-as	beberar+V.ele.ACC.3.F.PL+PQP+1+SG
beberara-as	beberar+V.ele.ACC.3.F.PL+PQP+3+SG
beberara-la	beberar+V.ele.ACC.3.F.SG+PQP+2+SG
beberara-las	beberar+V.ele.ACC.3.F.PL+PQP+2+SG
beberara-lhe	beberar+V.ele.DAT.3.SG+PQP+1+SG
beberara-lhe	beberar+V.ele.DAT.3.SG+PQP+3+SG
beberara-lhes	beberar+V.ele.DAT.3.PL+PQP+1+SG
beberara-lhes	beberar+V.ele.DAT.3.PL+PQP+3+SG
beberara-lo	beberar+V.ele.ACC.3.M.SG+PQP+2+SG
beberara-los	beberar+V.ele.ACC.3.M.PL+PQP+2+SG
beberara-me	beberar+V.eu.AD.1.SG+PQP+1+SG
beberara-me	beberar+V.eu.AD.1.SG+PQP+3+SG
beberaram-lhe	beberar+V.ele.DAT.3.SG+PQP+3+PL
beberaram-lhe	beberar+V.ele.DAT.3.SG+PRF+3+PL
beberaram-lhes	beberar+V.ele.DAT.3.PL+PQP+3+PL
beberaram-lhes	beberar+V.ele.DAT.3.PL+PRF+3+PL
beberaram-me	beberar+V.eu.AD.1.SG+PQP+3+PL
beberaram-me	beberar+V.eu.AD.1.SG+PRF+3+PL
beberaram-na	beberar+V.ele.ACC.3.F.SG+PQP+3+PL
beberaram-na	beberar+V.ele.ACC.3.F.SG+PRF+3+PL
beberaram-nas	beberar+V.ele.ACC.3.F.PL+PQP+3+PL
beberaram-nas	beberar+V.ele.ACC.3.F.PL+PRF+3+PL
beberaram-no	beberar+V.ele.ACC.3.M.SG+PQP+3+PL
beberaram-no	beberar+V.ele.ACC.3.M.SG+PRF+3+PL
beberaram-nos	beberar+V.ele.ACC.3.M.PL+PQP+3+PL
beberaram-nos	beberar+V.ele.ACC.3.M.PL+PRF+3+PL
beberaram-nos	beberar+V.nós.AD.1.PL+PQP+3+PL
beberaram-nos	beberar+V.nós.AD.1.PL+PRF+3+PL
beberáramo-la	beberar+V.ele.ACC.3.F.SG+PQP+1+PL
beberáramo-las	beberar+V.ele.ACC.3.F.PL+PQP+1+PL
beberáramo-lo	beberar+V.ele.ACC.3.M.SG+PQP+1+PL
beberáramo-los	beberar+V.ele.ACC.3.M.PL+PQP+1+PL
beberáramo-nos	beberar+nós.AD.1.PL+PQP+1+PL
beberáramos-lhe	beberar+V.ele.DAT.3.SG+PQP+1+PL
beberáramos-lhes	beberar+V.ele.DAT.3.PL+PQP+1+PL
beberáramos-me	beberar+V.eu.AD.1.SG+PQP+1+PL
beberáramos-te	beberar+V.tu.AD.2.SG+PQP+1+PL
beberáramos-vos	beberar+V.vós.AD.2.PL+PQP+1+PL
beberaram-se	beberar+V.ele.REFL+PQP+3+PL
beberaram-se	beberar+V.ele.REFL+PRF+3+PL
beberaram-te	beberar+V.tu.AD.2.SG+PQP+3+PL
beberaram-te	beberar+V.tu.AD.2.SG+PRF+3+PL
beberaram-vos	beberar+V.vós.AD.2.PL+PQP+3+PL
beberaram-vos	beberar+V.vós.AD.2.PL+PRF+3+PL
beberara-nos	beberar+nós.AD.1.PL+PQP+1+SG
beberara-nos	beberar+nós.AD.1.PL+PQP+2+SG
beberara-nos	beberar+nós.AD.1.PL+PQP+3+SG
beberara-o	beberar+V.ele.ACC.3.M.SG+PQP+1+SG
beberara-o	beberar+V.ele.ACC.3.M.SG+PQP+3+SG
beberara-os	beberar+V.ele.ACC.3.M.PL+PQP+1+SG
beberara-os	beberar+V.ele.ACC.3.M.PL+PQP+3+SG
beberara-se	beberar+V.ele.REFL+PQP+1+SG
beberara-se	beberar+V.ele.REFL+PQP+3+SG
beberaras-lhe	beberar+V.ele.DAT.3.SG+PQP+2+SG
beberaras-lhes	beberar+V.ele.DAT.3.PL+PQP+2+SG
beberaras-me	beberar+V.eu.AD.1.SG+PQP+2+SG
beberaras-te	beberar+V.tu.AD.2.SG+PQP+2+SG
beberaras-vos	beberar+V.vós.AD.2.PL+PQP+2+SG
beberara-te	beberar+V.tu.AD.2.SG+PQP+1+SG
beberara-te	beberar+V.tu.AD.2.SG+PQP+3+SG
beberara-vos	beberar+V.vós.AD.2.PL+PQP+1+SG
beberara-vos	beberar+V.vós.AD.2.PL+PQP+3+SG
beberarde-la	beberar+V.ele.ACC.3.F.SG+INF+2+PL
beberarde-la	beberar+V.ele.ACC.3.F.SG+SBJF+2+PL
beberarde-las	beberar+V.ele.ACC.3.F.PL+INF+2+PL
beberarde-las	beberar+V.ele.ACC.3.F.PL+SBJF+2+PL
beberarde-lo	beberar+V.ele.ACC.3.M.SG+INF+2+PL
beberarde-lo	beberar+V.ele.ACC.3.M.SG+SBJF+2+PL
beberarde-los	beberar+V.ele.ACC.3.M.PL+INF+2+PL
beberarde-los	beberar+V.ele.ACC.3.M.PL+SBJF+2+PL
beberarde-nos	beberar+nós.AD.1.PL+INF+2+PL
beberarde-nos	beberar+nós.AD.1.PL+SBJF+2+PL
beberardes-lhe	beberar+V.ele.DAT.3.SG+INF+2+PL
beberardes-lhe	beberar+V.ele.DAT.3.SG+SBJF+2+PL
beberardes-lhes	beberar+V.ele.DAT.3.PL+INF+2+PL
beberardes-lhes	beberar+V.ele.DAT.3.PL+SBJF+2+PL
beberardes-me	beberar+V.eu.AD.1.SG+INF+2+PL
beberardes-me	beberar+V.eu.AD.1.SG+SBJF+2+PL
beberardes-te	beberar+V.tu.AD.2.SG+INF+2+PL
beberardes-te	beberar+V.tu.AD.2.SG+SBJF+2+PL
beberardes-vos	beberar+V.vós.AD.2.PL+INF+2+PL
beberardes-vos	beberar+V.vós.AD.2.PL+SBJF+2+PL
beberárei-la	beberar+V.ele.ACC.3.F.SG+PQP+2+PL
beberárei-las	beberar+V.ele.ACC.3.F.PL+PQP+2+PL
beberárei-lo	beberar+V.ele.ACC.3.M.SG+PQP+2+PL
beberárei-los	beberar+V.ele.ACC.3.M.PL+PQP+2+PL
beberárei-nos	beberar+nós.AD.1.PL+PQP+2+PL
beberáreis-lhe	beberar+V.ele.DAT.3.SG+PQP+2+PL
beberáreis-lhes	beberar+V.ele.DAT.3.PL+PQP+2+PL
beberáreis-me	beberar+V.eu.AD.1.SG+PQP+2+PL
beberáreis-te	beberar+V.tu.AD.2.SG+PQP+2+PL
beberáreis-vos	beberar+V.vós.AD.2.PL+PQP+2+PL
beberare-la	beberar+V.ele.ACC.3.F.SG+INF+2+SG
beberare-la	beberar+V.ele.ACC.3.F.SG+SBJF+2+SG
beberare-las	beberar+V.ele.ACC.3.F.PL+INF+2+SG
beberare-las	beberar+V.ele.ACC.3.F.PL+SBJF+2+SG
beberare-lo	beberar+V.ele.ACC.3.M.SG+INF+2+SG
beberare-lo	beberar+V.ele.ACC.3.M.SG+SBJF+2+SG
beberare-los	beberar+V.ele.ACC.3.M.PL+INF+2+SG
beberare-los	beberar+V.ele.ACC.3.M.PL+SBJF+2+SG
beberarem-lhe	beberar+V.ele.DAT.3.SG+INF+3+PL
beberarem-lhe	beberar+V.ele.DAT.3.SG+SBJF+3+PL
beberarem-lhes	beberar+V.ele.DAT.3.PL+INF+3+PL
beberarem-lhes	beberar+V.ele.DAT.3.PL+SBJF+3+PL
beberarem-me	beberar+V.eu.AD.1.SG+INF+3+PL
beberarem-me	beberar+V.eu.AD.1.SG+SBJF+3+PL
beberarem-na	beberar+V.ele.ACC.3.F.SG+INF+3+PL
beberarem-na	beberar+V.ele.ACC.3.F.SG+SBJF+3+PL
beberarem-nas	beberar+V.ele.ACC.3.F.PL+INF+3+PL
beberarem-nas	beberar+V.ele.ACC.3.F.PL+SBJF+3+PL
beberarem-no	beberar+V.ele.ACC.3.M.SG+INF+3+PL
beberarem-no	beberar+V.ele.ACC.3.M.SG+SBJF+3+PL
beberarem-nos	beberar+V.ele.ACC.3.M.PL+INF+3+PL
beberarem-nos	beberar+V.ele.ACC.3.M.PL+SBJF+3+PL
beberarem-nos	beberar+V.nós.AD.1.PL+INF+3+PL
beberarem-nos	beberar+V.nós.AD.1.PL+SBJF+3+PL
beberarem-se	beberar+V.ele.REFL+INF+3+PL
beberarem-se	beberar+V.ele.REFL+SBJF+3+PL
beberarem-te	beberar+V.tu.AD.2.SG+INF+3+PL
beberarem-te	beberar+V.tu.AD.2.SG+SBJF+3+PL
beberarem-vos	beberar+V.vós.AD.2.PL+INF+3+PL
beberarem-vos	beberar+V.vós.AD.2.PL+SBJF+3+PL
beberare-nos	beberar+nós.AD.1.PL+INF+2+SG
beberare-nos	beberar+nós.AD.1.PL+SBJF+2+SG
beberares-lhe	beberar+V.ele.DAT.3.SG+INF+2+SG
beberares-lhe	beberar+V.ele.DAT.3.SG+SBJF+2+SG
beberares-lhes	beberar+V.ele.DAT.3.PL+INF+2+SG
beberares-lhes	beberar+V.ele.DAT.3.PL+SBJF+2+SG
beberares-me	beberar+V.eu.AD.1.SG+INF+2+SG
beberares-me	beberar+V.eu.AD.1.SG+SBJF+2+SG
beberares-te	beberar+V.tu.AD.2.SG+INF+2+SG
beberares-te	beberar+V.tu.AD.2.SG+SBJF+2+SG
beberares-vos	beberar+V.vós.AD.2.PL+INF+2+SG
beberares-vos	beberar+V.vós.AD.2.PL+SBJF+2+SG
beberar-lhe-á	beberar+V.ele.DAT.3.SG+FUT+3+SG
beberar-lhe-ão	beberar+V.ele.DAT.3.SG+FUT+3+PL
beberar-lhe-ás	beberar+V.ele.DAT.3.SG+FUT+2+SG
beberar-lhe	beberar+V.ele.DAT.3.SG+INF
beberar-lhe	beberar+V.ele.DAT.3.SG+INF+1+SG
beberar-lhe	beberar+V.ele.DAT.3.SG+INF+3+SG
beberar-lhe	beberar+V.ele.DAT.3.SG+SBJF+1+SG
beberar-lhe	beberar+V.ele.DAT.3.SG+SBJF+3+SG
beberar-lhe-ei	beberar+V.ele.DAT.3.SG+FUT+1+SG
beberar-lhe-eis	beberar+V.ele.DAT.3.SG+FUT+2+PL
beberar-lhe-emos	beberar+V.ele.DAT.3.SG+FUT+1+PL
beberar-lhe-ia	beberar+V.ele.DAT.3.SG+COND+1+SG
beberar-lhe-ia	beberar+V.ele.DAT.3.SG+COND+3+SG
beberar-lhe-iam	beberar+V.ele.DAT.3.SG+COND+3+PL
beberar-lhe-íamos	beberar+V.ele.DAT.3.SG+COND+1+PL
beberar-lhe-ias	beberar+V.ele.DAT.3.SG+COND+2+SG
beberar-lhe-íeis	beberar+V.ele.DAT.3.SG+COND+2+PL
beberar-lhes-á	beberar+V.ele.DAT.3.PL+FUT+3+SG
beberar-lhes-ão	beberar+V.ele.DAT.3.PL+FUT+3+PL
beberar-lhes-ás	beberar+V.ele.DAT.3.PL+FUT+2+SG
beberar-lhes	beberar+V.ele.DAT.3.PL+INF
beberar-lhes	beberar+V.ele.DAT.3.PL+INF+1+SG
beberar-lhes	beberar+V.ele.DAT.3.PL+INF+3+SG
beberar-lhes	beberar+V.ele.DAT.3.PL+SBJF+1+SG
beberar-lhes	beberar+V.ele.DAT.3.PL+SBJF+3+SG
beberar-lhes-ei	beberar+V.ele.DAT.3.PL+FUT+1+SG
beberar-lhes-eis	beberar+V.ele.DAT.3.PL+FUT+2+PL
beberar-lhes-emos	beberar+V.ele.DAT.3.PL+FUT+1+PL
beberar-lhes-ia	beberar+V.ele.DAT.3.PL+COND+1+SG
beberar-lhes-ia	beberar+V.ele.DAT.3.PL+COND+3+SG
beberar-lhes-iam	beberar+V.ele.DAT.3.PL+COND+3+PL
beberar-lhes-íamos	beberar+V.ele.DAT.3.PL+COND+1+PL
beberar-lhes-ias	beberar+V.ele.DAT.3.PL+COND+2+SG
beberar-lhes-íeis	beberar+V.ele.DAT.3.PL+COND+2+PL
beberar-me-á	beberar+V.eu.AD.1.SG+FUT+3+SG
beberar-me-ão	beberar+V.eu.AD.1.SG+FUT+3+PL
beberar-me-ás	beberar+V.eu.AD.1.SG+FUT+2+SG
beberar-me	beberar+V.eu.AD.1.SG+INF
beberar-me	beberar+V.eu.AD.1.SG+INF+1+SG
beberar-me	beberar+V.eu.AD.1.SG+INF+3+SG
beberar-me	beberar+V.eu.AD.1.SG+SBJF+1+SG
beberar-me	beberar+V.eu.AD.1.SG+SBJF+3+SG
beberar-me-ei	beberar+V.eu.AD.1.SG+FUT+1+SG
beberar-me-eis	beberar+V.eu.AD.1.SG+FUT+2+PL
beberar-me-emos	beberar+V.eu.AD.1.SG+FUT+1+PL
beberar-me-ia	beberar+V.eu.AD.1.SG+COND+1+SG
beberar-me-ia	beberar+V.eu.AD.1.SG+COND+3+SG
beberar-me-iam	beberar+V.eu.AD.1.SG+COND+3+PL
beberar-me-íamos	beberar+V.eu.AD.1.SG+COND+1+PL
beberar-me-ias	beberar+V.eu.AD.1.SG+COND+2+SG
beberar-me-íeis	beberar+V.eu.AD.1.SG+COND+2+PL
beberarmo-la	beberar+V.ele.ACC.3.F.SG+INF+1+PL
beberarmo-la	beberar+V.ele.ACC.3.F.SG+SBJF+1+PL
beberarmo-las	beberar+V.ele.ACC.3.F.PL+INF+1+PL
beberarmo-las	beberar+V.ele.ACC.3.F.PL+SBJF+1+PL
beberarmo-lo	beberar+V.ele.ACC.3.M.SG+INF+1+PL
beberarmo-lo	beberar+V.ele.ACC.3.M.SG+SBJF+1+PL
beberarmo-los	beberar+V.ele.ACC.3.M.PL+INF+1+PL
beberarmo-los	beberar+V.ele.ACC.3.M.PL+SBJF+1+PL
beberarmo-nos	beberar+nós.AD.1.PL+INF+1+PL
beberarmo-nos	beberar+nós.AD.1.PL+SBJF+1+PL
beberarmos-lhe	beberar+V.ele.DAT.3.SG+INF+1+PL
beberarmos-lhe	beberar+V.ele.DAT.3.SG+SBJF+1+PL
beberarmos-lhes	beberar+V.ele.DAT.3.PL+INF+1+PL
beberarmos-lhes	beberar+V.ele.DAT.3.PL+SBJF+1+PL
beberarmos-me	beberar+V.eu.AD.1.SG+INF+1+PL
beberarmos-me	beberar+V.eu.AD.1.SG+SBJF+1+PL
beberarmos-te	beberar+V.tu.AD.2.SG+INF+1+PL
beberarmos-te	beberar+V.tu.AD.2.SG+SBJF+1+PL
beberarmos-vos	beberar+V.vós.AD.2.PL+INF+1+PL
beberarmos-vos	beberar+V.vós.AD.2.PL+SBJF+1+PL
beberar-nos-á	beberar+nós.AD.1.PL+FUT+3+SG
beberar-nos-ão	beberar+nós.AD.1.PL+FUT+3+PL
beberar-nos-ás	beberar+nós.AD.1.PL+FUT+2+SG
beberar-nos	beberar+nós.AD.1.PL+INF
beberar-nos	beberar+nós.AD.1.PL+INF+1+SG
beberar-nos	beberar+nós.AD.1.PL+INF+3+SG
beberar-nos	beberar+nós.AD.1.PL+SBJF+1+SG
beberar-nos	beberar+nós.AD.1.PL+SBJF+3+SG
beberar-nos-ei	beberar+nós.AD.1.PL+FUT+1+SG
beberar-nos-eis	beberar+nós.AD.1.PL+FUT+2+PL
beberar-nos-emos	beberar+nós.AD.1.PL+FUT+1+PL
beberar-nos-ia	beberar+nós.AD.1.PL+COND+1+SG
beberar-nos-ia	beberar+nós.AD.1.PL+COND+3+SG
beberar-nos-iam	beberar+nós.AD.1.PL+COND+3+PL
beberar-nos-íamos	beberar+nós.AD.1.PL+COND+1+PL
beberar-nos-ias	beberar+nós.AD.1.PL+COND+2+SG
beberar-nos-íeis	beberar+nós.AD.1.PL+COND+2+PL
beberar-se-á	beberar+V.ele.REFL+FUT+3+SG
beberar-se-ão	beberar+V.ele.REFL+FUT+3+PL
beberar-se	beberar+V.ele.REFL+INF
beberar-se	beberar+V.ele.REFL+INF+3+SG
beberar-se	beberar+V.ele.REFL+SBJF+3+SG
beberar-se-ia	beberar+V.ele.REFL+COND+3+SG
beberar-se-iam	beberar+V.ele.REFL+COND+3+PL
beberar-te-á	beberar+V.tu.AD.2.SG+FUT+3+SG
beberar-te-ão	beberar+V.tu.AD.2.SG+FUT+3+PL
beberar-te-ás	beberar+V.tu.AD.2.SG+FUT+2+SG
beberar-te	beberar+V.tu.AD.2.SG+INF
beberar-te	beberar+V.tu.AD.2.SG+INF+1+SG
beberar-te	beberar+V.tu.AD.2.SG+INF+3+SG
beberar-te	beberar+V.tu.AD.2.SG+SBJF+1+SG
beberar-te	beberar+V.tu.AD.2.SG+SBJF+3+SG
beberar-te-ei	beberar+V.tu.AD.2.SG+FUT+1+SG
beberar-te-eis	beberar+V.tu.AD.2.SG+FUT+2+PL
beberar-te-emos	beberar+V.tu.AD.2.SG+FUT+1+PL
beberar-te-ia	beberar+V.tu.AD.2.SG+COND+1+SG
beberar-te-ia	beberar+V.tu.AD.2.SG+COND+3+SG
beberar-te-iam	beberar+V.tu.AD.2.SG+COND+3+PL
beberar-te-íamos	beberar+V.tu.AD.2.SG+COND+1+PL
beberar-te-ias	beberar+V.tu.AD.2.SG+COND+2+SG
beberar-te-íeis	beberar+V.tu.AD.2.SG+COND+2+PL
beberar-vos-á	beberar+V.vós.AD.2.PL+FUT+3+SG
beberar-vos-ão	beberar+V.vós.AD.2.PL+FUT+3+PL
beberar-vos-ás	beberar+V.vós.AD.2.PL+FUT+2+SG
beberar-vos	beberar+V.vós.AD.2.PL+INF
beberar-vos	beberar+V.vós.AD.2.PL+INF+1+SG
beberar-vos	beberar+V.vós.AD.2.PL+INF+3+SG
beberar-vos	beberar+V.vós.AD.2.PL+SBJF+1+SG
beberar-vos	beberar+V.vós.AD.2.PL+SBJF+3+SG
beberar-vos-ei	beberar+V.vós.AD.2.PL+FUT+1+SG
beberar-vos-eis	beberar+V.vós.AD.2.PL+FUT+2+PL
beberar-vos-emos	beberar+V.vós.AD.2.PL+FUT+1+PL
beberar-vos-ia	beberar+V.vós.AD.2.PL+COND+1+SG
beberar-vos-ia	beberar+V.vós.AD.2.PL+COND+3+SG
beberar-vos-iam	beberar+V.vós.AD.2.PL+COND+3+PL
beberar-vos-íamos	beberar+V.vós.AD.2.PL+COND+1+PL
beberar-vos-ias	beberar+V.vós.AD.2.PL+COND+2+SG
beberar-vos-íeis	beberar+V.vós.AD.2.PL+COND+2+PL
bebera-se	beberar+V.ele.REFL+PRS+3+SG
bebera-se	beber+V.ele.REFL+PQP+3+SG
beberas-lhe	beberar+V.ele.DAT.3.SG+PRS+2+SG
beberas-lhe	beber+V.ele.DAT.3.SG+PQP+2+SG
beberas-lhes	beberar+V.ele.DAT.3.PL+PRS+2+SG
beberas-lhes	beber+V.ele.DAT.3.PL+PQP+2+SG
beberas-me	beberar+V.eu.AD.1.SG+PRS+2+SG
beberas-me	beber+V.eu.AD.1.SG+PQP+2+SG
beberaste-a	beberar+V.ele.ACC.3.F.SG+PRF+2+SG
beberaste-as	beberar+V.ele.ACC.3.F.PL+PRF+2+SG
beberas-te	beberar+V.tu.AD.2.SG+PRS+2+SG
beberas-te	beber+V.tu.AD.2.SG+PQP+2+SG
beberaste-la	beberar+V.ele.ACC.3.F.SG+PRF+2+PL
beberaste-las	beberar+V.ele.ACC.3.F.PL+PRF+2+PL
beberaste-lhe	beberar+V.ele.DAT.3.SG+PRF+2+SG
beberaste-lhes	beberar+V.ele.DAT.3.PL+PRF+2+SG
beberaste-lo	beberar+V.ele.ACC.3.M.SG+PRF+2+PL
beberaste-los	beberar+V.ele.ACC.3.M.PL+PRF+2+PL
beberaste-me	beberar+V.eu.AD.1.SG+PRF+2+SG
beberaste-nos	beberar+nós.AD.1.PL+PRF+2+PL
beberaste-nos	beberar+nós.AD.1.PL+PRF+2+SG
beberaste-o	beberar+V.ele.ACC.3.M.SG+PRF+2+SG
beberaste-os	beberar+V.ele.ACC.3.M.PL+PRF+2+SG
beberastes-lhe	beberar+V.ele.DAT.3.SG+PRF+2+PL
beberastes-lhes	beberar+V.ele.DAT.3.PL+PRF+2+PL
beberastes-me	beberar+V.eu.AD.1.SG+PRF+2+PL
beberastes-te	beberar+V.tu.AD.2.SG+PRF+2+PL
beberastes-vos	beberar+V.vós.AD.2.PL+PRF+2+PL
beberaste-te	beberar+V.tu.AD.2.SG+PRF+2+SG
beberaste-vos	beberar+V.vós.AD.2.PL+PRF+2+SG
beberas-vos	beberar+V.vós.AD.2.PL+PRS+2+SG
beberas-vos	beber+V.vós.AD.2.PL+PQP+2+SG
bebera-te	beberar+V.tu.AD.2.SG+PRS+3+SG
bebera-te	beber+V.tu.AD.2.SG+PQP+1+SG
bebera-te	beber+V.tu.AD.2.SG+PQP+3+SG
beberava-a	beberar+V.ele.ACC.3.F.SG+IMPF+1+SG
beberava-a	beberar+V.ele.ACC.3.F.SG+IMPF+3+SG
beberava-as	beberar+V.ele.ACC.3.F.PL+IMPF+1+SG
beberava-as	beberar+V.ele.ACC.3.F.PL+IMPF+3+SG
beberava-la	beberar+V.ele.ACC.3.F.SG+IMPF+2+SG
beberava-las	beberar+V.ele.ACC.3.F.PL+IMPF+2+SG
beberava-lhe	beberar+V.ele.DAT.3.SG+IMPF+1+SG
beberava-lhe	beberar+V.ele.DAT.3.SG+IMPF+3+SG
beberava-lhes	beberar+V.ele.DAT.3.PL+IMPF+1+SG
beberava-lhes	beberar+V.ele.DAT.3.PL+IMPF+3+SG
beberava-lo	beberar+V.ele.ACC.3.M.SG+IMPF+2+SG
beberava-los	beberar+V.ele.ACC.3.M.PL+IMPF+2+SG
beberava-me	beberar+V.eu.AD.1.SG+IMPF+1+SG
beberava-me	beberar+V.eu.AD.1.SG+IMPF+3+SG
beberavam-lhe	beberar+V.ele.DAT.3.SG+IMPF+3+PL
beberavam-lhes	beberar+V.ele.DAT.3.PL+IMPF+3+PL
beberavam-me	beberar+V.eu.AD.1.SG+IMPF+3+PL
beberavam-na	beberar+V.ele.ACC.3.F.SG+IMPF+3+PL
beberavam-nas	beberar+V.ele.ACC.3.F.PL+IMPF+3+PL
beberavam-no	beberar+V.ele.ACC.3.M.SG+IMPF+3+PL
beberavam-nos	beberar+V.ele.ACC.3.M.PL+IMPF+3+PL
beberavam-nos	beberar+V.nós.AD.1.PL+IMPF+3+PL
beberávamo-la	beberar+V.ele.ACC.3.F.SG+IMPF+1+PL
beberávamo-las	beberar+V.ele.ACC.3.F.PL+IMPF+1+PL
beberávamo-lo	beberar+V.ele.ACC.3.M.SG+IMPF+1+PL
beberávamo-los	beberar+V.ele.ACC.3.M.PL+IMPF+1+PL
beberávamo-nos	beberar+nós.AD.1.PL+IMPF+1+PL
beberávamos-lhe	beberar+V.ele.DAT.3.SG+IMPF+1+PL
beberávamos-lhes	beberar+V.ele.DAT.3.PL+IMPF+1+PL
beberávamos-me	beberar+V.eu.AD.1.SG+IMPF+1+PL
beberávamos-te	beberar+V.tu.AD.2.SG+IMPF+1+PL
beberávamos-vos	beberar+V.vós.AD.2.PL+IMPF+1+PL
beberavam-se	beberar+V.ele.REFL+IMPF+3+PL
beberavam-te	beberar+V.tu.AD.2.SG+IMPF+3+PL
beberavam-vos	beberar+V.vós.AD.2.PL+IMPF+3+PL
beberava-nos	beberar+nós.AD.1.PL+IMPF+1+SG
beberava-nos	beberar+nós.AD.1.PL+IMPF+2+SG
beberava-nos	beberar+nós.AD.1.PL+IMPF+3+SG
beberava-o	beberar+V.ele.ACC.3.M.SG+IMPF+1+SG
beberava-o	beberar+V.ele.ACC.3.M.SG+IMPF+3+SG
beberava-os	beberar+V.ele.ACC.3.M.PL+IMPF+1+SG
beberava-os	beberar+V.ele.ACC.3.M.PL+IMPF+3+SG
beberava-se	beberar+V.ele.REFL+IMPF+1+SG
beberava-se	beberar+V.ele.REFL+IMPF+3+SG
beberavas-lhe	beberar+V.ele.DAT.3.SG+IMPF+2+SG
beberavas-lhes	beberar+V.ele.DAT.3.PL+IMPF+2+SG
beberavas-me	beberar+V.eu.AD.1.SG+IMPF+2+SG
beberavas-te	beberar+V.tu.AD.2.SG+IMPF+2+SG
beberavas-vos	beberar+V.vós.AD.2.PL+IMPF+2+SG
beberava-te	beberar+V.tu.AD.2.SG+IMPF+1+SG
beberava-te	beberar+V.tu.AD.2.SG+IMPF+3+SG
beberava-vos	beberar+V.vós.AD.2.PL+IMPF+1+SG
beberava-vos	beberar+V.vós.AD.2.PL+IMPF+3+SG
beberávei-la	beberar+V.ele.ACC.3.F.SG+IMPF+2+PL
beberávei-las	beberar+V.ele.ACC.3.F.PL+IMPF+2+PL
beberávei-lo	beberar+V.ele.ACC.3.M.SG+IMPF+2+PL
beberávei-los	beberar+V.ele.ACC.3.M.PL+IMPF+2+PL
beberávei-nos	beberar+nós.AD.1.PL+IMPF+2+PL
beberáveis-lhe	beberar+V.ele.DAT.3.SG+IMPF+2+PL
beberáveis-lhes	beberar+V.ele.DAT.3.PL+IMPF+2+PL
beberáveis-me	beberar+V.eu.AD.1.SG+IMPF+2+PL
beberáveis-te	beberar+V.tu.AD.2.SG+IMPF+2+PL
beberáveis-vos	beberar+V.vós.AD.2.PL+IMPF+2+PL
bebera-vos	beberar+V.vós.AD.2.PL+PRS+3+SG
bebera-vos	beber+V.vós.AD.2.PL+PQP+1+SG
bebera-vos	beber+V.vós.AD.2.PL+PQP+3+SG
beberde-la	beber+V.ele.ACC.3.F.SG+INF+2+PL
beberde-la	beber+V.ele.ACC.3.F.SG+SBJF+2+PL
beberde-las	beber+V.ele.ACC.3.F.PL+INF+2+PL
beberde-las	beber+V.ele.ACC.3.F.PL+SBJF+2+PL
beberde-lo	beber+V.ele.ACC.3.M.SG+INF+2+PL
beberde-lo	beber+V.ele.ACC.3.M.SG+SBJF+2+PL
beberde-los	beber+V.ele.ACC.3.M.PL+INF+2+PL
beberde-los	beber+V.ele.ACC.3.M.PL+SBJF+2+PL
beberde-nos	beber+nós.AD.1.PL+INF+2+PL
beberde-nos	beber+nós.AD.1.PL+SBJF+2+PL
beberdes-lhe	beber+V.ele.DAT.3.SG+INF+2+PL
beberdes-lhe	beber+V.ele.DAT.3.SG+SBJF+2+PL
beberdes-lhes	beber+V.ele.DAT.3.PL+INF+2+PL
beberdes-lhes	beber+V.ele.DAT.3.PL+SBJF+2+PL
beberdes-me	beber+V.eu.AD.1.SG+INF+2+PL
beberdes-me	beber+V.eu.AD.1.SG+SBJF+2+PL
beberdes-te	beber+V.tu.AD.2.SG+INF+2+PL
beberdes-te	beber+V.tu.AD.2.SG+SBJF+2+PL
beberdes-vos	beber+V.vós.AD.2.PL+INF+2+PL
beberdes-vos	beber+V.vós.AD.2.PL+SBJF+2+PL
bebere-a	beberar+V.ele.ACC.3.F.SG+IMP+3+SG
bebere-as	beberar+V.ele.ACC.3.F.PL+IMP+3+SG
beberei-a	beberar+V.ele.ACC.3.F.SG+PRF+1+SG
beberei-as	beberar+V.ele.ACC.3.F.PL+PRF+1+SG
bebêrei-la	beber+V.ele.ACC.3.F.SG+PQP+2+PL
bebêrei-las	beber+V.ele.ACC.3.F.PL+PQP+2+PL
beberei-lhe	beberar+V.ele.DAT.3.SG+PRF+1+SG
beberei-lhes	beberar+V.ele.DAT.3.PL+PRF+1+SG
bebêrei-lo	beber+V.ele.ACC.3.M.SG+PQP+2+PL
bebêrei-los	beber+V.ele.ACC.3.M.PL+PQP+2+PL
beberei-me	beberar+V.eu.AD.1.SG+PRF+1+SG
beberei-nos	beberar+nós.AD.1.PL+PRF+1+SG
bebêrei-nos	beber+nós.AD.1.PL+PQP+2+PL
beberei-o	beberar+V.ele.ACC.3.M.SG+PRF+1+SG
beberei-os	beberar+V.ele.ACC.3.M.PL+PRF+1+SG
bebêreis-lhe	beber+V.ele.DAT.3.SG+PQP+2+PL
bebêreis-lhes	beber+V.ele.DAT.3.PL+PQP+2+PL
bebêreis-me	beber+V.eu.AD.1.SG+PQP+2+PL
bebêreis-te	beber+V.tu.AD.2.SG+PQP+2+PL
bebêreis-vos	beber+V.vós.AD.2.PL+PQP+2+PL
beberei-te	beberar+V.tu.AD.2.SG+PRF+1+SG
beberei-vos	beberar+V.vós.AD.2.PL+PRF+1+SG
bebere-la	beber+V.ele.ACC.3.F.SG+INF+2+SG
bebere-la	beber+V.ele.ACC.3.F.SG+SBJF+2+SG
bebere-las	beber+V.ele.ACC.3.F.PL+INF+2+SG
bebere-las	beber+V.ele.ACC.3.F.PL+SBJF+2+SG
bebere-lhe	beberar+V.ele.DAT.3.SG+IMP+3+SG
bebere-lhes	beberar+V.ele.DAT.3.PL+IMP+3+SG
bebere-lo	beber+V.ele.ACC.3.M.SG+INF+2+SG
bebere-lo	beber+V.ele.ACC.3.M.SG+SBJF+2+SG
bebere-los	beber+V.ele.ACC.3.M.PL+INF+2+SG
bebere-los	beber+V.ele.ACC.3.M.PL+SBJF+2+SG
bebere-me	beberar+V.eu.AD.1.SG+IMP+3+SG
beberem-lhe	beberar+V.ele.DAT.3.SG+IMP+3+PL
beberem-lhe	beber+V.ele.DAT.3.SG+INF+3+PL
beberem-lhe	beber+V.ele.DAT.3.SG+SBJF+3+PL
beberem-lhes	beberar+V.ele.DAT.3.PL+IMP+3+PL
beberem-lhes	beber+V.ele.DAT.3.PL+INF+3+PL
beberem-lhes	beber+V.ele.DAT.3.PL+SBJF+3+PL
