caibrar-se-á	caibrar+V.ele.REFL+FUT+3+SG
caibrar-se-ão	caibrar+V.ele.REFL+FUT+3+PL
caibrar-se	caibrar+V.ele.REFL+INF
caibrar-se	caibrar+V.ele.REFL+INF+3+SG
caibrar-se	caibrar+V.ele.REFL+SBJF+3+SG
caibrar-se-ia	caibrar+V.ele.REFL+COND+3+SG
caibrar-se-iam	caibrar+V.ele.REFL+COND+3+PL
caibrar-te-á	caibrar+V.tu.AD.2.SG+FUT+3+SG
caibrar-te-ão	caibrar+V.tu.AD.2.SG+FUT+3+PL
caibrar-te-ás	caibrar+V.tu.AD.2.SG+FUT+2+SG
caibrar-te	caibrar+V.tu.AD.2.SG+INF
caibrar-te	caibrar+V.tu.AD.2.SG+INF+1+SG
caibrar-te	caibrar+V.tu.AD.2.SG+INF+3+SG
caibrar-te	caibrar+V.tu.AD.2.SG+SBJF+1+SG
caibrar-te	caibrar+V.tu.AD.2.SG+SBJF+3+SG
caibrar-te-ei	caibrar+V.tu.AD.2.SG+FUT+1+SG
caibrar-te-eis	caibrar+V.tu.AD.2.SG+FUT+2+PL
caibrar-te-emos	caibrar+V.tu.AD.2.SG+FUT+1+PL
caibrar-te-ia	caibrar+V.tu.AD.2.SG+COND+1+SG
caibrar-te-ia	caibrar+V.tu.AD.2.SG+COND+3+SG
caibrar-te-iam	caibrar+V.tu.AD.2.SG+COND+3+PL
caibrar-te-íamos	caibrar+V.tu.AD.2.SG+COND+1+PL
caibrar-te-ias	caibrar+V.tu.AD.2.SG+COND+2+SG
caibrar-te-íeis	caibrar+V.tu.AD.2.SG+COND+2+PL
caibrar-vos-á	caibrar+V.vós.AD.2.PL+FUT+3+SG
caibrar-vos-ão	caibrar+V.vós.AD.2.PL+FUT+3+PL
caibrar-vos-ás	caibrar+V.vós.AD.2.PL+FUT+2+SG
caibrar-vos	caibrar+V.vós.AD.2.PL+INF
caibrar-vos	caibrar+V.vós.AD.2.PL+INF+1+SG
caibrar-vos	caibrar+V.vós.AD.2.PL+INF+3+SG
caibrar-vos	caibrar+V.vós.AD.2.PL+SBJF+1+SG
caibrar-vos	caibrar+V.vós.AD.2.PL+SBJF+3+SG
caibrar-vos-ei	caibrar+V.vós.AD.2.PL+FUT+1+SG
caibrar-vos-eis	caibrar+V.vós.AD.2.PL+FUT+2+PL
caibrar-vos-emos	caibrar+V.vós.AD.2.PL+FUT+1+PL
caibrar-vos-ia	caibrar+V.vós.AD.2.PL+COND+1+SG
caibrar-vos-ia	caibrar+V.vós.AD.2.PL+COND+3+SG
caibrar-vos-iam	caibrar+V.vós.AD.2.PL+COND+3+PL
caibrar-vos-íamos	caibrar+V.vós.AD.2.PL+COND+1+PL
caibrar-vos-ias	caibrar+V.vós.AD.2.PL+COND+2+SG
caibrar-vos-íeis	caibrar+V.vós.AD.2.PL+COND+2+PL
caibra-se	caibrar+V.ele.REFL+PRS+3+SG
caibras-lhe	caibrar+V.ele.DAT.3.SG+PRS+2+SG
caibras-lhes	caibrar+V.ele.DAT.3.PL+PRS+2+SG
caibras-me	caibrar+V.eu.AD.1.SG+PRS+2+SG
caibraste-a	caibrar+V.ele.ACC.3.F.SG+PRF+2+SG
caibraste-as	caibrar+V.ele.ACC.3.F.PL+PRF+2+SG
caibras-te	caibrar+V.tu.AD.2.SG+PRS+2+SG
caibraste-la	caibrar+V.ele.ACC.3.F.SG+PRF+2+PL
caibraste-las	caibrar+V.ele.ACC.3.F.PL+PRF+2+PL
caibraste-lhe	caibrar+V.ele.DAT.3.SG+PRF+2+SG
caibraste-lhes	caibrar+V.ele.DAT.3.PL+PRF+2+SG
caibraste-lo	caibrar+V.ele.ACC.3.M.SG+PRF+2+PL
caibraste-los	caibrar+V.ele.ACC.3.M.PL+PRF+2+PL
caibraste-me	caibrar+V.eu.AD.1.SG+PRF+2+SG
caibraste-nos	caibrar+nós.AD.1.PL+PRF+2+PL
caibraste-nos	caibrar+nós.AD.1.PL+PRF+2+SG
caibraste-o	caibrar+V.ele.ACC.3.M.SG+PRF+2+SG
caibraste-os	caibrar+V.ele.ACC.3.M.PL+PRF+2+SG
caibrastes-lhe	caibrar+V.ele.DAT.3.SG+PRF+2+PL
caibrastes-lhes	caibrar+V.ele.DAT.3.PL+PRF+2+PL
caibrastes-me	caibrar+V.eu.AD.1.SG+PRF+2+PL
caibrastes-te	caibrar+V.tu.AD.2.SG+PRF+2+PL
caibrastes-vos	caibrar+V.vós.AD.2.PL+PRF+2+PL
caibraste-te	caibrar+V.tu.AD.2.SG+PRF+2+SG
caibraste-vos	caibrar+V.vós.AD.2.PL+PRF+2+SG
caibras-vos	caibrar+V.vós.AD.2.PL+PRS+2+SG
caibra-te	caibrar+V.tu.AD.2.SG+PRS+3+SG
caibrava-a	caibrar+V.ele.ACC.3.F.SG+IMPF+1+SG
caibrava-a	caibrar+V.ele.ACC.3.F.SG+IMPF+3+SG
caibrava-as	caibrar+V.ele.ACC.3.F.PL+IMPF+1+SG
caibrava-as	caibrar+V.ele.ACC.3.F.PL+IMPF+3+SG
caibrava-la	caibrar+V.ele.ACC.3.F.SG+IMPF+2+SG
caibrava-las	caibrar+V.ele.ACC.3.F.PL+IMPF+2+SG
caibrava-lhe	caibrar+V.ele.DAT.3.SG+IMPF+1+SG
caibrava-lhe	caibrar+V.ele.DAT.3.SG+IMPF+3+SG
caibrava-lhes	caibrar+V.ele.DAT.3.PL+IMPF+1+SG
caibrava-lhes	caibrar+V.ele.DAT.3.PL+IMPF+3+SG
caibrava-lo	caibrar+V.ele.ACC.3.M.SG+IMPF+2+SG
caibrava-los	caibrar+V.ele.ACC.3.M.PL+IMPF+2+SG
caibrava-me	caibrar+V.eu.AD.1.SG+IMPF+1+SG
caibrava-me	caibrar+V.eu.AD.1.SG+IMPF+3+SG
caibravam-lhe	caibrar+V.ele.DAT.3.SG+IMPF+3+PL
caibravam-lhes	caibrar+V.ele.DAT.3.PL+IMPF+3+PL
caibravam-me	caibrar+V.eu.AD.1.SG+IMPF+3+PL
caibravam-na	caibrar+V.ele.ACC.3.F.SG+IMPF+3+PL
caibravam-nas	caibrar+V.ele.ACC.3.F.PL+IMPF+3+PL
caibravam-no	caibrar+V.ele.ACC.3.M.SG+IMPF+3+PL
caibravam-nos	caibrar+V.ele.ACC.3.M.PL+IMPF+3+PL
caibravam-nos	caibrar+V.nós.AD.1.PL+IMPF+3+PL
caibrávamo-la	caibrar+V.ele.ACC.3.F.SG+IMPF+1+PL
caibrávamo-las	caibrar+V.ele.ACC.3.F.PL+IMPF+1+PL
caibrávamo-lo	caibrar+V.ele.ACC.3.M.SG+IMPF+1+PL
caibrávamo-los	caibrar+V.ele.ACC.3.M.PL+IMPF+1+PL
caibrávamo-nos	caibrar+nós.AD.1.PL+IMPF+1+PL
caibrávamos-lhe	caibrar+V.ele.DAT.3.SG+IMPF+1+PL
caibrávamos-lhes	caibrar+V.ele.DAT.3.PL+IMPF+1+PL
caibrávamos-me	caibrar+V.eu.AD.1.SG+IMPF+1+PL
caibrávamos-te	caibrar+V.tu.AD.2.SG+IMPF+1+PL
caibrávamos-vos	caibrar+V.vós.AD.2.PL+IMPF+1+PL
caibravam-se	caibrar+V.ele.REFL+IMPF+3+PL
caibravam-te	caibrar+V.tu.AD.2.SG+IMPF+3+PL
caibravam-vos	caibrar+V.vós.AD.2.PL+IMPF+3+PL
caibrava-nos	caibrar+nós.AD.1.PL+IMPF+1+SG
caibrava-nos	caibrar+nós.AD.1.PL+IMPF+2+SG
caibrava-nos	caibrar+nós.AD.1.PL+IMPF+3+SG
caibrava-o	caibrar+V.ele.ACC.3.M.SG+IMPF+1+SG
caibrava-o	caibrar+V.ele.ACC.3.M.SG+IMPF+3+SG
caibrava-os	caibrar+V.ele.ACC.3.M.PL+IMPF+1+SG
caibrava-os	caibrar+V.ele.ACC.3.M.PL+IMPF+3+SG
caibrava-se	caibrar+V.ele.REFL+IMPF+1+SG
caibrava-se	caibrar+V.ele.REFL+IMPF+3+SG
caibravas-lhe	caibrar+V.ele.DAT.3.SG+IMPF+2+SG
caibravas-lhes	caibrar+V.ele.DAT.3.PL+IMPF+2+SG
caibravas-me	caibrar+V.eu.AD.1.SG+IMPF+2+SG
caibravas-te	caibrar+V.tu.AD.2.SG+IMPF+2+SG
caibravas-vos	caibrar+V.vós.AD.2.PL+IMPF+2+SG
caibrava-te	caibrar+V.tu.AD.2.SG+IMPF+1+SG
caibrava-te	caibrar+V.tu.AD.2.SG+IMPF+3+SG
caibrava-vos	caibrar+V.vós.AD.2.PL+IMPF+1+SG
caibrava-vos	caibrar+V.vós.AD.2.PL+IMPF+3+SG
caibrávei-la	caibrar+V.ele.ACC.3.F.SG+IMPF+2+PL
caibrávei-las	caibrar+V.ele.ACC.3.F.PL+IMPF+2+PL
caibrávei-lo	caibrar+V.ele.ACC.3.M.SG+IMPF+2+PL
caibrávei-los	caibrar+V.ele.ACC.3.M.PL+IMPF+2+PL
caibrávei-nos	caibrar+nós.AD.1.PL+IMPF+2+PL
caibráveis-lhe	caibrar+V.ele.DAT.3.SG+IMPF+2+PL
caibráveis-lhes	caibrar+V.ele.DAT.3.PL+IMPF+2+PL
caibráveis-me	caibrar+V.eu.AD.1.SG+IMPF+2+PL
caibráveis-te	caibrar+V.tu.AD.2.SG+IMPF+2+PL
caibráveis-vos	caibrar+V.vós.AD.2.PL+IMPF+2+PL
caibra-vos	caibrar+V.vós.AD.2.PL+PRS+3+SG
caibre-a	caibrar+V.ele.ACC.3.F.SG+IMP+3+SG
caibre-as	caibrar+V.ele.ACC.3.F.PL+IMP+3+SG
caibrei-a	caibrar+V.ele.ACC.3.F.SG+PRF+1+SG
caibrei-as	caibrar+V.ele.ACC.3.F.PL+PRF+1+SG
caibrei-lhe	caibrar+V.ele.DAT.3.SG+PRF+1+SG
caibrei-lhes	caibrar+V.ele.DAT.3.PL+PRF+1+SG
caibrei-me	caibrar+V.eu.AD.1.SG+PRF+1+SG
caibrei-nos	caibrar+nós.AD.1.PL+PRF+1+SG
caibrei-o	caibrar+V.ele.ACC.3.M.SG+PRF+1+SG
caibrei-os	caibrar+V.ele.ACC.3.M.PL+PRF+1+SG
caibrei-te	caibrar+V.tu.AD.2.SG+PRF+1+SG
caibrei-vos	caibrar+V.vós.AD.2.PL+PRF+1+SG
caibre-lhe	caibrar+V.ele.DAT.3.SG+IMP+3+SG
caibre-lhes	caibrar+V.ele.DAT.3.PL+IMP+3+SG
caibre-me	caibrar+V.eu.AD.1.SG+IMP+3+SG
caibrem-lhe	caibrar+V.ele.DAT.3.SG+IMP+3+PL
caibrem-lhes	caibrar+V.ele.DAT.3.PL+IMP+3+PL
caibrem-me	caibrar+V.eu.AD.1.SG+IMP+3+PL
caibrem-na	caibrar+V.ele.ACC.3.F.SG+IMP+3+PL
caibrem-nas	caibrar+V.ele.ACC.3.F.PL+IMP+3+PL
caibrem-no	caibrar+V.ele.ACC.3.M.SG+IMP+3+PL
caibrem-nos	caibrar+V.ele.ACC.3.M.PL+IMP+3+PL
caibrem-nos	caibrar+V.nós.AD.1.PL+IMP+3+PL
caibremo-la	caibrar+V.ele.ACC.3.F.SG+IMP+1+PL
caibremo-las	caibrar+V.ele.ACC.3.F.PL+IMP+1+PL
caibremo-lo	caibrar+V.ele.ACC.3.M.SG+IMP+1+PL
caibremo-los	caibrar+V.ele.ACC.3.M.PL+IMP+1+PL
caibremo-nos	caibrar+nós.AD.1.PL+IMP+1+PL
caibremos-lhe	caibrar+V.ele.DAT.3.SG+IMP+1+PL
caibremos-lhes	caibrar+V.ele.DAT.3.PL+IMP+1+PL
caibremos-me	caibrar+V.eu.AD.1.SG+IMP+1+PL
caibremos-te	caibrar+V.tu.AD.2.SG+IMP+1+PL
caibremos-vos	caibrar+V.vós.AD.2.PL+IMP+1+PL
caibrem-se	caibrar+V.ele.REFL+IMP+3+PL
caibrem-te	caibrar+V.tu.AD.2.SG+IMP+3+PL
caibrem-vos	caibrar+V.vós.AD.2.PL+IMP+3+PL
caibre-nos	caibrar+nós.AD.1.PL+IMP+3+SG
caibre-o	caibrar+V.ele.ACC.3.M.SG+IMP+3+SG
caibre-os	caibrar+V.ele.ACC.3.M.PL+IMP+3+SG
caibre-se	caibrar+V.ele.REFL+IMP+3+SG
caibre-te	caibrar+V.tu.AD.2.SG+IMP+3+SG
caibre-vos	caibrar+V.vós.AD.2.PL+IMP+3+SG
caibro-a	caibrar+V.ele.ACC.3.F.SG+PRS+1+SG
caibro-as	caibrar+V.ele.ACC.3.F.PL+PRS+1+SG
caibro-lhe	caibrar+V.ele.DAT.3.SG+PRS+1+SG
caibro-lhes	caibrar+V.ele.DAT.3.PL+PRS+1+SG
caibro-me	caibrar+V.eu.AD.1.SG+PRS+1+SG
caibro-nos	caibrar+nós.AD.1.PL+PRS+1+SG
caibro-o	caibrar+V.ele.ACC.3.M.SG+PRS+1+SG
caibro-os	caibrar+V.ele.ACC.3.M.PL+PRS+1+SG
caibro-te	caibrar+V.tu.AD.2.SG+PRS+1+SG
caibrou-a	caibrar+V.ele.ACC.3.F.SG+PRF+3+SG
caibrou-as	caibrar+V.ele.ACC.3.F.PL+PRF+3+SG
caibrou-lhe	caibrar+V.ele.DAT.3.SG+PRF+3+SG
caibrou-lhes	caibrar+V.ele.DAT.3.PL+PRF+3+SG
caibrou-me	caibrar+V.eu.AD.1.SG+PRF+3+SG
caibrou-nos	caibrar+nós.AD.1.PL+PRF+3+SG
caibrou-o	caibrar+V.ele.ACC.3.M.SG+PRF+3+SG
caibrou-os	caibrar+V.ele.ACC.3.M.PL+PRF+3+SG
caibrou-se	caibrar+V.ele.REFL+PRF+3+SG
caibrou-te	caibrar+V.tu.AD.2.SG+PRF+3+SG
caibrou-vos	caibrar+V.vós.AD.2.PL+PRF+3+SG
caibro-vos	caibrar+V.vós.AD.2.PL+PRS+1+SG
caie-a	caiar+V.ele.ACC.3.F.SG+IMP+3+SG
caie-as	caiar+V.ele.ACC.3.F.PL+IMP+3+SG
caiei-a	caiar+V.ele.ACC.3.F.SG+PRF+1+SG
caiei-as	caiar+V.ele.ACC.3.F.PL+PRF+1+SG
caíei-la	cair+V.ele.ACC.3.F.SG+IMPF+2+PL
caíei-las	cair+V.ele.ACC.3.F.PL+IMPF+2+PL
caiei-lhe	caiar+V.ele.DAT.3.SG+PRF+1+SG
caiei-lhes	caiar+V.ele.DAT.3.PL+PRF+1+SG
caíei-lo	cair+V.ele.ACC.3.M.SG+IMPF+2+PL
caíei-los	cair+V.ele.ACC.3.M.PL+IMPF+2+PL
caiei-me	caiar+V.eu.AD.1.SG+PRF+1+SG
caiei-nos	caiar+nós.AD.1.PL+PRF+1+SG
caíei-nos	cair+nós.AD.1.PL+IMPF+2+PL
caiei-o	caiar+V.ele.ACC.3.M.SG+PRF+1+SG
caiei-os	caiar+V.ele.ACC.3.M.PL+PRF+1+SG
caíeis-lhe	cair+V.ele.DAT.3.SG+IMPF+2+PL
caíeis-lhes	cair+V.ele.DAT.3.PL+IMPF+2+PL
caíeis-me	cair+V.eu.AD.1.SG+IMPF+2+PL
caíeis-te	cair+V.tu.AD.2.SG+IMPF+2+PL
caíeis-vos	cair+V.vós.AD.2.PL+IMPF+2+PL
caiei-te	caiar+V.tu.AD.2.SG+PRF+1+SG
caiei-vos	caiar+V.vós.AD.2.PL+PRF+1+SG
caie-lhe	caiar+V.ele.DAT.3.SG+IMP+3+SG
caie-lhes	caiar+V.ele.DAT.3.PL+IMP+3+SG
caie-me	caiar+V.eu.AD.1.SG+IMP+3+SG
caiem-lhe	caiar+V.ele.DAT.3.SG+IMP+3+PL
caiem-lhes	caiar+V.ele.DAT.3.PL+IMP+3+PL
caiem-me	caiar+V.eu.AD.1.SG+IMP+3+PL
caiem-na	caiar+V.ele.ACC.3.F.SG+IMP+3+PL
caiem-nas	caiar+V.ele.ACC.3.F.PL+IMP+3+PL
caiem-no	caiar+V.ele.ACC.3.M.SG+IMP+3+PL
caiem-nos	caiar+V.ele.ACC.3.M.PL+IMP+3+PL
caiem-nos	caiar+V.nós.AD.1.PL+IMP+3+PL
caiemo-la	caiar+V.ele.ACC.3.F.SG+IMP+1+PL
caiemo-las	caiar+V.ele.ACC.3.F.PL+IMP+1+PL
caiemo-lo	caiar+V.ele.ACC.3.M.SG+IMP+1+PL
caiemo-los	caiar+V.ele.ACC.3.M.PL+IMP+1+PL
caiemo-nos	caiar+nós.AD.1.PL+IMP+1+PL
caiemos-lhe	caiar+V.ele.DAT.3.SG+IMP+1+PL
caiemos-lhes	caiar+V.ele.DAT.3.PL+IMP+1+PL
caiemos-me	caiar+V.eu.AD.1.SG+IMP+1+PL
caiemos-te	caiar+V.tu.AD.2.SG+IMP+1+PL
caiemos-vos	caiar+V.vós.AD.2.PL+IMP+1+PL
caiem-se	caiar+V.ele.REFL+IMP+3+PL
caiem-te	caiar+V.tu.AD.2.SG+IMP+3+PL
caiem-vos	caiar+V.vós.AD.2.PL+IMP+3+PL
caie-nos	caiar+nós.AD.1.PL+IMP+3+SG
caie-o	caiar+V.ele.ACC.3.M.SG+IMP+3+SG
caie-os	caiar+V.ele.ACC.3.M.PL+IMP+3+SG
caie-se	caiar+V.ele.REFL+IMP+3+SG
caie-te	caiar+V.tu.AD.2.SG+IMP+3+SG
caie-vos	caiar+V.vós.AD.2.PL+IMP+3+SG
cai-la-á	cair+V.ele.ACC.3.F.SG+FUT+3+SG
cai-la-ão	cair+V.ele.ACC.3.F.SG+FUT+3+PL
cai-la-ás	cair+V.ele.ACC.3.F.SG+FUT+2+SG
cai-la	cair+V.ele.ACC.3.F.SG+INF+1+SG
cai-la	cair+V.ele.ACC.3.F.SG+INF+3+SG
caí-la	cair+V.ele.ACC.3.F.SG+PRS+2+PL
cai-la	cair+V.ele.ACC.3.F.SG+PRS+2+SG
cai-la	cair+V.ele.ACC.3.F.SG+SBJF+1+SG
cai-la	cair+V.ele.ACC.3.F.SG+SBJF+3+SG
cai-la-ei	cair+V.ele.ACC.3.F.SG+FUT+1+SG
cai-la-eis	cair+V.ele.ACC.3.F.SG+FUT+2+PL
cai-la-emos	cair+V.ele.ACC.3.F.SG+FUT+1+PL
cai-la-ia	cair+V.ele.ACC.3.F.SG+COND+1+SG
cai-la-ia	cair+V.ele.ACC.3.F.SG+COND+3+SG
cai-la-iam	cair+V.ele.ACC.3.F.SG+COND+3+PL
cai-la-íamos	cair+V.ele.ACC.3.F.SG+COND+1+PL
cai-la-ias	cair+V.ele.ACC.3.F.SG+COND+2+SG
cai-la-íeis	cair+V.ele.ACC.3.F.SG+COND+2+PL
cai-las-á	cair+V.ele.ACC.3.F.PL+FUT+3+SG
cai-las-ão	cair+V.ele.ACC.3.F.PL+FUT+3+PL
cai-las-ás	cair+V.ele.ACC.3.F.PL+FUT+2+SG
cai-las	cair+V.ele.ACC.3.F.PL+INF+1+SG
cai-las	cair+V.ele.ACC.3.F.PL+INF+3+SG
caí-las	cair+V.ele.ACC.3.F.PL+PRS+2+PL
cai-las	cair+V.ele.ACC.3.F.PL+PRS+2+SG
cai-las	cair+V.ele.ACC.3.F.PL+SBJF+1+SG
cai-las	cair+V.ele.ACC.3.F.PL+SBJF+3+SG
cai-las-ei	cair+V.ele.ACC.3.F.PL+FUT+1+SG
cai-las-eis	cair+V.ele.ACC.3.F.PL+FUT+2+PL
cai-las-emos	cair+V.ele.ACC.3.F.PL+FUT+1+PL
cai-las-ia	cair+V.ele.ACC.3.F.PL+COND+1+SG
cai-las-ia	cair+V.ele.ACC.3.F.PL+COND+3+SG
cai-las-iam	cair+V.ele.ACC.3.F.PL+COND+3+PL
cai-las-íamos	cair+V.ele.ACC.3.F.PL+COND+1+PL
cai-las-ias	cair+V.ele.ACC.3.F.PL+COND+2+SG
cai-las-íeis	cair+V.ele.ACC.3.F.PL+COND+2+PL
caí-lhe	cair+V.ele.DAT.3.SG+PRF+1+SG
cai-lhe	cair+V.ele.DAT.3.SG+PRS+3+SG
caí-lhes	cair+V.ele.DAT.3.PL+PRF+1+SG
cai-lhes	cair+V.ele.DAT.3.PL+PRS+3+SG
cai-lo-á	cair+V.ele.ACC.3.M.SG+FUT+3+SG
cai-lo-ão	cair+V.ele.ACC.3.M.SG+FUT+3+PL
cai-lo-ás	cair+V.ele.ACC.3.M.SG+FUT+2+SG
cai-lo	cair+V.ele.ACC.3.M.SG+INF+1+SG
cai-lo	cair+V.ele.ACC.3.M.SG+INF+3+SG
caí-lo	cair+V.ele.ACC.3.M.SG+PRS+2+PL
cai-lo	cair+V.ele.ACC.3.M.SG+PRS+2+SG
cai-lo	cair+V.ele.ACC.3.M.SG+SBJF+1+SG
cai-lo	cair+V.ele.ACC.3.M.SG+SBJF+3+SG
cai-lo-ei	cair+V.ele.ACC.3.M.SG+FUT+1+SG
cai-lo-eis	cair+V.ele.ACC.3.M.SG+FUT+2+PL
cai-lo-emos	cair+V.ele.ACC.3.M.SG+FUT+1+PL
cai-lo-ia	cair+V.ele.ACC.3.M.SG+COND+1+SG
cai-lo-ia	cair+V.ele.ACC.3.M.SG+COND+3+SG
cai-lo-iam	cair+V.ele.ACC.3.M.SG+COND+3+PL
cai-lo-íamos	cair+V.ele.ACC.3.M.SG+COND+1+PL
cai-lo-ias	cair+V.ele.ACC.3.M.SG+COND+2+SG
cai-lo-íeis	cair+V.ele.ACC.3.M.SG+COND+2+PL
cai-los-á	cair+V.ele.ACC.3.M.PL+FUT+3+SG
cai-los-ão	cair+V.ele.ACC.3.M.PL+FUT+3+PL
cai-los-ás	cair+V.ele.ACC.3.M.PL+FUT+2+SG
cai-los	cair+V.ele.ACC.3.M.PL+INF+1+SG
cai-los	cair+V.ele.ACC.3.M.PL+INF+3+SG
caí-los	cair+V.ele.ACC.3.M.PL+PRS+2+PL
cai-los	cair+V.ele.ACC.3.M.PL+PRS+2+SG
cai-los	cair+V.ele.ACC.3.M.PL+SBJF+1+SG
cai-los	cair+V.ele.ACC.3.M.PL+SBJF+3+SG
cai-los-ei	cair+V.ele.ACC.3.M.PL+FUT+1+SG
cai-los-eis	cair+V.ele.ACC.3.M.PL+FUT+2+PL
cai-los-emos	cair+V.ele.ACC.3.M.PL+FUT+1+PL
cai-los-ia	cair+V.ele.ACC.3.M.PL+COND+1+SG
cai-los-ia	cair+V.ele.ACC.3.M.PL+COND+3+SG
cai-los-iam	cair+V.ele.ACC.3.M.PL+COND+3+PL
cai-los-íamos	cair+V.ele.ACC.3.M.PL+COND+1+PL
cai-los-ias	cair+V.ele.ACC.3.M.PL+COND+2+SG
cai-los-íeis	cair+V.ele.ACC.3.M.PL+COND+2+PL
caí-me	cair+V.eu.AD.1.SG+PRF+1+SG
cai-me	cair+V.eu.AD.1.SG+PRS+3+SG
caímo-la	cair+V.ele.ACC.3.F.SG+PRF+1+PL
caímo-la	cair+V.ele.ACC.3.F.SG+PRS+1+PL
caímo-las	cair+V.ele.ACC.3.F.PL+PRF+1+PL
caímo-las	cair+V.ele.ACC.3.F.PL+PRS+1+PL
caímo-lo	cair+V.ele.ACC.3.M.SG+PRF+1+PL
caímo-lo	cair+V.ele.ACC.3.M.SG+PRS+1+PL
caímo-los	cair+V.ele.ACC.3.M.PL+PRF+1+PL
caímo-los	cair+V.ele.ACC.3.M.PL+PRS+1+PL
caímo-nos	cair+nós.AD.1.PL+PRF+1+PL
caímo-nos	cair+nós.AD.1.PL+PRS+1+PL
caímos-lhe	cair+V.ele.DAT.3.SG+PRF+1+PL
caímos-lhe	cair+V.ele.DAT.3.SG+PRS+1+PL
caímos-lhes	cair+V.ele.DAT.3.PL+PRF+1+PL
caímos-lhes	cair+V.ele.DAT.3.PL+PRS+1+PL
caímos-me	cair+V.eu.AD.1.SG+PRF+1+PL
caímos-me	cair+V.eu.AD.1.SG+PRS+1+PL
caímos-te	cair+V.tu.AD.2.SG+PRF+1+PL
caímos-te	cair+V.tu.AD.2.SG+PRS+1+PL
caímos-vos	cair+V.vós.AD.2.PL+PRF+1+PL
caímos-vos	cair+V.vós.AD.2.PL+PRS+1+PL
caindo-a	cair+V.ele.ACC.3.F.SG+GRD
caindo-as	cair+V.ele.ACC.3.F.PL+GRD
caindo-lhe	cair+V.ele.DAT.3.SG+GRD
caindo-lhes	cair+V.ele.DAT.3.PL+GRD
caindo-me	cair+V.eu.AD.1.SG+GRD
caindo-nos	cair+nós.AD.1.PL+GRD
caindo-o	cair+V.ele.ACC.3.M.SG+GRD
caindo-os	cair+V.ele.ACC.3.M.PL+GRD
caindo-se	cair+V.ele.REFL+GRD
caindo-te	cair+V.tu.AD.2.SG+GRD
caindo-vos	cair+V.vós.AD.2.PL+GRD
cainha-a	cainhar+V.ele.ACC.3.F.SG+PRS+3+SG
cainha-as	cainhar+V.ele.ACC.3.F.PL+PRS+3+SG
cainhai-la	cainhar+V.ele.ACC.3.F.SG+PRS+2+PL
cainhai-las	cainhar+V.ele.ACC.3.F.PL+PRS+2+PL
cainhai-lo	cainhar+V.ele.ACC.3.M.SG+PRS+2+PL
cainhai-los	cainhar+V.ele.ACC.3.M.PL+PRS+2+PL
cainhai-nos	cainhar+nós.AD.1.PL+PRS+2+PL
cainhais-lhe	cainhar+V.ele.DAT.3.SG+PRS+2+PL
cainhais-lhes	cainhar+V.ele.DAT.3.PL+PRS+2+PL
cainhais-me	cainhar+V.eu.AD.1.SG+PRS+2+PL
cainhais-te	cainhar+V.tu.AD.2.SG+PRS+2+PL
cainhais-vos	cainhar+V.vós.AD.2.PL+PRS+2+PL
cainhá-la-á	cainhar+V.ele.ACC.3.F.SG+FUT+3+SG
cainhá-la-ão	cainhar+V.ele.ACC.3.F.SG+FUT+3+PL
cainhá-la-ás	cainhar+V.ele.ACC.3.F.SG+FUT+2+SG
cainhá-la	cainhar+V.ele.ACC.3.F.SG+INF+1+SG
cainhá-la	cainhar+V.ele.ACC.3.F.SG+INF+3+SG
cainha-la	cainhar+V.ele.ACC.3.F.SG+PRS+2+SG
cainhá-la	cainhar+V.ele.ACC.3.F.SG+SBJF+1+SG
cainhá-la	cainhar+V.ele.ACC.3.F.SG+SBJF+3+SG
cainhá-la-ei	cainhar+V.ele.ACC.3.F.SG+FUT+1+SG
cainhá-la-eis	cainhar+V.ele.ACC.3.F.SG+FUT+2+PL
cainhá-la-emos	cainhar+V.ele.ACC.3.F.SG+FUT+1+PL
cainhá-la-ia	cainhar+V.ele.ACC.3.F.SG+COND+1+SG
cainhá-la-ia	cainhar+V.ele.ACC.3.F.SG+COND+3+SG
cainhá-la-iam	cainhar+V.ele.ACC.3.F.SG+COND+3+PL
cainhá-la-íamos	cainhar+V.ele.ACC.3.F.SG+COND+1+PL
cainhá-la-ias	cainhar+V.ele.ACC.3.F.SG+COND+2+SG
cainhá-la-íeis	cainhar+V.ele.ACC.3.F.SG+COND+2+PL
cainhá-las-á	cainhar+V.ele.ACC.3.F.PL+FUT+3+SG
cainhá-las-ão	cainhar+V.ele.ACC.3.F.PL+FUT+3+PL
cainhá-las-ás	cainhar+V.ele.ACC.3.F.PL+FUT+2+SG
cainhá-las	cainhar+V.ele.ACC.3.F.PL+INF+1+SG
cainhá-las	cainhar+V.ele.ACC.3.F.PL+INF+3+SG
cainha-las	cainhar+V.ele.ACC.3.F.PL+PRS+2+SG
cainhá-las	cainhar+V.ele.ACC.3.F.PL+SBJF+1+SG
cainhá-las	cainhar+V.ele.ACC.3.F.PL+SBJF+3+SG
cainhá-las-ei	cainhar+V.ele.ACC.3.F.PL+FUT+1+SG
cainhá-las-eis	cainhar+V.ele.ACC.3.F.PL+FUT+2+PL
cainhá-las-emos	cainhar+V.ele.ACC.3.F.PL+FUT+1+PL
cainhá-las-ia	cainhar+V.ele.ACC.3.F.PL+COND+1+SG
cainhá-las-ia	cainhar+V.ele.ACC.3.F.PL+COND+3+SG
cainhá-las-iam	cainhar+V.ele.ACC.3.F.PL+COND+3+PL
cainhá-las-íamos	cainhar+V.ele.ACC.3.F.PL+COND+1+PL
cainhá-las-ias	cainhar+V.ele.ACC.3.F.PL+COND+2+SG
cainhá-las-íeis	cainhar+V.ele.ACC.3.F.PL+COND+2+PL
cainha-lhe	cainhar+V.ele.DAT.3.SG+PRS+3+SG
cainha-lhes	cainhar+V.ele.DAT.3.PL+PRS+3+SG
cainhá-lo-á	cainhar+V.ele.ACC.3.M.SG+FUT+3+SG
cainhá-lo-ão	cainhar+V.ele.ACC.3.M.SG+FUT+3+PL
cainhá-lo-ás	cainhar+V.ele.ACC.3.M.SG+FUT+2+SG
cainhá-lo	cainhar+V.ele.ACC.3.M.SG+INF+1+SG
cainhá-lo	cainhar+V.ele.ACC.3.M.SG+INF+3+SG
cainha-lo	cainhar+V.ele.ACC.3.M.SG+PRS+2+SG
cainhá-lo	cainhar+V.ele.ACC.3.M.SG+SBJF+1+SG
cainhá-lo	cainhar+V.ele.ACC.3.M.SG+SBJF+3+SG
cainhá-lo-ei	cainhar+V.ele.ACC.3.M.SG+FUT+1+SG
cainhá-lo-eis	cainhar+V.ele.ACC.3.M.SG+FUT+2+PL
cainhá-lo-emos	cainhar+V.ele.ACC.3.M.SG+FUT+1+PL
cainhá-lo-ia	cainhar+V.ele.ACC.3.M.SG+COND+1+SG
cainhá-lo-ia	cainhar+V.ele.ACC.3.M.SG+COND+3+SG
cainhá-lo-iam	cainhar+V.ele.ACC.3.M.SG+COND+3+PL
cainhá-lo-íamos	cainhar+V.ele.ACC.3.M.SG+COND+1+PL
cainhá-lo-ias	cainhar+V.ele.ACC.3.M.SG+COND+2+SG
cainhá-lo-íeis	cainhar+V.ele.ACC.3.M.SG+COND+2+PL
cainhá-los-á	cainhar+V.ele.ACC.3.M.PL+FUT+3+SG
cainhá-los-ão	cainhar+V.ele.ACC.3.M.PL+FUT+3+PL
cainhá-los-ás	cainhar+V.ele.ACC.3.M.PL+FUT+2+SG
cainhá-los	cainhar+V.ele.ACC.3.M.PL+INF+1+SG
cainhá-los	cainhar+V.ele.ACC.3.M.PL+INF+3+SG
cainha-los	cainhar+V.ele.ACC.3.M.PL+PRS+2+SG
cainhá-los	cainhar+V.ele.ACC.3.M.PL+SBJF+1+SG
cainhá-los	cainhar+V.ele.ACC.3.M.PL+SBJF+3+SG
cainhá-los-ei	cainhar+V.ele.ACC.3.M.PL+FUT+1+SG
cainhá-los-eis	cainhar+V.ele.ACC.3.M.PL+FUT+2+PL
cainhá-los-emos	cainhar+V.ele.ACC.3.M.PL+FUT+1+PL
cainhá-los-ia	cainhar+V.ele.ACC.3.M.PL+COND+1+SG
cainhá-los-ia	cainhar+V.ele.ACC.3.M.PL+COND+3+SG
cainhá-los-iam	cainhar+V.ele.ACC.3.M.PL+COND+3+PL
cainhá-los-íamos	cainhar+V.ele.ACC.3.M.PL+COND+1+PL
cainhá-los-ias	cainhar+V.ele.ACC.3.M.PL+COND+2+SG
cainhá-los-íeis	cainhar+V.ele.ACC.3.M.PL+COND+2+PL
cainha-me	cainhar+V.eu.AD.1.SG+PRS+3+SG
cainham-lhe	cainhar+V.ele.DAT.3.SG+PRS+3+PL
cainham-lhes	cainhar+V.ele.DAT.3.PL+PRS+3+PL
cainham-me	cainhar+V.eu.AD.1.SG+PRS+3+PL
cainham-na	cainhar+V.ele.ACC.3.F.SG+PRS+3+PL
cainham-nas	cainhar+V.ele.ACC.3.F.PL+PRS+3+PL
cainham-no	cainhar+V.ele.ACC.3.M.SG+PRS+3+PL
cainham-nos	cainhar+V.ele.ACC.3.M.PL+PRS+3+PL
cainham-nos	cainhar+V.nós.AD.1.PL+PRS+3+PL
cainhamo-la	cainhar+V.ele.ACC.3.F.SG+PRF+1+PL
cainhamo-la	cainhar+V.ele.ACC.3.F.SG+PRS+1+PL
cainhamo-las	cainhar+V.ele.ACC.3.F.PL+PRF+1+PL
cainhamo-las	cainhar+V.ele.ACC.3.F.PL+PRS+1+PL
cainhamo-lo	cainhar+V.ele.ACC.3.M.SG+PRF+1+PL
cainhamo-lo	cainhar+V.ele.ACC.3.M.SG+PRS+1+PL
cainhamo-los	cainhar+V.ele.ACC.3.M.PL+PRF+1+PL
cainhamo-los	cainhar+V.ele.ACC.3.M.PL+PRS+1+PL
cainhamo-nos	cainhar+nós.AD.1.PL+PRF+1+PL
cainhamo-nos	cainhar+nós.AD.1.PL+PRS+1+PL
cainhamos-lhe	cainhar+V.ele.DAT.3.SG+PRF+1+PL
cainhamos-lhe	cainhar+V.ele.DAT.3.SG+PRS+1+PL
cainhamos-lhes	cainhar+V.ele.DAT.3.PL+PRF+1+PL
cainhamos-lhes	cainhar+V.ele.DAT.3.PL+PRS+1+PL
cainhamos-me	cainhar+V.eu.AD.1.SG+PRF+1+PL
cainhamos-me	cainhar+V.eu.AD.1.SG+PRS+1+PL
cainhamos-te	cainhar+V.tu.AD.2.SG+PRF+1+PL
cainhamos-te	cainhar+V.tu.AD.2.SG+PRS+1+PL
cainhamos-vos	cainhar+V.vós.AD.2.PL+PRF+1+PL
cainhamos-vos	cainhar+V.vós.AD.2.PL+PRS+1+PL
cainham-se	cainhar+V.ele.REFL+PRS+3+PL
cainham-te	cainhar+V.tu.AD.2.SG+PRS+3+PL
cainham-vos	cainhar+V.vós.AD.2.PL+PRS+3+PL
cainhando-a	cainhar+V.ele.ACC.3.F.SG+GRD
cainhando-as	cainhar+V.ele.ACC.3.F.PL+GRD
cainhando-lhe	cainhar+V.ele.DAT.3.SG+GRD
cainhando-lhes	cainhar+V.ele.DAT.3.PL+GRD
cainhando-me	cainhar+V.eu.AD.1.SG+GRD
cainhando-nos	cainhar+nós.AD.1.PL+GRD
cainhando-o	cainhar+V.ele.ACC.3.M.SG+GRD
cainhando-os	cainhar+V.ele.ACC.3.M.PL+GRD
cainhando-se	cainhar+V.ele.REFL+GRD
cainhando-te	cainhar+V.tu.AD.2.SG+GRD
cainhando-vos	cainhar+V.vós.AD.2.PL+GRD
cainha-nos	cainhar+nós.AD.1.PL+PRS+2+SG
cainha-nos	cainhar+nós.AD.1.PL+PRS+3+SG
cainha-o	cainhar+V.ele.ACC.3.M.SG+PRS+3+SG
cainha-os	cainhar+V.ele.ACC.3.M.PL+PRS+3+SG
cainhara-a	cainhar+V.ele.ACC.3.F.SG+PQP+1+SG
cainhara-a	cainhar+V.ele.ACC.3.F.SG+PQP+3+SG
cainhara-as	cainhar+V.ele.ACC.3.F.PL+PQP+1+SG
cainhara-as	cainhar+V.ele.ACC.3.F.PL+PQP+3+SG
cainhara-la	cainhar+V.ele.ACC.3.F.SG+PQP+2+SG
cainhara-las	cainhar+V.ele.ACC.3.F.PL+PQP+2+SG
cainhara-lhe	cainhar+V.ele.DAT.3.SG+PQP+1+SG
cainhara-lhe	cainhar+V.ele.DAT.3.SG+PQP+3+SG
cainhara-lhes	cainhar+V.ele.DAT.3.PL+PQP+1+SG
cainhara-lhes	cainhar+V.ele.DAT.3.PL+PQP+3+SG
cainhara-lo	cainhar+V.ele.ACC.3.M.SG+PQP+2+SG
cainhara-los	cainhar+V.ele.ACC.3.M.PL+PQP+2+SG
cainhara-me	cainhar+V.eu.AD.1.SG+PQP+1+SG
cainhara-me	cainhar+V.eu.AD.1.SG+PQP+3+SG
cainharam-lhe	cainhar+V.ele.DAT.3.SG+PQP+3+PL
cainharam-lhe	cainhar+V.ele.DAT.3.SG+PRF+3+PL
cainharam-lhes	cainhar+V.ele.DAT.3.PL+PQP+3+PL
cainharam-lhes	cainhar+V.ele.DAT.3.PL+PRF+3+PL
cainharam-me	cainhar+V.eu.AD.1.SG+PQP+3+PL
cainharam-me	cainhar+V.eu.AD.1.SG+PRF+3+PL
cainharam-na	cainhar+V.ele.ACC.3.F.SG+PQP+3+PL
cainharam-na	cainhar+V.ele.ACC.3.F.SG+PRF+3+PL
cainharam-nas	cainhar+V.ele.ACC.3.F.PL+PQP+3+PL
cainharam-nas	cainhar+V.ele.ACC.3.F.PL+PRF+3+PL
cainharam-no	cainhar+V.ele.ACC.3.M.SG+PQP+3+PL
cainharam-no	cainhar+V.ele.ACC.3.M.SG+PRF+3+PL
cainharam-nos	cainhar+V.ele.ACC.3.M.PL+PQP+3+PL
cainharam-nos	cainhar+V.ele.ACC.3.M.PL+PRF+3+PL
cainharam-nos	cainhar+V.nós.AD.1.PL+PQP+3+PL
cainharam-nos	cainhar+V.nós.AD.1.PL+PRF+3+PL
cainháramo-la	cainhar+V.ele.ACC.3.F.SG+PQP+1+PL
cainháramo-las	cainhar+V.ele.ACC.3.F.PL+PQP+1+PL
cainháramo-lo	cainhar+V.ele.ACC.3.M.SG+PQP+1+PL
cainháramo-los	cainhar+V.ele.ACC.3.M.PL+PQP+1+PL
cainháramo-nos	cainhar+nós.AD.1.PL+PQP+1+PL
cainháramos-lhe	cainhar+V.ele.DAT.3.SG+PQP+1+PL
cainháramos-lhes	cainhar+V.ele.DAT.3.PL+PQP+1+PL
cainháramos-me	cainhar+V.eu.AD.1.SG+PQP+1+PL
cainháramos-te	cainhar+V.tu.AD.2.SG+PQP+1+PL
cainháramos-vos	cainhar+V.vós.AD.2.PL+PQP+1+PL
cainharam-se	cainhar+V.ele.REFL+PQP+3+PL
cainharam-se	cainhar+V.ele.REFL+PRF+3+PL
cainharam-te	cainhar+V.tu.AD.2.SG+PQP+3+PL
cainharam-te	cainhar+V.tu.AD.2.SG+PRF+3+PL
cainharam-vos	cainhar+V.vós.AD.2.PL+PQP+3+PL
cainharam-vos	cainhar+V.vós.AD.2.PL+PRF+3+PL
cainhara-nos	cainhar+nós.AD.1.PL+PQP+1+SG
cainhara-nos	cainhar+nós.AD.1.PL+PQP+2+SG
cainhara-nos	cainhar+nós.AD.1.PL+PQP+3+SG
cainhara-o	cainhar+V.ele.ACC.3.M.SG+PQP+1+SG
cainhara-o	cainhar+V.ele.ACC.3.M.SG+PQP+3+SG
cainhara-os	cainhar+V.ele.ACC.3.M.PL+PQP+1+SG
cainhara-os	cainhar+V.ele.ACC.3.M.PL+PQP+3+SG
cainhara-se	cainhar+V.ele.REFL+PQP+1+SG
cainhara-se	cainhar+V.ele.REFL+PQP+3+SG
cainharas-lhe	cainhar+V.ele.DAT.3.SG+PQP+2+SG
cainharas-lhes	cainhar+V.ele.DAT.3.PL+PQP+2+SG
cainharas-me	cainhar+V.eu.AD.1.SG+PQP+2+SG
cainharas-te	cainhar+V.tu.AD.2.SG+PQP+2+SG
cainharas-vos	cainhar+V.vós.AD.2.PL+PQP+2+SG
cainhara-te	cainhar+V.tu.AD.2.SG+PQP+1+SG
cainhara-te	cainhar+V.tu.AD.2.SG+PQP+3+SG
cainhara-vos	cainhar+V.vós.AD.2.PL+PQP+1+SG
cainhara-vos	cainhar+V.vós.AD.2.PL+PQP+3+SG
cainharde-la	cainhar+V.ele.ACC.3.F.SG+INF+2+PL
cainharde-la	cainhar+V.ele.ACC.3.F.SG+SBJF+2+PL
cainharde-las	cainhar+V.ele.ACC.3.F.PL+INF+2+PL
cainharde-las	cainhar+V.ele.ACC.3.F.PL+SBJF+2+PL
cainharde-lo	cainhar+V.ele.ACC.3.M.SG+INF+2+PL
cainharde-lo	cainhar+V.ele.ACC.3.M.SG+SBJF+2+PL
cainharde-los	cainhar+V.ele.ACC.3.M.PL+INF+2+PL
cainharde-los	cainhar+V.ele.ACC.3.M.PL+SBJF+2+PL
cainharde-nos	cainhar+nós.AD.1.PL+INF+2+PL
cainharde-nos	cainhar+nós.AD.1.PL+SBJF+2+PL
cainhardes-lhe	cainhar+V.ele.DAT.3.SG+INF+2+PL
cainhardes-lhe	cainhar+V.ele.DAT.3.SG+SBJF+2+PL
cainhardes-lhes	cainhar+V.ele.DAT.3.PL+INF+2+PL
cainhardes-lhes	cainhar+V.ele.DAT.3.PL+SBJF+2+PL
cainhardes-me	cainhar+V.eu.AD.1.SG+INF+2+PL
cainhardes-me	cainhar+V.eu.AD.1.SG+SBJF+2+PL
cainhardes-te	cainhar+V.tu.AD.2.SG+INF+2+PL
cainhardes-te	cainhar+V.tu.AD.2.SG+SBJF+2+PL
cainhardes-vos	cainhar+V.vós.AD.2.PL+INF+2+PL
cainhardes-vos	cainhar+V.vós.AD.2.PL+SBJF+2+PL
cainhárei-la	cainhar+V.ele.ACC.3.F.SG+PQP+2+PL
cainhárei-las	cainhar+V.ele.ACC.3.F.PL+PQP+2+PL
cainhárei-lo	cainhar+V.ele.ACC.3.M.SG+PQP+2+PL
cainhárei-los	cainhar+V.ele.ACC.3.M.PL+PQP+2+PL
cainhárei-nos	cainhar+nós.AD.1.PL+PQP+2+PL
cainháreis-lhe	cainhar+V.ele.DAT.3.SG+PQP+2+PL
cainháreis-lhes	cainhar+V.ele.DAT.3.PL+PQP+2+PL
cainháreis-me	cainhar+V.eu.AD.1.SG+PQP+2+PL
cainháreis-te	cainhar+V.tu.AD.2.SG+PQP+2+PL
cainháreis-vos	cainhar+V.vós.AD.2.PL+PQP+2+PL
cainhare-la	cainhar+V.ele.ACC.3.F.SG+INF+2+SG
cainhare-la	cainhar+V.ele.ACC.3.F.SG+SBJF+2+SG
cainhare-las	cainhar+V.ele.ACC.3.F.PL+INF+2+SG
cainhare-las	cainhar+V.ele.ACC.3.F.PL+SBJF+2+SG
cainhare-lo	cainhar+V.ele.ACC.3.M.SG+INF+2+SG
cainhare-lo	cainhar+V.ele.ACC.3.M.SG+SBJF+2+SG
cainhare-los	cainhar+V.ele.ACC.3.M.PL+INF+2+SG
cainhare-los	cainhar+V.ele.ACC.3.M.PL+SBJF+2+SG
cainharem-lhe	cainhar+V.ele.DAT.3.SG+INF+3+PL
cainharem-lhe	cainhar+V.ele.DAT.3.SG+SBJF+3+PL
cainharem-lhes	cainhar+V.ele.DAT.3.PL+INF+3+PL
cainharem-lhes	cainhar+V.ele.DAT.3.PL+SBJF+3+PL
cainharem-me	cainhar+V.eu.AD.1.SG+INF+3+PL
cainharem-me	cainhar+V.eu.AD.1.SG+SBJF+3+PL
cainharem-na	cainhar+V.ele.ACC.3.F.SG+INF+3+PL
cainharem-na	cainhar+V.ele.ACC.3.F.SG+SBJF+3+PL
cainharem-nas	cainhar+V.ele.ACC.3.F.PL+INF+3+PL
cainharem-nas	cainhar+V.ele.ACC.3.F.PL+SBJF+3+PL
cainharem-no	cainhar+V.ele.ACC.3.M.SG+INF+3+PL
cainharem-no	cainhar+V.ele.ACC.3.M.SG+SBJF+3+PL
cainharem-nos	cainhar+V.ele.ACC.3.M.PL+INF+3+PL
cainharem-nos	cainhar+V.ele.ACC.3.M.PL+SBJF+3+PL
cainharem-nos	cainhar+V.nós.AD.1.PL+INF+3+PL
cainharem-nos	cainhar+V.nós.AD.1.PL+SBJF+3+PL
cainharem-se	cainhar+V.ele.REFL+INF+3+PL
cainharem-se	cainhar+V.ele.REFL+SBJF+3+PL
cainharem-te	cainhar+V.tu.AD.2.SG+INF+3+PL
cainharem-te	cainhar+V.tu.AD.2.SG+SBJF+3+PL
cainharem-vos	cainhar+V.vós.AD.2.PL+INF+3+PL
cainharem-vos	cainhar+V.vós.AD.2.PL+SBJF+3+PL
cainhare-nos	cainhar+nós.AD.1.PL+INF+2+SG
cainhare-nos	cainhar+nós.AD.1.PL+SBJF+2+SG
cainhares-lhe	cainhar+V.ele.DAT.3.SG+INF+2+SG
cainhares-lhe	cainhar+V.ele.DAT.3.SG+SBJF+2+SG
cainhares-lhes	cainhar+V.ele.DAT.3.PL+INF+2+SG
cainhares-lhes	cainhar+V.ele.DAT.3.PL+SBJF+2+SG
cainhares-me	cainhar+V.eu.AD.1.SG+INF+2+SG
cainhares-me	cainhar+V.eu.AD.1.SG+SBJF+2+SG
cainhares-te	cainhar+V.tu.AD.2.SG+INF+2+SG
cainhares-te	cainhar+V.tu.AD.2.SG+SBJF+2+SG
cainhares-vos	cainhar+V.vós.AD.2.PL+INF+2+SG
cainhares-vos	cainhar+V.vós.AD.2.PL+SBJF+2+SG
cainhar-lhe-á	cainhar+V.ele.DAT.3.SG+FUT+3+SG
cainhar-lhe-ão	cainhar+V.ele.DAT.3.SG+FUT+3+PL
cainhar-lhe-ás	cainhar+V.ele.DAT.3.SG+FUT+2+SG
cainhar-lhe	cainhar+V.ele.DAT.3.SG+INF
cainhar-lhe	cainhar+V.ele.DAT.3.SG+INF+1+SG
cainhar-lhe	cainhar+V.ele.DAT.3.SG+INF+3+SG
cainhar-lhe	cainhar+V.ele.DAT.3.SG+SBJF+1+SG
cainhar-lhe	cainhar+V.ele.DAT.3.SG+SBJF+3+SG
cainhar-lhe-ei	cainhar+V.ele.DAT.3.SG+FUT+1+SG
cainhar-lhe-eis	cainhar+V.ele.DAT.3.SG+FUT+2+PL
cainhar-lhe-emos	cainhar+V.ele.DAT.3.SG+FUT+1+PL
cainhar-lhe-ia	cainhar+V.ele.DAT.3.SG+COND+1+SG
cainhar-lhe-ia	cainhar+V.ele.DAT.3.SG+COND+3+SG
cainhar-lhe-iam	cainhar+V.ele.DAT.3.SG+COND+3+PL
cainhar-lhe-íamos	cainhar+V.ele.DAT.3.SG+COND+1+PL
cainhar-lhe-ias	cainhar+V.ele.DAT.3.SG+COND+2+SG
cainhar-lhe-íeis	cainhar+V.ele.DAT.3.SG+COND+2+PL
cainhar-lhes-á	cainhar+V.ele.DAT.3.PL+FUT+3+SG
cainhar-lhes-ão	cainhar+V.ele.DAT.3.PL+FUT+3+PL
cainhar-lhes-ás	cainhar+V.ele.DAT.3.PL+FUT+2+SG
cainhar-lhes	cainhar+V.ele.DAT.3.PL+INF
cainhar-lhes	cainhar+V.ele.DAT.3.PL+INF+1+SG
cainhar-lhes	cainhar+V.ele.DAT.3.PL+INF+3+SG
cainhar-lhes	cainhar+V.ele.DAT.3.PL+SBJF+1+SG
cainhar-lhes	cainhar+V.ele.DAT.3.PL+SBJF+3+SG
cainhar-lhes-ei	cainhar+V.ele.DAT.3.PL+FUT+1+SG
cainhar-lhes-eis	cainhar+V.ele.DAT.3.PL+FUT+2+PL
cainhar-lhes-emos	cainhar+V.ele.DAT.3.PL+FUT+1+PL
cainhar-lhes-ia	cainhar+V.ele.DAT.3.PL+COND+1+SG
cainhar-lhes-ia	cainhar+V.ele.DAT.3.PL+COND+3+SG
cainhar-lhes-iam	cainhar+V.ele.DAT.3.PL+COND+3+PL
cainhar-lhes-íamos	cainhar+V.ele.DAT.3.PL+COND+1+PL
cainhar-lhes-ias	cainhar+V.ele.DAT.3.PL+COND+2+SG
cainhar-lhes-íeis	cainhar+V.ele.DAT.3.PL+COND+2+PL
cainhar-me-á	cainhar+V.eu.AD.1.SG+FUT+3+SG
cainhar-me-ão	cainhar+V.eu.AD.1.SG+FUT+3+PL
cainhar-me-ás	cainhar+V.eu.AD.1.SG+FUT+2+SG
cainhar-me	cainhar+V.eu.AD.1.SG+INF
cainhar-me	cainhar+V.eu.AD.1.SG+INF+1+SG
cainhar-me	cainhar+V.eu.AD.1.SG+INF+3+SG
cainhar-me	cainhar+V.eu.AD.1.SG+SBJF+1+SG
cainhar-me	cainhar+V.eu.AD.1.SG+SBJF+3+SG
cainhar-me-ei	cainhar+V.eu.AD.1.SG+FUT+1+SG
cainhar-me-eis	cainhar+V.eu.AD.1.SG+FUT+2+PL
cainhar-me-emos	cainhar+V.eu.AD.1.SG+FUT+1+PL
cainhar-me-ia	cainhar+V.eu.AD.1.SG+COND+1+SG
cainhar-me-ia	cainhar+V.eu.AD.1.SG+COND+3+SG
cainhar-me-iam	cainhar+V.eu.AD.1.SG+COND+3+PL
cainhar-me-íamos	cainhar+V.eu.AD.1.SG+COND+1+PL
cainhar-me-ias	cainhar+V.eu.AD.1.SG+COND+2+SG
cainhar-me-íeis	cainhar+V.eu.AD.1.SG+COND+2+PL
cainharmo-la	cainhar+V.ele.ACC.3.F.SG+INF+1+PL
cainharmo-la	cainhar+V.ele.ACC.3.F.SG+SBJF+1+PL
cainharmo-las	cainhar+V.ele.ACC.3.F.PL+INF+1+PL
cainharmo-las	cainhar+V.ele.ACC.3.F.PL+SBJF+1+PL
cainharmo-lo	cainhar+V.ele.ACC.3.M.SG+INF+1+PL
cainharmo-lo	cainhar+V.ele.ACC.3.M.SG+SBJF+1+PL
cainharmo-los	cainhar+V.ele.ACC.3.M.PL+INF+1+PL
cainharmo-los	cainhar+V.ele.ACC.3.M.PL+SBJF+1+PL
cainharmo-nos	cainhar+nós.AD.1.PL+INF+1+PL
cainharmo-nos	cainhar+nós.AD.1.PL+SBJF+1+PL
cainharmos-lhe	cainhar+V.ele.DAT.3.SG+INF+1+PL
cainharmos-lhe	cainhar+V.ele.DAT.3.SG+SBJF+1+PL
cainharmos-lhes	cainhar+V.ele.DAT.3.PL+INF+1+PL
cainharmos-lhes	cainhar+V.ele.DAT.3.PL+SBJF+1+PL
cainharmos-me	cainhar+V.eu.AD.1.SG+INF+1+PL
cainharmos-me	cainhar+V.eu.AD.1.SG+SBJF+1+PL
cainharmos-te	cainhar+V.tu.AD.2.SG+INF+1+PL
cainharmos-te	cainhar+V.tu.AD.2.SG+SBJF+1+PL
cainharmos-vos	cainhar+V.vós.AD.2.PL+INF+1+PL
cainharmos-vos	cainhar+V.vós.AD.2.PL+SBJF+1+PL
cainhar-nos-á	cainhar+nós.AD.1.PL+FUT+3+SG
cainhar-nos-ão	cainhar+nós.AD.1.PL+FUT+3+PL
cainhar-nos-ás	cainhar+nós.AD.1.PL+FUT+2+SG
cainhar-nos	cainhar+nós.AD.1.PL+INF
cainhar-nos	cainhar+nós.AD.1.PL+INF+1+SG
cainhar-nos	cainhar+nós.AD.1.PL+INF+3+SG
cainhar-nos	cainhar+nós.AD.1.PL+SBJF+1+SG
cainhar-nos	cainhar+nós.AD.1.PL+SBJF+3+SG
cainhar-nos-ei	cainhar+nós.AD.1.PL+FUT+1+SG
cainhar-nos-eis	cainhar+nós.AD.1.PL+FUT+2+PL
cainhar-nos-emos	cainhar+nós.AD.1.PL+FUT+1+PL
cainhar-nos-ia	cainhar+nós.AD.1.PL+COND+1+SG
cainhar-nos-ia	cainhar+nós.AD.1.PL+COND+3+SG
cainhar-nos-iam	cainhar+nós.AD.1.PL+COND+3+PL
cainhar-nos-íamos	cainhar+nós.AD.1.PL+COND+1+PL
cainhar-nos-ias	cainhar+nós.AD.1.PL+COND+2+SG
cainhar-nos-íeis	cainhar+nós.AD.1.PL+COND+2+PL
cainhar-se-á	cainhar+V.ele.REFL+FUT+3+SG
cainhar-se-ão	cainhar+V.ele.REFL+FUT+3+PL
cainhar-se	cainhar+V.ele.REFL+INF
cainhar-se	cainhar+V.ele.REFL+INF+3+SG
cainhar-se	cainhar+V.ele.REFL+SBJF+3+SG
cainhar-se-ia	cainhar+V.ele.REFL+COND+3+SG
cainhar-se-iam	cainhar+V.ele.REFL+COND+3+PL
cainhar-te-á	cainhar+V.tu.AD.2.SG+FUT+3+SG
cainhar-te-ão	cainhar+V.tu.AD.2.SG+FUT+3+PL
cainhar-te-ás	cainhar+V.tu.AD.2.SG+FUT+2+SG
cainhar-te	cainhar+V.tu.AD.2.SG+INF
cainhar-te	cainhar+V.tu.AD.2.SG+INF+1+SG
cainhar-te	cainhar+V.tu.AD.2.SG+INF+3+SG
cainhar-te	cainhar+V.tu.AD.2.SG+SBJF+1+SG
cainhar-te	cainhar+V.tu.AD.2.SG+SBJF+3+SG
cainhar-te-ei	cainhar+V.tu.AD.2.SG+FUT+1+SG
cainhar-te-eis	cainhar+V.tu.AD.2.SG+FUT+2+PL
cainhar-te-emos	cainhar+V.tu.AD.2.SG+FUT+1+PL
cainhar-te-ia	cainhar+V.tu.AD.2.SG+COND+1+SG
cainhar-te-ia	cainhar+V.tu.AD.2.SG+COND+3+SG
cainhar-te-iam	cainhar+V.tu.AD.2.SG+COND+3+PL
cainhar-te-íamos	cainhar+V.tu.AD.2.SG+COND+1+PL
cainhar-te-ias	cainhar+V.tu.AD.2.SG+COND+2+SG
cainhar-te-íeis	cainhar+V.tu.AD.2.SG+COND+2+PL
cainhar-vos-á	cainhar+V.vós.AD.2.PL+FUT+3+SG
cainhar-vos-ão	cainhar+V.vós.AD.2.PL+FUT+3+PL
cainhar-vos-ás	cainhar+V.vós.AD.2.PL+FUT+2+SG
cainhar-vos	cainhar+V.vós.AD.2.PL+INF
cainhar-vos	cainhar+V.vós.AD.2.PL+INF+1+SG
cainhar-vos	cainhar+V.vós.AD.2.PL+INF+3+SG
cainhar-vos	cainhar+V.vós.AD.2.PL+SBJF+1+SG
cainhar-vos	cainhar+V.vós.AD.2.PL+SBJF+3+SG
cainhar-vos-ei	cainhar+V.vós.AD.2.PL+FUT+1+SG
cainhar-vos-eis	cainhar+V.vós.AD.2.PL+FUT+2+PL
cainhar-vos-emos	cainhar+V.vós.AD.2.PL+FUT+1+PL
cainhar-vos-ia	cainhar+V.vós.AD.2.PL+COND+1+SG
cainhar-vos-ia	cainhar+V.vós.AD.2.PL+COND+3+SG
cainhar-vos-iam	cainhar+V.vós.AD.2.PL+COND+3+PL
cainhar-vos-íamos	cainhar+V.vós.AD.2.PL+COND+1+PL
cainhar-vos-ias	cainhar+V.vós.AD.2.PL+COND+2+SG
cainhar-vos-íeis	cainhar+V.vós.AD.2.PL+COND+2+PL
cainha-se	cainhar+V.ele.REFL+PRS+3+SG
cainhas-lhe	cainhar+V.ele.DAT.3.SG+PRS+2+SG
cainhas-lhes	cainhar+V.ele.DAT.3.PL+PRS+2+SG
cainhas-me	cainhar+V.eu.AD.1.SG+PRS+2+SG
cainhaste-a	cainhar+V.ele.ACC.3.F.SG+PRF+2+SG
cainhaste-as	cainhar+V.ele.ACC.3.F.PL+PRF+2+SG
cainhas-te	cainhar+V.tu.AD.2.SG+PRS+2+SG
cainhaste-la	cainhar+V.ele.ACC.3.F.SG+PRF+2+PL
cainhaste-las	cainhar+V.ele.ACC.3.F.PL+PRF+2+PL
cainhaste-lhe	cainhar+V.ele.DAT.3.SG+PRF+2+SG
cainhaste-lhes	cainhar+V.ele.DAT.3.PL+PRF+2+SG
cainhaste-lo	cainhar+V.ele.ACC.3.M.SG+PRF+2+PL
cainhaste-los	cainhar+V.ele.ACC.3.M.PL+PRF+2+PL
cainhaste-me	cainhar+V.eu.AD.1.SG+PRF+2+SG
cainhaste-nos	cainhar+nós.AD.1.PL+PRF+2+PL
cainhaste-nos	cainhar+nós.AD.1.PL+PRF+2+SG
cainhaste-o	cainhar+V.ele.ACC.3.M.SG+PRF+2+SG
cainhaste-os	cainhar+V.ele.ACC.3.M.PL+PRF+2+SG
cainhastes-lhe	cainhar+V.ele.DAT.3.SG+PRF+2+PL
cainhastes-lhes	cainhar+V.ele.DAT.3.PL+PRF+2+PL
cainhastes-me	cainhar+V.eu.AD.1.SG+PRF+2+PL
cainhastes-te	cainhar+V.tu.AD.2.SG+PRF+2+PL
cainhastes-vos	cainhar+V.vós.AD.2.PL+PRF+2+PL
cainhaste-te	cainhar+V.tu.AD.2.SG+PRF+2+SG
cainhaste-vos	cainhar+V.vós.AD.2.PL+PRF+2+SG
cainhas-vos	cainhar+V.vós.AD.2.PL+PRS+2+SG
cainha-te	cainhar+V.tu.AD.2.SG+PRS+3+SG
cainhava-a	cainhar+V.ele.ACC.3.F.SG+IMPF+1+SG
cainhava-a	cainhar+V.ele.ACC.3.F.SG+IMPF+3+SG
cainhava-as	cainhar+V.ele.ACC.3.F.PL+IMPF+1+SG
cainhava-as	cainhar+V.ele.ACC.3.F.PL+IMPF+3+SG
cainhava-la	cainhar+V.ele.ACC.3.F.SG+IMPF+2+SG
cainhava-las	cainhar+V.ele.ACC.3.F.PL+IMPF+2+SG
cainhava-lhe	cainhar+V.ele.DAT.3.SG+IMPF+1+SG
cainhava-lhe	cainhar+V.ele.DAT.3.SG+IMPF+3+SG
cainhava-lhes	cainhar+V.ele.DAT.3.PL+IMPF+1+SG
cainhava-lhes	cainhar+V.ele.DAT.3.PL+IMPF+3+SG
cainhava-lo	cainhar+V.ele.ACC.3.M.SG+IMPF+2+SG
cainhava-los	cainhar+V.ele.ACC.3.M.PL+IMPF+2+SG
cainhava-me	cainhar+V.eu.AD.1.SG+IMPF+1+SG
cainhava-me	cainhar+V.eu.AD.1.SG+IMPF+3+SG
cainhavam-lhe	cainhar+V.ele.DAT.3.SG+IMPF+3+PL
cainhavam-lhes	cainhar+V.ele.DAT.3.PL+IMPF+3+PL
cainhavam-me	cainhar+V.eu.AD.1.SG+IMPF+3+PL
cainhavam-na	cainhar+V.ele.ACC.3.F.SG+IMPF+3+PL
cainhavam-nas	cainhar+V.ele.ACC.3.F.PL+IMPF+3+PL
cainhavam-no	cainhar+V.ele.ACC.3.M.SG+IMPF+3+PL
cainhavam-nos	cainhar+V.ele.ACC.3.M.PL+IMPF+3+PL
cainhavam-nos	cainhar+V.nós.AD.1.PL+IMPF+3+PL
cainhávamo-la	cainhar+V.ele.ACC.3.F.SG+IMPF+1+PL
cainhávamo-las	cainhar+V.ele.ACC.3.F.PL+IMPF+1+PL
cainhávamo-lo	cainhar+V.ele.ACC.3.M.SG+IMPF+1+PL
cainhávamo-los	cainhar+V.ele.ACC.3.M.PL+IMPF+1+PL
cainhávamo-nos	cainhar+nós.AD.1.PL+IMPF+1+PL
cainhávamos-lhe	cainhar+V.ele.DAT.3.SG+IMPF+1+PL
cainhávamos-lhes	cainhar+V.ele.DAT.3.PL+IMPF+1+PL
cainhávamos-me	cainhar+V.eu.AD.1.SG+IMPF+1+PL
cainhávamos-te	cainhar+V.tu.AD.2.SG+IMPF+1+PL
cainhávamos-vos	cainhar+V.vós.AD.2.PL+IMPF+1+PL
cainhavam-se	cainhar+V.ele.REFL+IMPF+3+PL
cainhavam-te	cainhar+V.tu.AD.2.SG+IMPF+3+PL
cainhavam-vos	cainhar+V.vós.AD.2.PL+IMPF+3+PL
cainhava-nos	cainhar+nós.AD.1.PL+IMPF+1+SG
cainhava-nos	cainhar+nós.AD.1.PL+IMPF+2+SG
cainhava-nos	cainhar+nós.AD.1.PL+IMPF+3+SG
cainhava-o	cainhar+V.ele.ACC.3.M.SG+IMPF+1+SG
cainhava-o	cainhar+V.ele.ACC.3.M.SG+IMPF+3+SG
cainhava-os	cainhar+V.ele.ACC.3.M.PL+IMPF+1+SG
cainhava-os	cainhar+V.ele.ACC.3.M.PL+IMPF+3+SG
cainhava-se	cainhar+V.ele.REFL+IMPF+1+SG
cainhava-se	cainhar+V.ele.REFL+IMPF+3+SG
cainhavas-lhe	cainhar+V.ele.DAT.3.SG+IMPF+2+SG
cainhavas-lhes	cainhar+V.ele.DAT.3.PL+IMPF+2+SG
cainhavas-me	cainhar+V.eu.AD.1.SG+IMPF+2+SG
cainhavas-te	cainhar+V.tu.AD.2.SG+IMPF+2+SG
cainhavas-vos	cainhar+V.vós.AD.2.PL+IMPF+2+SG
cainhava-te	cainhar+V.tu.AD.2.SG+IMPF+1+SG
cainhava-te	cainhar+V.tu.AD.2.SG+IMPF+3+SG
cainhava-vos	cainhar+V.vós.AD.2.PL+IMPF+1+SG
cainhava-vos	cainhar+V.vós.AD.2.PL+IMPF+3+SG
cainhávei-la	cainhar+V.ele.ACC.3.F.SG+IMPF+2+PL
cainhávei-las	cainhar+V.ele.ACC.3.F.PL+IMPF+2+PL
cainhávei-lo	cainhar+V.ele.ACC.3.M.SG+IMPF+2+PL
cainhávei-los	cainhar+V.ele.ACC.3.M.PL+IMPF+2+PL
cainhávei-nos	cainhar+nós.AD.1.PL+IMPF+2+PL
cainháveis-lhe	cainhar+V.ele.DAT.3.SG+IMPF+2+PL
cainháveis-lhes	cainhar+V.ele.DAT.3.PL+IMPF+2+PL
cainháveis-me	cainhar+V.eu.AD.1.SG+IMPF+2+PL
cainháveis-te	cainhar+V.tu.AD.2.SG+IMPF+2+PL
cainháveis-vos	cainhar+V.vós.AD.2.PL+IMPF+2+PL
cainha-vos	cainhar+V.vós.AD.2.PL+PRS+3+SG
cainhe-a	cainhar+V.ele.ACC.3.F.SG+IMP+3+SG
cainhe-as	cainhar+V.ele.ACC.3.F.PL+IMP+3+SG
cainhei-a	cainhar+V.ele.ACC.3.F.SG+PRF+1+SG
cainhei-as	cainhar+V.ele.ACC.3.F.PL+PRF+1+SG
cainhei-lhe	cainhar+V.ele.DAT.3.SG+PRF+1+SG
cainhei-lhes	cainhar+V.ele.DAT.3.PL+PRF+1+SG
cainhei-me	cainhar+V.eu.AD.1.SG+PRF+1+SG
cainhei-nos	cainhar+nós.AD.1.PL+PRF+1+SG
cainhei-o	cainhar+V.ele.ACC.3.M.SG+PRF+1+SG
cainhei-os	cainhar+V.ele.ACC.3.M.PL+PRF+1+SG
cainhei-te	cainhar+V.tu.AD.2.SG+PRF+1+SG
cainhei-vos	cainhar+V.vós.AD.2.PL+PRF+1+SG
cainhe-lhe	cainhar+V.ele.DAT.3.SG+IMP+3+SG
cainhe-lhes	cainhar+V.ele.DAT.3.PL+IMP+3+SG
cainhe-me	cainhar+V.eu.AD.1.SG+IMP+3+SG
cainhem-lhe	cainhar+V.ele.DAT.3.SG+IMP+3+PL
cainhem-lhes	cainhar+V.ele.DAT.3.PL+IMP+3+PL
cainhem-me	cainhar+V.eu.AD.1.SG+IMP+3+PL
cainhem-na	cainhar+V.ele.ACC.3.F.SG+IMP+3+PL
cainhem-nas	cainhar+V.ele.ACC.3.F.PL+IMP+3+PL
cainhem-no	cainhar+V.ele.ACC.3.M.SG+IMP+3+PL
cainhem-nos	cainhar+V.ele.ACC.3.M.PL+IMP+3+PL
cainhem-nos	cainhar+V.nós.AD.1.PL+IMP+3+PL
cainhemo-la	cainhar+V.ele.ACC.3.F.SG+IMP+1+PL
cainhemo-las	cainhar+V.ele.ACC.3.F.PL+IMP+1+PL
cainhemo-lo	cainhar+V.ele.ACC.3.M.SG+IMP+1+PL
cainhemo-los	cainhar+V.ele.ACC.3.M.PL+IMP+1+PL
cainhemo-nos	cainhar+nós.AD.1.PL+IMP+1+PL
cainhemos-lhe	cainhar+V.ele.DAT.3.SG+IMP+1+PL
cainhemos-lhes	cainhar+V.ele.DAT.3.PL+IMP+1+PL
cainhemos-me	cainhar+V.eu.AD.1.SG+IMP+1+PL
cainhemos-te	cainhar+V.tu.AD.2.SG+IMP+1+PL
cainhemos-vos	cainhar+V.vós.AD.2.PL+IMP+1+PL
cainhem-se	cainhar+V.ele.REFL+IMP+3+PL
cainhem-te	cainhar+V.tu.AD.2.SG+IMP+3+PL
cainhem-vos	cainhar+V.vós.AD.2.PL+IMP+3+PL
cainhe-nos	cainhar+nós.AD.1.PL+IMP+3+SG
cainhe-o	cainhar+V.ele.ACC.3.M.SG+IMP+3+SG
cainhe-os	cainhar+V.ele.ACC.3.M.PL+IMP+3+SG
cainhe-se	cainhar+V.ele.REFL+IMP+3+SG
cainhe-te	cainhar+V.tu.AD.2.SG+IMP+3+SG
cainhe-vos	cainhar+V.vós.AD.2.PL+IMP+3+SG
cainho-a	cainhar+V.ele.ACC.3.F.SG+PRS+1+SG
cainho-as	cainhar+V.ele.ACC.3.F.PL+PRS+1+SG
cainho-lhe	cainhar+V.ele.DAT.3.SG+PRS+1+SG
cainho-lhes	cainhar+V.ele.DAT.3.PL+PRS+1+SG
cainho-me	cainhar+V.eu.AD.1.SG+PRS+1+SG
cainho-nos	cainhar+nós.AD.1.PL+PRS+1+SG
cainho-o	cainhar+V.ele.ACC.3.M.SG+PRS+1+SG
cainho-os	cainhar+V.ele.ACC.3.M.PL+PRS+1+SG
cainho-te	cainhar+V.tu.AD.2.SG+PRS+1+SG
cainhou-a	cainhar+V.ele.ACC.3.F.SG+PRF+3+SG
cainhou-as	cainhar+V.ele.ACC.3.F.PL+PRF+3+SG
cainhou-lhe	cainhar+V.ele.DAT.3.SG+PRF+3+SG
cainhou-lhes	cainhar+V.ele.DAT.3.PL+PRF+3+SG
cainhou-me	cainhar+V.eu.AD.1.SG+PRF+3+SG
cainhou-nos	cainhar+nós.AD.1.PL+PRF+3+SG
cainhou-o	cainhar+V.ele.ACC.3.M.SG+PRF+3+SG
cainhou-os	cainhar+V.ele.ACC.3.M.PL+PRF+3+SG
cainhou-se	cainhar+V.ele.REFL+PRF+3+SG
cainhou-te	cainhar+V.tu.AD.2.SG+PRF+3+SG
cainhou-vos	cainhar+V.vós.AD.2.PL+PRF+3+SG
cainho-vos	cainhar+V.vós.AD.2.PL+PRS+1+SG
caí-nos	cair+nós.AD.1.PL+PRF+1+SG
caí-nos	cair+nós.AD.1.PL+PRS+2+PL
cai-nos	cair+nós.AD.1.PL+PRS+2+SG
cai-nos	cair+nós.AD.1.PL+PRS+3+SG
caio-a	caiar+V.ele.ACC.3.F.SG+PRS+1+SG
caio-a	cair+V.ele.ACC.3.F.SG+PRS+1+SG
caio-as	caiar+V.ele.ACC.3.F.PL+PRS+1+SG
caio-as	cair+V.ele.ACC.3.F.PL+PRS+1+SG
caí-o	cair+V.ele.ACC.3.M.SG+PRF+1+SG
cai-o	cair+V.ele.ACC.3.M.SG+PRS+3+SG
caio-lhe	caiar+V.ele.DAT.3.SG+PRS+1+SG
caio-lhe	cair+V.ele.DAT.3.SG+PRS+1+SG
caio-lhes	caiar+V.ele.DAT.3.PL+PRS+1+SG
caio-lhes	cair+V.ele.DAT.3.PL+PRS+1+SG
caio-me	caiar+V.eu.AD.1.SG+PRS+1+SG
caio-me	cair+V.eu.AD.1.SG+PRS+1+SG
caio-nos	caiar+nós.AD.1.PL+PRS+1+SG
caio-nos	cair+nós.AD.1.PL+PRS+1+SG
caio-o	caiar+V.ele.ACC.3.M.SG+PRS+1+SG
caio-o	cair+V.ele.ACC.3.M.SG+PRS+1+SG
caio-os	caiar+V.ele.ACC.3.M.PL+PRS+1+SG
caio-os	cair+V.ele.ACC.3.M.PL+PRS+1+SG
caí-os	cair+V.ele.ACC.3.M.PL+PRF+1+SG
cai-os	cair+V.ele.ACC.3.M.PL+PRS+3+SG
caio-te	caiar+V.tu.AD.2.SG+PRS+1+SG
caio-te	cair+V.tu.AD.2.SG+PRS+1+SG
caiou-a	caiar+V.ele.ACC.3.F.SG+PRF+3+SG
caiou-as	caiar+V.ele.ACC.3.F.PL+PRF+3+SG
caiou-lhe	caiar+V.ele.DAT.3.SG+PRF+3+SG
caiou-lhes	caiar+V.ele.DAT.3.PL+PRF+3+SG
caiou-me	caiar+V.eu.AD.1.SG+PRF+3+SG
caiou-nos	caiar+nós.AD.1.PL+PRF+3+SG
caiou-o	caiar+V.ele.ACC.3.M.SG+PRF+3+SG
caiou-os	caiar+V.ele.ACC.3.M.PL+PRF+3+SG
caiou-se	caiar+V.ele.REFL+PRF+3+SG
caiou-te	caiar+V.tu.AD.2.SG+PRF+3+SG
caiou-vos	caiar+V.vós.AD.2.PL+PRF+3+SG
caio-vos	caiar+V.vós.AD.2.PL+PRS+1+SG
caio-vos	cair+V.vós.AD.2.PL+PRS+1+SG
caíra-a	cair+V.ele.ACC.3.F.SG+PQP+1+SG
caíra-a	cair+V.ele.ACC.3.F.SG+PQP+3+SG
caíra-as	cair+V.ele.ACC.3.F.PL+PQP+1+SG
caíra-as	cair+V.ele.ACC.3.F.PL+PQP+3+SG
caíra-la	cair+V.ele.ACC.3.F.SG+PQP+2+SG
caíra-las	cair+V.ele.ACC.3.F.PL+PQP+2+SG
caíra-lhe	cair+V.ele.DAT.3.SG+PQP+1+SG
caíra-lhe	cair+V.ele.DAT.3.SG+PQP+3+SG
caíra-lhes	cair+V.ele.DAT.3.PL+PQP+1+SG
caíra-lhes	cair+V.ele.DAT.3.PL+PQP+3+SG
caíra-lo	cair+V.ele.ACC.3.M.SG+PQP+2+SG
caíra-los	cair+V.ele.ACC.3.M.PL+PQP+2+SG
caíra-me	cair+V.eu.AD.1.SG+PQP+1+SG
caíra-me	cair+V.eu.AD.1.SG+PQP+3+SG
caíram-lhe	cair+V.ele.DAT.3.SG+PQP+3+PL
caíram-lhe	cair+V.ele.DAT.3.SG+PRF+3+PL
caíram-lhes	cair+V.ele.DAT.3.PL+PQP+3+PL
caíram-lhes	cair+V.ele.DAT.3.PL+PRF+3+PL
caíram-me	cair+V.eu.AD.1.SG+PQP+3+PL
caíram-me	cair+V.eu.AD.1.SG+PRF+3+PL
caíram-na	cair+V.ele.ACC.3.F.SG+PQP+3+PL
caíram-na	cair+V.ele.ACC.3.F.SG+PRF+3+PL
caíram-nas	cair+V.ele.ACC.3.F.PL+PQP+3+PL
caíram-nas	cair+V.ele.ACC.3.F.PL+PRF+3+PL
caíram-no	cair+V.ele.ACC.3.M.SG+PQP+3+PL
caíram-no	cair+V.ele.ACC.3.M.SG+PRF+3+PL
caíram-nos	cair+nós.AD.1.PL+PQP+3+PL
caíram-nos	cair+nós.AD.1.PL+PRF+3+PL
caíramo-la	cair+V.ele.ACC.3.F.SG+PQP+1+PL
caíramo-las	cair+V.ele.ACC.3.F.PL+PQP+1+PL
caíramo-lo	cair+V.ele.ACC.3.M.SG+PQP+1+PL
caíramo-los	cair+V.ele.ACC.3.M.PL+PQP+1+PL
caíramo-nos	cair+nós.AD.1.PL+PQP+1+PL
caíramos-lhe	cair+V.ele.DAT.3.SG+PQP+1+PL
caíramos-lhes	cair+V.ele.DAT.3.PL+PQP+1+PL
caíramos-me	cair+V.eu.AD.1.SG+PQP+1+PL
caíramos-te	cair+V.tu.AD.2.SG+PQP+1+PL
caíramos-vos	cair+V.vós.AD.2.PL+PQP+1+PL
caíram-se	cair+V.ele.REFL+PQP+3+PL
caíram-se	cair+V.ele.REFL+PRF+3+PL
caíram-te	cair+V.tu.AD.2.SG+PQP+3+PL
caíram-te	cair+V.tu.AD.2.SG+PRF+3+PL
caíram-vos	cair+V.vós.AD.2.PL+PQP+3+PL
caíram-vos	cair+V.vós.AD.2.PL+PRF+3+PL
caíra-nos	cair+nós.AD.1.PL+PQP+1+SG
caíra-nos	cair+nós.AD.1.PL+PQP+2+SG
caíra-nos	cair+nós.AD.1.PL+PQP+3+SG
caíra-o	cair+V.ele.ACC.3.M.SG+PQP+1+SG
caíra-o	cair+V.ele.ACC.3.M.SG+PQP+3+SG
caíra-os	cair+V.ele.ACC.3.M.PL+PQP+1+SG
caíra-os	cair+V.ele.ACC.3.M.PL+PQP+3+SG
caíra-se	cair+V.ele.REFL+PQP+3+SG
caíras-lhe	cair+V.ele.DAT.3.SG+PQP+2+SG
caíras-lhes	cair+V.ele.DAT.3.PL+PQP+2+SG
caíras-me	cair+V.eu.AD.1.SG+PQP+2+SG
caíras-te	cair+V.tu.AD.2.SG+PQP+2+SG
caíras-vos	cair+V.vós.AD.2.PL+PQP+2+SG
