cantarolar-lhe-íeis	cantarolar+V.ele.DAT.3.SG+COND+2+PL
cantarolar-lhes-á	cantarolar+V.ele.DAT.3.PL+FUT+3+SG
cantarolar-lhes-ão	cantarolar+V.ele.DAT.3.PL+FUT+3+PL
cantarolar-lhes-ás	cantarolar+V.ele.DAT.3.PL+FUT+2+SG
cantarolar-lhes	cantarolar+V.ele.DAT.3.PL+INF
cantarolar-lhes	cantarolar+V.ele.DAT.3.PL+INF+1+SG
cantarolar-lhes	cantarolar+V.ele.DAT.3.PL+INF+3+SG
cantarolar-lhes	cantarolar+V.ele.DAT.3.PL+SBJF+1+SG
cantarolar-lhes	cantarolar+V.ele.DAT.3.PL+SBJF+3+SG
cantarolar-lhes-ei	cantarolar+V.ele.DAT.3.PL+FUT+1+SG
cantarolar-lhes-eis	cantarolar+V.ele.DAT.3.PL+FUT+2+PL
cantarolar-lhes-emos	cantarolar+V.ele.DAT.3.PL+FUT+1+PL
cantarolar-lhes-ia	cantarolar+V.ele.DAT.3.PL+COND+1+SG
cantarolar-lhes-ia	cantarolar+V.ele.DAT.3.PL+COND+3+SG
cantarolar-lhes-iam	cantarolar+V.ele.DAT.3.PL+COND+3+PL
cantarolar-lhes-íamos	cantarolar+V.ele.DAT.3.PL+COND+1+PL
cantarolar-lhes-ias	cantarolar+V.ele.DAT.3.PL+COND+2+SG
cantarolar-lhes-íeis	cantarolar+V.ele.DAT.3.PL+COND+2+PL
cantarolar-me-á	cantarolar+V.eu.AD.1.SG+FUT+3+SG
cantarolar-me-ão	cantarolar+V.eu.AD.1.SG+FUT+3+PL
cantarolar-me-ás	cantarolar+V.eu.AD.1.SG+FUT+2+SG
cantarolar-me	cantarolar+V.eu.AD.1.SG+INF
cantarolar-me	cantarolar+V.eu.AD.1.SG+INF+1+SG
cantarolar-me	cantarolar+V.eu.AD.1.SG+INF+3+SG
cantarolar-me	cantarolar+V.eu.AD.1.SG+SBJF+1+SG
cantarolar-me	cantarolar+V.eu.AD.1.SG+SBJF+3+SG
cantarolar-me-ei	cantarolar+V.eu.AD.1.SG+FUT+1+SG
cantarolar-me-eis	cantarolar+V.eu.AD.1.SG+FUT+2+PL
cantarolar-me-emos	cantarolar+V.eu.AD.1.SG+FUT+1+PL
cantarolar-me-ia	cantarolar+V.eu.AD.1.SG+COND+1+SG
cantarolar-me-ia	cantarolar+V.eu.AD.1.SG+COND+3+SG
cantarolar-me-iam	cantarolar+V.eu.AD.1.SG+COND+3+PL
cantarolar-me-íamos	cantarolar+V.eu.AD.1.SG+COND+1+PL
cantarolar-me-ias	cantarolar+V.eu.AD.1.SG+COND+2+SG
cantarolar-me-íeis	cantarolar+V.eu.AD.1.SG+COND+2+PL
cantarolarmo-la	cantarolar+V.ele.ACC.3.F.SG+INF+1+PL
cantarolarmo-la	cantarolar+V.ele.ACC.3.F.SG+SBJF+1+PL
cantarolarmo-las	cantarolar+V.ele.ACC.3.F.PL+INF+1+PL
cantarolarmo-las	cantarolar+V.ele.ACC.3.F.PL+SBJF+1+PL
cantarolarmo-lo	cantarolar+V.ele.ACC.3.M.SG+INF+1+PL
cantarolarmo-lo	cantarolar+V.ele.ACC.3.M.SG+SBJF+1+PL
cantarolarmo-los	cantarolar+V.ele.ACC.3.M.PL+INF+1+PL
cantarolarmo-los	cantarolar+V.ele.ACC.3.M.PL+SBJF+1+PL
cantarolarmo-nos	cantarolar+nós.AD.1.PL+INF+1+PL
cantarolarmo-nos	cantarolar+nós.AD.1.PL+SBJF+1+PL
cantarolarmos-lhe	cantarolar+V.ele.DAT.3.SG+INF+1+PL
cantarolarmos-lhe	cantarolar+V.ele.DAT.3.SG+SBJF+1+PL
cantarolarmos-lhes	cantarolar+V.ele.DAT.3.PL+INF+1+PL
cantarolarmos-lhes	cantarolar+V.ele.DAT.3.PL+SBJF+1+PL
cantarolarmos-me	cantarolar+V.eu.AD.1.SG+INF+1+PL
cantarolarmos-me	cantarolar+V.eu.AD.1.SG+SBJF+1+PL
cantarolarmos-te	cantarolar+V.tu.AD.2.SG+INF+1+PL
cantarolarmos-te	cantarolar+V.tu.AD.2.SG+SBJF+1+PL
cantarolarmos-vos	cantarolar+V.vós.AD.2.PL+INF+1+PL
cantarolarmos-vos	cantarolar+V.vós.AD.2.PL+SBJF+1+PL
cantarolar-nos-á	cantarolar+nós.AD.1.PL+FUT+3+SG
cantarolar-nos-ão	cantarolar+nós.AD.1.PL+FUT+3+PL
cantarolar-nos-ás	cantarolar+nós.AD.1.PL+FUT+2+SG
cantarolar-nos	cantarolar+nós.AD.1.PL+INF
cantarolar-nos	cantarolar+nós.AD.1.PL+INF+1+SG
cantarolar-nos	cantarolar+nós.AD.1.PL+INF+3+SG
cantarolar-nos	cantarolar+nós.AD.1.PL+SBJF+1+SG
cantarolar-nos	cantarolar+nós.AD.1.PL+SBJF+3+SG
cantarolar-nos-ei	cantarolar+nós.AD.1.PL+FUT+1+SG
cantarolar-nos-eis	cantarolar+nós.AD.1.PL+FUT+2+PL
cantarolar-nos-emos	cantarolar+nós.AD.1.PL+FUT+1+PL
cantarolar-nos-ia	cantarolar+nós.AD.1.PL+COND+1+SG
cantarolar-nos-ia	cantarolar+nós.AD.1.PL+COND+3+SG
cantarolar-nos-iam	cantarolar+nós.AD.1.PL+COND+3+PL
cantarolar-nos-íamos	cantarolar+nós.AD.1.PL+COND+1+PL
cantarolar-nos-ias	cantarolar+nós.AD.1.PL+COND+2+SG
cantarolar-nos-íeis	cantarolar+nós.AD.1.PL+COND+2+PL
cantarolar-se-á	cantarolar+V.ele.REFL+FUT+3+SG
cantarolar-se-ão	cantarolar+V.ele.REFL+FUT+3+PL
cantarolar-se	cantarolar+V.ele.REFL+INF
cantarolar-se	cantarolar+V.ele.REFL+INF+3+SG
cantarolar-se	cantarolar+V.ele.REFL+SBJF+3+SG
cantarolar-se-ia	cantarolar+V.ele.REFL+COND+3+SG
cantarolar-se-iam	cantarolar+V.ele.REFL+COND+3+PL
cantarolar-te-á	cantarolar+V.tu.AD.2.SG+FUT+3+SG
cantarolar-te-ão	cantarolar+V.tu.AD.2.SG+FUT+3+PL
cantarolar-te-ás	cantarolar+V.tu.AD.2.SG+FUT+2+SG
cantarolar-te	cantarolar+V.tu.AD.2.SG+INF
cantarolar-te	cantarolar+V.tu.AD.2.SG+INF+1+SG
cantarolar-te	cantarolar+V.tu.AD.2.SG+INF+3+SG
cantarolar-te	cantarolar+V.tu.AD.2.SG+SBJF+1+SG
cantarolar-te	cantarolar+V.tu.AD.2.SG+SBJF+3+SG
cantarolar-te-ei	cantarolar+V.tu.AD.2.SG+FUT+1+SG
cantarolar-te-eis	cantarolar+V.tu.AD.2.SG+FUT+2+PL
cantarolar-te-emos	cantarolar+V.tu.AD.2.SG+FUT+1+PL
cantarolar-te-ia	cantarolar+V.tu.AD.2.SG+COND+1+SG
cantarolar-te-ia	cantarolar+V.tu.AD.2.SG+COND+3+SG
cantarolar-te-iam	cantarolar+V.tu.AD.2.SG+COND+3+PL
cantarolar-te-íamos	cantarolar+V.tu.AD.2.SG+COND+1+PL
cantarolar-te-ias	cantarolar+V.tu.AD.2.SG+COND+2+SG
cantarolar-te-íeis	cantarolar+V.tu.AD.2.SG+COND+2+PL
cantarolar-vos-á	cantarolar+V.vós.AD.2.PL+FUT+3+SG
cantarolar-vos-ão	cantarolar+V.vós.AD.2.PL+FUT+3+PL
cantarolar-vos-ás	cantarolar+V.vós.AD.2.PL+FUT+2+SG
cantarolar-vos	cantarolar+V.vós.AD.2.PL+INF
cantarolar-vos	cantarolar+V.vós.AD.2.PL+INF+1+SG
cantarolar-vos	cantarolar+V.vós.AD.2.PL+INF+3+SG
cantarolar-vos	cantarolar+V.vós.AD.2.PL+SBJF+1+SG
cantarolar-vos	cantarolar+V.vós.AD.2.PL+SBJF+3+SG
cantarolar-vos-ei	cantarolar+V.vós.AD.2.PL+FUT+1+SG
cantarolar-vos-eis	cantarolar+V.vós.AD.2.PL+FUT+2+PL
cantarolar-vos-emos	cantarolar+V.vós.AD.2.PL+FUT+1+PL
cantarolar-vos-ia	cantarolar+V.vós.AD.2.PL+COND+1+SG
cantarolar-vos-ia	cantarolar+V.vós.AD.2.PL+COND+3+SG
cantarolar-vos-iam	cantarolar+V.vós.AD.2.PL+COND+3+PL
cantarolar-vos-íamos	cantarolar+V.vós.AD.2.PL+COND+1+PL
cantarolar-vos-ias	cantarolar+V.vós.AD.2.PL+COND+2+SG
cantarolar-vos-íeis	cantarolar+V.vós.AD.2.PL+COND+2+PL
cantarola-se	cantarolar+V.ele.REFL+PRS+3+SG
cantarolas-lhe	cantarolar+V.ele.DAT.3.SG+PRS+2+SG
cantarolas-lhes	cantarolar+V.ele.DAT.3.PL+PRS+2+SG
cantarolas-me	cantarolar+V.eu.AD.1.SG+PRS+2+SG
cantarolaste-a	cantarolar+V.ele.ACC.3.F.SG+PRF+2+SG
cantarolaste-as	cantarolar+V.ele.ACC.3.F.PL+PRF+2+SG
cantarolas-te	cantarolar+V.tu.AD.2.SG+PRS+2+SG
cantarolaste-la	cantarolar+V.ele.ACC.3.F.SG+PRF+2+PL
cantarolaste-las	cantarolar+V.ele.ACC.3.F.PL+PRF+2+PL
cantarolaste-lhe	cantarolar+V.ele.DAT.3.SG+PRF+2+SG
cantarolaste-lhes	cantarolar+V.ele.DAT.3.PL+PRF+2+SG
cantarolaste-lo	cantarolar+V.ele.ACC.3.M.SG+PRF+2+PL
cantarolaste-los	cantarolar+V.ele.ACC.3.M.PL+PRF+2+PL
cantarolaste-me	cantarolar+V.eu.AD.1.SG+PRF+2+SG
cantarolaste-nos	cantarolar+nós.AD.1.PL+PRF+2+PL
cantarolaste-nos	cantarolar+nós.AD.1.PL+PRF+2+SG
cantarolaste-o	cantarolar+V.ele.ACC.3.M.SG+PRF+2+SG
cantarolaste-os	cantarolar+V.ele.ACC.3.M.PL+PRF+2+SG
cantarolastes-lhe	cantarolar+V.ele.DAT.3.SG+PRF+2+PL
cantarolastes-lhes	cantarolar+V.ele.DAT.3.PL+PRF+2+PL
cantarolastes-me	cantarolar+V.eu.AD.1.SG+PRF+2+PL
cantarolastes-te	cantarolar+V.tu.AD.2.SG+PRF+2+PL
cantarolastes-vos	cantarolar+V.vós.AD.2.PL+PRF+2+PL
cantarolaste-te	cantarolar+V.tu.AD.2.SG+PRF+2+SG
cantarolaste-vos	cantarolar+V.vós.AD.2.PL+PRF+2+SG
cantarolas-vos	cantarolar+V.vós.AD.2.PL+PRS+2+SG
cantarola-te	cantarolar+V.tu.AD.2.SG+PRS+3+SG
cantarolava-a	cantarolar+V.ele.ACC.3.F.SG+IMPF+1+SG
cantarolava-a	cantarolar+V.ele.ACC.3.F.SG+IMPF+3+SG
cantarolava-as	cantarolar+V.ele.ACC.3.F.PL+IMPF+1+SG
cantarolava-as	cantarolar+V.ele.ACC.3.F.PL+IMPF+3+SG
cantarolava-la	cantarolar+V.ele.ACC.3.F.SG+IMPF+2+SG
cantarolava-las	cantarolar+V.ele.ACC.3.F.PL+IMPF+2+SG
cantarolava-lhe	cantarolar+V.ele.DAT.3.SG+IMPF+1+SG
cantarolava-lhe	cantarolar+V.ele.DAT.3.SG+IMPF+3+SG
cantarolava-lhes	cantarolar+V.ele.DAT.3.PL+IMPF+1+SG
cantarolava-lhes	cantarolar+V.ele.DAT.3.PL+IMPF+3+SG
cantarolava-lo	cantarolar+V.ele.ACC.3.M.SG+IMPF+2+SG
cantarolava-los	cantarolar+V.ele.ACC.3.M.PL+IMPF+2+SG
cantarolava-me	cantarolar+V.eu.AD.1.SG+IMPF+1+SG
cantarolava-me	cantarolar+V.eu.AD.1.SG+IMPF+3+SG
cantarolavam-lhe	cantarolar+V.ele.DAT.3.SG+IMPF+3+PL
cantarolavam-lhes	cantarolar+V.ele.DAT.3.PL+IMPF+3+PL
cantarolavam-me	cantarolar+V.eu.AD.1.SG+IMPF+3+PL
cantarolavam-na	cantarolar+V.ele.ACC.3.F.SG+IMPF+3+PL
cantarolavam-nas	cantarolar+V.ele.ACC.3.F.PL+IMPF+3+PL
cantarolavam-no	cantarolar+V.ele.ACC.3.M.SG+IMPF+3+PL
cantarolavam-nos	cantarolar+V.ele.ACC.3.M.PL+IMPF+3+PL
cantarolavam-nos	cantarolar+V.nós.AD.1.PL+IMPF+3+PL
cantarolávamo-la	cantarolar+V.ele.ACC.3.F.SG+IMPF+1+PL
cantarolávamo-las	cantarolar+V.ele.ACC.3.F.PL+IMPF+1+PL
cantarolávamo-lo	cantarolar+V.ele.ACC.3.M.SG+IMPF+1+PL
cantarolávamo-los	cantarolar+V.ele.ACC.3.M.PL+IMPF+1+PL
cantarolávamo-nos	cantarolar+nós.AD.1.PL+IMPF+1+PL
cantarolávamos-lhe	cantarolar+V.ele.DAT.3.SG+IMPF+1+PL
cantarolávamos-lhes	cantarolar+V.ele.DAT.3.PL+IMPF+1+PL
cantarolávamos-me	cantarolar+V.eu.AD.1.SG+IMPF+1+PL
cantarolávamos-te	cantarolar+V.tu.AD.2.SG+IMPF+1+PL
cantarolávamos-vos	cantarolar+V.vós.AD.2.PL+IMPF+1+PL
cantarolavam-se	cantarolar+V.ele.REFL+IMPF+3+PL
cantarolavam-te	cantarolar+V.tu.AD.2.SG+IMPF+3+PL
cantarolavam-vos	cantarolar+V.vós.AD.2.PL+IMPF+3+PL
cantarolava-nos	cantarolar+nós.AD.1.PL+IMPF+1+SG
cantarolava-nos	cantarolar+nós.AD.1.PL+IMPF+2+SG
cantarolava-nos	cantarolar+nós.AD.1.PL+IMPF+3+SG
cantarolava-o	cantarolar+V.ele.ACC.3.M.SG+IMPF+1+SG
cantarolava-o	cantarolar+V.ele.ACC.3.M.SG+IMPF+3+SG
cantarolava-os	cantarolar+V.ele.ACC.3.M.PL+IMPF+1+SG
cantarolava-os	cantarolar+V.ele.ACC.3.M.PL+IMPF+3+SG
cantarolava-se	cantarolar+V.ele.REFL+IMPF+1+SG
cantarolava-se	cantarolar+V.ele.REFL+IMPF+3+SG
cantarolavas-lhe	cantarolar+V.ele.DAT.3.SG+IMPF+2+SG
cantarolavas-lhes	cantarolar+V.ele.DAT.3.PL+IMPF+2+SG
cantarolavas-me	cantarolar+V.eu.AD.1.SG+IMPF+2+SG
cantarolavas-te	cantarolar+V.tu.AD.2.SG+IMPF+2+SG
cantarolavas-vos	cantarolar+V.vós.AD.2.PL+IMPF+2+SG
cantarolava-te	cantarolar+V.tu.AD.2.SG+IMPF+1+SG
cantarolava-te	cantarolar+V.tu.AD.2.SG+IMPF+3+SG
cantarolava-vos	cantarolar+V.vós.AD.2.PL+IMPF+1+SG
cantarolava-vos	cantarolar+V.vós.AD.2.PL+IMPF+3+SG
cantarolávei-la	cantarolar+V.ele.ACC.3.F.SG+IMPF+2+PL
cantarolávei-las	cantarolar+V.ele.ACC.3.F.PL+IMPF+2+PL
cantarolávei-lo	cantarolar+V.ele.ACC.3.M.SG+IMPF+2+PL
cantarolávei-los	cantarolar+V.ele.ACC.3.M.PL+IMPF+2+PL
cantarolávei-nos	cantarolar+nós.AD.1.PL+IMPF+2+PL
cantaroláveis-lhe	cantarolar+V.ele.DAT.3.SG+IMPF+2+PL
cantaroláveis-lhes	cantarolar+V.ele.DAT.3.PL+IMPF+2+PL
cantaroláveis-me	cantarolar+V.eu.AD.1.SG+IMPF+2+PL
cantaroláveis-te	cantarolar+V.tu.AD.2.SG+IMPF+2+PL
cantaroláveis-vos	cantarolar+V.vós.AD.2.PL+IMPF+2+PL
cantarola-vos	cantarolar+V.vós.AD.2.PL+PRS+3+SG
cantarole-a	cantarolar+V.ele.ACC.3.F.SG+IMP+3+SG
cantarole-as	cantarolar+V.ele.ACC.3.F.PL+IMP+3+SG
cantarolei-a	cantarolar+V.ele.ACC.3.F.SG+PRF+1+SG
cantarolei-as	cantarolar+V.ele.ACC.3.F.PL+PRF+1+SG
cantarolei-lhe	cantarolar+V.ele.DAT.3.SG+PRF+1+SG
cantarolei-lhes	cantarolar+V.ele.DAT.3.PL+PRF+1+SG
cantarolei-me	cantarolar+V.eu.AD.1.SG+PRF+1+SG
cantarolei-nos	cantarolar+nós.AD.1.PL+PRF+1+SG
cantarolei-o	cantarolar+V.ele.ACC.3.M.SG+PRF+1+SG
cantarolei-os	cantarolar+V.ele.ACC.3.M.PL+PRF+1+SG
cantarolei-te	cantarolar+V.tu.AD.2.SG+PRF+1+SG
cantarolei-vos	cantarolar+V.vós.AD.2.PL+PRF+1+SG
cantarole-lhe	cantarolar+V.ele.DAT.3.SG+IMP+3+SG
cantarole-lhes	cantarolar+V.ele.DAT.3.PL+IMP+3+SG
cantarole-me	cantarolar+V.eu.AD.1.SG+IMP+3+SG
cantarolem-lhe	cantarolar+V.ele.DAT.3.SG+IMP+3+PL
cantarolem-lhes	cantarolar+V.ele.DAT.3.PL+IMP+3+PL
cantarolem-me	cantarolar+V.eu.AD.1.SG+IMP+3+PL
cantarolem-na	cantarolar+V.ele.ACC.3.F.SG+IMP+3+PL
cantarolem-nas	cantarolar+V.ele.ACC.3.F.PL+IMP+3+PL
cantarolem-no	cantarolar+V.ele.ACC.3.M.SG+IMP+3+PL
cantarolem-nos	cantarolar+V.ele.ACC.3.M.PL+IMP+3+PL
cantarolem-nos	cantarolar+V.nós.AD.1.PL+IMP+3+PL
cantarolemo-la	cantarolar+V.ele.ACC.3.F.SG+IMP+1+PL
cantarolemo-las	cantarolar+V.ele.ACC.3.F.PL+IMP+1+PL
cantarolemo-lo	cantarolar+V.ele.ACC.3.M.SG+IMP+1+PL
cantarolemo-los	cantarolar+V.ele.ACC.3.M.PL+IMP+1+PL
cantarolemo-nos	cantarolar+nós.AD.1.PL+IMP+1+PL
cantarolemos-lhe	cantarolar+V.ele.DAT.3.SG+IMP+1+PL
cantarolemos-lhes	cantarolar+V.ele.DAT.3.PL+IMP+1+PL
cantarolemos-me	cantarolar+V.eu.AD.1.SG+IMP+1+PL
cantarolemos-te	cantarolar+V.tu.AD.2.SG+IMP+1+PL
cantarolemos-vos	cantarolar+V.vós.AD.2.PL+IMP+1+PL
cantarolem-se	cantarolar+V.ele.REFL+IMP+3+PL
cantarolem-te	cantarolar+V.tu.AD.2.SG+IMP+3+PL
cantarolem-vos	cantarolar+V.vós.AD.2.PL+IMP+3+PL
cantarole-nos	cantarolar+nós.AD.1.PL+IMP+3+SG
cantarole-o	cantarolar+V.ele.ACC.3.M.SG+IMP+3+SG
cantarole-os	cantarolar+V.ele.ACC.3.M.PL+IMP+3+SG
cantarole-se	cantarolar+V.ele.REFL+IMP+3+SG
cantarole-te	cantarolar+V.tu.AD.2.SG+IMP+3+SG
cantarole-vos	cantarolar+V.vós.AD.2.PL+IMP+3+SG
cantarolo-a	cantarolar+V.ele.ACC.3.F.SG+PRS+1+SG
cantarolo-as	cantarolar+V.ele.ACC.3.F.PL+PRS+1+SG
cantarolo-lhe	cantarolar+V.ele.DAT.3.SG+PRS+1+SG
cantarolo-lhes	cantarolar+V.ele.DAT.3.PL+PRS+1+SG
cantarolo-me	cantarolar+V.eu.AD.1.SG+PRS+1+SG
cantarolo-nos	cantarolar+nós.AD.1.PL+PRS+1+SG
cantarolo-o	cantarolar+V.ele.ACC.3.M.SG+PRS+1+SG
cantarolo-os	cantarolar+V.ele.ACC.3.M.PL+PRS+1+SG
cantarolo-te	cantarolar+V.tu.AD.2.SG+PRS+1+SG
cantarolou-a	cantarolar+V.ele.ACC.3.F.SG+PRF+3+SG
cantarolou-as	cantarolar+V.ele.ACC.3.F.PL+PRF+3+SG
cantarolou-lhe	cantarolar+V.ele.DAT.3.SG+PRF+3+SG
cantarolou-lhes	cantarolar+V.ele.DAT.3.PL+PRF+3+SG
cantarolou-me	cantarolar+V.eu.AD.1.SG+PRF+3+SG
cantarolou-nos	cantarolar+nós.AD.1.PL+PRF+3+SG
cantarolou-o	cantarolar+V.ele.ACC.3.M.SG+PRF+3+SG
cantarolou-os	cantarolar+V.ele.ACC.3.M.PL+PRF+3+SG
cantarolou-se	cantarolar+V.ele.REFL+PRF+3+SG
cantarolou-te	cantarolar+V.tu.AD.2.SG+PRF+3+SG
cantarolou-vos	cantarolar+V.vós.AD.2.PL+PRF+3+SG
cantarolo-vos	cantarolar+V.vós.AD.2.PL+PRS+1+SG
cantar-se-á	cantar+V.ele.REFL+FUT+3+SG
cantar-se-ão	cantar+V.ele.REFL+FUT+3+PL
cantar-se	cantar+V.ele.REFL+INF
cantar-se	cantar+V.ele.REFL+INF+3+SG
cantar-se	cantar+V.ele.REFL+SBJF+3+SG
cantar-se-ia	cantar+V.ele.REFL+COND+3+SG
cantar-se-iam	cantar+V.ele.REFL+COND+3+PL
cantar-te-á	cantar+V.tu.AD.2.SG+FUT+3+SG
cantar-te-ão	cantar+V.tu.AD.2.SG+FUT+3+PL
cantar-te-ás	cantar+V.tu.AD.2.SG+FUT+2+SG
cantar-te	cantar+V.tu.AD.2.SG+INF
cantar-te	cantar+V.tu.AD.2.SG+INF+1+SG
cantar-te	cantar+V.tu.AD.2.SG+INF+3+SG
cantar-te	cantar+V.tu.AD.2.SG+SBJF+1+SG
cantar-te	cantar+V.tu.AD.2.SG+SBJF+3+SG
cantar-te-ei	cantar+V.tu.AD.2.SG+FUT+1+SG
cantar-te-eis	cantar+V.tu.AD.2.SG+FUT+2+PL
cantar-te-emos	cantar+V.tu.AD.2.SG+FUT+1+PL
cantar-te-ia	cantar+V.tu.AD.2.SG+COND+1+SG
cantar-te-ia	cantar+V.tu.AD.2.SG+COND+3+SG
cantar-te-iam	cantar+V.tu.AD.2.SG+COND+3+PL
cantar-te-íamos	cantar+V.tu.AD.2.SG+COND+1+PL
cantar-te-ias	cantar+V.tu.AD.2.SG+COND+2+SG
cantar-te-íeis	cantar+V.tu.AD.2.SG+COND+2+PL
cantar-vos-á	cantar+V.vós.AD.2.PL+FUT+3+SG
cantar-vos-ão	cantar+V.vós.AD.2.PL+FUT+3+PL
cantar-vos-ás	cantar+V.vós.AD.2.PL+FUT+2+SG
cantar-vos	cantar+V.vós.AD.2.PL+INF
cantar-vos	cantar+V.vós.AD.2.PL+INF+1+SG
cantar-vos	cantar+V.vós.AD.2.PL+INF+3+SG
cantar-vos	cantar+V.vós.AD.2.PL+SBJF+1+SG
cantar-vos	cantar+V.vós.AD.2.PL+SBJF+3+SG
cantar-vos-ei	cantar+V.vós.AD.2.PL+FUT+1+SG
cantar-vos-eis	cantar+V.vós.AD.2.PL+FUT+2+PL
cantar-vos-emos	cantar+V.vós.AD.2.PL+FUT+1+PL
cantar-vos-ia	cantar+V.vós.AD.2.PL+COND+1+SG
cantar-vos-ia	cantar+V.vós.AD.2.PL+COND+3+SG
cantar-vos-iam	cantar+V.vós.AD.2.PL+COND+3+PL
cantar-vos-íamos	cantar+V.vós.AD.2.PL+COND+1+PL
cantar-vos-ias	cantar+V.vós.AD.2.PL+COND+2+SG
cantar-vos-íeis	cantar+V.vós.AD.2.PL+COND+2+PL
canta-se	cantar+V.ele.REFL+PRS+3+SG
cantas-lhe	cantar+V.ele.DAT.3.SG+PRS+2+SG
cantas-lhes	cantar+V.ele.DAT.3.PL+PRS+2+SG
cantas-me	cantar+V.eu.AD.1.SG+PRS+2+SG
cantaste-a	cantar+V.ele.ACC.3.F.SG+PRF+2+SG
cantaste-as	cantar+V.ele.ACC.3.F.PL+PRF+2+SG
cantas-te	cantar+V.tu.AD.2.SG+PRS+2+SG
cantaste-la	cantar+V.ele.ACC.3.F.SG+PRF+2+PL
cantaste-las	cantar+V.ele.ACC.3.F.PL+PRF+2+PL
cantaste-lhe	cantar+V.ele.DAT.3.SG+PRF+2+SG
cantaste-lhes	cantar+V.ele.DAT.3.PL+PRF+2+SG
cantaste-lo	cantar+V.ele.ACC.3.M.SG+PRF+2+PL
cantaste-los	cantar+V.ele.ACC.3.M.PL+PRF+2+PL
cantaste-me	cantar+V.eu.AD.1.SG+PRF+2+SG
cantaste-nos	cantar+nós.AD.1.PL+PRF+2+PL
cantaste-nos	cantar+nós.AD.1.PL+PRF+2+SG
cantaste-o	cantar+V.ele.ACC.3.M.SG+PRF+2+SG
cantaste-os	cantar+V.ele.ACC.3.M.PL+PRF+2+SG
cantastes-lhe	cantar+V.ele.DAT.3.SG+PRF+2+PL
cantastes-lhes	cantar+V.ele.DAT.3.PL+PRF+2+PL
cantastes-me	cantar+V.eu.AD.1.SG+PRF+2+PL
cantastes-te	cantar+V.tu.AD.2.SG+PRF+2+PL
cantastes-vos	cantar+V.vós.AD.2.PL+PRF+2+PL
cantaste-te	cantar+V.tu.AD.2.SG+PRF+2+SG
cantaste-vos	cantar+V.vós.AD.2.PL+PRF+2+SG
cantas-vos	cantar+V.vós.AD.2.PL+PRS+2+SG
canta-te	cantar+V.tu.AD.2.SG+PRS+3+SG
cantava-a	cantar+V.ele.ACC.3.F.SG+IMPF+1+SG
cantava-a	cantar+V.ele.ACC.3.F.SG+IMPF+3+SG
cantava-as	cantar+V.ele.ACC.3.F.PL+IMPF+1+SG
cantava-as	cantar+V.ele.ACC.3.F.PL+IMPF+3+SG
cantava-la	cantar+V.ele.ACC.3.F.SG+IMPF+2+SG
cantava-las	cantar+V.ele.ACC.3.F.PL+IMPF+2+SG
cantava-lhe	cantar+V.ele.DAT.3.SG+IMPF+1+SG
cantava-lhe	cantar+V.ele.DAT.3.SG+IMPF+3+SG
cantava-lhes	cantar+V.ele.DAT.3.PL+IMPF+1+SG
cantava-lhes	cantar+V.ele.DAT.3.PL+IMPF+3+SG
cantava-lo	cantar+V.ele.ACC.3.M.SG+IMPF+2+SG
cantava-los	cantar+V.ele.ACC.3.M.PL+IMPF+2+SG
cantava-me	cantar+V.eu.AD.1.SG+IMPF+1+SG
cantava-me	cantar+V.eu.AD.1.SG+IMPF+3+SG
cantavam-lhe	cantar+V.ele.DAT.3.SG+IMPF+3+PL
cantavam-lhes	cantar+V.ele.DAT.3.PL+IMPF+3+PL
cantavam-me	cantar+V.eu.AD.1.SG+IMPF+3+PL
cantavam-na	cantar+V.ele.ACC.3.F.SG+IMPF+3+PL
cantavam-nas	cantar+V.ele.ACC.3.F.PL+IMPF+3+PL
cantavam-no	cantar+V.ele.ACC.3.M.SG+IMPF+3+PL
cantavam-nos	cantar+V.ele.ACC.3.M.PL+IMPF+3+PL
cantavam-nos	cantar+V.nós.AD.1.PL+IMPF+3+PL
cantávamo-la	cantar+V.ele.ACC.3.F.SG+IMPF+1+PL
cantávamo-las	cantar+V.ele.ACC.3.F.PL+IMPF+1+PL
cantávamo-lo	cantar+V.ele.ACC.3.M.SG+IMPF+1+PL
cantávamo-los	cantar+V.ele.ACC.3.M.PL+IMPF+1+PL
cantávamo-nos	cantar+nós.AD.1.PL+IMPF+1+PL
cantávamos-lhe	cantar+V.ele.DAT.3.SG+IMPF+1+PL
cantávamos-lhes	cantar+V.ele.DAT.3.PL+IMPF+1+PL
cantávamos-me	cantar+V.eu.AD.1.SG+IMPF+1+PL
cantávamos-te	cantar+V.tu.AD.2.SG+IMPF+1+PL
cantávamos-vos	cantar+V.vós.AD.2.PL+IMPF+1+PL
cantavam-se	cantar+V.ele.REFL+IMPF+3+PL
cantavam-te	cantar+V.tu.AD.2.SG+IMPF+3+PL
cantavam-vos	cantar+V.vós.AD.2.PL+IMPF+3+PL
cantava-nos	cantar+nós.AD.1.PL+IMPF+1+SG
cantava-nos	cantar+nós.AD.1.PL+IMPF+2+SG
cantava-nos	cantar+nós.AD.1.PL+IMPF+3+SG
cantava-o	cantar+V.ele.ACC.3.M.SG+IMPF+1+SG
cantava-o	cantar+V.ele.ACC.3.M.SG+IMPF+3+SG
cantava-os	cantar+V.ele.ACC.3.M.PL+IMPF+1+SG
cantava-os	cantar+V.ele.ACC.3.M.PL+IMPF+3+SG
cantava-se	cantar+V.ele.REFL+IMPF+1+SG
cantava-se	cantar+V.ele.REFL+IMPF+3+SG
cantavas-lhe	cantar+V.ele.DAT.3.SG+IMPF+2+SG
cantavas-lhes	cantar+V.ele.DAT.3.PL+IMPF+2+SG
cantavas-me	cantar+V.eu.AD.1.SG+IMPF+2+SG
cantavas-te	cantar+V.tu.AD.2.SG+IMPF+2+SG
cantavas-vos	cantar+V.vós.AD.2.PL+IMPF+2+SG
cantava-te	cantar+V.tu.AD.2.SG+IMPF+1+SG
cantava-te	cantar+V.tu.AD.2.SG+IMPF+3+SG
cantava-vos	cantar+V.vós.AD.2.PL+IMPF+1+SG
cantava-vos	cantar+V.vós.AD.2.PL+IMPF+3+SG
cantávei-la	cantar+V.ele.ACC.3.F.SG+IMPF+2+PL
cantávei-las	cantar+V.ele.ACC.3.F.PL+IMPF+2+PL
cantávei-lo	cantar+V.ele.ACC.3.M.SG+IMPF+2+PL
cantávei-los	cantar+V.ele.ACC.3.M.PL+IMPF+2+PL
cantávei-nos	cantar+nós.AD.1.PL+IMPF+2+PL
cantáveis-lhe	cantar+V.ele.DAT.3.SG+IMPF+2+PL
cantáveis-lhes	cantar+V.ele.DAT.3.PL+IMPF+2+PL
cantáveis-me	cantar+V.eu.AD.1.SG+IMPF+2+PL
cantáveis-te	cantar+V.tu.AD.2.SG+IMPF+2+PL
cantáveis-vos	cantar+V.vós.AD.2.PL+IMPF+2+PL
canta-vos	cantar+V.vós.AD.2.PL+PRS+3+SG
cante-a	cantar+V.ele.ACC.3.F.SG+IMP+3+SG
canteai-la	cantear+V.ele.ACC.3.F.SG+PRS+2+PL
canteai-las	cantear+V.ele.ACC.3.F.PL+PRS+2+PL
canteai-lo	cantear+V.ele.ACC.3.M.SG+PRS+2+PL
canteai-los	cantear+V.ele.ACC.3.M.PL+PRS+2+PL
canteai-nos	cantear+nós.AD.1.PL+PRS+2+PL
canteais-lhe	cantear+V.ele.DAT.3.SG+PRS+2+PL
canteais-lhes	cantear+V.ele.DAT.3.PL+PRS+2+PL
canteais-me	cantear+V.eu.AD.1.SG+PRS+2+PL
canteais-te	cantear+V.tu.AD.2.SG+PRS+2+PL
canteais-vos	cantear+V.vós.AD.2.PL+PRS+2+PL
canteá-la-á	cantear+V.ele.ACC.3.F.SG+FUT+3+SG
canteá-la-ão	cantear+V.ele.ACC.3.F.SG+FUT+3+PL
canteá-la-ás	cantear+V.ele.ACC.3.F.SG+FUT+2+SG
canteá-la	cantear+V.ele.ACC.3.F.SG+INF+1+SG
canteá-la	cantear+V.ele.ACC.3.F.SG+INF+3+SG
canteá-la	cantear+V.ele.ACC.3.F.SG+SBJF+1+SG
canteá-la	cantear+V.ele.ACC.3.F.SG+SBJF+3+SG
canteá-la-ei	cantear+V.ele.ACC.3.F.SG+FUT+1+SG
canteá-la-eis	cantear+V.ele.ACC.3.F.SG+FUT+2+PL
canteá-la-emos	cantear+V.ele.ACC.3.F.SG+FUT+1+PL
canteá-la-ia	cantear+V.ele.ACC.3.F.SG+COND+1+SG
canteá-la-ia	cantear+V.ele.ACC.3.F.SG+COND+3+SG
canteá-la-iam	cantear+V.ele.ACC.3.F.SG+COND+3+PL
canteá-la-íamos	cantear+V.ele.ACC.3.F.SG+COND+1+PL
canteá-la-ias	cantear+V.ele.ACC.3.F.SG+COND+2+SG
canteá-la-íeis	cantear+V.ele.ACC.3.F.SG+COND+2+PL
canteá-las-á	cantear+V.ele.ACC.3.F.PL+FUT+3+SG
canteá-las-ão	cantear+V.ele.ACC.3.F.PL+FUT+3+PL
canteá-las-ás	cantear+V.ele.ACC.3.F.PL+FUT+2+SG
canteá-las	cantear+V.ele.ACC.3.F.PL+INF+1+SG
canteá-las	cantear+V.ele.ACC.3.F.PL+INF+3+SG
canteá-las	cantear+V.ele.ACC.3.F.PL+SBJF+1+SG
canteá-las	cantear+V.ele.ACC.3.F.PL+SBJF+3+SG
canteá-las-ei	cantear+V.ele.ACC.3.F.PL+FUT+1+SG
canteá-las-eis	cantear+V.ele.ACC.3.F.PL+FUT+2+PL
canteá-las-emos	cantear+V.ele.ACC.3.F.PL+FUT+1+PL
canteá-las-ia	cantear+V.ele.ACC.3.F.PL+COND+1+SG
canteá-las-ia	cantear+V.ele.ACC.3.F.PL+COND+3+SG
canteá-las-iam	cantear+V.ele.ACC.3.F.PL+COND+3+PL
canteá-las-íamos	cantear+V.ele.ACC.3.F.PL+COND+1+PL
canteá-las-ias	cantear+V.ele.ACC.3.F.PL+COND+2+SG
canteá-las-íeis	cantear+V.ele.ACC.3.F.PL+COND+2+PL
canteá-lo-á	cantear+V.ele.ACC.3.M.SG+FUT+3+SG
canteá-lo-ão	cantear+V.ele.ACC.3.M.SG+FUT+3+PL
canteá-lo-ás	cantear+V.ele.ACC.3.M.SG+FUT+2+SG
canteá-lo	cantear+V.ele.ACC.3.M.SG+INF+1+SG
canteá-lo	cantear+V.ele.ACC.3.M.SG+INF+3+SG
canteá-lo	cantear+V.ele.ACC.3.M.SG+SBJF+1+SG
canteá-lo	cantear+V.ele.ACC.3.M.SG+SBJF+3+SG
canteá-lo-ei	cantear+V.ele.ACC.3.M.SG+FUT+1+SG
canteá-lo-eis	cantear+V.ele.ACC.3.M.SG+FUT+2+PL
canteá-lo-emos	cantear+V.ele.ACC.3.M.SG+FUT+1+PL
canteá-lo-ia	cantear+V.ele.ACC.3.M.SG+COND+1+SG
canteá-lo-ia	cantear+V.ele.ACC.3.M.SG+COND+3+SG
canteá-lo-iam	cantear+V.ele.ACC.3.M.SG+COND+3+PL
canteá-lo-íamos	cantear+V.ele.ACC.3.M.SG+COND+1+PL
canteá-lo-ias	cantear+V.ele.ACC.3.M.SG+COND+2+SG
canteá-lo-íeis	cantear+V.ele.ACC.3.M.SG+COND+2+PL
canteá-los-á	cantear+V.ele.ACC.3.M.PL+FUT+3+SG
canteá-los-ão	cantear+V.ele.ACC.3.M.PL+FUT+3+PL
canteá-los-ás	cantear+V.ele.ACC.3.M.PL+FUT+2+SG
canteá-los	cantear+V.ele.ACC.3.M.PL+INF+1+SG
canteá-los	cantear+V.ele.ACC.3.M.PL+INF+3+SG
canteá-los	cantear+V.ele.ACC.3.M.PL+SBJF+1+SG
canteá-los	cantear+V.ele.ACC.3.M.PL+SBJF+3+SG
canteá-los-ei	cantear+V.ele.ACC.3.M.PL+FUT+1+SG
canteá-los-eis	cantear+V.ele.ACC.3.M.PL+FUT+2+PL
canteá-los-emos	cantear+V.ele.ACC.3.M.PL+FUT+1+PL
canteá-los-ia	cantear+V.ele.ACC.3.M.PL+COND+1+SG
canteá-los-ia	cantear+V.ele.ACC.3.M.PL+COND+3+SG
canteá-los-iam	cantear+V.ele.ACC.3.M.PL+COND+3+PL
canteá-los-íamos	cantear+V.ele.ACC.3.M.PL+COND+1+PL
canteá-los-ias	cantear+V.ele.ACC.3.M.PL+COND+2+SG
canteá-los-íeis	cantear+V.ele.ACC.3.M.PL+COND+2+PL
canteamo-la	cantear+V.ele.ACC.3.F.SG+PRF+1+PL
canteamo-la	cantear+V.ele.ACC.3.F.SG+PRS+1+PL
canteamo-las	cantear+V.ele.ACC.3.F.PL+PRF+1+PL
canteamo-las	cantear+V.ele.ACC.3.F.PL+PRS+1+PL
canteamo-lo	cantear+V.ele.ACC.3.M.SG+PRF+1+PL
canteamo-lo	cantear+V.ele.ACC.3.M.SG+PRS+1+PL
canteamo-los	cantear+V.ele.ACC.3.M.PL+PRF+1+PL
canteamo-los	cantear+V.ele.ACC.3.M.PL+PRS+1+PL
canteamo-nos	cantear+nós.AD.1.PL+PRF+1+PL
canteamo-nos	cantear+nós.AD.1.PL+PRS+1+PL
canteamos-lhe	cantear+V.ele.DAT.3.SG+PRF+1+PL
canteamos-lhe	cantear+V.ele.DAT.3.SG+PRS+1+PL
canteamos-lhes	cantear+V.ele.DAT.3.PL+PRF+1+PL
canteamos-lhes	cantear+V.ele.DAT.3.PL+PRS+1+PL
canteamos-me	cantear+V.eu.AD.1.SG+PRF+1+PL
canteamos-me	cantear+V.eu.AD.1.SG+PRS+1+PL
canteamos-te	cantear+V.tu.AD.2.SG+PRF+1+PL
canteamos-te	cantear+V.tu.AD.2.SG+PRS+1+PL
canteamos-vos	cantear+V.vós.AD.2.PL+PRF+1+PL
canteamos-vos	cantear+V.vós.AD.2.PL+PRS+1+PL
canteando-a	cantear+V.ele.ACC.3.F.SG+GRD
canteando-as	cantear+V.ele.ACC.3.F.PL+GRD
canteando-lhe	cantear+V.ele.DAT.3.SG+GRD
canteando-lhes	cantear+V.ele.DAT.3.PL+GRD
canteando-me	cantear+V.eu.AD.1.SG+GRD
canteando-nos	cantear+nós.AD.1.PL+GRD
canteando-o	cantear+V.ele.ACC.3.M.SG+GRD
canteando-os	cantear+V.ele.ACC.3.M.PL+GRD
canteando-se	cantear+V.ele.REFL+GRD
canteando-te	cantear+V.tu.AD.2.SG+GRD
canteando-vos	cantear+V.vós.AD.2.PL+GRD
canteara-a	cantear+V.ele.ACC.3.F.SG+PQP+1+SG
canteara-a	cantear+V.ele.ACC.3.F.SG+PQP+3+SG
canteara-as	cantear+V.ele.ACC.3.F.PL+PQP+1+SG
canteara-as	cantear+V.ele.ACC.3.F.PL+PQP+3+SG
canteara-la	cantear+V.ele.ACC.3.F.SG+PQP+2+SG
canteara-las	cantear+V.ele.ACC.3.F.PL+PQP+2+SG
canteara-lhe	cantear+V.ele.DAT.3.SG+PQP+1+SG
canteara-lhe	cantear+V.ele.DAT.3.SG+PQP+3+SG
canteara-lhes	cantear+V.ele.DAT.3.PL+PQP+1+SG
canteara-lhes	cantear+V.ele.DAT.3.PL+PQP+3+SG
canteara-lo	cantear+V.ele.ACC.3.M.SG+PQP+2+SG
canteara-los	cantear+V.ele.ACC.3.M.PL+PQP+2+SG
canteara-me	cantear+V.eu.AD.1.SG+PQP+1+SG
canteara-me	cantear+V.eu.AD.1.SG+PQP+3+SG
cantearam-lhe	cantear+V.ele.DAT.3.SG+PQP+3+PL
cantearam-lhe	cantear+V.ele.DAT.3.SG+PRF+3+PL
cantearam-lhes	cantear+V.ele.DAT.3.PL+PQP+3+PL
cantearam-lhes	cantear+V.ele.DAT.3.PL+PRF+3+PL
cantearam-me	cantear+V.eu.AD.1.SG+PQP+3+PL
cantearam-me	cantear+V.eu.AD.1.SG+PRF+3+PL
cantearam-na	cantear+V.ele.ACC.3.F.SG+PQP+3+PL
cantearam-na	cantear+V.ele.ACC.3.F.SG+PRF+3+PL
cantearam-nas	cantear+V.ele.ACC.3.F.PL+PQP+3+PL
cantearam-nas	cantear+V.ele.ACC.3.F.PL+PRF+3+PL
cantearam-no	cantear+V.ele.ACC.3.M.SG+PQP+3+PL
cantearam-no	cantear+V.ele.ACC.3.M.SG+PRF+3+PL
cantearam-nos	cantear+V.ele.ACC.3.M.PL+PQP+3+PL
cantearam-nos	cantear+V.ele.ACC.3.M.PL+PRF+3+PL
cantearam-nos	cantear+V.nós.AD.1.PL+PQP+3+PL
cantearam-nos	cantear+V.nós.AD.1.PL+PRF+3+PL
canteáramo-la	cantear+V.ele.ACC.3.F.SG+PQP+1+PL
canteáramo-las	cantear+V.ele.ACC.3.F.PL+PQP+1+PL
canteáramo-lo	cantear+V.ele.ACC.3.M.SG+PQP+1+PL
canteáramo-los	cantear+V.ele.ACC.3.M.PL+PQP+1+PL
canteáramo-nos	cantear+nós.AD.1.PL+PQP+1+PL
canteáramos-lhe	cantear+V.ele.DAT.3.SG+PQP+1+PL
canteáramos-lhes	cantear+V.ele.DAT.3.PL+PQP+1+PL
canteáramos-me	cantear+V.eu.AD.1.SG+PQP+1+PL
canteáramos-te	cantear+V.tu.AD.2.SG+PQP+1+PL
canteáramos-vos	cantear+V.vós.AD.2.PL+PQP+1+PL
cantearam-se	cantear+V.ele.REFL+PQP+3+PL
cantearam-se	cantear+V.ele.REFL+PRF+3+PL
cantearam-te	cantear+V.tu.AD.2.SG+PQP+3+PL
cantearam-te	cantear+V.tu.AD.2.SG+PRF+3+PL
cantearam-vos	cantear+V.vós.AD.2.PL+PQP+3+PL
cantearam-vos	cantear+V.vós.AD.2.PL+PRF+3+PL
canteara-nos	cantear+nós.AD.1.PL+PQP+1+SG
canteara-nos	cantear+nós.AD.1.PL+PQP+2+SG
canteara-nos	cantear+nós.AD.1.PL+PQP+3+SG
canteara-o	cantear+V.ele.ACC.3.M.SG+PQP+1+SG
canteara-o	cantear+V.ele.ACC.3.M.SG+PQP+3+SG
canteara-os	cantear+V.ele.ACC.3.M.PL+PQP+1+SG
canteara-os	cantear+V.ele.ACC.3.M.PL+PQP+3+SG
canteara-se	cantear+V.ele.REFL+PQP+1+SG
canteara-se	cantear+V.ele.REFL+PQP+3+SG
cantearas-lhe	cantear+V.ele.DAT.3.SG+PQP+2+SG
cantearas-lhes	cantear+V.ele.DAT.3.PL+PQP+2+SG
cantearas-me	cantear+V.eu.AD.1.SG+PQP+2+SG
cantearas-te	cantear+V.tu.AD.2.SG+PQP+2+SG
cantearas-vos	cantear+V.vós.AD.2.PL+PQP+2+SG
canteara-te	cantear+V.tu.AD.2.SG+PQP+1+SG
canteara-te	cantear+V.tu.AD.2.SG+PQP+3+SG
canteara-vos	cantear+V.vós.AD.2.PL+PQP+1+SG
canteara-vos	cantear+V.vós.AD.2.PL+PQP+3+SG
cantearde-la	cantear+V.ele.ACC.3.F.SG+INF+2+PL
cantearde-la	cantear+V.ele.ACC.3.F.SG+SBJF+2+PL
cantearde-las	cantear+V.ele.ACC.3.F.PL+INF+2+PL
cantearde-las	cantear+V.ele.ACC.3.F.PL+SBJF+2+PL
cantearde-lo	cantear+V.ele.ACC.3.M.SG+INF+2+PL
cantearde-lo	cantear+V.ele.ACC.3.M.SG+SBJF+2+PL
cantearde-los	cantear+V.ele.ACC.3.M.PL+INF+2+PL
cantearde-los	cantear+V.ele.ACC.3.M.PL+SBJF+2+PL
cantearde-nos	cantear+nós.AD.1.PL+INF+2+PL
cantearde-nos	cantear+nós.AD.1.PL+SBJF+2+PL
canteardes-lhe	cantear+V.ele.DAT.3.SG+INF+2+PL
canteardes-lhe	cantear+V.ele.DAT.3.SG+SBJF+2+PL
canteardes-lhes	cantear+V.ele.DAT.3.PL+INF+2+PL
canteardes-lhes	cantear+V.ele.DAT.3.PL+SBJF+2+PL
canteardes-me	cantear+V.eu.AD.1.SG+INF+2+PL
canteardes-me	cantear+V.eu.AD.1.SG+SBJF+2+PL
canteardes-te	cantear+V.tu.AD.2.SG+INF+2+PL
canteardes-te	cantear+V.tu.AD.2.SG+SBJF+2+PL
canteardes-vos	cantear+V.vós.AD.2.PL+INF+2+PL
canteardes-vos	cantear+V.vós.AD.2.PL+SBJF+2+PL
canteárei-la	cantear+V.ele.ACC.3.F.SG+PQP+2+PL
canteárei-las	cantear+V.ele.ACC.3.F.PL+PQP+2+PL
canteárei-lo	cantear+V.ele.ACC.3.M.SG+PQP+2+PL
canteárei-los	cantear+V.ele.ACC.3.M.PL+PQP+2+PL
canteárei-nos	cantear+nós.AD.1.PL+PQP+2+PL
canteáreis-lhe	cantear+V.ele.DAT.3.SG+PQP+2+PL
canteáreis-lhes	cantear+V.ele.DAT.3.PL+PQP+2+PL
canteáreis-me	cantear+V.eu.AD.1.SG+PQP+2+PL
canteáreis-te	cantear+V.tu.AD.2.SG+PQP+2+PL
canteáreis-vos	cantear+V.vós.AD.2.PL+PQP+2+PL
canteare-la	cantear+V.ele.ACC.3.F.SG+INF+2+SG
canteare-la	cantear+V.ele.ACC.3.F.SG+SBJF+2+SG
canteare-las	cantear+V.ele.ACC.3.F.PL+INF+2+SG
canteare-las	cantear+V.ele.ACC.3.F.PL+SBJF+2+SG
canteare-lo	cantear+V.ele.ACC.3.M.SG+INF+2+SG
canteare-lo	cantear+V.ele.ACC.3.M.SG+SBJF+2+SG
canteare-los	cantear+V.ele.ACC.3.M.PL+INF+2+SG
canteare-los	cantear+V.ele.ACC.3.M.PL+SBJF+2+SG
cantearem-lhe	cantear+V.ele.DAT.3.SG+INF+3+PL
cantearem-lhe	cantear+V.ele.DAT.3.SG+SBJF+3+PL
cantearem-lhes	cantear+V.ele.DAT.3.PL+INF+3+PL
cantearem-lhes	cantear+V.ele.DAT.3.PL+SBJF+3+PL
cantearem-me	cantear+V.eu.AD.1.SG+INF+3+PL
cantearem-me	cantear+V.eu.AD.1.SG+SBJF+3+PL
cantearem-na	cantear+V.ele.ACC.3.F.SG+INF+3+PL
cantearem-na	cantear+V.ele.ACC.3.F.SG+SBJF+3+PL
cantearem-nas	cantear+V.ele.ACC.3.F.PL+INF+3+PL
cantearem-nas	cantear+V.ele.ACC.3.F.PL+SBJF+3+PL
cantearem-no	cantear+V.ele.ACC.3.M.SG+INF+3+PL
cantearem-no	cantear+V.ele.ACC.3.M.SG+SBJF+3+PL
cantearem-nos	cantear+V.ele.ACC.3.M.PL+INF+3+PL
cantearem-nos	cantear+V.ele.ACC.3.M.PL+SBJF+3+PL
cantearem-nos	cantear+V.nós.AD.1.PL+INF+3+PL
cantearem-nos	cantear+V.nós.AD.1.PL+SBJF+3+PL
cantearem-se	cantear+V.ele.REFL+INF+3+PL
cantearem-se	cantear+V.ele.REFL+SBJF+3+PL
cantearem-te	cantear+V.tu.AD.2.SG+INF+3+PL
cantearem-te	cantear+V.tu.AD.2.SG+SBJF+3+PL
cantearem-vos	cantear+V.vós.AD.2.PL+INF+3+PL
cantearem-vos	cantear+V.vós.AD.2.PL+SBJF+3+PL
canteare-nos	cantear+nós.AD.1.PL+INF+2+SG
canteare-nos	cantear+nós.AD.1.PL+SBJF+2+SG
canteares-lhe	cantear+V.ele.DAT.3.SG+INF+2+SG
canteares-lhe	cantear+V.ele.DAT.3.SG+SBJF+2+SG
canteares-lhes	cantear+V.ele.DAT.3.PL+INF+2+SG
canteares-lhes	cantear+V.ele.DAT.3.PL+SBJF+2+SG
canteares-me	cantear+V.eu.AD.1.SG+INF+2+SG
canteares-me	cantear+V.eu.AD.1.SG+SBJF+2+SG
canteares-te	cantear+V.tu.AD.2.SG+INF+2+SG
canteares-te	cantear+V.tu.AD.2.SG+SBJF+2+SG
canteares-vos	cantear+V.vós.AD.2.PL+INF+2+SG
canteares-vos	cantear+V.vós.AD.2.PL+SBJF+2+SG
cantear-lhe-á	cantear+V.ele.DAT.3.SG+FUT+3+SG
cantear-lhe-ão	cantear+V.ele.DAT.3.SG+FUT+3+PL
cantear-lhe-ás	cantear+V.ele.DAT.3.SG+FUT+2+SG
cantear-lhe	cantear+V.ele.DAT.3.SG+INF
cantear-lhe	cantear+V.ele.DAT.3.SG+INF+1+SG
cantear-lhe	cantear+V.ele.DAT.3.SG+INF+3+SG
cantear-lhe	cantear+V.ele.DAT.3.SG+SBJF+1+SG
cantear-lhe	cantear+V.ele.DAT.3.SG+SBJF+3+SG
cantear-lhe-ei	cantear+V.ele.DAT.3.SG+FUT+1+SG
cantear-lhe-eis	cantear+V.ele.DAT.3.SG+FUT+2+PL
cantear-lhe-emos	cantear+V.ele.DAT.3.SG+FUT+1+PL
cantear-lhe-ia	cantear+V.ele.DAT.3.SG+COND+1+SG
cantear-lhe-ia	cantear+V.ele.DAT.3.SG+COND+3+SG
cantear-lhe-iam	cantear+V.ele.DAT.3.SG+COND+3+PL
cantear-lhe-íamos	cantear+V.ele.DAT.3.SG+COND+1+PL
cantear-lhe-ias	cantear+V.ele.DAT.3.SG+COND+2+SG
cantear-lhe-íeis	cantear+V.ele.DAT.3.SG+COND+2+PL
cantear-lhes-á	cantear+V.ele.DAT.3.PL+FUT+3+SG
cantear-lhes-ão	cantear+V.ele.DAT.3.PL+FUT+3+PL
cantear-lhes-ás	cantear+V.ele.DAT.3.PL+FUT+2+SG
cantear-lhes	cantear+V.ele.DAT.3.PL+INF
cantear-lhes	cantear+V.ele.DAT.3.PL+INF+1+SG
cantear-lhes	cantear+V.ele.DAT.3.PL+INF+3+SG
cantear-lhes	cantear+V.ele.DAT.3.PL+SBJF+1+SG
cantear-lhes	cantear+V.ele.DAT.3.PL+SBJF+3+SG
cantear-lhes-ei	cantear+V.ele.DAT.3.PL+FUT+1+SG
cantear-lhes-eis	cantear+V.ele.DAT.3.PL+FUT+2+PL
cantear-lhes-emos	cantear+V.ele.DAT.3.PL+FUT+1+PL
cantear-lhes-ia	cantear+V.ele.DAT.3.PL+COND+1+SG
cantear-lhes-ia	cantear+V.ele.DAT.3.PL+COND+3+SG
cantear-lhes-iam	cantear+V.ele.DAT.3.PL+COND+3+PL
cantear-lhes-íamos	cantear+V.ele.DAT.3.PL+COND+1+PL
cantear-lhes-ias	cantear+V.ele.DAT.3.PL+COND+2+SG
cantear-lhes-íeis	cantear+V.ele.DAT.3.PL+COND+2+PL
cantear-me-á	cantear+V.eu.AD.1.SG+FUT+3+SG
cantear-me-ão	cantear+V.eu.AD.1.SG+FUT+3+PL
cantear-me-ás	cantear+V.eu.AD.1.SG+FUT+2+SG
cantear-me	cantear+V.eu.AD.1.SG+INF
cantear-me	cantear+V.eu.AD.1.SG+INF+1+SG
cantear-me	cantear+V.eu.AD.1.SG+INF+3+SG
cantear-me	cantear+V.eu.AD.1.SG+SBJF+1+SG
cantear-me	cantear+V.eu.AD.1.SG+SBJF+3+SG
cantear-me-ei	cantear+V.eu.AD.1.SG+FUT+1+SG
cantear-me-eis	cantear+V.eu.AD.1.SG+FUT+2+PL
cantear-me-emos	cantear+V.eu.AD.1.SG+FUT+1+PL
cantear-me-ia	cantear+V.eu.AD.1.SG+COND+1+SG
cantear-me-ia	cantear+V.eu.AD.1.SG+COND+3+SG
cantear-me-iam	cantear+V.eu.AD.1.SG+COND+3+PL
cantear-me-íamos	cantear+V.eu.AD.1.SG+COND+1+PL
cantear-me-ias	cantear+V.eu.AD.1.SG+COND+2+SG
cantear-me-íeis	cantear+V.eu.AD.1.SG+COND+2+PL
cantearmo-la	cantear+V.ele.ACC.3.F.SG+INF+1+PL
cantearmo-la	cantear+V.ele.ACC.3.F.SG+SBJF+1+PL
cantearmo-las	cantear+V.ele.ACC.3.F.PL+INF+1+PL
cantearmo-las	cantear+V.ele.ACC.3.F.PL+SBJF+1+PL
cantearmo-lo	cantear+V.ele.ACC.3.M.SG+INF+1+PL
cantearmo-lo	cantear+V.ele.ACC.3.M.SG+SBJF+1+PL
cantearmo-los	cantear+V.ele.ACC.3.M.PL+INF+1+PL
cantearmo-los	cantear+V.ele.ACC.3.M.PL+SBJF+1+PL
cantearmo-nos	cantear+nós.AD.1.PL+INF+1+PL
cantearmo-nos	cantear+nós.AD.1.PL+SBJF+1+PL
cantearmos-lhe	cantear+V.ele.DAT.3.SG+INF+1+PL
cantearmos-lhe	cantear+V.ele.DAT.3.SG+SBJF+1+PL
cantearmos-lhes	cantear+V.ele.DAT.3.PL+INF+1+PL
cantearmos-lhes	cantear+V.ele.DAT.3.PL+SBJF+1+PL
cantearmos-me	cantear+V.eu.AD.1.SG+INF+1+PL
cantearmos-me	cantear+V.eu.AD.1.SG+SBJF+1+PL
cantearmos-te	cantear+V.tu.AD.2.SG+INF+1+PL
cantearmos-te	cantear+V.tu.AD.2.SG+SBJF+1+PL
cantearmos-vos	cantear+V.vós.AD.2.PL+INF+1+PL
cantearmos-vos	cantear+V.vós.AD.2.PL+SBJF+1+PL
cantear-nos-á	cantear+nós.AD.1.PL+FUT+3+SG
cantear-nos-ão	cantear+nós.AD.1.PL+FUT+3+PL
cantear-nos-ás	cantear+nós.AD.1.PL+FUT+2+SG
cantear-nos	cantear+nós.AD.1.PL+INF
cantear-nos	cantear+nós.AD.1.PL+INF+1+SG
cantear-nos	cantear+nós.AD.1.PL+INF+3+SG
cantear-nos	cantear+nós.AD.1.PL+SBJF+1+SG
cantear-nos	cantear+nós.AD.1.PL+SBJF+3+SG
cantear-nos-ei	cantear+nós.AD.1.PL+FUT+1+SG
cantear-nos-eis	cantear+nós.AD.1.PL+FUT+2+PL
cantear-nos-emos	cantear+nós.AD.1.PL+FUT+1+PL
cantear-nos-ia	cantear+nós.AD.1.PL+COND+1+SG
cantear-nos-ia	cantear+nós.AD.1.PL+COND+3+SG
cantear-nos-iam	cantear+nós.AD.1.PL+COND+3+PL
cantear-nos-íamos	cantear+nós.AD.1.PL+COND+1+PL
cantear-nos-ias	cantear+nós.AD.1.PL+COND+2+SG
cantear-nos-íeis	cantear+nós.AD.1.PL+COND+2+PL
cantear-se-á	cantear+V.ele.REFL+FUT+3+SG
cantear-se-ão	cantear+V.ele.REFL+FUT+3+PL
cantear-se	cantear+V.ele.REFL+INF
cantear-se	cantear+V.ele.REFL+INF+3+SG
cantear-se	cantear+V.ele.REFL+SBJF+3+SG
cantear-se-ia	cantear+V.ele.REFL+COND+3+SG
cantear-se-iam	cantear+V.ele.REFL+COND+3+PL
cantear-te-á	cantear+V.tu.AD.2.SG+FUT+3+SG
cantear-te-ão	cantear+V.tu.AD.2.SG+FUT+3+PL
cantear-te-ás	cantear+V.tu.AD.2.SG+FUT+2+SG
cantear-te	cantear+V.tu.AD.2.SG+INF
cantear-te	cantear+V.tu.AD.2.SG+INF+1+SG
cantear-te	cantear+V.tu.AD.2.SG+INF+3+SG
cantear-te	cantear+V.tu.AD.2.SG+SBJF+1+SG
cantear-te	cantear+V.tu.AD.2.SG+SBJF+3+SG
cantear-te-ei	cantear+V.tu.AD.2.SG+FUT+1+SG
cantear-te-eis	cantear+V.tu.AD.2.SG+FUT+2+PL
cantear-te-emos	cantear+V.tu.AD.2.SG+FUT+1+PL
cantear-te-ia	cantear+V.tu.AD.2.SG+COND+1+SG
cantear-te-ia	cantear+V.tu.AD.2.SG+COND+3+SG
cantear-te-iam	cantear+V.tu.AD.2.SG+COND+3+PL
cantear-te-íamos	cantear+V.tu.AD.2.SG+COND+1+PL
cantear-te-ias	cantear+V.tu.AD.2.SG+COND+2+SG
cantear-te-íeis	cantear+V.tu.AD.2.SG+COND+2+PL
cantear-vos-á	cantear+V.vós.AD.2.PL+FUT+3+SG
cantear-vos-ão	cantear+V.vós.AD.2.PL+FUT+3+PL
cantear-vos-ás	cantear+V.vós.AD.2.PL+FUT+2+SG
cantear-vos	cantear+V.vós.AD.2.PL+INF
cantear-vos	cantear+V.vós.AD.2.PL+INF+1+SG
cantear-vos	cantear+V.vós.AD.2.PL+INF+3+SG
cantear-vos	cantear+V.vós.AD.2.PL+SBJF+1+SG
cantear-vos	cantear+V.vós.AD.2.PL+SBJF+3+SG
cantear-vos-ei	cantear+V.vós.AD.2.PL+FUT+1+SG
cantear-vos-eis	cantear+V.vós.AD.2.PL+FUT+2+PL
cantear-vos-emos	cantear+V.vós.AD.2.PL+FUT+1+PL
cantear-vos-ia	cantear+V.vós.AD.2.PL+COND+1+SG
cantear-vos-ia	cantear+V.vós.AD.2.PL+COND+3+SG
cantear-vos-iam	cantear+V.vós.AD.2.PL+COND+3+PL
cantear-vos-íamos	cantear+V.vós.AD.2.PL+COND+1+PL
cantear-vos-ias	cantear+V.vós.AD.2.PL+COND+2+SG
cantear-vos-íeis	cantear+V.vós.AD.2.PL+COND+2+PL
cante-as	cantar+V.ele.ACC.3.F.PL+IMP+3+SG
canteaste-a	cantear+V.ele.ACC.3.F.SG+PRF+2+SG
canteaste-as	cantear+V.ele.ACC.3.F.PL+PRF+2+SG
canteaste-la	cantear+V.ele.ACC.3.F.SG+PRF+2+PL
canteaste-las	cantear+V.ele.ACC.3.F.PL+PRF+2+PL
canteaste-lhe	cantear+V.ele.DAT.3.SG+PRF+2+SG
canteaste-lhes	cantear+V.ele.DAT.3.PL+PRF+2+SG
canteaste-lo	cantear+V.ele.ACC.3.M.SG+PRF+2+PL
canteaste-los	cantear+V.ele.ACC.3.M.PL+PRF+2+PL
canteaste-me	cantear+V.eu.AD.1.SG+PRF+2+SG
canteaste-nos	cantear+nós.AD.1.PL+PRF+2+PL
canteaste-nos	cantear+nós.AD.1.PL+PRF+2+SG
canteaste-o	cantear+V.ele.ACC.3.M.SG+PRF+2+SG
canteaste-os	cantear+V.ele.ACC.3.M.PL+PRF+2+SG
canteastes-lhe	cantear+V.ele.DAT.3.SG+PRF+2+PL
canteastes-lhes	cantear+V.ele.DAT.3.PL+PRF+2+PL
canteastes-me	cantear+V.eu.AD.1.SG+PRF+2+PL
canteastes-te	cantear+V.tu.AD.2.SG+PRF+2+PL
canteastes-vos	cantear+V.vós.AD.2.PL+PRF+2+PL
canteaste-te	cantear+V.tu.AD.2.SG+PRF+2+SG
canteaste-vos	cantear+V.vós.AD.2.PL+PRF+2+SG
canteava-a	cantear+V.ele.ACC.3.F.SG+IMPF+1+SG
canteava-a	cantear+V.ele.ACC.3.F.SG+IMPF+3+SG
canteava-as	cantear+V.ele.ACC.3.F.PL+IMPF+1+SG
canteava-as	cantear+V.ele.ACC.3.F.PL+IMPF+3+SG
canteava-la	cantear+V.ele.ACC.3.F.SG+IMPF+2+SG
canteava-las	cantear+V.ele.ACC.3.F.PL+IMPF+2+SG
canteava-lhe	cantear+V.ele.DAT.3.SG+IMPF+1+SG
canteava-lhe	cantear+V.ele.DAT.3.SG+IMPF+3+SG
canteava-lhes	cantear+V.ele.DAT.3.PL+IMPF+1+SG
canteava-lhes	cantear+V.ele.DAT.3.PL+IMPF+3+SG
canteava-lo	cantear+V.ele.ACC.3.M.SG+IMPF+2+SG
canteava-los	cantear+V.ele.ACC.3.M.PL+IMPF+2+SG
canteava-me	cantear+V.eu.AD.1.SG+IMPF+1+SG
canteava-me	cantear+V.eu.AD.1.SG+IMPF+3+SG
canteavam-lhe	cantear+V.ele.DAT.3.SG+IMPF+3+PL
canteavam-lhes	cantear+V.ele.DAT.3.PL+IMPF+3+PL
canteavam-me	cantear+V.eu.AD.1.SG+IMPF+3+PL
canteavam-na	cantear+V.ele.ACC.3.F.SG+IMPF+3+PL
canteavam-nas	cantear+V.ele.ACC.3.F.PL+IMPF+3+PL
canteavam-no	cantear+V.ele.ACC.3.M.SG+IMPF+3+PL
canteavam-nos	cantear+V.ele.ACC.3.M.PL+IMPF+3+PL
canteavam-nos	cantear+V.nós.AD.1.PL+IMPF+3+PL
canteávamo-la	cantear+V.ele.ACC.3.F.SG+IMPF+1+PL
canteávamo-las	cantear+V.ele.ACC.3.F.PL+IMPF+1+PL
canteávamo-lo	cantear+V.ele.ACC.3.M.SG+IMPF+1+PL
canteávamo-los	cantear+V.ele.ACC.3.M.PL+IMPF+1+PL
canteávamo-nos	cantear+nós.AD.1.PL+IMPF+1+PL
canteávamos-lhe	cantear+V.ele.DAT.3.SG+IMPF+1+PL
canteávamos-lhes	cantear+V.ele.DAT.3.PL+IMPF+1+PL
canteávamos-me	cantear+V.eu.AD.1.SG+IMPF+1+PL
canteávamos-te	cantear+V.tu.AD.2.SG+IMPF+1+PL
canteávamos-vos	cantear+V.vós.AD.2.PL+IMPF+1+PL
canteavam-se	cantear+V.ele.REFL+IMPF+3+PL
canteavam-te	cantear+V.tu.AD.2.SG+IMPF+3+PL
canteavam-vos	cantear+V.vós.AD.2.PL+IMPF+3+PL
canteava-nos	cantear+nós.AD.1.PL+IMPF+1+SG
canteava-nos	cantear+nós.AD.1.PL+IMPF+2+SG
canteava-nos	cantear+nós.AD.1.PL+IMPF+3+SG
canteava-o	cantear+V.ele.ACC.3.M.SG+IMPF+1+SG
canteava-o	cantear+V.ele.ACC.3.M.SG+IMPF+3+SG
canteava-os	cantear+V.ele.ACC.3.M.PL+IMPF+1+SG
canteava-os	cantear+V.ele.ACC.3.M.PL+IMPF+3+SG
canteava-se	cantear+V.ele.REFL+IMPF+1+SG
canteava-se	cantear+V.ele.REFL+IMPF+3+SG
canteavas-lhe	cantear+V.ele.DAT.3.SG+IMPF+2+SG
canteavas-lhes	cantear+V.ele.DAT.3.PL+IMPF+2+SG
canteavas-me	cantear+V.eu.AD.1.SG+IMPF+2+SG
canteavas-te	cantear+V.tu.AD.2.SG+IMPF+2+SG
canteavas-vos	cantear+V.vós.AD.2.PL+IMPF+2+SG
canteava-te	cantear+V.tu.AD.2.SG+IMPF+1+SG
canteava-te	cantear+V.tu.AD.2.SG+IMPF+3+SG
canteava-vos	cantear+V.vós.AD.2.PL+IMPF+1+SG
canteava-vos	cantear+V.vós.AD.2.PL+IMPF+3+SG
canteávei-la	cantear+V.ele.ACC.3.F.SG+IMPF+2+PL
canteávei-las	cantear+V.ele.ACC.3.F.PL+IMPF+2+PL
canteávei-lo	cantear+V.ele.ACC.3.M.SG+IMPF+2+PL
canteávei-los	cantear+V.ele.ACC.3.M.PL+IMPF+2+PL
canteávei-nos	cantear+nós.AD.1.PL+IMPF+2+PL
canteáveis-lhe	cantear+V.ele.DAT.3.SG+IMPF+2+PL
canteáveis-lhes	cantear+V.ele.DAT.3.PL+IMPF+2+PL
canteáveis-me	cantear+V.eu.AD.1.SG+IMPF+2+PL
canteáveis-te	cantear+V.tu.AD.2.SG+IMPF+2+PL
canteáveis-vos	cantear+V.vós.AD.2.PL+IMPF+2+PL
canteei-a	cantear+V.ele.ACC.3.F.SG+PRF+1+SG
canteei-as	cantear+V.ele.ACC.3.F.PL+PRF+1+SG
canteei-lhe	cantear+V.ele.DAT.3.SG+PRF+1+SG
canteei-lhes	cantear+V.ele.DAT.3.PL+PRF+1+SG
canteei-me	cantear+V.eu.AD.1.SG+PRF+1+SG
canteei-nos	cantear+nós.AD.1.PL+PRF+1+SG
canteei-o	cantear+V.ele.ACC.3.M.SG+PRF+1+SG
canteei-os	cantear+V.ele.ACC.3.M.PL+PRF+1+SG
canteei-te	cantear+V.tu.AD.2.SG+PRF+1+SG
canteei-vos	cantear+V.vós.AD.2.PL+PRF+1+SG
canteia-a	cantear+V.ele.ACC.3.F.SG+PRS+3+SG
canteia-as	cantear+V.ele.ACC.3.F.PL+PRS+3+SG
cantei-a	cantar+V.ele.ACC.3.F.SG+PRF+1+SG
canteia-la	cantear+V.ele.ACC.3.F.SG+PRS+2+SG
canteia-las	cantear+V.ele.ACC.3.F.PL+PRS+2+SG
canteia-lhe	cantear+V.ele.DAT.3.SG+PRS+3+SG
canteia-lhes	cantear+V.ele.DAT.3.PL+PRS+3+SG
canteia-lo	cantear+V.ele.ACC.3.M.SG+PRS+2+SG
canteia-los	cantear+V.ele.ACC.3.M.PL+PRS+2+SG
canteia-me	cantear+V.eu.AD.1.SG+PRS+3+SG
canteiam-lhe	cantear+V.ele.DAT.3.SG+PRS+3+PL
canteiam-lhes	cantear+V.ele.DAT.3.PL+PRS+3+PL
canteiam-me	cantear+V.eu.AD.1.SG+PRS+3+PL
canteiam-na	cantear+V.ele.ACC.3.F.SG+PRS+3+PL
canteiam-nas	cantear+V.ele.ACC.3.F.PL+PRS+3+PL
canteiam-no	cantear+V.ele.ACC.3.M.SG+PRS+3+PL
canteiam-nos	cantear+V.ele.ACC.3.M.PL+PRS+3+PL
canteiam-nos	cantear+V.nós.AD.1.PL+PRS+3+PL
canteiam-se	cantear+V.ele.REFL+PRS+3+PL
canteiam-te	cantear+V.tu.AD.2.SG+PRS+3+PL
canteiam-vos	cantear+V.vós.AD.2.PL+PRS+3+PL
canteia-nos	cantear+nós.AD.1.PL+PRS+2+SG
canteia-nos	cantear+nós.AD.1.PL+PRS+3+SG
canteia-o	cantear+V.ele.ACC.3.M.SG+PRS+3+SG
canteia-os	cantear+V.ele.ACC.3.M.PL+PRS+3+SG
cantei-as	cantar+V.ele.ACC.3.F.PL+PRF+1+SG
canteia-se	cantear+V.ele.REFL+PRS+3+SG
canteias-lhe	cantear+V.ele.DAT.3.SG+PRS+2+SG
canteias-lhes	cantear+V.ele.DAT.3.PL+PRS+2+SG
canteias-me	cantear+V.eu.AD.1.SG+PRS+2+SG
canteias-te	cantear+V.tu.AD.2.SG+PRS+2+SG
canteias-vos	cantear+V.vós.AD.2.PL+PRS+2+SG
canteia-te	cantear+V.tu.AD.2.SG+PRS+3+SG
canteia-vos	cantear+V.vós.AD.2.PL+PRS+3+SG
cantei-lhe	cantar+V.ele.DAT.3.SG+PRF+1+SG
cantei-lhes	cantar+V.ele.DAT.3.PL+PRF+1+SG
cantei-me	cantar+V.eu.AD.1.SG+PRF+1+SG
cantei-nos	cantar+nós.AD.1.PL+PRF+1+SG
canteio-a	cantear+V.ele.ACC.3.F.SG+PRS+1+SG
canteio-as	cantear+V.ele.ACC.3.F.PL+PRS+1+SG
cantei-o	cantar+V.ele.ACC.3.M.SG+PRF+1+SG
canteio-lhe	cantear+V.ele.DAT.3.SG+PRS+1+SG
canteio-lhes	cantear+V.ele.DAT.3.PL+PRS+1+SG
canteio-me	cantear+V.eu.AD.1.SG+PRS+1+SG
canteio-nos	cantear+nós.AD.1.PL+PRS+1+SG
canteio-o	cantear+V.ele.ACC.3.M.SG+PRS+1+SG
canteio-os	cantear+V.ele.ACC.3.M.PL+PRS+1+SG
cantei-os	cantar+V.ele.ACC.3.M.PL+PRF+1+SG
canteio-te	cantear+V.tu.AD.2.SG+PRS+1+SG
canteio-vos	cantear+V.vós.AD.2.PL+PRS+1+SG
cantei-te	cantar+V.tu.AD.2.SG+PRF+1+SG
cantei-vos	cantar+V.vós.AD.2.PL+PRF+1+SG
cante-lhe	cantar+V.ele.DAT.3.SG+IMP+3+SG
cante-lhes	cantar+V.ele.DAT.3.PL+IMP+3+SG
cante-me	cantar+V.eu.AD.1.SG+IMP+3+SG
cantem-lhe	cantar+V.ele.DAT.3.SG+IMP+3+PL
cantem-lhes	cantar+V.ele.DAT.3.PL+IMP+3+PL
cantem-me	cantar+V.eu.AD.1.SG+IMP+3+PL
cantem-na	cantar+V.ele.ACC.3.F.SG+IMP+3+PL
cantem-nas	cantar+V.ele.ACC.3.F.PL+IMP+3+PL
cantem-no	cantar+V.ele.ACC.3.M.SG+IMP+3+PL
cantem-nos	cantar+V.ele.ACC.3.M.PL+IMP+3+PL
cantem-nos	cantar+V.nós.AD.1.PL+IMP+3+PL
cantemo-la	cantar+V.ele.ACC.3.F.SG+IMP+1+PL
cantemo-las	cantar+V.ele.ACC.3.F.PL+IMP+1+PL
cantemo-lo	cantar+V.ele.ACC.3.M.SG+IMP+1+PL
cantemo-los	cantar+V.ele.ACC.3.M.PL+IMP+1+PL
cantemo-nos	cantar+nós.AD.1.PL+IMP+1+PL
cantemos-lhe	cantar+V.ele.DAT.3.SG+IMP+1+PL
cantemos-lhes	cantar+V.ele.DAT.3.PL+IMP+1+PL
cantemos-me	cantar+V.eu.AD.1.SG+IMP+1+PL
cantemos-te	cantar+V.tu.AD.2.SG+IMP+1+PL
cantemos-vos	cantar+V.vós.AD.2.PL+IMP+1+PL
cantem-se	cantar+V.ele.REFL+IMP+3+PL
cantem-te	cantar+V.tu.AD.2.SG+IMP+3+PL
cantem-vos	cantar+V.vós.AD.2.PL+IMP+3+PL
cante-nos	cantar+nós.AD.1.PL+IMP+3+SG
cante-o	cantar+V.ele.ACC.3.M.SG+IMP+3+SG
cante-os	cantar+V.ele.ACC.3.M.PL+IMP+3+SG
canteou-a	cantear+V.ele.ACC.3.F.SG+PRF+3+SG
canteou-as	cantear+V.ele.ACC.3.F.PL+PRF+3+SG
canteou-lhe	cantear+V.ele.DAT.3.SG+PRF+3+SG
canteou-lhes	cantear+V.ele.DAT.3.PL+PRF+3+SG
canteou-me	cantear+V.eu.AD.1.SG+PRF+3+SG
canteou-nos	cantear+nós.AD.1.PL+PRF+3+SG
canteou-o	cantear+V.ele.ACC.3.M.SG+PRF+3+SG
canteou-os	cantear+V.ele.ACC.3.M.PL+PRF+3+SG
canteou-se	cantear+V.ele.REFL+PRF+3+SG
canteou-te	cantear+V.tu.AD.2.SG+PRF+3+SG
canteou-vos	cantear+V.vós.AD.2.PL+PRF+3+SG
cante-se	cantar+V.ele.REFL+IMP+3+SG
cante-te	cantar+V.tu.AD.2.SG+IMP+3+SG
cante-vos	cantar+V.vós.AD.2.PL+IMP+3+SG
canto-a	cantar+V.ele.ACC.3.F.SG+PRS+1+SG
canto-as	cantar+V.ele.ACC.3.F.PL+PRS+1+SG
canto-lhe	cantar+V.ele.DAT.3.SG+PRS+1+SG
canto-lhes	cantar+V.ele.DAT.3.PL+PRS+1+SG
canto-me	cantar+V.eu.AD.1.SG+PRS+1+SG
canto-nos	cantar+nós.AD.1.PL+PRS+1+SG
canto-o	cantar+V.ele.ACC.3.M.SG+PRS+1+SG
canto-os	cantar+V.ele.ACC.3.M.PL+PRS+1+SG
canto-te	cantar+V.tu.AD.2.SG+PRS+1+SG
cantou-a	cantar+V.ele.ACC.3.F.SG+PRF+3+SG
cantou-as	cantar+V.ele.ACC.3.F.PL+PRF+3+SG
cantou-lhe	cantar+V.ele.DAT.3.SG+PRF+3+SG
cantou-lhes	cantar+V.ele.DAT.3.PL+PRF+3+SG
cantou-me	cantar+V.eu.AD.1.SG+PRF+3+SG
cantou-nos	cantar+nós.AD.1.PL+PRF+3+SG
cantou-o	cantar+V.ele.ACC.3.M.SG+PRF+3+SG
cantou-os	cantar+V.ele.ACC.3.M.PL+PRF+3+SG
cantou-se	cantar+V.ele.REFL+PRF+3+SG
cantou-te	cantar+V.tu.AD.2.SG+PRF+3+SG
cantou-vos	cantar+V.vós.AD.2.PL+PRF+3+SG
canto-vos	cantar+V.vós.AD.2.PL+PRS+1+SG
caotiza-a	caotizar+V.ele.ACC.3.F.SG+PRS+3+SG
caotiza-as	caotizar+V.ele.ACC.3.F.PL+PRS+3+SG
caotizai-la	caotizar+V.ele.ACC.3.F.SG+PRS+2+PL
caotizai-las	caotizar+V.ele.ACC.3.F.PL+PRS+2+PL
caotizai-lo	caotizar+V.ele.ACC.3.M.SG+PRS+2+PL
caotizai-los	caotizar+V.ele.ACC.3.M.PL+PRS+2+PL
caotizai-nos	caotizar+nós.AD.1.PL+PRS+2+PL
caotizais-lhe	caotizar+V.ele.DAT.3.SG+PRS+2+PL
caotizais-lhes	caotizar+V.ele.DAT.3.PL+PRS+2+PL
caotizais-me	caotizar+V.eu.AD.1.SG+PRS+2+PL
caotizais-te	caotizar+V.tu.AD.2.SG+PRS+2+PL
caotizais-vos	caotizar+V.vós.AD.2.PL+PRS+2+PL
caotizá-la-á	caotizar+V.ele.ACC.3.F.SG+FUT+3+SG
caotizá-la-ão	caotizar+V.ele.ACC.3.F.SG+FUT+3+PL
caotizá-la-ás	caotizar+V.ele.ACC.3.F.SG+FUT+2+SG
caotizá-la	caotizar+V.ele.ACC.3.F.SG+INF+1+SG
caotizá-la	caotizar+V.ele.ACC.3.F.SG+INF+3+SG
caotiza-la	caotizar+V.ele.ACC.3.F.SG+PRS+2+SG
caotizá-la	caotizar+V.ele.ACC.3.F.SG+SBJF+1+SG
caotizá-la	caotizar+V.ele.ACC.3.F.SG+SBJF+3+SG
caotizá-la-ei	caotizar+V.ele.ACC.3.F.SG+FUT+1+SG
caotizá-la-eis	caotizar+V.ele.ACC.3.F.SG+FUT+2+PL
