cesurar-lhes	cesurar+V.ele.DAT.3.PL+SBJF+1+SG
cesurar-lhes	cesurar+V.ele.DAT.3.PL+SBJF+3+SG
cesurar-lhes-ei	cesurar+V.ele.DAT.3.PL+FUT+1+SG
cesurar-lhes-eis	cesurar+V.ele.DAT.3.PL+FUT+2+PL
cesurar-lhes-emos	cesurar+V.ele.DAT.3.PL+FUT+1+PL
cesurar-lhes-ia	cesurar+V.ele.DAT.3.PL+COND+1+SG
cesurar-lhes-ia	cesurar+V.ele.DAT.3.PL+COND+3+SG
cesurar-lhes-iam	cesurar+V.ele.DAT.3.PL+COND+3+PL
cesurar-lhes-íamos	cesurar+V.ele.DAT.3.PL+COND+1+PL
cesurar-lhes-ias	cesurar+V.ele.DAT.3.PL+COND+2+SG
cesurar-lhes-íeis	cesurar+V.ele.DAT.3.PL+COND+2+PL
cesurar-me-á	cesurar+V.eu.AD.1.SG+FUT+3+SG
cesurar-me-ão	cesurar+V.eu.AD.1.SG+FUT+3+PL
cesurar-me-ás	cesurar+V.eu.AD.1.SG+FUT+2+SG
cesurar-me	cesurar+V.eu.AD.1.SG+INF
cesurar-me	cesurar+V.eu.AD.1.SG+INF+1+SG
cesurar-me	cesurar+V.eu.AD.1.SG+INF+3+SG
cesurar-me	cesurar+V.eu.AD.1.SG+SBJF+1+SG
cesurar-me	cesurar+V.eu.AD.1.SG+SBJF+3+SG
cesurar-me-ei	cesurar+V.eu.AD.1.SG+FUT+1+SG
cesurar-me-eis	cesurar+V.eu.AD.1.SG+FUT+2+PL
cesurar-me-emos	cesurar+V.eu.AD.1.SG+FUT+1+PL
cesurar-me-ia	cesurar+V.eu.AD.1.SG+COND+1+SG
cesurar-me-ia	cesurar+V.eu.AD.1.SG+COND+3+SG
cesurar-me-iam	cesurar+V.eu.AD.1.SG+COND+3+PL
cesurar-me-íamos	cesurar+V.eu.AD.1.SG+COND+1+PL
cesurar-me-ias	cesurar+V.eu.AD.1.SG+COND+2+SG
cesurar-me-íeis	cesurar+V.eu.AD.1.SG+COND+2+PL
cesurarmo-la	cesurar+V.ele.ACC.3.F.SG+INF+1+PL
cesurarmo-la	cesurar+V.ele.ACC.3.F.SG+SBJF+1+PL
cesurarmo-las	cesurar+V.ele.ACC.3.F.PL+INF+1+PL
cesurarmo-las	cesurar+V.ele.ACC.3.F.PL+SBJF+1+PL
cesurarmo-lo	cesurar+V.ele.ACC.3.M.SG+INF+1+PL
cesurarmo-lo	cesurar+V.ele.ACC.3.M.SG+SBJF+1+PL
cesurarmo-los	cesurar+V.ele.ACC.3.M.PL+INF+1+PL
cesurarmo-los	cesurar+V.ele.ACC.3.M.PL+SBJF+1+PL
cesurarmo-nos	cesurar+nós.AD.1.PL+INF+1+PL
cesurarmo-nos	cesurar+nós.AD.1.PL+SBJF+1+PL
cesurarmos-lhe	cesurar+V.ele.DAT.3.SG+INF+1+PL
cesurarmos-lhe	cesurar+V.ele.DAT.3.SG+SBJF+1+PL
cesurarmos-lhes	cesurar+V.ele.DAT.3.PL+INF+1+PL
cesurarmos-lhes	cesurar+V.ele.DAT.3.PL+SBJF+1+PL
cesurarmos-me	cesurar+V.eu.AD.1.SG+INF+1+PL
cesurarmos-me	cesurar+V.eu.AD.1.SG+SBJF+1+PL
cesurarmos-te	cesurar+V.tu.AD.2.SG+INF+1+PL
cesurarmos-te	cesurar+V.tu.AD.2.SG+SBJF+1+PL
cesurarmos-vos	cesurar+V.vós.AD.2.PL+INF+1+PL
cesurarmos-vos	cesurar+V.vós.AD.2.PL+SBJF+1+PL
cesurar-nos-á	cesurar+nós.AD.1.PL+FUT+3+SG
cesurar-nos-ão	cesurar+nós.AD.1.PL+FUT+3+PL
cesurar-nos-ás	cesurar+nós.AD.1.PL+FUT+2+SG
cesurar-nos	cesurar+nós.AD.1.PL+INF
cesurar-nos	cesurar+nós.AD.1.PL+INF+1+SG
cesurar-nos	cesurar+nós.AD.1.PL+INF+3+SG
cesurar-nos	cesurar+nós.AD.1.PL+SBJF+1+SG
cesurar-nos	cesurar+nós.AD.1.PL+SBJF+3+SG
cesurar-nos-ei	cesurar+nós.AD.1.PL+FUT+1+SG
cesurar-nos-eis	cesurar+nós.AD.1.PL+FUT+2+PL
cesurar-nos-emos	cesurar+nós.AD.1.PL+FUT+1+PL
cesurar-nos-ia	cesurar+nós.AD.1.PL+COND+1+SG
cesurar-nos-ia	cesurar+nós.AD.1.PL+COND+3+SG
cesurar-nos-iam	cesurar+nós.AD.1.PL+COND+3+PL
cesurar-nos-íamos	cesurar+nós.AD.1.PL+COND+1+PL
cesurar-nos-ias	cesurar+nós.AD.1.PL+COND+2+SG
cesurar-nos-íeis	cesurar+nós.AD.1.PL+COND+2+PL
cesurar-se-á	cesurar+V.ele.REFL+FUT+3+SG
cesurar-se-ão	cesurar+V.ele.REFL+FUT+3+PL
cesurar-se	cesurar+V.ele.REFL+INF
cesurar-se	cesurar+V.ele.REFL+INF+3+SG
cesurar-se	cesurar+V.ele.REFL+SBJF+3+SG
cesurar-se-ia	cesurar+V.ele.REFL+COND+3+SG
cesurar-se-iam	cesurar+V.ele.REFL+COND+3+PL
cesurar-te-á	cesurar+V.tu.AD.2.SG+FUT+3+SG
cesurar-te-ão	cesurar+V.tu.AD.2.SG+FUT+3+PL
cesurar-te-ás	cesurar+V.tu.AD.2.SG+FUT+2+SG
cesurar-te	cesurar+V.tu.AD.2.SG+INF
cesurar-te	cesurar+V.tu.AD.2.SG+INF+1+SG
cesurar-te	cesurar+V.tu.AD.2.SG+INF+3+SG
cesurar-te	cesurar+V.tu.AD.2.SG+SBJF+1+SG
cesurar-te	cesurar+V.tu.AD.2.SG+SBJF+3+SG
cesurar-te-ei	cesurar+V.tu.AD.2.SG+FUT+1+SG
cesurar-te-eis	cesurar+V.tu.AD.2.SG+FUT+2+PL
cesurar-te-emos	cesurar+V.tu.AD.2.SG+FUT+1+PL
cesurar-te-ia	cesurar+V.tu.AD.2.SG+COND+1+SG
cesurar-te-ia	cesurar+V.tu.AD.2.SG+COND+3+SG
cesurar-te-iam	cesurar+V.tu.AD.2.SG+COND+3+PL
cesurar-te-íamos	cesurar+V.tu.AD.2.SG+COND+1+PL
cesurar-te-ias	cesurar+V.tu.AD.2.SG+COND+2+SG
cesurar-te-íeis	cesurar+V.tu.AD.2.SG+COND+2+PL
cesurar-vos-á	cesurar+V.vós.AD.2.PL+FUT+3+SG
cesurar-vos-ão	cesurar+V.vós.AD.2.PL+FUT+3+PL
cesurar-vos-ás	cesurar+V.vós.AD.2.PL+FUT+2+SG
cesurar-vos	cesurar+V.vós.AD.2.PL+INF
cesurar-vos	cesurar+V.vós.AD.2.PL+INF+1+SG
cesurar-vos	cesurar+V.vós.AD.2.PL+INF+3+SG
cesurar-vos	cesurar+V.vós.AD.2.PL+SBJF+1+SG
cesurar-vos	cesurar+V.vós.AD.2.PL+SBJF+3+SG
cesurar-vos-ei	cesurar+V.vós.AD.2.PL+FUT+1+SG
cesurar-vos-eis	cesurar+V.vós.AD.2.PL+FUT+2+PL
cesurar-vos-emos	cesurar+V.vós.AD.2.PL+FUT+1+PL
cesurar-vos-ia	cesurar+V.vós.AD.2.PL+COND+1+SG
cesurar-vos-ia	cesurar+V.vós.AD.2.PL+COND+3+SG
cesurar-vos-iam	cesurar+V.vós.AD.2.PL+COND+3+PL
cesurar-vos-íamos	cesurar+V.vós.AD.2.PL+COND+1+PL
cesurar-vos-ias	cesurar+V.vós.AD.2.PL+COND+2+SG
cesurar-vos-íeis	cesurar+V.vós.AD.2.PL+COND+2+PL
cesura-se	cesurar+V.ele.REFL+PRS+3+SG
cesuras-lhe	cesurar+V.ele.DAT.3.SG+PRS+2+SG
cesuras-lhes	cesurar+V.ele.DAT.3.PL+PRS+2+SG
cesuras-me	cesurar+V.eu.AD.1.SG+PRS+2+SG
cesuraste-a	cesurar+V.ele.ACC.3.F.SG+PRF+2+SG
cesuraste-as	cesurar+V.ele.ACC.3.F.PL+PRF+2+SG
cesuras-te	cesurar+V.tu.AD.2.SG+PRS+2+SG
cesuraste-la	cesurar+V.ele.ACC.3.F.SG+PRF+2+PL
cesuraste-las	cesurar+V.ele.ACC.3.F.PL+PRF+2+PL
cesuraste-lhe	cesurar+V.ele.DAT.3.SG+PRF+2+SG
cesuraste-lhes	cesurar+V.ele.DAT.3.PL+PRF+2+SG
cesuraste-lo	cesurar+V.ele.ACC.3.M.SG+PRF+2+PL
cesuraste-los	cesurar+V.ele.ACC.3.M.PL+PRF+2+PL
cesuraste-me	cesurar+V.eu.AD.1.SG+PRF+2+SG
cesuraste-nos	cesurar+nós.AD.1.PL+PRF+2+PL
cesuraste-nos	cesurar+nós.AD.1.PL+PRF+2+SG
cesuraste-o	cesurar+V.ele.ACC.3.M.SG+PRF+2+SG
cesuraste-os	cesurar+V.ele.ACC.3.M.PL+PRF+2+SG
cesurastes-lhe	cesurar+V.ele.DAT.3.SG+PRF+2+PL
cesurastes-lhes	cesurar+V.ele.DAT.3.PL+PRF+2+PL
cesurastes-me	cesurar+V.eu.AD.1.SG+PRF+2+PL
cesurastes-te	cesurar+V.tu.AD.2.SG+PRF+2+PL
cesurastes-vos	cesurar+V.vós.AD.2.PL+PRF+2+PL
cesuraste-te	cesurar+V.tu.AD.2.SG+PRF+2+SG
cesuraste-vos	cesurar+V.vós.AD.2.PL+PRF+2+SG
cesuras-vos	cesurar+V.vós.AD.2.PL+PRS+2+SG
cesura-te	cesurar+V.tu.AD.2.SG+PRS+3+SG
cesurava-a	cesurar+V.ele.ACC.3.F.SG+IMPF+1+SG
cesurava-a	cesurar+V.ele.ACC.3.F.SG+IMPF+3+SG
cesurava-as	cesurar+V.ele.ACC.3.F.PL+IMPF+1+SG
cesurava-as	cesurar+V.ele.ACC.3.F.PL+IMPF+3+SG
cesurava-la	cesurar+V.ele.ACC.3.F.SG+IMPF+2+SG
cesurava-las	cesurar+V.ele.ACC.3.F.PL+IMPF+2+SG
cesurava-lhe	cesurar+V.ele.DAT.3.SG+IMPF+1+SG
cesurava-lhe	cesurar+V.ele.DAT.3.SG+IMPF+3+SG
cesurava-lhes	cesurar+V.ele.DAT.3.PL+IMPF+1+SG
cesurava-lhes	cesurar+V.ele.DAT.3.PL+IMPF+3+SG
cesurava-lo	cesurar+V.ele.ACC.3.M.SG+IMPF+2+SG
cesurava-los	cesurar+V.ele.ACC.3.M.PL+IMPF+2+SG
cesurava-me	cesurar+V.eu.AD.1.SG+IMPF+1+SG
cesurava-me	cesurar+V.eu.AD.1.SG+IMPF+3+SG
cesuravam-lhe	cesurar+V.ele.DAT.3.SG+IMPF+3+PL
cesuravam-lhes	cesurar+V.ele.DAT.3.PL+IMPF+3+PL
cesuravam-me	cesurar+V.eu.AD.1.SG+IMPF+3+PL
cesuravam-na	cesurar+V.ele.ACC.3.F.SG+IMPF+3+PL
cesuravam-nas	cesurar+V.ele.ACC.3.F.PL+IMPF+3+PL
cesuravam-no	cesurar+V.ele.ACC.3.M.SG+IMPF+3+PL
cesuravam-nos	cesurar+V.ele.ACC.3.M.PL+IMPF+3+PL
cesuravam-nos	cesurar+V.nós.AD.1.PL+IMPF+3+PL
cesurávamo-la	cesurar+V.ele.ACC.3.F.SG+IMPF+1+PL
cesurávamo-las	cesurar+V.ele.ACC.3.F.PL+IMPF+1+PL
cesurávamo-lo	cesurar+V.ele.ACC.3.M.SG+IMPF+1+PL
cesurávamo-los	cesurar+V.ele.ACC.3.M.PL+IMPF+1+PL
cesurávamo-nos	cesurar+nós.AD.1.PL+IMPF+1+PL
cesurávamos-lhe	cesurar+V.ele.DAT.3.SG+IMPF+1+PL
cesurávamos-lhes	cesurar+V.ele.DAT.3.PL+IMPF+1+PL
cesurávamos-me	cesurar+V.eu.AD.1.SG+IMPF+1+PL
cesurávamos-te	cesurar+V.tu.AD.2.SG+IMPF+1+PL
cesurávamos-vos	cesurar+V.vós.AD.2.PL+IMPF+1+PL
cesuravam-se	cesurar+V.ele.REFL+IMPF+3+PL
cesuravam-te	cesurar+V.tu.AD.2.SG+IMPF+3+PL
cesuravam-vos	cesurar+V.vós.AD.2.PL+IMPF+3+PL
cesurava-nos	cesurar+nós.AD.1.PL+IMPF+1+SG
cesurava-nos	cesurar+nós.AD.1.PL+IMPF+2+SG
cesurava-nos	cesurar+nós.AD.1.PL+IMPF+3+SG
cesurava-o	cesurar+V.ele.ACC.3.M.SG+IMPF+1+SG
cesurava-o	cesurar+V.ele.ACC.3.M.SG+IMPF+3+SG
cesurava-os	cesurar+V.ele.ACC.3.M.PL+IMPF+1+SG
cesurava-os	cesurar+V.ele.ACC.3.M.PL+IMPF+3+SG
cesurava-se	cesurar+V.ele.REFL+IMPF+1+SG
cesurava-se	cesurar+V.ele.REFL+IMPF+3+SG
cesuravas-lhe	cesurar+V.ele.DAT.3.SG+IMPF+2+SG
cesuravas-lhes	cesurar+V.ele.DAT.3.PL+IMPF+2+SG
cesuravas-me	cesurar+V.eu.AD.1.SG+IMPF+2+SG
cesuravas-te	cesurar+V.tu.AD.2.SG+IMPF+2+SG
cesuravas-vos	cesurar+V.vós.AD.2.PL+IMPF+2+SG
cesurava-te	cesurar+V.tu.AD.2.SG+IMPF+1+SG
cesurava-te	cesurar+V.tu.AD.2.SG+IMPF+3+SG
cesurava-vos	cesurar+V.vós.AD.2.PL+IMPF+1+SG
cesurava-vos	cesurar+V.vós.AD.2.PL+IMPF+3+SG
cesurávei-la	cesurar+V.ele.ACC.3.F.SG+IMPF+2+PL
cesurávei-las	cesurar+V.ele.ACC.3.F.PL+IMPF+2+PL
cesurávei-lo	cesurar+V.ele.ACC.3.M.SG+IMPF+2+PL
cesurávei-los	cesurar+V.ele.ACC.3.M.PL+IMPF+2+PL
cesurávei-nos	cesurar+nós.AD.1.PL+IMPF+2+PL
cesuráveis-lhe	cesurar+V.ele.DAT.3.SG+IMPF+2+PL
cesuráveis-lhes	cesurar+V.ele.DAT.3.PL+IMPF+2+PL
cesuráveis-me	cesurar+V.eu.AD.1.SG+IMPF+2+PL
cesuráveis-te	cesurar+V.tu.AD.2.SG+IMPF+2+PL
cesuráveis-vos	cesurar+V.vós.AD.2.PL+IMPF+2+PL
cesura-vos	cesurar+V.vós.AD.2.PL+PRS+3+SG
cesure-a	cesurar+V.ele.ACC.3.F.SG+IMP+3+SG
cesure-as	cesurar+V.ele.ACC.3.F.PL+IMP+3+SG
cesurei-a	cesurar+V.ele.ACC.3.F.SG+PRF+1+SG
cesurei-as	cesurar+V.ele.ACC.3.F.PL+PRF+1+SG
cesurei-lhe	cesurar+V.ele.DAT.3.SG+PRF+1+SG
cesurei-lhes	cesurar+V.ele.DAT.3.PL+PRF+1+SG
cesurei-me	cesurar+V.eu.AD.1.SG+PRF+1+SG
cesurei-nos	cesurar+nós.AD.1.PL+PRF+1+SG
cesurei-o	cesurar+V.ele.ACC.3.M.SG+PRF+1+SG
cesurei-os	cesurar+V.ele.ACC.3.M.PL+PRF+1+SG
cesurei-te	cesurar+V.tu.AD.2.SG+PRF+1+SG
cesurei-vos	cesurar+V.vós.AD.2.PL+PRF+1+SG
cesure-lhe	cesurar+V.ele.DAT.3.SG+IMP+3+SG
cesure-lhes	cesurar+V.ele.DAT.3.PL+IMP+3+SG
cesure-me	cesurar+V.eu.AD.1.SG+IMP+3+SG
cesurem-lhe	cesurar+V.ele.DAT.3.SG+IMP+3+PL
cesurem-lhes	cesurar+V.ele.DAT.3.PL+IMP+3+PL
cesurem-me	cesurar+V.eu.AD.1.SG+IMP+3+PL
cesurem-na	cesurar+V.ele.ACC.3.F.SG+IMP+3+PL
cesurem-nas	cesurar+V.ele.ACC.3.F.PL+IMP+3+PL
cesurem-no	cesurar+V.ele.ACC.3.M.SG+IMP+3+PL
cesurem-nos	cesurar+V.ele.ACC.3.M.PL+IMP+3+PL
cesurem-nos	cesurar+V.nós.AD.1.PL+IMP+3+PL
cesuremo-la	cesurar+V.ele.ACC.3.F.SG+IMP+1+PL
cesuremo-las	cesurar+V.ele.ACC.3.F.PL+IMP+1+PL
cesuremo-lo	cesurar+V.ele.ACC.3.M.SG+IMP+1+PL
cesuremo-los	cesurar+V.ele.ACC.3.M.PL+IMP+1+PL
cesuremo-nos	cesurar+nós.AD.1.PL+IMP+1+PL
cesuremos-lhe	cesurar+V.ele.DAT.3.SG+IMP+1+PL
cesuremos-lhes	cesurar+V.ele.DAT.3.PL+IMP+1+PL
cesuremos-me	cesurar+V.eu.AD.1.SG+IMP+1+PL
cesuremos-te	cesurar+V.tu.AD.2.SG+IMP+1+PL
cesuremos-vos	cesurar+V.vós.AD.2.PL+IMP+1+PL
cesurem-se	cesurar+V.ele.REFL+IMP+3+PL
cesurem-te	cesurar+V.tu.AD.2.SG+IMP+3+PL
cesurem-vos	cesurar+V.vós.AD.2.PL+IMP+3+PL
cesure-nos	cesurar+nós.AD.1.PL+IMP+3+SG
cesure-o	cesurar+V.ele.ACC.3.M.SG+IMP+3+SG
cesure-os	cesurar+V.ele.ACC.3.M.PL+IMP+3+SG
cesure-se	cesurar+V.ele.REFL+IMP+3+SG
cesure-te	cesurar+V.tu.AD.2.SG+IMP+3+SG
cesure-vos	cesurar+V.vós.AD.2.PL+IMP+3+SG
cesuro-a	cesurar+V.ele.ACC.3.F.SG+PRS+1+SG
cesuro-as	cesurar+V.ele.ACC.3.F.PL+PRS+1+SG
cesuro-lhe	cesurar+V.ele.DAT.3.SG+PRS+1+SG
cesuro-lhes	cesurar+V.ele.DAT.3.PL+PRS+1+SG
cesuro-me	cesurar+V.eu.AD.1.SG+PRS+1+SG
cesuro-nos	cesurar+nós.AD.1.PL+PRS+1+SG
cesuro-o	cesurar+V.ele.ACC.3.M.SG+PRS+1+SG
cesuro-os	cesurar+V.ele.ACC.3.M.PL+PRS+1+SG
cesuro-te	cesurar+V.tu.AD.2.SG+PRS+1+SG
cesurou-a	cesurar+V.ele.ACC.3.F.SG+PRF+3+SG
cesurou-as	cesurar+V.ele.ACC.3.F.PL+PRF+3+SG
cesurou-lhe	cesurar+V.ele.DAT.3.SG+PRF+3+SG
cesurou-lhes	cesurar+V.ele.DAT.3.PL+PRF+3+SG
cesurou-me	cesurar+V.eu.AD.1.SG+PRF+3+SG
cesurou-nos	cesurar+nós.AD.1.PL+PRF+3+SG
cesurou-o	cesurar+V.ele.ACC.3.M.SG+PRF+3+SG
cesurou-os	cesurar+V.ele.ACC.3.M.PL+PRF+3+SG
cesurou-se	cesurar+V.ele.REFL+PRF+3+SG
cesurou-te	cesurar+V.tu.AD.2.SG+PRF+3+SG
cesurou-vos	cesurar+V.vós.AD.2.PL+PRF+3+SG
cesuro-vos	cesurar+V.vós.AD.2.PL+PRS+1+SG
ceva-a	cevar+V.ele.ACC.3.F.SG+PRS+3+SG
ceva-as	cevar+V.ele.ACC.3.F.PL+PRS+3+SG
cevai-la	cevar+V.ele.ACC.3.F.SG+PRS+2+PL
cevai-las	cevar+V.ele.ACC.3.F.PL+PRS+2+PL
cevai-lo	cevar+V.ele.ACC.3.M.SG+PRS+2+PL
cevai-los	cevar+V.ele.ACC.3.M.PL+PRS+2+PL
cevai-nos	cevar+nós.AD.1.PL+PRS+2+PL
cevais-lhe	cevar+V.ele.DAT.3.SG+PRS+2+PL
cevais-lhes	cevar+V.ele.DAT.3.PL+PRS+2+PL
cevais-me	cevar+V.eu.AD.1.SG+PRS+2+PL
cevais-te	cevar+V.tu.AD.2.SG+PRS+2+PL
cevais-vos	cevar+V.vós.AD.2.PL+PRS+2+PL
cevá-la-á	cevar+V.ele.ACC.3.F.SG+FUT+3+SG
cevá-la-ão	cevar+V.ele.ACC.3.F.SG+FUT+3+PL
cevá-la-ás	cevar+V.ele.ACC.3.F.SG+FUT+2+SG
cevá-la	cevar+V.ele.ACC.3.F.SG+INF+1+SG
cevá-la	cevar+V.ele.ACC.3.F.SG+INF+3+SG
ceva-la	cevar+V.ele.ACC.3.F.SG+PRS+2+SG
cevá-la	cevar+V.ele.ACC.3.F.SG+SBJF+1+SG
cevá-la	cevar+V.ele.ACC.3.F.SG+SBJF+3+SG
cevá-la-ei	cevar+V.ele.ACC.3.F.SG+FUT+1+SG
cevá-la-eis	cevar+V.ele.ACC.3.F.SG+FUT+2+PL
cevá-la-emos	cevar+V.ele.ACC.3.F.SG+FUT+1+PL
cevá-la-ia	cevar+V.ele.ACC.3.F.SG+COND+1+SG
cevá-la-ia	cevar+V.ele.ACC.3.F.SG+COND+3+SG
cevá-la-iam	cevar+V.ele.ACC.3.F.SG+COND+3+PL
cevá-la-íamos	cevar+V.ele.ACC.3.F.SG+COND+1+PL
cevá-la-ias	cevar+V.ele.ACC.3.F.SG+COND+2+SG
cevá-la-íeis	cevar+V.ele.ACC.3.F.SG+COND+2+PL
cevá-las-á	cevar+V.ele.ACC.3.F.PL+FUT+3+SG
cevá-las-ão	cevar+V.ele.ACC.3.F.PL+FUT+3+PL
cevá-las-ás	cevar+V.ele.ACC.3.F.PL+FUT+2+SG
cevá-las	cevar+V.ele.ACC.3.F.PL+INF+1+SG
cevá-las	cevar+V.ele.ACC.3.F.PL+INF+3+SG
ceva-las	cevar+V.ele.ACC.3.F.PL+PRS+2+SG
cevá-las	cevar+V.ele.ACC.3.F.PL+SBJF+1+SG
cevá-las	cevar+V.ele.ACC.3.F.PL+SBJF+3+SG
cevá-las-ei	cevar+V.ele.ACC.3.F.PL+FUT+1+SG
cevá-las-eis	cevar+V.ele.ACC.3.F.PL+FUT+2+PL
cevá-las-emos	cevar+V.ele.ACC.3.F.PL+FUT+1+PL
cevá-las-ia	cevar+V.ele.ACC.3.F.PL+COND+1+SG
cevá-las-ia	cevar+V.ele.ACC.3.F.PL+COND+3+SG
cevá-las-iam	cevar+V.ele.ACC.3.F.PL+COND+3+PL
cevá-las-íamos	cevar+V.ele.ACC.3.F.PL+COND+1+PL
cevá-las-ias	cevar+V.ele.ACC.3.F.PL+COND+2+SG
cevá-las-íeis	cevar+V.ele.ACC.3.F.PL+COND+2+PL
ceva-lhe	cevar+V.ele.DAT.3.SG+PRS+3+SG
ceva-lhes	cevar+V.ele.DAT.3.PL+PRS+3+SG
cevá-lo-á	cevar+V.ele.ACC.3.M.SG+FUT+3+SG
cevá-lo-ão	cevar+V.ele.ACC.3.M.SG+FUT+3+PL
cevá-lo-ás	cevar+V.ele.ACC.3.M.SG+FUT+2+SG
cevá-lo	cevar+V.ele.ACC.3.M.SG+INF+1+SG
cevá-lo	cevar+V.ele.ACC.3.M.SG+INF+3+SG
ceva-lo	cevar+V.ele.ACC.3.M.SG+PRS+2+SG
cevá-lo	cevar+V.ele.ACC.3.M.SG+SBJF+1+SG
cevá-lo	cevar+V.ele.ACC.3.M.SG+SBJF+3+SG
cevá-lo-ei	cevar+V.ele.ACC.3.M.SG+FUT+1+SG
cevá-lo-eis	cevar+V.ele.ACC.3.M.SG+FUT+2+PL
cevá-lo-emos	cevar+V.ele.ACC.3.M.SG+FUT+1+PL
cevá-lo-ia	cevar+V.ele.ACC.3.M.SG+COND+1+SG
cevá-lo-ia	cevar+V.ele.ACC.3.M.SG+COND+3+SG
cevá-lo-iam	cevar+V.ele.ACC.3.M.SG+COND+3+PL
cevá-lo-íamos	cevar+V.ele.ACC.3.M.SG+COND+1+PL
cevá-lo-ias	cevar+V.ele.ACC.3.M.SG+COND+2+SG
cevá-lo-íeis	cevar+V.ele.ACC.3.M.SG+COND+2+PL
cevá-los-á	cevar+V.ele.ACC.3.M.PL+FUT+3+SG
cevá-los-ão	cevar+V.ele.ACC.3.M.PL+FUT+3+PL
cevá-los-ás	cevar+V.ele.ACC.3.M.PL+FUT+2+SG
cevá-los	cevar+V.ele.ACC.3.M.PL+INF+1+SG
cevá-los	cevar+V.ele.ACC.3.M.PL+INF+3+SG
ceva-los	cevar+V.ele.ACC.3.M.PL+PRS+2+SG
cevá-los	cevar+V.ele.ACC.3.M.PL+SBJF+1+SG
cevá-los	cevar+V.ele.ACC.3.M.PL+SBJF+3+SG
cevá-los-ei	cevar+V.ele.ACC.3.M.PL+FUT+1+SG
cevá-los-eis	cevar+V.ele.ACC.3.M.PL+FUT+2+PL
cevá-los-emos	cevar+V.ele.ACC.3.M.PL+FUT+1+PL
cevá-los-ia	cevar+V.ele.ACC.3.M.PL+COND+1+SG
cevá-los-ia	cevar+V.ele.ACC.3.M.PL+COND+3+SG
cevá-los-iam	cevar+V.ele.ACC.3.M.PL+COND+3+PL
cevá-los-íamos	cevar+V.ele.ACC.3.M.PL+COND+1+PL
cevá-los-ias	cevar+V.ele.ACC.3.M.PL+COND+2+SG
cevá-los-íeis	cevar+V.ele.ACC.3.M.PL+COND+2+PL
ceva-me	cevar+V.eu.AD.1.SG+PRS+3+SG
cevam-lhe	cevar+V.ele.DAT.3.SG+PRS+3+PL
cevam-lhes	cevar+V.ele.DAT.3.PL+PRS+3+PL
cevam-me	cevar+V.eu.AD.1.SG+PRS+3+PL
cevam-na	cevar+V.ele.ACC.3.F.SG+PRS+3+PL
cevam-nas	cevar+V.ele.ACC.3.F.PL+PRS+3+PL
cevam-no	cevar+V.ele.ACC.3.M.SG+PRS+3+PL
cevam-nos	cevar+V.ele.ACC.3.M.PL+PRS+3+PL
cevam-nos	cevar+V.nós.AD.1.PL+PRS+3+PL
cevamo-la	cevar+V.ele.ACC.3.F.SG+PRF+1+PL
cevamo-la	cevar+V.ele.ACC.3.F.SG+PRS+1+PL
cevamo-las	cevar+V.ele.ACC.3.F.PL+PRF+1+PL
cevamo-las	cevar+V.ele.ACC.3.F.PL+PRS+1+PL
cevamo-lo	cevar+V.ele.ACC.3.M.SG+PRF+1+PL
cevamo-lo	cevar+V.ele.ACC.3.M.SG+PRS+1+PL
cevamo-los	cevar+V.ele.ACC.3.M.PL+PRF+1+PL
cevamo-los	cevar+V.ele.ACC.3.M.PL+PRS+1+PL
cevamo-nos	cevar+nós.AD.1.PL+PRF+1+PL
cevamo-nos	cevar+nós.AD.1.PL+PRS+1+PL
cevamos-lhe	cevar+V.ele.DAT.3.SG+PRF+1+PL
cevamos-lhe	cevar+V.ele.DAT.3.SG+PRS+1+PL
cevamos-lhes	cevar+V.ele.DAT.3.PL+PRF+1+PL
cevamos-lhes	cevar+V.ele.DAT.3.PL+PRS+1+PL
cevamos-me	cevar+V.eu.AD.1.SG+PRF+1+PL
cevamos-me	cevar+V.eu.AD.1.SG+PRS+1+PL
cevamos-te	cevar+V.tu.AD.2.SG+PRF+1+PL
cevamos-te	cevar+V.tu.AD.2.SG+PRS+1+PL
cevamos-vos	cevar+V.vós.AD.2.PL+PRF+1+PL
cevamos-vos	cevar+V.vós.AD.2.PL+PRS+1+PL
cevam-se	cevar+V.ele.REFL+PRS+3+PL
cevam-te	cevar+V.tu.AD.2.SG+PRS+3+PL
cevam-vos	cevar+V.vós.AD.2.PL+PRS+3+PL
cevandija-a	cevandijar+V.ele.ACC.3.F.SG+PRS+3+SG
cevandija-as	cevandijar+V.ele.ACC.3.F.PL+PRS+3+SG
cevandijai-la	cevandijar+V.ele.ACC.3.F.SG+PRS+2+PL
cevandijai-las	cevandijar+V.ele.ACC.3.F.PL+PRS+2+PL
cevandijai-lo	cevandijar+V.ele.ACC.3.M.SG+PRS+2+PL
cevandijai-los	cevandijar+V.ele.ACC.3.M.PL+PRS+2+PL
cevandijai-nos	cevandijar+nós.AD.1.PL+PRS+2+PL
cevandijais-lhe	cevandijar+V.ele.DAT.3.SG+PRS+2+PL
cevandijais-lhes	cevandijar+V.ele.DAT.3.PL+PRS+2+PL
cevandijais-me	cevandijar+V.eu.AD.1.SG+PRS+2+PL
cevandijais-te	cevandijar+V.tu.AD.2.SG+PRS+2+PL
cevandijais-vos	cevandijar+V.vós.AD.2.PL+PRS+2+PL
cevandijá-la-á	cevandijar+V.ele.ACC.3.F.SG+FUT+3+SG
cevandijá-la-ão	cevandijar+V.ele.ACC.3.F.SG+FUT+3+PL
cevandijá-la-ás	cevandijar+V.ele.ACC.3.F.SG+FUT+2+SG
cevandijá-la	cevandijar+V.ele.ACC.3.F.SG+INF+1+SG
cevandijá-la	cevandijar+V.ele.ACC.3.F.SG+INF+3+SG
cevandija-la	cevandijar+V.ele.ACC.3.F.SG+PRS+2+SG
cevandijá-la	cevandijar+V.ele.ACC.3.F.SG+SBJF+1+SG
cevandijá-la	cevandijar+V.ele.ACC.3.F.SG+SBJF+3+SG
cevandijá-la-ei	cevandijar+V.ele.ACC.3.F.SG+FUT+1+SG
cevandijá-la-eis	cevandijar+V.ele.ACC.3.F.SG+FUT+2+PL
cevandijá-la-emos	cevandijar+V.ele.ACC.3.F.SG+FUT+1+PL
cevandijá-la-ia	cevandijar+V.ele.ACC.3.F.SG+COND+1+SG
cevandijá-la-ia	cevandijar+V.ele.ACC.3.F.SG+COND+3+SG
cevandijá-la-iam	cevandijar+V.ele.ACC.3.F.SG+COND+3+PL
cevandijá-la-íamos	cevandijar+V.ele.ACC.3.F.SG+COND+1+PL
cevandijá-la-ias	cevandijar+V.ele.ACC.3.F.SG+COND+2+SG
cevandijá-la-íeis	cevandijar+V.ele.ACC.3.F.SG+COND+2+PL
cevandijá-las-á	cevandijar+V.ele.ACC.3.F.PL+FUT+3+SG
cevandijá-las-ão	cevandijar+V.ele.ACC.3.F.PL+FUT+3+PL
cevandijá-las-ás	cevandijar+V.ele.ACC.3.F.PL+FUT+2+SG
cevandijá-las	cevandijar+V.ele.ACC.3.F.PL+INF+1+SG
cevandijá-las	cevandijar+V.ele.ACC.3.F.PL+INF+3+SG
cevandija-las	cevandijar+V.ele.ACC.3.F.PL+PRS+2+SG
cevandijá-las	cevandijar+V.ele.ACC.3.F.PL+SBJF+1+SG
cevandijá-las	cevandijar+V.ele.ACC.3.F.PL+SBJF+3+SG
cevandijá-las-ei	cevandijar+V.ele.ACC.3.F.PL+FUT+1+SG
cevandijá-las-eis	cevandijar+V.ele.ACC.3.F.PL+FUT+2+PL
cevandijá-las-emos	cevandijar+V.ele.ACC.3.F.PL+FUT+1+PL
cevandijá-las-ia	cevandijar+V.ele.ACC.3.F.PL+COND+1+SG
cevandijá-las-ia	cevandijar+V.ele.ACC.3.F.PL+COND+3+SG
cevandijá-las-iam	cevandijar+V.ele.ACC.3.F.PL+COND+3+PL
cevandijá-las-íamos	cevandijar+V.ele.ACC.3.F.PL+COND+1+PL
cevandijá-las-ias	cevandijar+V.ele.ACC.3.F.PL+COND+2+SG
cevandijá-las-íeis	cevandijar+V.ele.ACC.3.F.PL+COND+2+PL
cevandija-lhe	cevandijar+V.ele.DAT.3.SG+PRS+3+SG
cevandija-lhes	cevandijar+V.ele.DAT.3.PL+PRS+3+SG
cevandijá-lo-á	cevandijar+V.ele.ACC.3.M.SG+FUT+3+SG
cevandijá-lo-ão	cevandijar+V.ele.ACC.3.M.SG+FUT+3+PL
cevandijá-lo-ás	cevandijar+V.ele.ACC.3.M.SG+FUT+2+SG
cevandijá-lo	cevandijar+V.ele.ACC.3.M.SG+INF+1+SG
cevandijá-lo	cevandijar+V.ele.ACC.3.M.SG+INF+3+SG
cevandija-lo	cevandijar+V.ele.ACC.3.M.SG+PRS+2+SG
cevandijá-lo	cevandijar+V.ele.ACC.3.M.SG+SBJF+1+SG
cevandijá-lo	cevandijar+V.ele.ACC.3.M.SG+SBJF+3+SG
cevandijá-lo-ei	cevandijar+V.ele.ACC.3.M.SG+FUT+1+SG
cevandijá-lo-eis	cevandijar+V.ele.ACC.3.M.SG+FUT+2+PL
cevandijá-lo-emos	cevandijar+V.ele.ACC.3.M.SG+FUT+1+PL
cevandijá-lo-ia	cevandijar+V.ele.ACC.3.M.SG+COND+1+SG
cevandijá-lo-ia	cevandijar+V.ele.ACC.3.M.SG+COND+3+SG
cevandijá-lo-iam	cevandijar+V.ele.ACC.3.M.SG+COND+3+PL
cevandijá-lo-íamos	cevandijar+V.ele.ACC.3.M.SG+COND+1+PL
cevandijá-lo-ias	cevandijar+V.ele.ACC.3.M.SG+COND+2+SG
cevandijá-lo-íeis	cevandijar+V.ele.ACC.3.M.SG+COND+2+PL
cevandijá-los-á	cevandijar+V.ele.ACC.3.M.PL+FUT+3+SG
cevandijá-los-ão	cevandijar+V.ele.ACC.3.M.PL+FUT+3+PL
cevandijá-los-ás	cevandijar+V.ele.ACC.3.M.PL+FUT+2+SG
cevandijá-los	cevandijar+V.ele.ACC.3.M.PL+INF+1+SG
cevandijá-los	cevandijar+V.ele.ACC.3.M.PL+INF+3+SG
cevandija-los	cevandijar+V.ele.ACC.3.M.PL+PRS+2+SG
cevandijá-los	cevandijar+V.ele.ACC.3.M.PL+SBJF+1+SG
cevandijá-los	cevandijar+V.ele.ACC.3.M.PL+SBJF+3+SG
cevandijá-los-ei	cevandijar+V.ele.ACC.3.M.PL+FUT+1+SG
cevandijá-los-eis	cevandijar+V.ele.ACC.3.M.PL+FUT+2+PL
cevandijá-los-emos	cevandijar+V.ele.ACC.3.M.PL+FUT+1+PL
cevandijá-los-ia	cevandijar+V.ele.ACC.3.M.PL+COND+1+SG
cevandijá-los-ia	cevandijar+V.ele.ACC.3.M.PL+COND+3+SG
cevandijá-los-iam	cevandijar+V.ele.ACC.3.M.PL+COND+3+PL
cevandijá-los-íamos	cevandijar+V.ele.ACC.3.M.PL+COND+1+PL
cevandijá-los-ias	cevandijar+V.ele.ACC.3.M.PL+COND+2+SG
cevandijá-los-íeis	cevandijar+V.ele.ACC.3.M.PL+COND+2+PL
cevandija-me	cevandijar+V.eu.AD.1.SG+PRS+3+SG
cevandijam-lhe	cevandijar+V.ele.DAT.3.SG+PRS+3+PL
cevandijam-lhes	cevandijar+V.ele.DAT.3.PL+PRS+3+PL
cevandijam-me	cevandijar+V.eu.AD.1.SG+PRS+3+PL
cevandijam-na	cevandijar+V.ele.ACC.3.F.SG+PRS+3+PL
cevandijam-nas	cevandijar+V.ele.ACC.3.F.PL+PRS+3+PL
cevandijam-no	cevandijar+V.ele.ACC.3.M.SG+PRS+3+PL
cevandijam-nos	cevandijar+V.ele.ACC.3.M.PL+PRS+3+PL
cevandijam-nos	cevandijar+V.nós.AD.1.PL+PRS+3+PL
cevandijamo-la	cevandijar+V.ele.ACC.3.F.SG+PRF+1+PL
cevandijamo-la	cevandijar+V.ele.ACC.3.F.SG+PRS+1+PL
cevandijamo-las	cevandijar+V.ele.ACC.3.F.PL+PRF+1+PL
cevandijamo-las	cevandijar+V.ele.ACC.3.F.PL+PRS+1+PL
cevandijamo-lo	cevandijar+V.ele.ACC.3.M.SG+PRF+1+PL
cevandijamo-lo	cevandijar+V.ele.ACC.3.M.SG+PRS+1+PL
cevandijamo-los	cevandijar+V.ele.ACC.3.M.PL+PRF+1+PL
cevandijamo-los	cevandijar+V.ele.ACC.3.M.PL+PRS+1+PL
cevandijamo-nos	cevandijar+nós.AD.1.PL+PRF+1+PL
cevandijamo-nos	cevandijar+nós.AD.1.PL+PRS+1+PL
cevandijamos-lhe	cevandijar+V.ele.DAT.3.SG+PRF+1+PL
cevandijamos-lhe	cevandijar+V.ele.DAT.3.SG+PRS+1+PL
cevandijamos-lhes	cevandijar+V.ele.DAT.3.PL+PRF+1+PL
cevandijamos-lhes	cevandijar+V.ele.DAT.3.PL+PRS+1+PL
cevandijamos-me	cevandijar+V.eu.AD.1.SG+PRF+1+PL
cevandijamos-me	cevandijar+V.eu.AD.1.SG+PRS+1+PL
cevandijamos-te	cevandijar+V.tu.AD.2.SG+PRF+1+PL
cevandijamos-te	cevandijar+V.tu.AD.2.SG+PRS+1+PL
cevandijamos-vos	cevandijar+V.vós.AD.2.PL+PRF+1+PL
cevandijamos-vos	cevandijar+V.vós.AD.2.PL+PRS+1+PL
cevandijam-se	cevandijar+V.ele.REFL+PRS+3+PL
cevandijam-te	cevandijar+V.tu.AD.2.SG+PRS+3+PL
cevandijam-vos	cevandijar+V.vós.AD.2.PL+PRS+3+PL
cevandijando-a	cevandijar+V.ele.ACC.3.F.SG+GRD
cevandijando-as	cevandijar+V.ele.ACC.3.F.PL+GRD
cevandijando-lhe	cevandijar+V.ele.DAT.3.SG+GRD
cevandijando-lhes	cevandijar+V.ele.DAT.3.PL+GRD
cevandijando-me	cevandijar+V.eu.AD.1.SG+GRD
cevandijando-nos	cevandijar+nós.AD.1.PL+GRD
cevandijando-o	cevandijar+V.ele.ACC.3.M.SG+GRD
cevandijando-os	cevandijar+V.ele.ACC.3.M.PL+GRD
cevandijando-se	cevandijar+V.ele.REFL+GRD
cevandijando-te	cevandijar+V.tu.AD.2.SG+GRD
cevandijando-vos	cevandijar+V.vós.AD.2.PL+GRD
cevandija-nos	cevandijar+nós.AD.1.PL+PRS+2+SG
cevandija-nos	cevandijar+nós.AD.1.PL+PRS+3+SG
cevandija-o	cevandijar+V.ele.ACC.3.M.SG+PRS+3+SG
cevandija-os	cevandijar+V.ele.ACC.3.M.PL+PRS+3+SG
cevandijara-a	cevandijar+V.ele.ACC.3.F.SG+PQP+1+SG
cevandijara-a	cevandijar+V.ele.ACC.3.F.SG+PQP+3+SG
cevandijara-as	cevandijar+V.ele.ACC.3.F.PL+PQP+1+SG
cevandijara-as	cevandijar+V.ele.ACC.3.F.PL+PQP+3+SG
cevandijara-la	cevandijar+V.ele.ACC.3.F.SG+PQP+2+SG
cevandijara-las	cevandijar+V.ele.ACC.3.F.PL+PQP+2+SG
cevandijara-lhe	cevandijar+V.ele.DAT.3.SG+PQP+1+SG
cevandijara-lhe	cevandijar+V.ele.DAT.3.SG+PQP+3+SG
cevandijara-lhes	cevandijar+V.ele.DAT.3.PL+PQP+1+SG
cevandijara-lhes	cevandijar+V.ele.DAT.3.PL+PQP+3+SG
cevandijara-lo	cevandijar+V.ele.ACC.3.M.SG+PQP+2+SG
cevandijara-los	cevandijar+V.ele.ACC.3.M.PL+PQP+2+SG
cevandijara-me	cevandijar+V.eu.AD.1.SG+PQP+1+SG
cevandijara-me	cevandijar+V.eu.AD.1.SG+PQP+3+SG
cevandijaram-lhe	cevandijar+V.ele.DAT.3.SG+PQP+3+PL
cevandijaram-lhe	cevandijar+V.ele.DAT.3.SG+PRF+3+PL
cevandijaram-lhes	cevandijar+V.ele.DAT.3.PL+PQP+3+PL
cevandijaram-lhes	cevandijar+V.ele.DAT.3.PL+PRF+3+PL
cevandijaram-me	cevandijar+V.eu.AD.1.SG+PQP+3+PL
cevandijaram-me	cevandijar+V.eu.AD.1.SG+PRF+3+PL
cevandijaram-na	cevandijar+V.ele.ACC.3.F.SG+PQP+3+PL
cevandijaram-na	cevandijar+V.ele.ACC.3.F.SG+PRF+3+PL
cevandijaram-nas	cevandijar+V.ele.ACC.3.F.PL+PQP+3+PL
cevandijaram-nas	cevandijar+V.ele.ACC.3.F.PL+PRF+3+PL
cevandijaram-no	cevandijar+V.ele.ACC.3.M.SG+PQP+3+PL
cevandijaram-no	cevandijar+V.ele.ACC.3.M.SG+PRF+3+PL
cevandijaram-nos	cevandijar+V.ele.ACC.3.M.PL+PQP+3+PL
cevandijaram-nos	cevandijar+V.ele.ACC.3.M.PL+PRF+3+PL
cevandijaram-nos	cevandijar+V.nós.AD.1.PL+PQP+3+PL
cevandijaram-nos	cevandijar+V.nós.AD.1.PL+PRF+3+PL
cevandijáramo-la	cevandijar+V.ele.ACC.3.F.SG+PQP+1+PL
cevandijáramo-las	cevandijar+V.ele.ACC.3.F.PL+PQP+1+PL
cevandijáramo-lo	cevandijar+V.ele.ACC.3.M.SG+PQP+1+PL
cevandijáramo-los	cevandijar+V.ele.ACC.3.M.PL+PQP+1+PL
cevandijáramo-nos	cevandijar+nós.AD.1.PL+PQP+1+PL
cevandijáramos-lhe	cevandijar+V.ele.DAT.3.SG+PQP+1+PL
cevandijáramos-lhes	cevandijar+V.ele.DAT.3.PL+PQP+1+PL
cevandijáramos-me	cevandijar+V.eu.AD.1.SG+PQP+1+PL
cevandijáramos-te	cevandijar+V.tu.AD.2.SG+PQP+1+PL
cevandijáramos-vos	cevandijar+V.vós.AD.2.PL+PQP+1+PL
cevandijaram-se	cevandijar+V.ele.REFL+PQP+3+PL
cevandijaram-se	cevandijar+V.ele.REFL+PRF+3+PL
cevandijaram-te	cevandijar+V.tu.AD.2.SG+PQP+3+PL
cevandijaram-te	cevandijar+V.tu.AD.2.SG+PRF+3+PL
cevandijaram-vos	cevandijar+V.vós.AD.2.PL+PQP+3+PL
cevandijaram-vos	cevandijar+V.vós.AD.2.PL+PRF+3+PL
cevandijara-nos	cevandijar+nós.AD.1.PL+PQP+1+SG
cevandijara-nos	cevandijar+nós.AD.1.PL+PQP+2+SG
cevandijara-nos	cevandijar+nós.AD.1.PL+PQP+3+SG
cevandijara-o	cevandijar+V.ele.ACC.3.M.SG+PQP+1+SG
cevandijara-o	cevandijar+V.ele.ACC.3.M.SG+PQP+3+SG
cevandijara-os	cevandijar+V.ele.ACC.3.M.PL+PQP+1+SG
cevandijara-os	cevandijar+V.ele.ACC.3.M.PL+PQP+3+SG
cevandijara-se	cevandijar+V.ele.REFL+PQP+1+SG
cevandijara-se	cevandijar+V.ele.REFL+PQP+3+SG
cevandijaras-lhe	cevandijar+V.ele.DAT.3.SG+PQP+2+SG
cevandijaras-lhes	cevandijar+V.ele.DAT.3.PL+PQP+2+SG
cevandijaras-me	cevandijar+V.eu.AD.1.SG+PQP+2+SG
cevandijaras-te	cevandijar+V.tu.AD.2.SG+PQP+2+SG
cevandijaras-vos	cevandijar+V.vós.AD.2.PL+PQP+2+SG
cevandijara-te	cevandijar+V.tu.AD.2.SG+PQP+1+SG
cevandijara-te	cevandijar+V.tu.AD.2.SG+PQP+3+SG
cevandijara-vos	cevandijar+V.vós.AD.2.PL+PQP+1+SG
cevandijara-vos	cevandijar+V.vós.AD.2.PL+PQP+3+SG
cevandijarde-la	cevandijar+V.ele.ACC.3.F.SG+INF+2+PL
cevandijarde-la	cevandijar+V.ele.ACC.3.F.SG+SBJF+2+PL
cevandijarde-las	cevandijar+V.ele.ACC.3.F.PL+INF+2+PL
cevandijarde-las	cevandijar+V.ele.ACC.3.F.PL+SBJF+2+PL
cevandijarde-lo	cevandijar+V.ele.ACC.3.M.SG+INF+2+PL
cevandijarde-lo	cevandijar+V.ele.ACC.3.M.SG+SBJF+2+PL
cevandijarde-los	cevandijar+V.ele.ACC.3.M.PL+INF+2+PL
cevandijarde-los	cevandijar+V.ele.ACC.3.M.PL+SBJF+2+PL
cevandijarde-nos	cevandijar+nós.AD.1.PL+INF+2+PL
cevandijarde-nos	cevandijar+nós.AD.1.PL+SBJF+2+PL
cevandijardes-lhe	cevandijar+V.ele.DAT.3.SG+INF+2+PL
cevandijardes-lhe	cevandijar+V.ele.DAT.3.SG+SBJF+2+PL
cevandijardes-lhes	cevandijar+V.ele.DAT.3.PL+INF+2+PL
cevandijardes-lhes	cevandijar+V.ele.DAT.3.PL+SBJF+2+PL
cevandijardes-me	cevandijar+V.eu.AD.1.SG+INF+2+PL
cevandijardes-me	cevandijar+V.eu.AD.1.SG+SBJF+2+PL
cevandijardes-te	cevandijar+V.tu.AD.2.SG+INF+2+PL
cevandijardes-te	cevandijar+V.tu.AD.2.SG+SBJF+2+PL
cevandijardes-vos	cevandijar+V.vós.AD.2.PL+INF+2+PL
cevandijardes-vos	cevandijar+V.vós.AD.2.PL+SBJF+2+PL
cevandijárei-la	cevandijar+V.ele.ACC.3.F.SG+PQP+2+PL
cevandijárei-las	cevandijar+V.ele.ACC.3.F.PL+PQP+2+PL
cevandijárei-lo	cevandijar+V.ele.ACC.3.M.SG+PQP+2+PL
cevandijárei-los	cevandijar+V.ele.ACC.3.M.PL+PQP+2+PL
cevandijárei-nos	cevandijar+nós.AD.1.PL+PQP+2+PL
cevandijáreis-lhe	cevandijar+V.ele.DAT.3.SG+PQP+2+PL
cevandijáreis-lhes	cevandijar+V.ele.DAT.3.PL+PQP+2+PL
cevandijáreis-me	cevandijar+V.eu.AD.1.SG+PQP+2+PL
cevandijáreis-te	cevandijar+V.tu.AD.2.SG+PQP+2+PL
cevandijáreis-vos	cevandijar+V.vós.AD.2.PL+PQP+2+PL
cevandijare-la	cevandijar+V.ele.ACC.3.F.SG+INF+2+SG
cevandijare-la	cevandijar+V.ele.ACC.3.F.SG+SBJF+2+SG
cevandijare-las	cevandijar+V.ele.ACC.3.F.PL+INF+2+SG
cevandijare-las	cevandijar+V.ele.ACC.3.F.PL+SBJF+2+SG
cevandijare-lo	cevandijar+V.ele.ACC.3.M.SG+INF+2+SG
cevandijare-lo	cevandijar+V.ele.ACC.3.M.SG+SBJF+2+SG
cevandijare-los	cevandijar+V.ele.ACC.3.M.PL+INF+2+SG
cevandijare-los	cevandijar+V.ele.ACC.3.M.PL+SBJF+2+SG
cevandijarem-lhe	cevandijar+V.ele.DAT.3.SG+INF+3+PL
cevandijarem-lhe	cevandijar+V.ele.DAT.3.SG+SBJF+3+PL
cevandijarem-lhes	cevandijar+V.ele.DAT.3.PL+INF+3+PL
cevandijarem-lhes	cevandijar+V.ele.DAT.3.PL+SBJF+3+PL
cevandijarem-me	cevandijar+V.eu.AD.1.SG+INF+3+PL
cevandijarem-me	cevandijar+V.eu.AD.1.SG+SBJF+3+PL
cevandijarem-na	cevandijar+V.ele.ACC.3.F.SG+INF+3+PL
cevandijarem-na	cevandijar+V.ele.ACC.3.F.SG+SBJF+3+PL
cevandijarem-nas	cevandijar+V.ele.ACC.3.F.PL+INF+3+PL
cevandijarem-nas	cevandijar+V.ele.ACC.3.F.PL+SBJF+3+PL
cevandijarem-no	cevandijar+V.ele.ACC.3.M.SG+INF+3+PL
cevandijarem-no	cevandijar+V.ele.ACC.3.M.SG+SBJF+3+PL
cevandijarem-nos	cevandijar+V.ele.ACC.3.M.PL+INF+3+PL
cevandijarem-nos	cevandijar+V.ele.ACC.3.M.PL+SBJF+3+PL
cevandijarem-nos	cevandijar+V.nós.AD.1.PL+INF+3+PL
cevandijarem-nos	cevandijar+V.nós.AD.1.PL+SBJF+3+PL
cevandijarem-se	cevandijar+V.ele.REFL+INF+3+PL
cevandijarem-se	cevandijar+V.ele.REFL+SBJF+3+PL
cevandijarem-te	cevandijar+V.tu.AD.2.SG+INF+3+PL
cevandijarem-te	cevandijar+V.tu.AD.2.SG+SBJF+3+PL
cevandijarem-vos	cevandijar+V.vós.AD.2.PL+INF+3+PL
cevandijarem-vos	cevandijar+V.vós.AD.2.PL+SBJF+3+PL
cevandijare-nos	cevandijar+nós.AD.1.PL+INF+2+SG
cevandijare-nos	cevandijar+nós.AD.1.PL+SBJF+2+SG
cevandijares-lhe	cevandijar+V.ele.DAT.3.SG+INF+2+SG
cevandijares-lhe	cevandijar+V.ele.DAT.3.SG+SBJF+2+SG
cevandijares-lhes	cevandijar+V.ele.DAT.3.PL+INF+2+SG
cevandijares-lhes	cevandijar+V.ele.DAT.3.PL+SBJF+2+SG
cevandijares-me	cevandijar+V.eu.AD.1.SG+INF+2+SG
cevandijares-me	cevandijar+V.eu.AD.1.SG+SBJF+2+SG
cevandijares-te	cevandijar+V.tu.AD.2.SG+INF+2+SG
cevandijares-te	cevandijar+V.tu.AD.2.SG+SBJF+2+SG
cevandijares-vos	cevandijar+V.vós.AD.2.PL+INF+2+SG
cevandijares-vos	cevandijar+V.vós.AD.2.PL+SBJF+2+SG
cevandijar-lhe-á	cevandijar+V.ele.DAT.3.SG+FUT+3+SG
cevandijar-lhe-ão	cevandijar+V.ele.DAT.3.SG+FUT+3+PL
cevandijar-lhe-ás	cevandijar+V.ele.DAT.3.SG+FUT+2+SG
cevandijar-lhe	cevandijar+V.ele.DAT.3.SG+INF
cevandijar-lhe	cevandijar+V.ele.DAT.3.SG+INF+1+SG
cevandijar-lhe	cevandijar+V.ele.DAT.3.SG+INF+3+SG
cevandijar-lhe	cevandijar+V.ele.DAT.3.SG+SBJF+1+SG
cevandijar-lhe	cevandijar+V.ele.DAT.3.SG+SBJF+3+SG
cevandijar-lhe-ei	cevandijar+V.ele.DAT.3.SG+FUT+1+SG
cevandijar-lhe-eis	cevandijar+V.ele.DAT.3.SG+FUT+2+PL
cevandijar-lhe-emos	cevandijar+V.ele.DAT.3.SG+FUT+1+PL
cevandijar-lhe-ia	cevandijar+V.ele.DAT.3.SG+COND+1+SG
cevandijar-lhe-ia	cevandijar+V.ele.DAT.3.SG+COND+3+SG
cevandijar-lhe-iam	cevandijar+V.ele.DAT.3.SG+COND+3+PL
cevandijar-lhe-íamos	cevandijar+V.ele.DAT.3.SG+COND+1+PL
cevandijar-lhe-ias	cevandijar+V.ele.DAT.3.SG+COND+2+SG
cevandijar-lhe-íeis	cevandijar+V.ele.DAT.3.SG+COND+2+PL
cevandijar-lhes-á	cevandijar+V.ele.DAT.3.PL+FUT+3+SG
cevandijar-lhes-ão	cevandijar+V.ele.DAT.3.PL+FUT+3+PL
cevandijar-lhes-ás	cevandijar+V.ele.DAT.3.PL+FUT+2+SG
cevandijar-lhes	cevandijar+V.ele.DAT.3.PL+INF
cevandijar-lhes	cevandijar+V.ele.DAT.3.PL+INF+1+SG
cevandijar-lhes	cevandijar+V.ele.DAT.3.PL+INF+3+SG
cevandijar-lhes	cevandijar+V.ele.DAT.3.PL+SBJF+1+SG
cevandijar-lhes	cevandijar+V.ele.DAT.3.PL+SBJF+3+SG
cevandijar-lhes-ei	cevandijar+V.ele.DAT.3.PL+FUT+1+SG
cevandijar-lhes-eis	cevandijar+V.ele.DAT.3.PL+FUT+2+PL
cevandijar-lhes-emos	cevandijar+V.ele.DAT.3.PL+FUT+1+PL
cevandijar-lhes-ia	cevandijar+V.ele.DAT.3.PL+COND+1+SG
cevandijar-lhes-ia	cevandijar+V.ele.DAT.3.PL+COND+3+SG
cevandijar-lhes-iam	cevandijar+V.ele.DAT.3.PL+COND+3+PL
cevandijar-lhes-íamos	cevandijar+V.ele.DAT.3.PL+COND+1+PL
cevandijar-lhes-ias	cevandijar+V.ele.DAT.3.PL+COND+2+SG
cevandijar-lhes-íeis	cevandijar+V.ele.DAT.3.PL+COND+2+PL
cevandijar-me-á	cevandijar+V.eu.AD.1.SG+FUT+3+SG
cevandijar-me-ão	cevandijar+V.eu.AD.1.SG+FUT+3+PL
cevandijar-me-ás	cevandijar+V.eu.AD.1.SG+FUT+2+SG
cevandijar-me	cevandijar+V.eu.AD.1.SG+INF
cevandijar-me	cevandijar+V.eu.AD.1.SG+INF+1+SG
cevandijar-me	cevandijar+V.eu.AD.1.SG+INF+3+SG
cevandijar-me	cevandijar+V.eu.AD.1.SG+SBJF+1+SG
cevandijar-me	cevandijar+V.eu.AD.1.SG+SBJF+3+SG
cevandijar-me-ei	cevandijar+V.eu.AD.1.SG+FUT+1+SG
cevandijar-me-eis	cevandijar+V.eu.AD.1.SG+FUT+2+PL
cevandijar-me-emos	cevandijar+V.eu.AD.1.SG+FUT+1+PL
cevandijar-me-ia	cevandijar+V.eu.AD.1.SG+COND+1+SG
cevandijar-me-ia	cevandijar+V.eu.AD.1.SG+COND+3+SG
cevandijar-me-iam	cevandijar+V.eu.AD.1.SG+COND+3+PL
cevandijar-me-íamos	cevandijar+V.eu.AD.1.SG+COND+1+PL
cevandijar-me-ias	cevandijar+V.eu.AD.1.SG+COND+2+SG
cevandijar-me-íeis	cevandijar+V.eu.AD.1.SG+COND+2+PL
cevandijarmo-la	cevandijar+V.ele.ACC.3.F.SG+INF+1+PL
cevandijarmo-la	cevandijar+V.ele.ACC.3.F.SG+SBJF+1+PL
cevandijarmo-las	cevandijar+V.ele.ACC.3.F.PL+INF+1+PL
cevandijarmo-las	cevandijar+V.ele.ACC.3.F.PL+SBJF+1+PL
cevandijarmo-lo	cevandijar+V.ele.ACC.3.M.SG+INF+1+PL
cevandijarmo-lo	cevandijar+V.ele.ACC.3.M.SG+SBJF+1+PL
cevandijarmo-los	cevandijar+V.ele.ACC.3.M.PL+INF+1+PL
cevandijarmo-los	cevandijar+V.ele.ACC.3.M.PL+SBJF+1+PL
cevandijarmo-nos	cevandijar+nós.AD.1.PL+INF+1+PL
cevandijarmo-nos	cevandijar+nós.AD.1.PL+SBJF+1+PL
cevandijarmos-lhe	cevandijar+V.ele.DAT.3.SG+INF+1+PL
cevandijarmos-lhe	cevandijar+V.ele.DAT.3.SG+SBJF+1+PL
cevandijarmos-lhes	cevandijar+V.ele.DAT.3.PL+INF+1+PL
cevandijarmos-lhes	cevandijar+V.ele.DAT.3.PL+SBJF+1+PL
cevandijarmos-me	cevandijar+V.eu.AD.1.SG+INF+1+PL
cevandijarmos-me	cevandijar+V.eu.AD.1.SG+SBJF+1+PL
cevandijarmos-te	cevandijar+V.tu.AD.2.SG+INF+1+PL
cevandijarmos-te	cevandijar+V.tu.AD.2.SG+SBJF+1+PL
cevandijarmos-vos	cevandijar+V.vós.AD.2.PL+INF+1+PL
cevandijarmos-vos	cevandijar+V.vós.AD.2.PL+SBJF+1+PL
cevandijar-nos-á	cevandijar+nós.AD.1.PL+FUT+3+SG
cevandijar-nos-ão	cevandijar+nós.AD.1.PL+FUT+3+PL
cevandijar-nos-ás	cevandijar+nós.AD.1.PL+FUT+2+SG
cevandijar-nos	cevandijar+nós.AD.1.PL+INF
cevandijar-nos	cevandijar+nós.AD.1.PL+INF+1+SG
cevandijar-nos	cevandijar+nós.AD.1.PL+INF+3+SG
cevandijar-nos	cevandijar+nós.AD.1.PL+SBJF+1+SG
cevandijar-nos	cevandijar+nós.AD.1.PL+SBJF+3+SG
cevandijar-nos-ei	cevandijar+nós.AD.1.PL+FUT+1+SG
cevandijar-nos-eis	cevandijar+nós.AD.1.PL+FUT+2+PL
cevandijar-nos-emos	cevandijar+nós.AD.1.PL+FUT+1+PL
cevandijar-nos-ia	cevandijar+nós.AD.1.PL+COND+1+SG
cevandijar-nos-ia	cevandijar+nós.AD.1.PL+COND+3+SG
cevandijar-nos-iam	cevandijar+nós.AD.1.PL+COND+3+PL
cevandijar-nos-íamos	cevandijar+nós.AD.1.PL+COND+1+PL
cevandijar-nos-ias	cevandijar+nós.AD.1.PL+COND+2+SG
cevandijar-nos-íeis	cevandijar+nós.AD.1.PL+COND+2+PL
cevandijar-se-á	cevandijar+V.ele.REFL+FUT+3+SG
cevandijar-se-ão	cevandijar+V.ele.REFL+FUT+3+PL
cevandijar-se	cevandijar+V.ele.REFL+INF
cevandijar-se	cevandijar+V.ele.REFL+INF+3+SG
cevandijar-se	cevandijar+V.ele.REFL+SBJF+3+SG
cevandijar-se-ia	cevandijar+V.ele.REFL+COND+3+SG
cevandijar-se-iam	cevandijar+V.ele.REFL+COND+3+PL
cevandijar-te-á	cevandijar+V.tu.AD.2.SG+FUT+3+SG
cevandijar-te-ão	cevandijar+V.tu.AD.2.SG+FUT+3+PL
cevandijar-te-ás	cevandijar+V.tu.AD.2.SG+FUT+2+SG
cevandijar-te	cevandijar+V.tu.AD.2.SG+INF
cevandijar-te	cevandijar+V.tu.AD.2.SG+INF+1+SG
cevandijar-te	cevandijar+V.tu.AD.2.SG+INF+3+SG
cevandijar-te	cevandijar+V.tu.AD.2.SG+SBJF+1+SG
cevandijar-te	cevandijar+V.tu.AD.2.SG+SBJF+3+SG
cevandijar-te-ei	cevandijar+V.tu.AD.2.SG+FUT+1+SG
cevandijar-te-eis	cevandijar+V.tu.AD.2.SG+FUT+2+PL
cevandijar-te-emos	cevandijar+V.tu.AD.2.SG+FUT+1+PL
cevandijar-te-ia	cevandijar+V.tu.AD.2.SG+COND+1+SG
cevandijar-te-ia	cevandijar+V.tu.AD.2.SG+COND+3+SG
cevandijar-te-iam	cevandijar+V.tu.AD.2.SG+COND+3+PL
cevandijar-te-íamos	cevandijar+V.tu.AD.2.SG+COND+1+PL
cevandijar-te-ias	cevandijar+V.tu.AD.2.SG+COND+2+SG
cevandijar-te-íeis	cevandijar+V.tu.AD.2.SG+COND+2+PL
cevandijar-vos-á	cevandijar+V.vós.AD.2.PL+FUT+3+SG
cevandijar-vos-ão	cevandijar+V.vós.AD.2.PL+FUT+3+PL
cevandijar-vos-ás	cevandijar+V.vós.AD.2.PL+FUT+2+SG
cevandijar-vos	cevandijar+V.vós.AD.2.PL+INF
cevandijar-vos	cevandijar+V.vós.AD.2.PL+INF+1+SG
cevandijar-vos	cevandijar+V.vós.AD.2.PL+INF+3+SG
cevandijar-vos	cevandijar+V.vós.AD.2.PL+SBJF+1+SG
cevandijar-vos	cevandijar+V.vós.AD.2.PL+SBJF+3+SG
cevandijar-vos-ei	cevandijar+V.vós.AD.2.PL+FUT+1+SG
cevandijar-vos-eis	cevandijar+V.vós.AD.2.PL+FUT+2+PL
cevandijar-vos-emos	cevandijar+V.vós.AD.2.PL+FUT+1+PL
cevandijar-vos-ia	cevandijar+V.vós.AD.2.PL+COND+1+SG
cevandijar-vos-ia	cevandijar+V.vós.AD.2.PL+COND+3+SG
cevandijar-vos-iam	cevandijar+V.vós.AD.2.PL+COND+3+PL
cevandijar-vos-íamos	cevandijar+V.vós.AD.2.PL+COND+1+PL
cevandijar-vos-ias	cevandijar+V.vós.AD.2.PL+COND+2+SG
cevandijar-vos-íeis	cevandijar+V.vós.AD.2.PL+COND+2+PL
cevandija-se	cevandijar+V.ele.REFL+PRS+3+SG
cevandijas-lhe	cevandijar+V.ele.DAT.3.SG+PRS+2+SG
cevandijas-lhes	cevandijar+V.ele.DAT.3.PL+PRS+2+SG
cevandijas-me	cevandijar+V.eu.AD.1.SG+PRS+2+SG
cevandijaste-a	cevandijar+V.ele.ACC.3.F.SG+PRF+2+SG
cevandijaste-as	cevandijar+V.ele.ACC.3.F.PL+PRF+2+SG
cevandijas-te	cevandijar+V.tu.AD.2.SG+PRS+2+SG
cevandijaste-la	cevandijar+V.ele.ACC.3.F.SG+PRF+2+PL
cevandijaste-las	cevandijar+V.ele.ACC.3.F.PL+PRF+2+PL
cevandijaste-lhe	cevandijar+V.ele.DAT.3.SG+PRF+2+SG
cevandijaste-lhes	cevandijar+V.ele.DAT.3.PL+PRF+2+SG
cevandijaste-lo	cevandijar+V.ele.ACC.3.M.SG+PRF+2+PL
cevandijaste-los	cevandijar+V.ele.ACC.3.M.PL+PRF+2+PL
cevandijaste-me	cevandijar+V.eu.AD.1.SG+PRF+2+SG
cevandijaste-nos	cevandijar+nós.AD.1.PL+PRF+2+PL
cevandijaste-nos	cevandijar+nós.AD.1.PL+PRF+2+SG
cevandijaste-o	cevandijar+V.ele.ACC.3.M.SG+PRF+2+SG
cevandijaste-os	cevandijar+V.ele.ACC.3.M.PL+PRF+2+SG
cevandijastes-lhe	cevandijar+V.ele.DAT.3.SG+PRF+2+PL
cevandijastes-lhes	cevandijar+V.ele.DAT.3.PL+PRF+2+PL
cevandijastes-me	cevandijar+V.eu.AD.1.SG+PRF+2+PL
cevandijastes-te	cevandijar+V.tu.AD.2.SG+PRF+2+PL
cevandijastes-vos	cevandijar+V.vós.AD.2.PL+PRF+2+PL
cevandijaste-te	cevandijar+V.tu.AD.2.SG+PRF+2+SG
cevandijaste-vos	cevandijar+V.vós.AD.2.PL+PRF+2+SG
cevandijas-vos	cevandijar+V.vós.AD.2.PL+PRS+2+SG
cevandija-te	cevandijar+V.tu.AD.2.SG+PRS+3+SG
cevandijava-a	cevandijar+V.ele.ACC.3.F.SG+IMPF+1+SG
cevandijava-a	cevandijar+V.ele.ACC.3.F.SG+IMPF+3+SG
cevandijava-as	cevandijar+V.ele.ACC.3.F.PL+IMPF+1+SG
cevandijava-as	cevandijar+V.ele.ACC.3.F.PL+IMPF+3+SG
cevandijava-la	cevandijar+V.ele.ACC.3.F.SG+IMPF+2+SG
cevandijava-las	cevandijar+V.ele.ACC.3.F.PL+IMPF+2+SG
cevandijava-lhe	cevandijar+V.ele.DAT.3.SG+IMPF+1+SG
cevandijava-lhe	cevandijar+V.ele.DAT.3.SG+IMPF+3+SG
cevandijava-lhes	cevandijar+V.ele.DAT.3.PL+IMPF+1+SG
cevandijava-lhes	cevandijar+V.ele.DAT.3.PL+IMPF+3+SG
cevandijava-lo	cevandijar+V.ele.ACC.3.M.SG+IMPF+2+SG
cevandijava-los	cevandijar+V.ele.ACC.3.M.PL+IMPF+2+SG
cevandijava-me	cevandijar+V.eu.AD.1.SG+IMPF+1+SG
cevandijava-me	cevandijar+V.eu.AD.1.SG+IMPF+3+SG
cevandijavam-lhe	cevandijar+V.ele.DAT.3.SG+IMPF+3+PL
cevandijavam-lhes	cevandijar+V.ele.DAT.3.PL+IMPF+3+PL
cevandijavam-me	cevandijar+V.eu.AD.1.SG+IMPF+3+PL
cevandijavam-na	cevandijar+V.ele.ACC.3.F.SG+IMPF+3+PL
cevandijavam-nas	cevandijar+V.ele.ACC.3.F.PL+IMPF+3+PL
cevandijavam-no	cevandijar+V.ele.ACC.3.M.SG+IMPF+3+PL
cevandijavam-nos	cevandijar+V.ele.ACC.3.M.PL+IMPF+3+PL
cevandijavam-nos	cevandijar+V.nós.AD.1.PL+IMPF+3+PL
cevandijávamo-la	cevandijar+V.ele.ACC.3.F.SG+IMPF+1+PL
cevandijávamo-las	cevandijar+V.ele.ACC.3.F.PL+IMPF+1+PL
cevandijávamo-lo	cevandijar+V.ele.ACC.3.M.SG+IMPF+1+PL
cevandijávamo-los	cevandijar+V.ele.ACC.3.M.PL+IMPF+1+PL
cevandijávamo-nos	cevandijar+nós.AD.1.PL+IMPF+1+PL
cevandijávamos-lhe	cevandijar+V.ele.DAT.3.SG+IMPF+1+PL
cevandijávamos-lhes	cevandijar+V.ele.DAT.3.PL+IMPF+1+PL
cevandijávamos-me	cevandijar+V.eu.AD.1.SG+IMPF+1+PL
cevandijávamos-te	cevandijar+V.tu.AD.2.SG+IMPF+1+PL
cevandijávamos-vos	cevandijar+V.vós.AD.2.PL+IMPF+1+PL
cevandijavam-se	cevandijar+V.ele.REFL+IMPF+3+PL
cevandijavam-te	cevandijar+V.tu.AD.2.SG+IMPF+3+PL
cevandijavam-vos	cevandijar+V.vós.AD.2.PL+IMPF+3+PL
cevandijava-nos	cevandijar+nós.AD.1.PL+IMPF+1+SG
cevandijava-nos	cevandijar+nós.AD.1.PL+IMPF+2+SG
cevandijava-nos	cevandijar+nós.AD.1.PL+IMPF+3+SG
cevandijava-o	cevandijar+V.ele.ACC.3.M.SG+IMPF+1+SG
cevandijava-o	cevandijar+V.ele.ACC.3.M.SG+IMPF+3+SG
cevandijava-os	cevandijar+V.ele.ACC.3.M.PL+IMPF+1+SG
cevandijava-os	cevandijar+V.ele.ACC.3.M.PL+IMPF+3+SG
cevandijava-se	cevandijar+V.ele.REFL+IMPF+1+SG
cevandijava-se	cevandijar+V.ele.REFL+IMPF+3+SG
cevandijavas-lhe	cevandijar+V.ele.DAT.3.SG+IMPF+2+SG
cevandijavas-lhes	cevandijar+V.ele.DAT.3.PL+IMPF+2+SG
cevandijavas-me	cevandijar+V.eu.AD.1.SG+IMPF+2+SG
cevandijavas-te	cevandijar+V.tu.AD.2.SG+IMPF+2+SG
cevandijavas-vos	cevandijar+V.vós.AD.2.PL+IMPF+2+SG
cevandijava-te	cevandijar+V.tu.AD.2.SG+IMPF+1+SG
cevandijava-te	cevandijar+V.tu.AD.2.SG+IMPF+3+SG
cevandijava-vos	cevandijar+V.vós.AD.2.PL+IMPF+1+SG
cevandijava-vos	cevandijar+V.vós.AD.2.PL+IMPF+3+SG
cevandijávei-la	cevandijar+V.ele.ACC.3.F.SG+IMPF+2+PL
cevandijávei-las	cevandijar+V.ele.ACC.3.F.PL+IMPF+2+PL
cevandijávei-lo	cevandijar+V.ele.ACC.3.M.SG+IMPF+2+PL
cevandijávei-los	cevandijar+V.ele.ACC.3.M.PL+IMPF+2+PL
cevandijávei-nos	cevandijar+nós.AD.1.PL+IMPF+2+PL
cevandijáveis-lhe	cevandijar+V.ele.DAT.3.SG+IMPF+2+PL
cevandijáveis-lhes	cevandijar+V.ele.DAT.3.PL+IMPF+2+PL
cevandijáveis-me	cevandijar+V.eu.AD.1.SG+IMPF+2+PL
cevandijáveis-te	cevandijar+V.tu.AD.2.SG+IMPF+2+PL
cevandijáveis-vos	cevandijar+V.vós.AD.2.PL+IMPF+2+PL
cevandija-vos	cevandijar+V.vós.AD.2.PL+PRS+3+SG
cevandije-a	cevandijar+V.ele.ACC.3.F.SG+IMP+3+SG
cevandije-as	cevandijar+V.ele.ACC.3.F.PL+IMP+3+SG
cevandijei-a	cevandijar+V.ele.ACC.3.F.SG+PRF+1+SG
cevandijei-as	cevandijar+V.ele.ACC.3.F.PL+PRF+1+SG
cevandijei-lhe	cevandijar+V.ele.DAT.3.SG+PRF+1+SG
cevandijei-lhes	cevandijar+V.ele.DAT.3.PL+PRF+1+SG
cevandijei-me	cevandijar+V.eu.AD.1.SG+PRF+1+SG
cevandijei-nos	cevandijar+nós.AD.1.PL+PRF+1+SG
cevandijei-o	cevandijar+V.ele.ACC.3.M.SG+PRF+1+SG
cevandijei-os	cevandijar+V.ele.ACC.3.M.PL+PRF+1+SG
cevandijei-te	cevandijar+V.tu.AD.2.SG+PRF+1+SG
cevandijei-vos	cevandijar+V.vós.AD.2.PL+PRF+1+SG
cevandije-lhe	cevandijar+V.ele.DAT.3.SG+IMP+3+SG
cevandije-lhes	cevandijar+V.ele.DAT.3.PL+IMP+3+SG
cevandije-me	cevandijar+V.eu.AD.1.SG+IMP+3+SG
cevandijem-lhe	cevandijar+V.ele.DAT.3.SG+IMP+3+PL
cevandijem-lhes	cevandijar+V.ele.DAT.3.PL+IMP+3+PL
cevandijem-me	cevandijar+V.eu.AD.1.SG+IMP+3+PL
cevandijem-na	cevandijar+V.ele.ACC.3.F.SG+IMP+3+PL
cevandijem-nas	cevandijar+V.ele.ACC.3.F.PL+IMP+3+PL
cevandijem-no	cevandijar+V.ele.ACC.3.M.SG+IMP+3+PL
cevandijem-nos	cevandijar+V.ele.ACC.3.M.PL+IMP+3+PL
cevandijem-nos	cevandijar+V.nós.AD.1.PL+IMP+3+PL
cevandijemo-la	cevandijar+V.ele.ACC.3.F.SG+IMP+1+PL
cevandijemo-las	cevandijar+V.ele.ACC.3.F.PL+IMP+1+PL
cevandijemo-lo	cevandijar+V.ele.ACC.3.M.SG+IMP+1+PL
cevandijemo-los	cevandijar+V.ele.ACC.3.M.PL+IMP+1+PL
cevandijemo-nos	cevandijar+nós.AD.1.PL+IMP+1+PL
cevandijemos-lhe	cevandijar+V.ele.DAT.3.SG+IMP+1+PL
cevandijemos-lhes	cevandijar+V.ele.DAT.3.PL+IMP+1+PL
cevandijemos-me	cevandijar+V.eu.AD.1.SG+IMP+1+PL
cevandijemos-te	cevandijar+V.tu.AD.2.SG+IMP+1+PL
cevandijemos-vos	cevandijar+V.vós.AD.2.PL+IMP+1+PL
cevandijem-se	cevandijar+V.ele.REFL+IMP+3+PL
cevandijem-te	cevandijar+V.tu.AD.2.SG+IMP+3+PL
cevandijem-vos	cevandijar+V.vós.AD.2.PL+IMP+3+PL
cevandije-nos	cevandijar+nós.AD.1.PL+IMP+3+SG
cevandije-o	cevandijar+V.ele.ACC.3.M.SG+IMP+3+SG
cevandije-os	cevandijar+V.ele.ACC.3.M.PL+IMP+3+SG
cevandije-se	cevandijar+V.ele.REFL+IMP+3+SG
cevandije-te	cevandijar+V.tu.AD.2.SG+IMP+3+SG
cevandije-vos	cevandijar+V.vós.AD.2.PL+IMP+3+SG
cevandijo-a	cevandijar+V.ele.ACC.3.F.SG+PRS+1+SG
cevandijo-as	cevandijar+V.ele.ACC.3.F.PL+PRS+1+SG
cevandijo-lhe	cevandijar+V.ele.DAT.3.SG+PRS+1+SG
cevandijo-lhes	cevandijar+V.ele.DAT.3.PL+PRS+1+SG
cevandijo-me	cevandijar+V.eu.AD.1.SG+PRS+1+SG
cevandijo-nos	cevandijar+nós.AD.1.PL+PRS+1+SG
cevandijo-o	cevandijar+V.ele.ACC.3.M.SG+PRS+1+SG
cevandijo-os	cevandijar+V.ele.ACC.3.M.PL+PRS+1+SG
cevandijo-te	cevandijar+V.tu.AD.2.SG+PRS+1+SG
cevandijou-a	cevandijar+V.ele.ACC.3.F.SG+PRF+3+SG
cevandijou-as	cevandijar+V.ele.ACC.3.F.PL+PRF+3+SG
cevandijou-lhe	cevandijar+V.ele.DAT.3.SG+PRF+3+SG
cevandijou-lhes	cevandijar+V.ele.DAT.3.PL+PRF+3+SG
cevandijou-me	cevandijar+V.eu.AD.1.SG+PRF+3+SG
cevandijou-nos	cevandijar+nós.AD.1.PL+PRF+3+SG
cevandijou-o	cevandijar+V.ele.ACC.3.M.SG+PRF+3+SG
cevandijou-os	cevandijar+V.ele.ACC.3.M.PL+PRF+3+SG
cevandijou-se	cevandijar+V.ele.REFL+PRF+3+SG
cevandijou-te	cevandijar+V.tu.AD.2.SG+PRF+3+SG
cevandijou-vos	cevandijar+V.vós.AD.2.PL+PRF+3+SG
cevandijo-vos	cevandijar+V.vós.AD.2.PL+PRS+1+SG
cevando-a	cevar+V.ele.ACC.3.F.SG+GRD
cevando-as	cevar+V.ele.ACC.3.F.PL+GRD
cevando-lhe	cevar+V.ele.DAT.3.SG+GRD
cevando-lhes	cevar+V.ele.DAT.3.PL+GRD
cevando-me	cevar+V.eu.AD.1.SG+GRD
cevando-nos	cevar+nós.AD.1.PL+GRD
cevando-o	cevar+V.ele.ACC.3.M.SG+GRD
cevando-os	cevar+V.ele.ACC.3.M.PL+GRD
cevando-se	cevar+V.ele.REFL+GRD
cevando-te	cevar+V.tu.AD.2.SG+GRD
cevando-vos	cevar+V.vós.AD.2.PL+GRD
ceva-nos	cevar+nós.AD.1.PL+PRS+2+SG
ceva-nos	cevar+nós.AD.1.PL+PRS+3+SG
ceva-o	cevar+V.ele.ACC.3.M.SG+PRS+3+SG
ceva-os	cevar+V.ele.ACC.3.M.PL+PRS+3+SG
cevara-a	cevar+V.ele.ACC.3.F.SG+PQP+1+SG
cevara-a	cevar+V.ele.ACC.3.F.SG+PQP+3+SG
cevara-as	cevar+V.ele.ACC.3.F.PL+PQP+1+SG
cevara-as	cevar+V.ele.ACC.3.F.PL+PQP+3+SG
cevara-la	cevar+V.ele.ACC.3.F.SG+PQP+2+SG
cevara-las	cevar+V.ele.ACC.3.F.PL+PQP+2+SG
cevara-lhe	cevar+V.ele.DAT.3.SG+PQP+1+SG
cevara-lhe	cevar+V.ele.DAT.3.SG+PQP+3+SG
cevara-lhes	cevar+V.ele.DAT.3.PL+PQP+1+SG
cevara-lhes	cevar+V.ele.DAT.3.PL+PQP+3+SG
cevara-lo	cevar+V.ele.ACC.3.M.SG+PQP+2+SG
cevara-los	cevar+V.ele.ACC.3.M.PL+PQP+2+SG
cevara-me	cevar+V.eu.AD.1.SG+PQP+1+SG
cevara-me	cevar+V.eu.AD.1.SG+PQP+3+SG
cevaram-lhe	cevar+V.ele.DAT.3.SG+PQP+3+PL
cevaram-lhe	cevar+V.ele.DAT.3.SG+PRF+3+PL
cevaram-lhes	cevar+V.ele.DAT.3.PL+PQP+3+PL
cevaram-lhes	cevar+V.ele.DAT.3.PL+PRF+3+PL
cevaram-me	cevar+V.eu.AD.1.SG+PQP+3+PL
cevaram-me	cevar+V.eu.AD.1.SG+PRF+3+PL
cevaram-na	cevar+V.ele.ACC.3.F.SG+PQP+3+PL
cevaram-na	cevar+V.ele.ACC.3.F.SG+PRF+3+PL
cevaram-nas	cevar+V.ele.ACC.3.F.PL+PQP+3+PL
cevaram-nas	cevar+V.ele.ACC.3.F.PL+PRF+3+PL
cevaram-no	cevar+V.ele.ACC.3.M.SG+PQP+3+PL
cevaram-no	cevar+V.ele.ACC.3.M.SG+PRF+3+PL
cevaram-nos	cevar+V.ele.ACC.3.M.PL+PQP+3+PL
cevaram-nos	cevar+V.ele.ACC.3.M.PL+PRF+3+PL
cevaram-nos	cevar+V.nós.AD.1.PL+PQP+3+PL
cevaram-nos	cevar+V.nós.AD.1.PL+PRF+3+PL
ceváramo-la	cevar+V.ele.ACC.3.F.SG+PQP+1+PL
ceváramo-las	cevar+V.ele.ACC.3.F.PL+PQP+1+PL
ceváramo-lo	cevar+V.ele.ACC.3.M.SG+PQP+1+PL
ceváramo-los	cevar+V.ele.ACC.3.M.PL+PQP+1+PL
ceváramo-nos	cevar+nós.AD.1.PL+PQP+1+PL
ceváramos-lhe	cevar+V.ele.DAT.3.SG+PQP+1+PL
ceváramos-lhes	cevar+V.ele.DAT.3.PL+PQP+1+PL
ceváramos-me	cevar+V.eu.AD.1.SG+PQP+1+PL
ceváramos-te	cevar+V.tu.AD.2.SG+PQP+1+PL
ceváramos-vos	cevar+V.vós.AD.2.PL+PQP+1+PL
cevaram-se	cevar+V.ele.REFL+PQP+3+PL
cevaram-se	cevar+V.ele.REFL+PRF+3+PL
cevaram-te	cevar+V.tu.AD.2.SG+PQP+3+PL
cevaram-te	cevar+V.tu.AD.2.SG+PRF+3+PL
cevaram-vos	cevar+V.vós.AD.2.PL+PQP+3+PL
cevaram-vos	cevar+V.vós.AD.2.PL+PRF+3+PL
cevara-nos	cevar+nós.AD.1.PL+PQP+1+SG
cevara-nos	cevar+nós.AD.1.PL+PQP+2+SG
cevara-nos	cevar+nós.AD.1.PL+PQP+3+SG
cevara-o	cevar+V.ele.ACC.3.M.SG+PQP+1+SG
cevara-o	cevar+V.ele.ACC.3.M.SG+PQP+3+SG
cevara-os	cevar+V.ele.ACC.3.M.PL+PQP+1+SG
cevara-os	cevar+V.ele.ACC.3.M.PL+PQP+3+SG
cevara-se	cevar+V.ele.REFL+PQP+1+SG
cevara-se	cevar+V.ele.REFL+PQP+3+SG
cevaras-lhe	cevar+V.ele.DAT.3.SG+PQP+2+SG
cevaras-lhes	cevar+V.ele.DAT.3.PL+PQP+2+SG
cevaras-me	cevar+V.eu.AD.1.SG+PQP+2+SG
cevaras-te	cevar+V.tu.AD.2.SG+PQP+2+SG
cevaras-vos	cevar+V.vós.AD.2.PL+PQP+2+SG
cevara-te	cevar+V.tu.AD.2.SG+PQP+1+SG
cevara-te	cevar+V.tu.AD.2.SG+PQP+3+SG
cevara-vos	cevar+V.vós.AD.2.PL+PQP+1+SG
