colonizar-vos-íeis	colonizar+V.vós.AD.2.PL+COND+2+PL
coloniza-se	colonizar+V.ele.REFL+PRS+3+SG
colonizas-lhe	colonizar+V.ele.DAT.3.SG+PRS+2+SG
colonizas-lhes	colonizar+V.ele.DAT.3.PL+PRS+2+SG
colonizas-me	colonizar+V.eu.AD.1.SG+PRS+2+SG
colonizaste-a	colonizar+V.ele.ACC.3.F.SG+PRF+2+SG
colonizaste-as	colonizar+V.ele.ACC.3.F.PL+PRF+2+SG
colonizas-te	colonizar+V.tu.AD.2.SG+PRS+2+SG
colonizaste-la	colonizar+V.ele.ACC.3.F.SG+PRF+2+PL
colonizaste-las	colonizar+V.ele.ACC.3.F.PL+PRF+2+PL
colonizaste-lhe	colonizar+V.ele.DAT.3.SG+PRF+2+SG
colonizaste-lhes	colonizar+V.ele.DAT.3.PL+PRF+2+SG
colonizaste-lo	colonizar+V.ele.ACC.3.M.SG+PRF+2+PL
colonizaste-los	colonizar+V.ele.ACC.3.M.PL+PRF+2+PL
colonizaste-me	colonizar+V.eu.AD.1.SG+PRF+2+SG
colonizaste-nos	colonizar+nós.AD.1.PL+PRF+2+PL
colonizaste-nos	colonizar+nós.AD.1.PL+PRF+2+SG
colonizaste-o	colonizar+V.ele.ACC.3.M.SG+PRF+2+SG
colonizaste-os	colonizar+V.ele.ACC.3.M.PL+PRF+2+SG
colonizastes-lhe	colonizar+V.ele.DAT.3.SG+PRF+2+PL
colonizastes-lhes	colonizar+V.ele.DAT.3.PL+PRF+2+PL
colonizastes-me	colonizar+V.eu.AD.1.SG+PRF+2+PL
colonizastes-te	colonizar+V.tu.AD.2.SG+PRF+2+PL
colonizastes-vos	colonizar+V.vós.AD.2.PL+PRF+2+PL
colonizaste-te	colonizar+V.tu.AD.2.SG+PRF+2+SG
colonizaste-vos	colonizar+V.vós.AD.2.PL+PRF+2+SG
colonizas-vos	colonizar+V.vós.AD.2.PL+PRS+2+SG
coloniza-te	colonizar+V.tu.AD.2.SG+PRS+3+SG
colonizava-a	colonizar+V.ele.ACC.3.F.SG+IMPF+1+SG
colonizava-a	colonizar+V.ele.ACC.3.F.SG+IMPF+3+SG
colonizava-as	colonizar+V.ele.ACC.3.F.PL+IMPF+1+SG
colonizava-as	colonizar+V.ele.ACC.3.F.PL+IMPF+3+SG
colonizava-la	colonizar+V.ele.ACC.3.F.SG+IMPF+2+SG
colonizava-las	colonizar+V.ele.ACC.3.F.PL+IMPF+2+SG
colonizava-lhe	colonizar+V.ele.DAT.3.SG+IMPF+1+SG
colonizava-lhe	colonizar+V.ele.DAT.3.SG+IMPF+3+SG
colonizava-lhes	colonizar+V.ele.DAT.3.PL+IMPF+1+SG
colonizava-lhes	colonizar+V.ele.DAT.3.PL+IMPF+3+SG
colonizava-lo	colonizar+V.ele.ACC.3.M.SG+IMPF+2+SG
colonizava-los	colonizar+V.ele.ACC.3.M.PL+IMPF+2+SG
colonizava-me	colonizar+V.eu.AD.1.SG+IMPF+1+SG
colonizava-me	colonizar+V.eu.AD.1.SG+IMPF+3+SG
colonizavam-lhe	colonizar+V.ele.DAT.3.SG+IMPF+3+PL
colonizavam-lhes	colonizar+V.ele.DAT.3.PL+IMPF+3+PL
colonizavam-me	colonizar+V.eu.AD.1.SG+IMPF+3+PL
colonizavam-na	colonizar+V.ele.ACC.3.F.SG+IMPF+3+PL
colonizavam-nas	colonizar+V.ele.ACC.3.F.PL+IMPF+3+PL
colonizavam-no	colonizar+V.ele.ACC.3.M.SG+IMPF+3+PL
colonizavam-nos	colonizar+V.ele.ACC.3.M.PL+IMPF+3+PL
colonizavam-nos	colonizar+V.nós.AD.1.PL+IMPF+3+PL
colonizávamo-la	colonizar+V.ele.ACC.3.F.SG+IMPF+1+PL
colonizávamo-las	colonizar+V.ele.ACC.3.F.PL+IMPF+1+PL
colonizávamo-lo	colonizar+V.ele.ACC.3.M.SG+IMPF+1+PL
colonizávamo-los	colonizar+V.ele.ACC.3.M.PL+IMPF+1+PL
colonizávamo-nos	colonizar+nós.AD.1.PL+IMPF+1+PL
colonizávamos-lhe	colonizar+V.ele.DAT.3.SG+IMPF+1+PL
colonizávamos-lhes	colonizar+V.ele.DAT.3.PL+IMPF+1+PL
colonizávamos-me	colonizar+V.eu.AD.1.SG+IMPF+1+PL
colonizávamos-te	colonizar+V.tu.AD.2.SG+IMPF+1+PL
colonizávamos-vos	colonizar+V.vós.AD.2.PL+IMPF+1+PL
colonizavam-se	colonizar+V.ele.REFL+IMPF+3+PL
colonizavam-te	colonizar+V.tu.AD.2.SG+IMPF+3+PL
colonizavam-vos	colonizar+V.vós.AD.2.PL+IMPF+3+PL
colonizava-nos	colonizar+nós.AD.1.PL+IMPF+1+SG
colonizava-nos	colonizar+nós.AD.1.PL+IMPF+2+SG
colonizava-nos	colonizar+nós.AD.1.PL+IMPF+3+SG
colonizava-o	colonizar+V.ele.ACC.3.M.SG+IMPF+1+SG
colonizava-o	colonizar+V.ele.ACC.3.M.SG+IMPF+3+SG
colonizava-os	colonizar+V.ele.ACC.3.M.PL+IMPF+1+SG
colonizava-os	colonizar+V.ele.ACC.3.M.PL+IMPF+3+SG
colonizava-se	colonizar+V.ele.REFL+IMPF+1+SG
colonizava-se	colonizar+V.ele.REFL+IMPF+3+SG
colonizavas-lhe	colonizar+V.ele.DAT.3.SG+IMPF+2+SG
colonizavas-lhes	colonizar+V.ele.DAT.3.PL+IMPF+2+SG
colonizavas-me	colonizar+V.eu.AD.1.SG+IMPF+2+SG
colonizavas-te	colonizar+V.tu.AD.2.SG+IMPF+2+SG
colonizavas-vos	colonizar+V.vós.AD.2.PL+IMPF+2+SG
colonizava-te	colonizar+V.tu.AD.2.SG+IMPF+1+SG
colonizava-te	colonizar+V.tu.AD.2.SG+IMPF+3+SG
colonizava-vos	colonizar+V.vós.AD.2.PL+IMPF+1+SG
colonizava-vos	colonizar+V.vós.AD.2.PL+IMPF+3+SG
colonizávei-la	colonizar+V.ele.ACC.3.F.SG+IMPF+2+PL
colonizávei-las	colonizar+V.ele.ACC.3.F.PL+IMPF+2+PL
colonizávei-lo	colonizar+V.ele.ACC.3.M.SG+IMPF+2+PL
colonizávei-los	colonizar+V.ele.ACC.3.M.PL+IMPF+2+PL
colonizávei-nos	colonizar+nós.AD.1.PL+IMPF+2+PL
colonizáveis-lhe	colonizar+V.ele.DAT.3.SG+IMPF+2+PL
colonizáveis-lhes	colonizar+V.ele.DAT.3.PL+IMPF+2+PL
colonizáveis-me	colonizar+V.eu.AD.1.SG+IMPF+2+PL
colonizáveis-te	colonizar+V.tu.AD.2.SG+IMPF+2+PL
colonizáveis-vos	colonizar+V.vós.AD.2.PL+IMPF+2+PL
coloniza-vos	colonizar+V.vós.AD.2.PL+PRS+3+SG
colonize-a	colonizar+V.ele.ACC.3.F.SG+IMP+3+SG
colonize-as	colonizar+V.ele.ACC.3.F.PL+IMP+3+SG
colonizei-a	colonizar+V.ele.ACC.3.F.SG+PRF+1+SG
colonizei-as	colonizar+V.ele.ACC.3.F.PL+PRF+1+SG
colonizei-lhe	colonizar+V.ele.DAT.3.SG+PRF+1+SG
colonizei-lhes	colonizar+V.ele.DAT.3.PL+PRF+1+SG
colonizei-me	colonizar+V.eu.AD.1.SG+PRF+1+SG
colonizei-nos	colonizar+nós.AD.1.PL+PRF+1+SG
colonizei-o	colonizar+V.ele.ACC.3.M.SG+PRF+1+SG
colonizei-os	colonizar+V.ele.ACC.3.M.PL+PRF+1+SG
colonizei-te	colonizar+V.tu.AD.2.SG+PRF+1+SG
colonizei-vos	colonizar+V.vós.AD.2.PL+PRF+1+SG
colonize-lhe	colonizar+V.ele.DAT.3.SG+IMP+3+SG
colonize-lhes	colonizar+V.ele.DAT.3.PL+IMP+3+SG
colonize-me	colonizar+V.eu.AD.1.SG+IMP+3+SG
colonizem-lhe	colonizar+V.ele.DAT.3.SG+IMP+3+PL
colonizem-lhes	colonizar+V.ele.DAT.3.PL+IMP+3+PL
colonizem-me	colonizar+V.eu.AD.1.SG+IMP+3+PL
colonizem-na	colonizar+V.ele.ACC.3.F.SG+IMP+3+PL
colonizem-nas	colonizar+V.ele.ACC.3.F.PL+IMP+3+PL
colonizem-no	colonizar+V.ele.ACC.3.M.SG+IMP+3+PL
colonizem-nos	colonizar+V.ele.ACC.3.M.PL+IMP+3+PL
colonizem-nos	colonizar+V.nós.AD.1.PL+IMP+3+PL
colonizemo-la	colonizar+V.ele.ACC.3.F.SG+IMP+1+PL
colonizemo-las	colonizar+V.ele.ACC.3.F.PL+IMP+1+PL
colonizemo-lo	colonizar+V.ele.ACC.3.M.SG+IMP+1+PL
colonizemo-los	colonizar+V.ele.ACC.3.M.PL+IMP+1+PL
colonizemo-nos	colonizar+nós.AD.1.PL+IMP+1+PL
colonizemos-lhe	colonizar+V.ele.DAT.3.SG+IMP+1+PL
colonizemos-lhes	colonizar+V.ele.DAT.3.PL+IMP+1+PL
colonizemos-me	colonizar+V.eu.AD.1.SG+IMP+1+PL
colonizemos-te	colonizar+V.tu.AD.2.SG+IMP+1+PL
colonizemos-vos	colonizar+V.vós.AD.2.PL+IMP+1+PL
colonizem-se	colonizar+V.ele.REFL+IMP+3+PL
colonizem-te	colonizar+V.tu.AD.2.SG+IMP+3+PL
colonizem-vos	colonizar+V.vós.AD.2.PL+IMP+3+PL
colonize-nos	colonizar+nós.AD.1.PL+IMP+3+SG
colonize-o	colonizar+V.ele.ACC.3.M.SG+IMP+3+SG
colonize-os	colonizar+V.ele.ACC.3.M.PL+IMP+3+SG
colonize-se	colonizar+V.ele.REFL+IMP+3+SG
colonize-te	colonizar+V.tu.AD.2.SG+IMP+3+SG
colonize-vos	colonizar+V.vós.AD.2.PL+IMP+3+SG
colonizo-a	colonizar+V.ele.ACC.3.F.SG+PRS+1+SG
colonizo-as	colonizar+V.ele.ACC.3.F.PL+PRS+1+SG
colonizo-lhe	colonizar+V.ele.DAT.3.SG+PRS+1+SG
colonizo-lhes	colonizar+V.ele.DAT.3.PL+PRS+1+SG
colonizo-me	colonizar+V.eu.AD.1.SG+PRS+1+SG
colonizo-nos	colonizar+nós.AD.1.PL+PRS+1+SG
colonizo-o	colonizar+V.ele.ACC.3.M.SG+PRS+1+SG
colonizo-os	colonizar+V.ele.ACC.3.M.PL+PRS+1+SG
colonizo-te	colonizar+V.tu.AD.2.SG+PRS+1+SG
colonizou-a	colonizar+V.ele.ACC.3.F.SG+PRF+3+SG
colonizou-as	colonizar+V.ele.ACC.3.F.PL+PRF+3+SG
colonizou-lhe	colonizar+V.ele.DAT.3.SG+PRF+3+SG
colonizou-lhes	colonizar+V.ele.DAT.3.PL+PRF+3+SG
colonizou-me	colonizar+V.eu.AD.1.SG+PRF+3+SG
colonizou-nos	colonizar+nós.AD.1.PL+PRF+3+SG
colonizou-o	colonizar+V.ele.ACC.3.M.SG+PRF+3+SG
colonizou-os	colonizar+V.ele.ACC.3.M.PL+PRF+3+SG
colonizou-se	colonizar+V.ele.REFL+PRF+3+SG
colonizou-te	colonizar+V.tu.AD.2.SG+PRF+3+SG
colonizou-vos	colonizar+V.vós.AD.2.PL+PRF+3+SG
colonizo-vos	colonizar+V.vós.AD.2.PL+PRS+1+SG
colo-nos	colar+nós.AD.1.PL+PRS+1+SG
colo-o	colar+V.ele.ACC.3.M.SG+PRS+1+SG
colo-os	colar+V.ele.ACC.3.M.PL+PRS+1+SG
coloque-a	colocar+V.ele.ACC.3.F.SG+IMP+3+SG
coloque-as	colocar+V.ele.ACC.3.F.PL+IMP+3+SG
coloquei-a	colocar+V.ele.ACC.3.F.SG+PRF+1+SG
coloquei-as	colocar+V.ele.ACC.3.F.PL+PRF+1+SG
coloquei-lhe	colocar+V.ele.DAT.3.SG+PRF+1+SG
coloquei-lhes	colocar+V.ele.DAT.3.PL+PRF+1+SG
coloquei-me	colocar+V.eu.AD.1.SG+PRF+1+SG
coloquei-nos	colocar+nós.AD.1.PL+PRF+1+SG
coloquei-o	colocar+V.ele.ACC.3.M.SG+PRF+1+SG
coloquei-os	colocar+V.ele.ACC.3.M.PL+PRF+1+SG
coloquei-te	colocar+V.tu.AD.2.SG+PRF+1+SG
coloquei-vos	colocar+V.vós.AD.2.PL+PRF+1+SG
coloque-lhe	colocar+V.ele.DAT.3.SG+IMP+3+SG
coloque-lhes	colocar+V.ele.DAT.3.PL+IMP+3+SG
coloque-me	colocar+V.eu.AD.1.SG+IMP+3+SG
coloquem-lhe	colocar+V.ele.DAT.3.SG+IMP+3+PL
coloquem-lhes	colocar+V.ele.DAT.3.PL+IMP+3+PL
coloquem-me	colocar+V.eu.AD.1.SG+IMP+3+PL
coloquem-na	colocar+V.ele.ACC.3.F.SG+IMP+3+PL
coloquem-nas	colocar+V.ele.ACC.3.F.PL+IMP+3+PL
coloquem-no	colocar+V.ele.ACC.3.M.SG+IMP+3+PL
coloquem-nos	colocar+V.ele.ACC.3.M.PL+IMP+3+PL
coloquem-nos	colocar+V.nós.AD.1.PL+IMP+3+PL
coloquemo-la	colocar+V.ele.ACC.3.F.SG+IMP+1+PL
coloquemo-las	colocar+V.ele.ACC.3.F.PL+IMP+1+PL
coloquemo-lo	colocar+V.ele.ACC.3.M.SG+IMP+1+PL
coloquemo-los	colocar+V.ele.ACC.3.M.PL+IMP+1+PL
coloquemo-nos	colocar+nós.AD.1.PL+IMP+1+PL
coloquemos-lhe	colocar+V.ele.DAT.3.SG+IMP+1+PL
coloquemos-lhes	colocar+V.ele.DAT.3.PL+IMP+1+PL
coloquemos-me	colocar+V.eu.AD.1.SG+IMP+1+PL
coloquemos-te	colocar+V.tu.AD.2.SG+IMP+1+PL
coloquemos-vos	colocar+V.vós.AD.2.PL+IMP+1+PL
coloquem-se	colocar+V.ele.REFL+IMP+3+PL
coloquem-te	colocar+V.tu.AD.2.SG+IMP+3+PL
coloquem-vos	colocar+V.vós.AD.2.PL+IMP+3+PL
coloque-nos	colocar+nós.AD.1.PL+IMP+3+SG
coloque-o	colocar+V.ele.ACC.3.M.SG+IMP+3+SG
coloque-os	colocar+V.ele.ACC.3.M.PL+IMP+3+SG
coloque-se	colocar+V.ele.REFL+IMP+3+SG
coloque-te	colocar+V.tu.AD.2.SG+IMP+3+SG
coloque-vos	colocar+V.vós.AD.2.PL+IMP+3+SG
coloquia-a	coloquiar+V.ele.ACC.3.F.SG+PRS+3+SG
coloquia-as	coloquiar+V.ele.ACC.3.F.PL+PRS+3+SG
coloquiai-la	coloquiar+V.ele.ACC.3.F.SG+PRS+2+PL
coloquiai-las	coloquiar+V.ele.ACC.3.F.PL+PRS+2+PL
coloquiai-lo	coloquiar+V.ele.ACC.3.M.SG+PRS+2+PL
coloquiai-los	coloquiar+V.ele.ACC.3.M.PL+PRS+2+PL
coloquiai-nos	coloquiar+nós.AD.1.PL+PRS+2+PL
coloquiais-lhe	coloquiar+V.ele.DAT.3.SG+PRS+2+PL
coloquiais-lhes	coloquiar+V.ele.DAT.3.PL+PRS+2+PL
coloquiais-me	coloquiar+V.eu.AD.1.SG+PRS+2+PL
coloquiais-te	coloquiar+V.tu.AD.2.SG+PRS+2+PL
coloquiais-vos	coloquiar+V.vós.AD.2.PL+PRS+2+PL
coloquiá-la-á	coloquiar+V.ele.ACC.3.F.SG+FUT+3+SG
coloquiá-la-ão	coloquiar+V.ele.ACC.3.F.SG+FUT+3+PL
coloquiá-la-ás	coloquiar+V.ele.ACC.3.F.SG+FUT+2+SG
coloquiá-la	coloquiar+V.ele.ACC.3.F.SG+INF+1+SG
coloquiá-la	coloquiar+V.ele.ACC.3.F.SG+INF+3+SG
coloquia-la	coloquiar+V.ele.ACC.3.F.SG+PRS+2+SG
coloquiá-la	coloquiar+V.ele.ACC.3.F.SG+SBJF+1+SG
coloquiá-la	coloquiar+V.ele.ACC.3.F.SG+SBJF+3+SG
coloquiá-la-ei	coloquiar+V.ele.ACC.3.F.SG+FUT+1+SG
coloquiá-la-eis	coloquiar+V.ele.ACC.3.F.SG+FUT+2+PL
coloquiá-la-emos	coloquiar+V.ele.ACC.3.F.SG+FUT+1+PL
coloquiá-la-ia	coloquiar+V.ele.ACC.3.F.SG+COND+1+SG
coloquiá-la-ia	coloquiar+V.ele.ACC.3.F.SG+COND+3+SG
coloquiá-la-iam	coloquiar+V.ele.ACC.3.F.SG+COND+3+PL
coloquiá-la-íamos	coloquiar+V.ele.ACC.3.F.SG+COND+1+PL
coloquiá-la-ias	coloquiar+V.ele.ACC.3.F.SG+COND+2+SG
coloquiá-la-íeis	coloquiar+V.ele.ACC.3.F.SG+COND+2+PL
coloquiá-las-á	coloquiar+V.ele.ACC.3.F.PL+FUT+3+SG
coloquiá-las-ão	coloquiar+V.ele.ACC.3.F.PL+FUT+3+PL
coloquiá-las-ás	coloquiar+V.ele.ACC.3.F.PL+FUT+2+SG
coloquiá-las	coloquiar+V.ele.ACC.3.F.PL+INF+1+SG
coloquiá-las	coloquiar+V.ele.ACC.3.F.PL+INF+3+SG
coloquia-las	coloquiar+V.ele.ACC.3.F.PL+PRS+2+SG
coloquiá-las	coloquiar+V.ele.ACC.3.F.PL+SBJF+1+SG
coloquiá-las	coloquiar+V.ele.ACC.3.F.PL+SBJF+3+SG
coloquiá-las-ei	coloquiar+V.ele.ACC.3.F.PL+FUT+1+SG
coloquiá-las-eis	coloquiar+V.ele.ACC.3.F.PL+FUT+2+PL
coloquiá-las-emos	coloquiar+V.ele.ACC.3.F.PL+FUT+1+PL
coloquiá-las-ia	coloquiar+V.ele.ACC.3.F.PL+COND+1+SG
coloquiá-las-ia	coloquiar+V.ele.ACC.3.F.PL+COND+3+SG
coloquiá-las-iam	coloquiar+V.ele.ACC.3.F.PL+COND+3+PL
coloquiá-las-íamos	coloquiar+V.ele.ACC.3.F.PL+COND+1+PL
coloquiá-las-ias	coloquiar+V.ele.ACC.3.F.PL+COND+2+SG
coloquiá-las-íeis	coloquiar+V.ele.ACC.3.F.PL+COND+2+PL
coloquia-lhe	coloquiar+V.ele.DAT.3.SG+PRS+3+SG
coloquia-lhes	coloquiar+V.ele.DAT.3.PL+PRS+3+SG
coloquiá-lo-á	coloquiar+V.ele.ACC.3.M.SG+FUT+3+SG
coloquiá-lo-ão	coloquiar+V.ele.ACC.3.M.SG+FUT+3+PL
coloquiá-lo-ás	coloquiar+V.ele.ACC.3.M.SG+FUT+2+SG
coloquiá-lo	coloquiar+V.ele.ACC.3.M.SG+INF+1+SG
coloquiá-lo	coloquiar+V.ele.ACC.3.M.SG+INF+3+SG
coloquia-lo	coloquiar+V.ele.ACC.3.M.SG+PRS+2+SG
coloquiá-lo	coloquiar+V.ele.ACC.3.M.SG+SBJF+1+SG
coloquiá-lo	coloquiar+V.ele.ACC.3.M.SG+SBJF+3+SG
coloquiá-lo-ei	coloquiar+V.ele.ACC.3.M.SG+FUT+1+SG
coloquiá-lo-eis	coloquiar+V.ele.ACC.3.M.SG+FUT+2+PL
coloquiá-lo-emos	coloquiar+V.ele.ACC.3.M.SG+FUT+1+PL
coloquiá-lo-ia	coloquiar+V.ele.ACC.3.M.SG+COND+1+SG
coloquiá-lo-ia	coloquiar+V.ele.ACC.3.M.SG+COND+3+SG
coloquiá-lo-iam	coloquiar+V.ele.ACC.3.M.SG+COND+3+PL
coloquiá-lo-íamos	coloquiar+V.ele.ACC.3.M.SG+COND+1+PL
coloquiá-lo-ias	coloquiar+V.ele.ACC.3.M.SG+COND+2+SG
coloquiá-lo-íeis	coloquiar+V.ele.ACC.3.M.SG+COND+2+PL
coloquiá-los-á	coloquiar+V.ele.ACC.3.M.PL+FUT+3+SG
coloquiá-los-ão	coloquiar+V.ele.ACC.3.M.PL+FUT+3+PL
coloquiá-los-ás	coloquiar+V.ele.ACC.3.M.PL+FUT+2+SG
coloquiá-los	coloquiar+V.ele.ACC.3.M.PL+INF+1+SG
coloquiá-los	coloquiar+V.ele.ACC.3.M.PL+INF+3+SG
coloquia-los	coloquiar+V.ele.ACC.3.M.PL+PRS+2+SG
coloquiá-los	coloquiar+V.ele.ACC.3.M.PL+SBJF+1+SG
coloquiá-los	coloquiar+V.ele.ACC.3.M.PL+SBJF+3+SG
coloquiá-los-ei	coloquiar+V.ele.ACC.3.M.PL+FUT+1+SG
coloquiá-los-eis	coloquiar+V.ele.ACC.3.M.PL+FUT+2+PL
coloquiá-los-emos	coloquiar+V.ele.ACC.3.M.PL+FUT+1+PL
coloquiá-los-ia	coloquiar+V.ele.ACC.3.M.PL+COND+1+SG
coloquiá-los-ia	coloquiar+V.ele.ACC.3.M.PL+COND+3+SG
coloquiá-los-iam	coloquiar+V.ele.ACC.3.M.PL+COND+3+PL
coloquiá-los-íamos	coloquiar+V.ele.ACC.3.M.PL+COND+1+PL
coloquiá-los-ias	coloquiar+V.ele.ACC.3.M.PL+COND+2+SG
coloquiá-los-íeis	coloquiar+V.ele.ACC.3.M.PL+COND+2+PL
coloquia-me	coloquiar+V.eu.AD.1.SG+PRS+3+SG
coloquiam-lhe	coloquiar+V.ele.DAT.3.SG+PRS+3+PL
coloquiam-lhes	coloquiar+V.ele.DAT.3.PL+PRS+3+PL
coloquiam-me	coloquiar+V.eu.AD.1.SG+PRS+3+PL
coloquiam-na	coloquiar+V.ele.ACC.3.F.SG+PRS+3+PL
coloquiam-nas	coloquiar+V.ele.ACC.3.F.PL+PRS+3+PL
coloquiam-no	coloquiar+V.ele.ACC.3.M.SG+PRS+3+PL
coloquiam-nos	coloquiar+V.ele.ACC.3.M.PL+PRS+3+PL
coloquiam-nos	coloquiar+V.nós.AD.1.PL+PRS+3+PL
coloquiamo-la	coloquiar+V.ele.ACC.3.F.SG+PRF+1+PL
coloquiamo-la	coloquiar+V.ele.ACC.3.F.SG+PRS+1+PL
coloquiamo-las	coloquiar+V.ele.ACC.3.F.PL+PRF+1+PL
coloquiamo-las	coloquiar+V.ele.ACC.3.F.PL+PRS+1+PL
coloquiamo-lo	coloquiar+V.ele.ACC.3.M.SG+PRF+1+PL
coloquiamo-lo	coloquiar+V.ele.ACC.3.M.SG+PRS+1+PL
coloquiamo-los	coloquiar+V.ele.ACC.3.M.PL+PRF+1+PL
coloquiamo-los	coloquiar+V.ele.ACC.3.M.PL+PRS+1+PL
coloquiamo-nos	coloquiar+nós.AD.1.PL+PRF+1+PL
coloquiamo-nos	coloquiar+nós.AD.1.PL+PRS+1+PL
coloquiamos-lhe	coloquiar+V.ele.DAT.3.SG+PRF+1+PL
coloquiamos-lhe	coloquiar+V.ele.DAT.3.SG+PRS+1+PL
coloquiamos-lhes	coloquiar+V.ele.DAT.3.PL+PRF+1+PL
coloquiamos-lhes	coloquiar+V.ele.DAT.3.PL+PRS+1+PL
coloquiamos-me	coloquiar+V.eu.AD.1.SG+PRF+1+PL
coloquiamos-me	coloquiar+V.eu.AD.1.SG+PRS+1+PL
coloquiamos-te	coloquiar+V.tu.AD.2.SG+PRF+1+PL
coloquiamos-te	coloquiar+V.tu.AD.2.SG+PRS+1+PL
coloquiamos-vos	coloquiar+V.vós.AD.2.PL+PRF+1+PL
coloquiamos-vos	coloquiar+V.vós.AD.2.PL+PRS+1+PL
coloquiam-se	coloquiar+V.ele.REFL+PRS+3+PL
coloquiam-te	coloquiar+V.tu.AD.2.SG+PRS+3+PL
coloquiam-vos	coloquiar+V.vós.AD.2.PL+PRS+3+PL
coloquiando-a	coloquiar+V.ele.ACC.3.F.SG+GRD
coloquiando-as	coloquiar+V.ele.ACC.3.F.PL+GRD
coloquiando-lhe	coloquiar+V.ele.DAT.3.SG+GRD
coloquiando-lhes	coloquiar+V.ele.DAT.3.PL+GRD
coloquiando-me	coloquiar+V.eu.AD.1.SG+GRD
coloquiando-nos	coloquiar+nós.AD.1.PL+GRD
coloquiando-o	coloquiar+V.ele.ACC.3.M.SG+GRD
coloquiando-os	coloquiar+V.ele.ACC.3.M.PL+GRD
coloquiando-se	coloquiar+V.ele.REFL+GRD
coloquiando-te	coloquiar+V.tu.AD.2.SG+GRD
coloquiando-vos	coloquiar+V.vós.AD.2.PL+GRD
coloquia-nos	coloquiar+nós.AD.1.PL+PRS+2+SG
coloquia-nos	coloquiar+nós.AD.1.PL+PRS+3+SG
coloquia-o	coloquiar+V.ele.ACC.3.M.SG+PRS+3+SG
coloquia-os	coloquiar+V.ele.ACC.3.M.PL+PRS+3+SG
coloquiara-a	coloquiar+V.ele.ACC.3.F.SG+PQP+1+SG
coloquiara-a	coloquiar+V.ele.ACC.3.F.SG+PQP+3+SG
coloquiara-as	coloquiar+V.ele.ACC.3.F.PL+PQP+1+SG
coloquiara-as	coloquiar+V.ele.ACC.3.F.PL+PQP+3+SG
coloquiara-la	coloquiar+V.ele.ACC.3.F.SG+PQP+2+SG
coloquiara-las	coloquiar+V.ele.ACC.3.F.PL+PQP+2+SG
coloquiara-lhe	coloquiar+V.ele.DAT.3.SG+PQP+1+SG
coloquiara-lhe	coloquiar+V.ele.DAT.3.SG+PQP+3+SG
coloquiara-lhes	coloquiar+V.ele.DAT.3.PL+PQP+1+SG
coloquiara-lhes	coloquiar+V.ele.DAT.3.PL+PQP+3+SG
coloquiara-lo	coloquiar+V.ele.ACC.3.M.SG+PQP+2+SG
coloquiara-los	coloquiar+V.ele.ACC.3.M.PL+PQP+2+SG
coloquiara-me	coloquiar+V.eu.AD.1.SG+PQP+1+SG
coloquiara-me	coloquiar+V.eu.AD.1.SG+PQP+3+SG
coloquiaram-lhe	coloquiar+V.ele.DAT.3.SG+PQP+3+PL
coloquiaram-lhe	coloquiar+V.ele.DAT.3.SG+PRF+3+PL
coloquiaram-lhes	coloquiar+V.ele.DAT.3.PL+PQP+3+PL
coloquiaram-lhes	coloquiar+V.ele.DAT.3.PL+PRF+3+PL
coloquiaram-me	coloquiar+V.eu.AD.1.SG+PQP+3+PL
coloquiaram-me	coloquiar+V.eu.AD.1.SG+PRF+3+PL
coloquiaram-na	coloquiar+V.ele.ACC.3.F.SG+PQP+3+PL
coloquiaram-na	coloquiar+V.ele.ACC.3.F.SG+PRF+3+PL
coloquiaram-nas	coloquiar+V.ele.ACC.3.F.PL+PQP+3+PL
coloquiaram-nas	coloquiar+V.ele.ACC.3.F.PL+PRF+3+PL
coloquiaram-no	coloquiar+V.ele.ACC.3.M.SG+PQP+3+PL
coloquiaram-no	coloquiar+V.ele.ACC.3.M.SG+PRF+3+PL
coloquiaram-nos	coloquiar+V.ele.ACC.3.M.PL+PQP+3+PL
coloquiaram-nos	coloquiar+V.ele.ACC.3.M.PL+PRF+3+PL
coloquiaram-nos	coloquiar+V.nós.AD.1.PL+PQP+3+PL
coloquiaram-nos	coloquiar+V.nós.AD.1.PL+PRF+3+PL
coloquiáramo-la	coloquiar+V.ele.ACC.3.F.SG+PQP+1+PL
coloquiáramo-las	coloquiar+V.ele.ACC.3.F.PL+PQP+1+PL
coloquiáramo-lo	coloquiar+V.ele.ACC.3.M.SG+PQP+1+PL
coloquiáramo-los	coloquiar+V.ele.ACC.3.M.PL+PQP+1+PL
coloquiáramo-nos	coloquiar+nós.AD.1.PL+PQP+1+PL
coloquiáramos-lhe	coloquiar+V.ele.DAT.3.SG+PQP+1+PL
coloquiáramos-lhes	coloquiar+V.ele.DAT.3.PL+PQP+1+PL
coloquiáramos-me	coloquiar+V.eu.AD.1.SG+PQP+1+PL
coloquiáramos-te	coloquiar+V.tu.AD.2.SG+PQP+1+PL
coloquiáramos-vos	coloquiar+V.vós.AD.2.PL+PQP+1+PL
coloquiaram-se	coloquiar+V.ele.REFL+PQP+3+PL
coloquiaram-se	coloquiar+V.ele.REFL+PRF+3+PL
coloquiaram-te	coloquiar+V.tu.AD.2.SG+PQP+3+PL
coloquiaram-te	coloquiar+V.tu.AD.2.SG+PRF+3+PL
coloquiaram-vos	coloquiar+V.vós.AD.2.PL+PQP+3+PL
coloquiaram-vos	coloquiar+V.vós.AD.2.PL+PRF+3+PL
coloquiara-nos	coloquiar+nós.AD.1.PL+PQP+1+SG
coloquiara-nos	coloquiar+nós.AD.1.PL+PQP+2+SG
coloquiara-nos	coloquiar+nós.AD.1.PL+PQP+3+SG
coloquiara-o	coloquiar+V.ele.ACC.3.M.SG+PQP+1+SG
coloquiara-o	coloquiar+V.ele.ACC.3.M.SG+PQP+3+SG
coloquiara-os	coloquiar+V.ele.ACC.3.M.PL+PQP+1+SG
coloquiara-os	coloquiar+V.ele.ACC.3.M.PL+PQP+3+SG
coloquiara-se	coloquiar+V.ele.REFL+PQP+1+SG
coloquiara-se	coloquiar+V.ele.REFL+PQP+3+SG
coloquiaras-lhe	coloquiar+V.ele.DAT.3.SG+PQP+2+SG
coloquiaras-lhes	coloquiar+V.ele.DAT.3.PL+PQP+2+SG
coloquiaras-me	coloquiar+V.eu.AD.1.SG+PQP+2+SG
coloquiaras-te	coloquiar+V.tu.AD.2.SG+PQP+2+SG
coloquiaras-vos	coloquiar+V.vós.AD.2.PL+PQP+2+SG
coloquiara-te	coloquiar+V.tu.AD.2.SG+PQP+1+SG
coloquiara-te	coloquiar+V.tu.AD.2.SG+PQP+3+SG
coloquiara-vos	coloquiar+V.vós.AD.2.PL+PQP+1+SG
coloquiara-vos	coloquiar+V.vós.AD.2.PL+PQP+3+SG
coloquiarde-la	coloquiar+V.ele.ACC.3.F.SG+INF+2+PL
coloquiarde-la	coloquiar+V.ele.ACC.3.F.SG+SBJF+2+PL
coloquiarde-las	coloquiar+V.ele.ACC.3.F.PL+INF+2+PL
coloquiarde-las	coloquiar+V.ele.ACC.3.F.PL+SBJF+2+PL
coloquiarde-lo	coloquiar+V.ele.ACC.3.M.SG+INF+2+PL
coloquiarde-lo	coloquiar+V.ele.ACC.3.M.SG+SBJF+2+PL
coloquiarde-los	coloquiar+V.ele.ACC.3.M.PL+INF+2+PL
coloquiarde-los	coloquiar+V.ele.ACC.3.M.PL+SBJF+2+PL
coloquiarde-nos	coloquiar+nós.AD.1.PL+INF+2+PL
coloquiarde-nos	coloquiar+nós.AD.1.PL+SBJF+2+PL
coloquiardes-lhe	coloquiar+V.ele.DAT.3.SG+INF+2+PL
coloquiardes-lhe	coloquiar+V.ele.DAT.3.SG+SBJF+2+PL
coloquiardes-lhes	coloquiar+V.ele.DAT.3.PL+INF+2+PL
coloquiardes-lhes	coloquiar+V.ele.DAT.3.PL+SBJF+2+PL
coloquiardes-me	coloquiar+V.eu.AD.1.SG+INF+2+PL
coloquiardes-me	coloquiar+V.eu.AD.1.SG+SBJF+2+PL
coloquiardes-te	coloquiar+V.tu.AD.2.SG+INF+2+PL
coloquiardes-te	coloquiar+V.tu.AD.2.SG+SBJF+2+PL
coloquiardes-vos	coloquiar+V.vós.AD.2.PL+INF+2+PL
coloquiardes-vos	coloquiar+V.vós.AD.2.PL+SBJF+2+PL
coloquiárei-la	coloquiar+V.ele.ACC.3.F.SG+PQP+2+PL
coloquiárei-las	coloquiar+V.ele.ACC.3.F.PL+PQP+2+PL
coloquiárei-lo	coloquiar+V.ele.ACC.3.M.SG+PQP+2+PL
coloquiárei-los	coloquiar+V.ele.ACC.3.M.PL+PQP+2+PL
coloquiárei-nos	coloquiar+nós.AD.1.PL+PQP+2+PL
coloquiáreis-lhe	coloquiar+V.ele.DAT.3.SG+PQP+2+PL
coloquiáreis-lhes	coloquiar+V.ele.DAT.3.PL+PQP+2+PL
coloquiáreis-me	coloquiar+V.eu.AD.1.SG+PQP+2+PL
coloquiáreis-te	coloquiar+V.tu.AD.2.SG+PQP+2+PL
coloquiáreis-vos	coloquiar+V.vós.AD.2.PL+PQP+2+PL
coloquiare-la	coloquiar+V.ele.ACC.3.F.SG+INF+2+SG
coloquiare-la	coloquiar+V.ele.ACC.3.F.SG+SBJF+2+SG
coloquiare-las	coloquiar+V.ele.ACC.3.F.PL+INF+2+SG
coloquiare-las	coloquiar+V.ele.ACC.3.F.PL+SBJF+2+SG
coloquiare-lo	coloquiar+V.ele.ACC.3.M.SG+INF+2+SG
coloquiare-lo	coloquiar+V.ele.ACC.3.M.SG+SBJF+2+SG
coloquiare-los	coloquiar+V.ele.ACC.3.M.PL+INF+2+SG
coloquiare-los	coloquiar+V.ele.ACC.3.M.PL+SBJF+2+SG
coloquiarem-lhe	coloquiar+V.ele.DAT.3.SG+INF+3+PL
coloquiarem-lhe	coloquiar+V.ele.DAT.3.SG+SBJF+3+PL
coloquiarem-lhes	coloquiar+V.ele.DAT.3.PL+INF+3+PL
coloquiarem-lhes	coloquiar+V.ele.DAT.3.PL+SBJF+3+PL
coloquiarem-me	coloquiar+V.eu.AD.1.SG+INF+3+PL
coloquiarem-me	coloquiar+V.eu.AD.1.SG+SBJF+3+PL
coloquiarem-na	coloquiar+V.ele.ACC.3.F.SG+INF+3+PL
coloquiarem-na	coloquiar+V.ele.ACC.3.F.SG+SBJF+3+PL
coloquiarem-nas	coloquiar+V.ele.ACC.3.F.PL+INF+3+PL
coloquiarem-nas	coloquiar+V.ele.ACC.3.F.PL+SBJF+3+PL
coloquiarem-no	coloquiar+V.ele.ACC.3.M.SG+INF+3+PL
coloquiarem-no	coloquiar+V.ele.ACC.3.M.SG+SBJF+3+PL
coloquiarem-nos	coloquiar+V.ele.ACC.3.M.PL+INF+3+PL
coloquiarem-nos	coloquiar+V.ele.ACC.3.M.PL+SBJF+3+PL
coloquiarem-nos	coloquiar+V.nós.AD.1.PL+INF+3+PL
coloquiarem-nos	coloquiar+V.nós.AD.1.PL+SBJF+3+PL
coloquiarem-se	coloquiar+V.ele.REFL+INF+3+PL
coloquiarem-se	coloquiar+V.ele.REFL+SBJF+3+PL
coloquiarem-te	coloquiar+V.tu.AD.2.SG+INF+3+PL
coloquiarem-te	coloquiar+V.tu.AD.2.SG+SBJF+3+PL
coloquiarem-vos	coloquiar+V.vós.AD.2.PL+INF+3+PL
coloquiarem-vos	coloquiar+V.vós.AD.2.PL+SBJF+3+PL
coloquiare-nos	coloquiar+nós.AD.1.PL+INF+2+SG
coloquiare-nos	coloquiar+nós.AD.1.PL+SBJF+2+SG
coloquiares-lhe	coloquiar+V.ele.DAT.3.SG+INF+2+SG
coloquiares-lhe	coloquiar+V.ele.DAT.3.SG+SBJF+2+SG
coloquiares-lhes	coloquiar+V.ele.DAT.3.PL+INF+2+SG
coloquiares-lhes	coloquiar+V.ele.DAT.3.PL+SBJF+2+SG
coloquiares-me	coloquiar+V.eu.AD.1.SG+INF+2+SG
coloquiares-me	coloquiar+V.eu.AD.1.SG+SBJF+2+SG
coloquiares-te	coloquiar+V.tu.AD.2.SG+INF+2+SG
coloquiares-te	coloquiar+V.tu.AD.2.SG+SBJF+2+SG
coloquiares-vos	coloquiar+V.vós.AD.2.PL+INF+2+SG
coloquiares-vos	coloquiar+V.vós.AD.2.PL+SBJF+2+SG
coloquiar-lhe-á	coloquiar+V.ele.DAT.3.SG+FUT+3+SG
coloquiar-lhe-ão	coloquiar+V.ele.DAT.3.SG+FUT+3+PL
coloquiar-lhe-ás	coloquiar+V.ele.DAT.3.SG+FUT+2+SG
coloquiar-lhe	coloquiar+V.ele.DAT.3.SG+INF
coloquiar-lhe	coloquiar+V.ele.DAT.3.SG+INF+1+SG
coloquiar-lhe	coloquiar+V.ele.DAT.3.SG+INF+3+SG
coloquiar-lhe	coloquiar+V.ele.DAT.3.SG+SBJF+1+SG
coloquiar-lhe	coloquiar+V.ele.DAT.3.SG+SBJF+3+SG
coloquiar-lhe-ei	coloquiar+V.ele.DAT.3.SG+FUT+1+SG
coloquiar-lhe-eis	coloquiar+V.ele.DAT.3.SG+FUT+2+PL
coloquiar-lhe-emos	coloquiar+V.ele.DAT.3.SG+FUT+1+PL
coloquiar-lhe-ia	coloquiar+V.ele.DAT.3.SG+COND+1+SG
coloquiar-lhe-ia	coloquiar+V.ele.DAT.3.SG+COND+3+SG
coloquiar-lhe-iam	coloquiar+V.ele.DAT.3.SG+COND+3+PL
coloquiar-lhe-íamos	coloquiar+V.ele.DAT.3.SG+COND+1+PL
coloquiar-lhe-ias	coloquiar+V.ele.DAT.3.SG+COND+2+SG
coloquiar-lhe-íeis	coloquiar+V.ele.DAT.3.SG+COND+2+PL
coloquiar-lhes-á	coloquiar+V.ele.DAT.3.PL+FUT+3+SG
coloquiar-lhes-ão	coloquiar+V.ele.DAT.3.PL+FUT+3+PL
coloquiar-lhes-ás	coloquiar+V.ele.DAT.3.PL+FUT+2+SG
coloquiar-lhes	coloquiar+V.ele.DAT.3.PL+INF
coloquiar-lhes	coloquiar+V.ele.DAT.3.PL+INF+1+SG
coloquiar-lhes	coloquiar+V.ele.DAT.3.PL+INF+3+SG
coloquiar-lhes	coloquiar+V.ele.DAT.3.PL+SBJF+1+SG
coloquiar-lhes	coloquiar+V.ele.DAT.3.PL+SBJF+3+SG
coloquiar-lhes-ei	coloquiar+V.ele.DAT.3.PL+FUT+1+SG
coloquiar-lhes-eis	coloquiar+V.ele.DAT.3.PL+FUT+2+PL
coloquiar-lhes-emos	coloquiar+V.ele.DAT.3.PL+FUT+1+PL
coloquiar-lhes-ia	coloquiar+V.ele.DAT.3.PL+COND+1+SG
coloquiar-lhes-ia	coloquiar+V.ele.DAT.3.PL+COND+3+SG
coloquiar-lhes-iam	coloquiar+V.ele.DAT.3.PL+COND+3+PL
coloquiar-lhes-íamos	coloquiar+V.ele.DAT.3.PL+COND+1+PL
coloquiar-lhes-ias	coloquiar+V.ele.DAT.3.PL+COND+2+SG
coloquiar-lhes-íeis	coloquiar+V.ele.DAT.3.PL+COND+2+PL
coloquiar-me-á	coloquiar+V.eu.AD.1.SG+FUT+3+SG
coloquiar-me-ão	coloquiar+V.eu.AD.1.SG+FUT+3+PL
coloquiar-me-ás	coloquiar+V.eu.AD.1.SG+FUT+2+SG
coloquiar-me	coloquiar+V.eu.AD.1.SG+INF
coloquiar-me	coloquiar+V.eu.AD.1.SG+INF+1+SG
coloquiar-me	coloquiar+V.eu.AD.1.SG+INF+3+SG
coloquiar-me	coloquiar+V.eu.AD.1.SG+SBJF+1+SG
coloquiar-me	coloquiar+V.eu.AD.1.SG+SBJF+3+SG
coloquiar-me-ei	coloquiar+V.eu.AD.1.SG+FUT+1+SG
coloquiar-me-eis	coloquiar+V.eu.AD.1.SG+FUT+2+PL
coloquiar-me-emos	coloquiar+V.eu.AD.1.SG+FUT+1+PL
coloquiar-me-ia	coloquiar+V.eu.AD.1.SG+COND+1+SG
coloquiar-me-ia	coloquiar+V.eu.AD.1.SG+COND+3+SG
coloquiar-me-iam	coloquiar+V.eu.AD.1.SG+COND+3+PL
coloquiar-me-íamos	coloquiar+V.eu.AD.1.SG+COND+1+PL
coloquiar-me-ias	coloquiar+V.eu.AD.1.SG+COND+2+SG
coloquiar-me-íeis	coloquiar+V.eu.AD.1.SG+COND+2+PL
coloquiarmo-la	coloquiar+V.ele.ACC.3.F.SG+INF+1+PL
coloquiarmo-la	coloquiar+V.ele.ACC.3.F.SG+SBJF+1+PL
coloquiarmo-las	coloquiar+V.ele.ACC.3.F.PL+INF+1+PL
coloquiarmo-las	coloquiar+V.ele.ACC.3.F.PL+SBJF+1+PL
coloquiarmo-lo	coloquiar+V.ele.ACC.3.M.SG+INF+1+PL
coloquiarmo-lo	coloquiar+V.ele.ACC.3.M.SG+SBJF+1+PL
coloquiarmo-los	coloquiar+V.ele.ACC.3.M.PL+INF+1+PL
coloquiarmo-los	coloquiar+V.ele.ACC.3.M.PL+SBJF+1+PL
coloquiarmo-nos	coloquiar+nós.AD.1.PL+INF+1+PL
coloquiarmo-nos	coloquiar+nós.AD.1.PL+SBJF+1+PL
coloquiarmos-lhe	coloquiar+V.ele.DAT.3.SG+INF+1+PL
coloquiarmos-lhe	coloquiar+V.ele.DAT.3.SG+SBJF+1+PL
coloquiarmos-lhes	coloquiar+V.ele.DAT.3.PL+INF+1+PL
coloquiarmos-lhes	coloquiar+V.ele.DAT.3.PL+SBJF+1+PL
coloquiarmos-me	coloquiar+V.eu.AD.1.SG+INF+1+PL
coloquiarmos-me	coloquiar+V.eu.AD.1.SG+SBJF+1+PL
coloquiarmos-te	coloquiar+V.tu.AD.2.SG+INF+1+PL
coloquiarmos-te	coloquiar+V.tu.AD.2.SG+SBJF+1+PL
coloquiarmos-vos	coloquiar+V.vós.AD.2.PL+INF+1+PL
coloquiarmos-vos	coloquiar+V.vós.AD.2.PL+SBJF+1+PL
coloquiar-nos-á	coloquiar+nós.AD.1.PL+FUT+3+SG
coloquiar-nos-ão	coloquiar+nós.AD.1.PL+FUT+3+PL
coloquiar-nos-ás	coloquiar+nós.AD.1.PL+FUT+2+SG
coloquiar-nos	coloquiar+nós.AD.1.PL+INF
coloquiar-nos	coloquiar+nós.AD.1.PL+INF+1+SG
coloquiar-nos	coloquiar+nós.AD.1.PL+INF+3+SG
coloquiar-nos	coloquiar+nós.AD.1.PL+SBJF+1+SG
coloquiar-nos	coloquiar+nós.AD.1.PL+SBJF+3+SG
coloquiar-nos-ei	coloquiar+nós.AD.1.PL+FUT+1+SG
coloquiar-nos-eis	coloquiar+nós.AD.1.PL+FUT+2+PL
coloquiar-nos-emos	coloquiar+nós.AD.1.PL+FUT+1+PL
coloquiar-nos-ia	coloquiar+nós.AD.1.PL+COND+1+SG
coloquiar-nos-ia	coloquiar+nós.AD.1.PL+COND+3+SG
coloquiar-nos-iam	coloquiar+nós.AD.1.PL+COND+3+PL
coloquiar-nos-íamos	coloquiar+nós.AD.1.PL+COND+1+PL
coloquiar-nos-ias	coloquiar+nós.AD.1.PL+COND+2+SG
coloquiar-nos-íeis	coloquiar+nós.AD.1.PL+COND+2+PL
coloquiar-se-á	coloquiar+V.ele.REFL+FUT+3+SG
coloquiar-se-ão	coloquiar+V.ele.REFL+FUT+3+PL
coloquiar-se	coloquiar+V.ele.REFL+INF
coloquiar-se	coloquiar+V.ele.REFL+INF+3+SG
coloquiar-se	coloquiar+V.ele.REFL+SBJF+3+SG
coloquiar-se-ia	coloquiar+V.ele.REFL+COND+3+SG
coloquiar-se-iam	coloquiar+V.ele.REFL+COND+3+PL
coloquiar-te-á	coloquiar+V.tu.AD.2.SG+FUT+3+SG
coloquiar-te-ão	coloquiar+V.tu.AD.2.SG+FUT+3+PL
coloquiar-te-ás	coloquiar+V.tu.AD.2.SG+FUT+2+SG
coloquiar-te	coloquiar+V.tu.AD.2.SG+INF
coloquiar-te	coloquiar+V.tu.AD.2.SG+INF+1+SG
coloquiar-te	coloquiar+V.tu.AD.2.SG+INF+3+SG
coloquiar-te	coloquiar+V.tu.AD.2.SG+SBJF+1+SG
coloquiar-te	coloquiar+V.tu.AD.2.SG+SBJF+3+SG
coloquiar-te-ei	coloquiar+V.tu.AD.2.SG+FUT+1+SG
coloquiar-te-eis	coloquiar+V.tu.AD.2.SG+FUT+2+PL
coloquiar-te-emos	coloquiar+V.tu.AD.2.SG+FUT+1+PL
coloquiar-te-ia	coloquiar+V.tu.AD.2.SG+COND+1+SG
coloquiar-te-ia	coloquiar+V.tu.AD.2.SG+COND+3+SG
coloquiar-te-iam	coloquiar+V.tu.AD.2.SG+COND+3+PL
coloquiar-te-íamos	coloquiar+V.tu.AD.2.SG+COND+1+PL
coloquiar-te-ias	coloquiar+V.tu.AD.2.SG+COND+2+SG
coloquiar-te-íeis	coloquiar+V.tu.AD.2.SG+COND+2+PL
coloquiar-vos-á	coloquiar+V.vós.AD.2.PL+FUT+3+SG
coloquiar-vos-ão	coloquiar+V.vós.AD.2.PL+FUT+3+PL
coloquiar-vos-ás	coloquiar+V.vós.AD.2.PL+FUT+2+SG
coloquiar-vos	coloquiar+V.vós.AD.2.PL+INF
coloquiar-vos	coloquiar+V.vós.AD.2.PL+INF+1+SG
coloquiar-vos	coloquiar+V.vós.AD.2.PL+INF+3+SG
coloquiar-vos	coloquiar+V.vós.AD.2.PL+SBJF+1+SG
coloquiar-vos	coloquiar+V.vós.AD.2.PL+SBJF+3+SG
coloquiar-vos-ei	coloquiar+V.vós.AD.2.PL+FUT+1+SG
coloquiar-vos-eis	coloquiar+V.vós.AD.2.PL+FUT+2+PL
coloquiar-vos-emos	coloquiar+V.vós.AD.2.PL+FUT+1+PL
coloquiar-vos-ia	coloquiar+V.vós.AD.2.PL+COND+1+SG
coloquiar-vos-ia	coloquiar+V.vós.AD.2.PL+COND+3+SG
coloquiar-vos-iam	coloquiar+V.vós.AD.2.PL+COND+3+PL
coloquiar-vos-íamos	coloquiar+V.vós.AD.2.PL+COND+1+PL
coloquiar-vos-ias	coloquiar+V.vós.AD.2.PL+COND+2+SG
coloquiar-vos-íeis	coloquiar+V.vós.AD.2.PL+COND+2+PL
coloquia-se	coloquiar+V.ele.REFL+PRS+3+SG
coloquias-lhe	coloquiar+V.ele.DAT.3.SG+PRS+2+SG
coloquias-lhes	coloquiar+V.ele.DAT.3.PL+PRS+2+SG
coloquias-me	coloquiar+V.eu.AD.1.SG+PRS+2+SG
coloquiaste-a	coloquiar+V.ele.ACC.3.F.SG+PRF+2+SG
coloquiaste-as	coloquiar+V.ele.ACC.3.F.PL+PRF+2+SG
coloquias-te	coloquiar+V.tu.AD.2.SG+PRS+2+SG
coloquiaste-la	coloquiar+V.ele.ACC.3.F.SG+PRF+2+PL
coloquiaste-las	coloquiar+V.ele.ACC.3.F.PL+PRF+2+PL
coloquiaste-lhe	coloquiar+V.ele.DAT.3.SG+PRF+2+SG
coloquiaste-lhes	coloquiar+V.ele.DAT.3.PL+PRF+2+SG
coloquiaste-lo	coloquiar+V.ele.ACC.3.M.SG+PRF+2+PL
coloquiaste-los	coloquiar+V.ele.ACC.3.M.PL+PRF+2+PL
coloquiaste-me	coloquiar+V.eu.AD.1.SG+PRF+2+SG
coloquiaste-nos	coloquiar+nós.AD.1.PL+PRF+2+PL
coloquiaste-nos	coloquiar+nós.AD.1.PL+PRF+2+SG
coloquiaste-o	coloquiar+V.ele.ACC.3.M.SG+PRF+2+SG
coloquiaste-os	coloquiar+V.ele.ACC.3.M.PL+PRF+2+SG
coloquiastes-lhe	coloquiar+V.ele.DAT.3.SG+PRF+2+PL
coloquiastes-lhes	coloquiar+V.ele.DAT.3.PL+PRF+2+PL
coloquiastes-me	coloquiar+V.eu.AD.1.SG+PRF+2+PL
coloquiastes-te	coloquiar+V.tu.AD.2.SG+PRF+2+PL
coloquiastes-vos	coloquiar+V.vós.AD.2.PL+PRF+2+PL
coloquiaste-te	coloquiar+V.tu.AD.2.SG+PRF+2+SG
coloquiaste-vos	coloquiar+V.vós.AD.2.PL+PRF+2+SG
coloquias-vos	coloquiar+V.vós.AD.2.PL+PRS+2+SG
coloquia-te	coloquiar+V.tu.AD.2.SG+PRS+3+SG
coloquiava-a	coloquiar+V.ele.ACC.3.F.SG+IMPF+1+SG
coloquiava-a	coloquiar+V.ele.ACC.3.F.SG+IMPF+3+SG
coloquiava-as	coloquiar+V.ele.ACC.3.F.PL+IMPF+1+SG
coloquiava-as	coloquiar+V.ele.ACC.3.F.PL+IMPF+3+SG
coloquiava-la	coloquiar+V.ele.ACC.3.F.SG+IMPF+2+SG
coloquiava-las	coloquiar+V.ele.ACC.3.F.PL+IMPF+2+SG
coloquiava-lhe	coloquiar+V.ele.DAT.3.SG+IMPF+1+SG
coloquiava-lhe	coloquiar+V.ele.DAT.3.SG+IMPF+3+SG
coloquiava-lhes	coloquiar+V.ele.DAT.3.PL+IMPF+1+SG
coloquiava-lhes	coloquiar+V.ele.DAT.3.PL+IMPF+3+SG
coloquiava-lo	coloquiar+V.ele.ACC.3.M.SG+IMPF+2+SG
coloquiava-los	coloquiar+V.ele.ACC.3.M.PL+IMPF+2+SG
coloquiava-me	coloquiar+V.eu.AD.1.SG+IMPF+1+SG
coloquiava-me	coloquiar+V.eu.AD.1.SG+IMPF+3+SG
coloquiavam-lhe	coloquiar+V.ele.DAT.3.SG+IMPF+3+PL
coloquiavam-lhes	coloquiar+V.ele.DAT.3.PL+IMPF+3+PL
coloquiavam-me	coloquiar+V.eu.AD.1.SG+IMPF+3+PL
coloquiavam-na	coloquiar+V.ele.ACC.3.F.SG+IMPF+3+PL
coloquiavam-nas	coloquiar+V.ele.ACC.3.F.PL+IMPF+3+PL
coloquiavam-no	coloquiar+V.ele.ACC.3.M.SG+IMPF+3+PL
coloquiavam-nos	coloquiar+V.ele.ACC.3.M.PL+IMPF+3+PL
coloquiavam-nos	coloquiar+V.nós.AD.1.PL+IMPF+3+PL
coloquiávamo-la	coloquiar+V.ele.ACC.3.F.SG+IMPF+1+PL
coloquiávamo-las	coloquiar+V.ele.ACC.3.F.PL+IMPF+1+PL
coloquiávamo-lo	coloquiar+V.ele.ACC.3.M.SG+IMPF+1+PL
coloquiávamo-los	coloquiar+V.ele.ACC.3.M.PL+IMPF+1+PL
coloquiávamo-nos	coloquiar+nós.AD.1.PL+IMPF+1+PL
coloquiávamos-lhe	coloquiar+V.ele.DAT.3.SG+IMPF+1+PL
coloquiávamos-lhes	coloquiar+V.ele.DAT.3.PL+IMPF+1+PL
coloquiávamos-me	coloquiar+V.eu.AD.1.SG+IMPF+1+PL
coloquiávamos-te	coloquiar+V.tu.AD.2.SG+IMPF+1+PL
coloquiávamos-vos	coloquiar+V.vós.AD.2.PL+IMPF+1+PL
coloquiavam-se	coloquiar+V.ele.REFL+IMPF+3+PL
coloquiavam-te	coloquiar+V.tu.AD.2.SG+IMPF+3+PL
coloquiavam-vos	coloquiar+V.vós.AD.2.PL+IMPF+3+PL
coloquiava-nos	coloquiar+nós.AD.1.PL+IMPF+1+SG
coloquiava-nos	coloquiar+nós.AD.1.PL+IMPF+2+SG
coloquiava-nos	coloquiar+nós.AD.1.PL+IMPF+3+SG
coloquiava-o	coloquiar+V.ele.ACC.3.M.SG+IMPF+1+SG
coloquiava-o	coloquiar+V.ele.ACC.3.M.SG+IMPF+3+SG
coloquiava-os	coloquiar+V.ele.ACC.3.M.PL+IMPF+1+SG
coloquiava-os	coloquiar+V.ele.ACC.3.M.PL+IMPF+3+SG
coloquiava-se	coloquiar+V.ele.REFL+IMPF+1+SG
coloquiava-se	coloquiar+V.ele.REFL+IMPF+3+SG
coloquiavas-lhe	coloquiar+V.ele.DAT.3.SG+IMPF+2+SG
coloquiavas-lhes	coloquiar+V.ele.DAT.3.PL+IMPF+2+SG
coloquiavas-me	coloquiar+V.eu.AD.1.SG+IMPF+2+SG
coloquiavas-te	coloquiar+V.tu.AD.2.SG+IMPF+2+SG
coloquiavas-vos	coloquiar+V.vós.AD.2.PL+IMPF+2+SG
coloquiava-te	coloquiar+V.tu.AD.2.SG+IMPF+1+SG
coloquiava-te	coloquiar+V.tu.AD.2.SG+IMPF+3+SG
coloquiava-vos	coloquiar+V.vós.AD.2.PL+IMPF+1+SG
coloquiava-vos	coloquiar+V.vós.AD.2.PL+IMPF+3+SG
coloquiávei-la	coloquiar+V.ele.ACC.3.F.SG+IMPF+2+PL
coloquiávei-las	coloquiar+V.ele.ACC.3.F.PL+IMPF+2+PL
coloquiávei-lo	coloquiar+V.ele.ACC.3.M.SG+IMPF+2+PL
coloquiávei-los	coloquiar+V.ele.ACC.3.M.PL+IMPF+2+PL
coloquiávei-nos	coloquiar+nós.AD.1.PL+IMPF+2+PL
coloquiáveis-lhe	coloquiar+V.ele.DAT.3.SG+IMPF+2+PL
coloquiáveis-lhes	coloquiar+V.ele.DAT.3.PL+IMPF+2+PL
coloquiáveis-me	coloquiar+V.eu.AD.1.SG+IMPF+2+PL
coloquiáveis-te	coloquiar+V.tu.AD.2.SG+IMPF+2+PL
coloquiáveis-vos	coloquiar+V.vós.AD.2.PL+IMPF+2+PL
coloquia-vos	coloquiar+V.vós.AD.2.PL+PRS+3+SG
coloquie-a	coloquiar+V.ele.ACC.3.F.SG+IMP+3+SG
coloquie-as	coloquiar+V.ele.ACC.3.F.PL+IMP+3+SG
coloquiei-a	coloquiar+V.ele.ACC.3.F.SG+PRF+1+SG
coloquiei-as	coloquiar+V.ele.ACC.3.F.PL+PRF+1+SG
coloquiei-lhe	coloquiar+V.ele.DAT.3.SG+PRF+1+SG
coloquiei-lhes	coloquiar+V.ele.DAT.3.PL+PRF+1+SG
coloquiei-me	coloquiar+V.eu.AD.1.SG+PRF+1+SG
coloquiei-nos	coloquiar+nós.AD.1.PL+PRF+1+SG
coloquiei-o	coloquiar+V.ele.ACC.3.M.SG+PRF+1+SG
coloquiei-os	coloquiar+V.ele.ACC.3.M.PL+PRF+1+SG
coloquiei-te	coloquiar+V.tu.AD.2.SG+PRF+1+SG
coloquiei-vos	coloquiar+V.vós.AD.2.PL+PRF+1+SG
coloquie-lhe	coloquiar+V.ele.DAT.3.SG+IMP+3+SG
coloquie-lhes	coloquiar+V.ele.DAT.3.PL+IMP+3+SG
coloquie-me	coloquiar+V.eu.AD.1.SG+IMP+3+SG
coloquiem-lhe	coloquiar+V.ele.DAT.3.SG+IMP+3+PL
coloquiem-lhes	coloquiar+V.ele.DAT.3.PL+IMP+3+PL
coloquiem-me	coloquiar+V.eu.AD.1.SG+IMP+3+PL
coloquiem-na	coloquiar+V.ele.ACC.3.F.SG+IMP+3+PL
coloquiem-nas	coloquiar+V.ele.ACC.3.F.PL+IMP+3+PL
coloquiem-no	coloquiar+V.ele.ACC.3.M.SG+IMP+3+PL
coloquiem-nos	coloquiar+V.ele.ACC.3.M.PL+IMP+3+PL
coloquiem-nos	coloquiar+V.nós.AD.1.PL+IMP+3+PL
coloquiemo-la	coloquiar+V.ele.ACC.3.F.SG+IMP+1+PL
coloquiemo-las	coloquiar+V.ele.ACC.3.F.PL+IMP+1+PL
coloquiemo-lo	coloquiar+V.ele.ACC.3.M.SG+IMP+1+PL
coloquiemo-los	coloquiar+V.ele.ACC.3.M.PL+IMP+1+PL
coloquiemo-nos	coloquiar+nós.AD.1.PL+IMP+1+PL
coloquiemos-lhe	coloquiar+V.ele.DAT.3.SG+IMP+1+PL
coloquiemos-lhes	coloquiar+V.ele.DAT.3.PL+IMP+1+PL
coloquiemos-me	coloquiar+V.eu.AD.1.SG+IMP+1+PL
coloquiemos-te	coloquiar+V.tu.AD.2.SG+IMP+1+PL
coloquiemos-vos	coloquiar+V.vós.AD.2.PL+IMP+1+PL
coloquiem-se	coloquiar+V.ele.REFL+IMP+3+PL
coloquiem-te	coloquiar+V.tu.AD.2.SG+IMP+3+PL
coloquiem-vos	coloquiar+V.vós.AD.2.PL+IMP+3+PL
coloquie-nos	coloquiar+nós.AD.1.PL+IMP+3+SG
coloquie-o	coloquiar+V.ele.ACC.3.M.SG+IMP+3+SG
coloquie-os	coloquiar+V.ele.ACC.3.M.PL+IMP+3+SG
coloquie-se	coloquiar+V.ele.REFL+IMP+3+SG
coloquie-te	coloquiar+V.tu.AD.2.SG+IMP+3+SG
coloquie-vos	coloquiar+V.vós.AD.2.PL+IMP+3+SG
coloquio-a	coloquiar+V.ele.ACC.3.F.SG+PRS+1+SG
coloquio-as	coloquiar+V.ele.ACC.3.F.PL+PRS+1+SG
coloquio-lhe	coloquiar+V.ele.DAT.3.SG+PRS+1+SG
coloquio-lhes	coloquiar+V.ele.DAT.3.PL+PRS+1+SG
coloquio-me	coloquiar+V.eu.AD.1.SG+PRS+1+SG
coloquio-nos	coloquiar+nós.AD.1.PL+PRS+1+SG
coloquio-o	coloquiar+V.ele.ACC.3.M.SG+PRS+1+SG
coloquio-os	coloquiar+V.ele.ACC.3.M.PL+PRS+1+SG
coloquio-te	coloquiar+V.tu.AD.2.SG+PRS+1+SG
coloquiou-a	coloquiar+V.ele.ACC.3.F.SG+PRF+3+SG
coloquiou-as	coloquiar+V.ele.ACC.3.F.PL+PRF+3+SG
coloquiou-lhe	coloquiar+V.ele.DAT.3.SG+PRF+3+SG
coloquiou-lhes	coloquiar+V.ele.DAT.3.PL+PRF+3+SG
coloquiou-me	coloquiar+V.eu.AD.1.SG+PRF+3+SG
coloquiou-nos	coloquiar+nós.AD.1.PL+PRF+3+SG
coloquiou-o	coloquiar+V.ele.ACC.3.M.SG+PRF+3+SG
coloquiou-os	coloquiar+V.ele.ACC.3.M.PL+PRF+3+SG
coloquiou-se	coloquiar+V.ele.REFL+PRF+3+SG
coloquiou-te	coloquiar+V.tu.AD.2.SG+PRF+3+SG
coloquiou-vos	coloquiar+V.vós.AD.2.PL+PRF+3+SG
coloquio-vos	coloquiar+V.vós.AD.2.PL+PRS+1+SG
colora-a	colorar+V.ele.ACC.3.F.SG+PRS+3+SG
colora-a	colorir+V.ele.ACC.3.F.SG+IMP+3+SG
colora-as	colorar+V.ele.ACC.3.F.PL+PRS+3+SG
colora-as	colorir+V.ele.ACC.3.F.PL+IMP+3+SG
colorai-la	colorar+V.ele.ACC.3.F.SG+PRS+2+PL
colorai-las	colorar+V.ele.ACC.3.F.PL+PRS+2+PL
colorai-lo	colorar+V.ele.ACC.3.M.SG+PRS+2+PL
colorai-los	colorar+V.ele.ACC.3.M.PL+PRS+2+PL
colorai-nos	colorar+nós.AD.1.PL+PRS+2+PL
colorais-lhe	colorar+V.ele.DAT.3.SG+PRS+2+PL
colorais-lhes	colorar+V.ele.DAT.3.PL+PRS+2+PL
colorais-me	colorar+V.eu.AD.1.SG+PRS+2+PL
colorais-te	colorar+V.tu.AD.2.SG+PRS+2+PL
colorais-vos	colorar+V.vós.AD.2.PL+PRS+2+PL
colorá-la-á	colorar+V.ele.ACC.3.F.SG+FUT+3+SG
colorá-la-ão	colorar+V.ele.ACC.3.F.SG+FUT+3+PL
colorá-la-ás	colorar+V.ele.ACC.3.F.SG+FUT+2+SG
colorá-la	colorar+V.ele.ACC.3.F.SG+INF+1+SG
colorá-la	colorar+V.ele.ACC.3.F.SG+INF+3+SG
colora-la	colorar+V.ele.ACC.3.F.SG+PRS+2+SG
colorá-la	colorar+V.ele.ACC.3.F.SG+SBJF+1+SG
colorá-la	colorar+V.ele.ACC.3.F.SG+SBJF+3+SG
colorá-la-ei	colorar+V.ele.ACC.3.F.SG+FUT+1+SG
colorá-la-eis	colorar+V.ele.ACC.3.F.SG+FUT+2+PL
colorá-la-emos	colorar+V.ele.ACC.3.F.SG+FUT+1+PL
colorá-la-ia	colorar+V.ele.ACC.3.F.SG+COND+1+SG
colorá-la-ia	colorar+V.ele.ACC.3.F.SG+COND+3+SG
colorá-la-iam	colorar+V.ele.ACC.3.F.SG+COND+3+PL
colorá-la-íamos	colorar+V.ele.ACC.3.F.SG+COND+1+PL
colorá-la-ias	colorar+V.ele.ACC.3.F.SG+COND+2+SG
colorá-la-íeis	colorar+V.ele.ACC.3.F.SG+COND+2+PL
colorá-las-á	colorar+V.ele.ACC.3.F.PL+FUT+3+SG
colorá-las-ão	colorar+V.ele.ACC.3.F.PL+FUT+3+PL
colorá-las-ás	colorar+V.ele.ACC.3.F.PL+FUT+2+SG
colorá-las	colorar+V.ele.ACC.3.F.PL+INF+1+SG
colorá-las	colorar+V.ele.ACC.3.F.PL+INF+3+SG
colora-las	colorar+V.ele.ACC.3.F.PL+PRS+2+SG
colorá-las	colorar+V.ele.ACC.3.F.PL+SBJF+1+SG
colorá-las	colorar+V.ele.ACC.3.F.PL+SBJF+3+SG
colorá-las-ei	colorar+V.ele.ACC.3.F.PL+FUT+1+SG
colorá-las-eis	colorar+V.ele.ACC.3.F.PL+FUT+2+PL
colorá-las-emos	colorar+V.ele.ACC.3.F.PL+FUT+1+PL
colorá-las-ia	colorar+V.ele.ACC.3.F.PL+COND+1+SG
colorá-las-ia	colorar+V.ele.ACC.3.F.PL+COND+3+SG
colorá-las-iam	colorar+V.ele.ACC.3.F.PL+COND+3+PL
colorá-las-íamos	colorar+V.ele.ACC.3.F.PL+COND+1+PL
colorá-las-ias	colorar+V.ele.ACC.3.F.PL+COND+2+SG
colorá-las-íeis	colorar+V.ele.ACC.3.F.PL+COND+2+PL
colora-lhe	colorar+V.ele.DAT.3.SG+PRS+3+SG
colora-lhe	colorir+V.ele.DAT.3.SG+IMP+3+SG
colora-lhes	colorar+V.ele.DAT.3.PL+PRS+3+SG
colora-lhes	colorir+V.ele.DAT.3.PL+IMP+3+SG
colorá-lo-á	colorar+V.ele.ACC.3.M.SG+FUT+3+SG
colorá-lo-ão	colorar+V.ele.ACC.3.M.SG+FUT+3+PL
colorá-lo-ás	colorar+V.ele.ACC.3.M.SG+FUT+2+SG
colorá-lo	colorar+V.ele.ACC.3.M.SG+INF+1+SG
colorá-lo	colorar+V.ele.ACC.3.M.SG+INF+3+SG
colora-lo	colorar+V.ele.ACC.3.M.SG+PRS+2+SG
colorá-lo	colorar+V.ele.ACC.3.M.SG+SBJF+1+SG
colorá-lo	colorar+V.ele.ACC.3.M.SG+SBJF+3+SG
colorá-lo-ei	colorar+V.ele.ACC.3.M.SG+FUT+1+SG
colorá-lo-eis	colorar+V.ele.ACC.3.M.SG+FUT+2+PL
colorá-lo-emos	colorar+V.ele.ACC.3.M.SG+FUT+1+PL
colorá-lo-ia	colorar+V.ele.ACC.3.M.SG+COND+1+SG
colorá-lo-ia	colorar+V.ele.ACC.3.M.SG+COND+3+SG
colorá-lo-iam	colorar+V.ele.ACC.3.M.SG+COND+3+PL
colorá-lo-íamos	colorar+V.ele.ACC.3.M.SG+COND+1+PL
colorá-lo-ias	colorar+V.ele.ACC.3.M.SG+COND+2+SG
colorá-lo-íeis	colorar+V.ele.ACC.3.M.SG+COND+2+PL
colorá-los-á	colorar+V.ele.ACC.3.M.PL+FUT+3+SG
colorá-los-ão	colorar+V.ele.ACC.3.M.PL+FUT+3+PL
colorá-los-ás	colorar+V.ele.ACC.3.M.PL+FUT+2+SG
colorá-los	colorar+V.ele.ACC.3.M.PL+INF+1+SG
colorá-los	colorar+V.ele.ACC.3.M.PL+INF+3+SG
colora-los	colorar+V.ele.ACC.3.M.PL+PRS+2+SG
colorá-los	colorar+V.ele.ACC.3.M.PL+SBJF+1+SG
colorá-los	colorar+V.ele.ACC.3.M.PL+SBJF+3+SG
colorá-los-ei	colorar+V.ele.ACC.3.M.PL+FUT+1+SG
colorá-los-eis	colorar+V.ele.ACC.3.M.PL+FUT+2+PL
colorá-los-emos	colorar+V.ele.ACC.3.M.PL+FUT+1+PL
colorá-los-ia	colorar+V.ele.ACC.3.M.PL+COND+1+SG
colorá-los-ia	colorar+V.ele.ACC.3.M.PL+COND+3+SG
colorá-los-iam	colorar+V.ele.ACC.3.M.PL+COND+3+PL
colorá-los-íamos	colorar+V.ele.ACC.3.M.PL+COND+1+PL
colorá-los-ias	colorar+V.ele.ACC.3.M.PL+COND+2+SG
colorá-los-íeis	colorar+V.ele.ACC.3.M.PL+COND+2+PL
colora-me	colorar+V.eu.AD.1.SG+PRS+3+SG
colora-me	colorir+V.eu.AD.1.SG+IMP+3+SG
coloram-lhe	colorar+V.ele.DAT.3.SG+PRS+3+PL
coloram-lhe	colorir+V.ele.DAT.3.SG+IMP+3+PL
coloram-lhes	colorar+V.ele.DAT.3.PL+PRS+3+PL
coloram-lhes	colorir+V.ele.DAT.3.PL+IMP+3+PL
coloram-me	colorar+V.eu.AD.1.SG+PRS+3+PL
coloram-me	colorir+V.eu.AD.1.SG+IMP+3+PL
coloram-na	colorar+V.ele.ACC.3.F.SG+PRS+3+PL
coloram-na	colorir+V.ele.ACC.3.F.SG+IMP+3+PL
coloram-nas	colorar+V.ele.ACC.3.F.PL+PRS+3+PL
coloram-nas	colorir+V.ele.ACC.3.F.PL+IMP+3+PL
coloram-no	colorar+V.ele.ACC.3.M.SG+PRS+3+PL
coloram-no	colorir+V.ele.ACC.3.M.SG+IMP+3+PL
coloram-nos	colorar+V.ele.ACC.3.M.PL+PRS+3+PL
coloram-nos	colorar+V.nós.AD.1.PL+PRS+3+PL
coloram-nos	colorir+V.ele.ACC.3.M.PL+IMP+3+PL
coloram-nos	colorir+V.nós.AD.1.PL+IMP+3+PL
coloramo-la	colorar+V.ele.ACC.3.F.SG+PRF+1+PL
coloramo-la	colorar+V.ele.ACC.3.F.SG+PRS+1+PL
coloramo-la	colorir+V.ele.ACC.3.F.SG+IMP+1+PL
coloramo-las	colorar+V.ele.ACC.3.F.PL+PRF+1+PL
coloramo-las	colorar+V.ele.ACC.3.F.PL+PRS+1+PL
coloramo-las	colorir+V.ele.ACC.3.F.PL+IMP+1+PL
coloramo-lo	colorar+V.ele.ACC.3.M.SG+PRF+1+PL
coloramo-lo	colorar+V.ele.ACC.3.M.SG+PRS+1+PL
coloramo-lo	colorir+V.ele.ACC.3.M.SG+IMP+1+PL
coloramo-los	colorar+V.ele.ACC.3.M.PL+PRF+1+PL
coloramo-los	colorar+V.ele.ACC.3.M.PL+PRS+1+PL
coloramo-los	colorir+V.ele.ACC.3.M.PL+IMP+1+PL
coloramo-nos	colorar+nós.AD.1.PL+PRF+1+PL
coloramo-nos	colorar+nós.AD.1.PL+PRS+1+PL
coloramo-nos	colorir+nós.AD.1.PL+IMP+1+PL
coloramos-lhe	colorar+V.ele.DAT.3.SG+PRF+1+PL
coloramos-lhe	colorar+V.ele.DAT.3.SG+PRS+1+PL
coloramos-lhe	colorir+V.ele.DAT.3.SG+IMP+1+PL
coloramos-lhes	colorar+V.ele.DAT.3.PL+PRF+1+PL
coloramos-lhes	colorar+V.ele.DAT.3.PL+PRS+1+PL
coloramos-lhes	colorir+V.ele.DAT.3.PL+IMP+1+PL
coloramos-me	colorar+V.eu.AD.1.SG+PRF+1+PL
coloramos-me	colorar+V.eu.AD.1.SG+PRS+1+PL
coloramos-me	colorir+V.eu.AD.1.SG+IMP+1+PL
coloramos-te	colorar+V.tu.AD.2.SG+PRF+1+PL
coloramos-te	colorar+V.tu.AD.2.SG+PRS+1+PL
coloramos-te	colorir+V.tu.AD.2.SG+IMP+1+PL
coloramos-vos	colorar+V.vós.AD.2.PL+PRF+1+PL
coloramos-vos	colorar+V.vós.AD.2.PL+PRS+1+PL
coloramos-vos	colorir+V.vós.AD.2.PL+IMP+1+PL
coloram-se	colorar+V.ele.REFL+PRS+3+PL
coloram-se	colorir+V.ele.REFL+IMP+3+PL
coloram-te	colorar+V.tu.AD.2.SG+PRS+3+PL
coloram-te	colorir+V.tu.AD.2.SG+IMP+3+PL
coloram-vos	colorar+V.vós.AD.2.PL+PRS+3+PL
coloram-vos	colorir+V.vós.AD.2.PL+IMP+3+PL
colorando-a	colorar+V.ele.ACC.3.F.SG+GRD
colorando-as	colorar+V.ele.ACC.3.F.PL+GRD
colorando-lhe	colorar+V.ele.DAT.3.SG+GRD
colorando-lhes	colorar+V.ele.DAT.3.PL+GRD
colorando-me	colorar+V.eu.AD.1.SG+GRD
colorando-nos	colorar+nós.AD.1.PL+GRD
colorando-o	colorar+V.ele.ACC.3.M.SG+GRD
colorando-os	colorar+V.ele.ACC.3.M.PL+GRD
colorando-se	colorar+V.ele.REFL+GRD
colorando-te	colorar+V.tu.AD.2.SG+GRD
colorando-vos	colorar+V.vós.AD.2.PL+GRD
colora-nos	colorar+nós.AD.1.PL+PRS+2+SG
colora-nos	colorar+nós.AD.1.PL+PRS+3+SG
colora-nos	colorir+nós.AD.1.PL+IMP+3+SG
colora-o	colorar+V.ele.ACC.3.M.SG+PRS+3+SG
colora-o	colorir+V.ele.ACC.3.M.SG+IMP+3+SG
colora-os	colorar+V.ele.ACC.3.M.PL+PRS+3+SG
colora-os	colorir+V.ele.ACC.3.M.PL+IMP+3+SG
colorara-a	colorar+V.ele.ACC.3.F.SG+PQP+1+SG
colorara-a	colorar+V.ele.ACC.3.F.SG+PQP+3+SG
colorara-as	colorar+V.ele.ACC.3.F.PL+PQP+1+SG
colorara-as	colorar+V.ele.ACC.3.F.PL+PQP+3+SG
colorara-la	colorar+V.ele.ACC.3.F.SG+PQP+2+SG
colorara-las	colorar+V.ele.ACC.3.F.PL+PQP+2+SG
colorara-lhe	colorar+V.ele.DAT.3.SG+PQP+1+SG
colorara-lhe	colorar+V.ele.DAT.3.SG+PQP+3+SG
colorara-lhes	colorar+V.ele.DAT.3.PL+PQP+1+SG
colorara-lhes	colorar+V.ele.DAT.3.PL+PQP+3+SG
colorara-lo	colorar+V.ele.ACC.3.M.SG+PQP+2+SG
colorara-los	colorar+V.ele.ACC.3.M.PL+PQP+2+SG
colorara-me	colorar+V.eu.AD.1.SG+PQP+1+SG
colorara-me	colorar+V.eu.AD.1.SG+PQP+3+SG
coloraram-lhe	colorar+V.ele.DAT.3.SG+PQP+3+PL
coloraram-lhe	colorar+V.ele.DAT.3.SG+PRF+3+PL
coloraram-lhes	colorar+V.ele.DAT.3.PL+PQP+3+PL
coloraram-lhes	colorar+V.ele.DAT.3.PL+PRF+3+PL
coloraram-me	colorar+V.eu.AD.1.SG+PQP+3+PL
coloraram-me	colorar+V.eu.AD.1.SG+PRF+3+PL
coloraram-na	colorar+V.ele.ACC.3.F.SG+PQP+3+PL
coloraram-na	colorar+V.ele.ACC.3.F.SG+PRF+3+PL
coloraram-nas	colorar+V.ele.ACC.3.F.PL+PQP+3+PL
coloraram-nas	colorar+V.ele.ACC.3.F.PL+PRF+3+PL
coloraram-no	colorar+V.ele.ACC.3.M.SG+PQP+3+PL
coloraram-no	colorar+V.ele.ACC.3.M.SG+PRF+3+PL
coloraram-nos	colorar+V.ele.ACC.3.M.PL+PQP+3+PL
coloraram-nos	colorar+V.ele.ACC.3.M.PL+PRF+3+PL
coloraram-nos	colorar+V.nós.AD.1.PL+PQP+3+PL
coloraram-nos	colorar+V.nós.AD.1.PL+PRF+3+PL
coloráramo-la	colorar+V.ele.ACC.3.F.SG+PQP+1+PL
coloráramo-las	colorar+V.ele.ACC.3.F.PL+PQP+1+PL
coloráramo-lo	colorar+V.ele.ACC.3.M.SG+PQP+1+PL
coloráramo-los	colorar+V.ele.ACC.3.M.PL+PQP+1+PL
coloráramo-nos	colorar+nós.AD.1.PL+PQP+1+PL
coloráramos-lhe	colorar+V.ele.DAT.3.SG+PQP+1+PL
coloráramos-lhes	colorar+V.ele.DAT.3.PL+PQP+1+PL
coloráramos-me	colorar+V.eu.AD.1.SG+PQP+1+PL
coloráramos-te	colorar+V.tu.AD.2.SG+PQP+1+PL
coloráramos-vos	colorar+V.vós.AD.2.PL+PQP+1+PL
coloraram-se	colorar+V.ele.REFL+PQP+3+PL
coloraram-se	colorar+V.ele.REFL+PRF+3+PL
coloraram-te	colorar+V.tu.AD.2.SG+PQP+3+PL
coloraram-te	colorar+V.tu.AD.2.SG+PRF+3+PL
coloraram-vos	colorar+V.vós.AD.2.PL+PQP+3+PL
coloraram-vos	colorar+V.vós.AD.2.PL+PRF+3+PL
colorara-nos	colorar+nós.AD.1.PL+PQP+1+SG
colorara-nos	colorar+nós.AD.1.PL+PQP+2+SG
colorara-nos	colorar+nós.AD.1.PL+PQP+3+SG
colorara-o	colorar+V.ele.ACC.3.M.SG+PQP+1+SG
colorara-o	colorar+V.ele.ACC.3.M.SG+PQP+3+SG
colorara-os	colorar+V.ele.ACC.3.M.PL+PQP+1+SG
colorara-os	colorar+V.ele.ACC.3.M.PL+PQP+3+SG
colorara-se	colorar+V.ele.REFL+PQP+1+SG
colorara-se	colorar+V.ele.REFL+PQP+3+SG
coloraras-lhe	colorar+V.ele.DAT.3.SG+PQP+2+SG
coloraras-lhes	colorar+V.ele.DAT.3.PL+PQP+2+SG
coloraras-me	colorar+V.eu.AD.1.SG+PQP+2+SG
coloraras-te	colorar+V.tu.AD.2.SG+PQP+2+SG
coloraras-vos	colorar+V.vós.AD.2.PL+PQP+2+SG
colorara-te	colorar+V.tu.AD.2.SG+PQP+1+SG
colorara-te	colorar+V.tu.AD.2.SG+PQP+3+SG
colorara-vos	colorar+V.vós.AD.2.PL+PQP+1+SG
colorara-vos	colorar+V.vós.AD.2.PL+PQP+3+SG
colorarde-la	colorar+V.ele.ACC.3.F.SG+INF+2+PL
colorarde-la	colorar+V.ele.ACC.3.F.SG+SBJF+2+PL
colorarde-las	colorar+V.ele.ACC.3.F.PL+INF+2+PL
colorarde-las	colorar+V.ele.ACC.3.F.PL+SBJF+2+PL
colorarde-lo	colorar+V.ele.ACC.3.M.SG+INF+2+PL
colorarde-lo	colorar+V.ele.ACC.3.M.SG+SBJF+2+PL
colorarde-los	colorar+V.ele.ACC.3.M.PL+INF+2+PL
colorarde-los	colorar+V.ele.ACC.3.M.PL+SBJF+2+PL
colorarde-nos	colorar+nós.AD.1.PL+INF+2+PL
colorarde-nos	colorar+nós.AD.1.PL+SBJF+2+PL
colorardes-lhe	colorar+V.ele.DAT.3.SG+INF+2+PL
colorardes-lhe	colorar+V.ele.DAT.3.SG+SBJF+2+PL
colorardes-lhes	colorar+V.ele.DAT.3.PL+INF+2+PL
colorardes-lhes	colorar+V.ele.DAT.3.PL+SBJF+2+PL
colorardes-me	colorar+V.eu.AD.1.SG+INF+2+PL
colorardes-me	colorar+V.eu.AD.1.SG+SBJF+2+PL
colorardes-te	colorar+V.tu.AD.2.SG+INF+2+PL
colorardes-te	colorar+V.tu.AD.2.SG+SBJF+2+PL
colorardes-vos	colorar+V.vós.AD.2.PL+INF+2+PL
colorardes-vos	colorar+V.vós.AD.2.PL+SBJF+2+PL
colorárei-la	colorar+V.ele.ACC.3.F.SG+PQP+2+PL
colorárei-las	colorar+V.ele.ACC.3.F.PL+PQP+2+PL
colorárei-lo	colorar+V.ele.ACC.3.M.SG+PQP+2+PL
colorárei-los	colorar+V.ele.ACC.3.M.PL+PQP+2+PL
colorárei-nos	colorar+nós.AD.1.PL+PQP+2+PL
coloráreis-lhe	colorar+V.ele.DAT.3.SG+PQP+2+PL
coloráreis-lhes	colorar+V.ele.DAT.3.PL+PQP+2+PL
coloráreis-me	colorar+V.eu.AD.1.SG+PQP+2+PL
coloráreis-te	colorar+V.tu.AD.2.SG+PQP+2+PL
coloráreis-vos	colorar+V.vós.AD.2.PL+PQP+2+PL
