constipava-me	constipar+V.eu.AD.1.SG+IMPF+3+SG
constipavam-lhe	constipar+V.ele.DAT.3.SG+IMPF+3+PL
constipavam-lhes	constipar+V.ele.DAT.3.PL+IMPF+3+PL
constipavam-me	constipar+V.eu.AD.1.SG+IMPF+3+PL
constipavam-na	constipar+V.ele.ACC.3.F.SG+IMPF+3+PL
constipavam-nas	constipar+V.ele.ACC.3.F.PL+IMPF+3+PL
constipavam-no	constipar+V.ele.ACC.3.M.SG+IMPF+3+PL
constipavam-nos	constipar+V.ele.ACC.3.M.PL+IMPF+3+PL
constipavam-nos	constipar+V.nós.AD.1.PL+IMPF+3+PL
constipávamo-la	constipar+V.ele.ACC.3.F.SG+IMPF+1+PL
constipávamo-las	constipar+V.ele.ACC.3.F.PL+IMPF+1+PL
constipávamo-lo	constipar+V.ele.ACC.3.M.SG+IMPF+1+PL
constipávamo-los	constipar+V.ele.ACC.3.M.PL+IMPF+1+PL
constipávamo-nos	constipar+nós.AD.1.PL+IMPF+1+PL
constipávamos-lhe	constipar+V.ele.DAT.3.SG+IMPF+1+PL
constipávamos-lhes	constipar+V.ele.DAT.3.PL+IMPF+1+PL
constipávamos-me	constipar+V.eu.AD.1.SG+IMPF+1+PL
constipávamos-te	constipar+V.tu.AD.2.SG+IMPF+1+PL
constipávamos-vos	constipar+V.vós.AD.2.PL+IMPF+1+PL
constipavam-se	constipar+V.ele.REFL+IMPF+3+PL
constipavam-te	constipar+V.tu.AD.2.SG+IMPF+3+PL
constipavam-vos	constipar+V.vós.AD.2.PL+IMPF+3+PL
constipava-nos	constipar+nós.AD.1.PL+IMPF+1+SG
constipava-nos	constipar+nós.AD.1.PL+IMPF+2+SG
constipava-nos	constipar+nós.AD.1.PL+IMPF+3+SG
constipava-o	constipar+V.ele.ACC.3.M.SG+IMPF+1+SG
constipava-o	constipar+V.ele.ACC.3.M.SG+IMPF+3+SG
constipava-os	constipar+V.ele.ACC.3.M.PL+IMPF+1+SG
constipava-os	constipar+V.ele.ACC.3.M.PL+IMPF+3+SG
constipava-se	constipar+V.ele.REFL+IMPF+1+SG
constipava-se	constipar+V.ele.REFL+IMPF+3+SG
constipavas-lhe	constipar+V.ele.DAT.3.SG+IMPF+2+SG
constipavas-lhes	constipar+V.ele.DAT.3.PL+IMPF+2+SG
constipavas-me	constipar+V.eu.AD.1.SG+IMPF+2+SG
constipavas-te	constipar+V.tu.AD.2.SG+IMPF+2+SG
constipavas-vos	constipar+V.vós.AD.2.PL+IMPF+2+SG
constipava-te	constipar+V.tu.AD.2.SG+IMPF+1+SG
constipava-te	constipar+V.tu.AD.2.SG+IMPF+3+SG
constipava-vos	constipar+V.vós.AD.2.PL+IMPF+1+SG
constipava-vos	constipar+V.vós.AD.2.PL+IMPF+3+SG
constipávei-la	constipar+V.ele.ACC.3.F.SG+IMPF+2+PL
constipávei-las	constipar+V.ele.ACC.3.F.PL+IMPF+2+PL
constipávei-lo	constipar+V.ele.ACC.3.M.SG+IMPF+2+PL
constipávei-los	constipar+V.ele.ACC.3.M.PL+IMPF+2+PL
constipávei-nos	constipar+nós.AD.1.PL+IMPF+2+PL
constipáveis-lhe	constipar+V.ele.DAT.3.SG+IMPF+2+PL
constipáveis-lhes	constipar+V.ele.DAT.3.PL+IMPF+2+PL
constipáveis-me	constipar+V.eu.AD.1.SG+IMPF+2+PL
constipáveis-te	constipar+V.tu.AD.2.SG+IMPF+2+PL
constipáveis-vos	constipar+V.vós.AD.2.PL+IMPF+2+PL
constipa-vos	constipar+V.vós.AD.2.PL+PRS+3+SG
constipe-a	constipar+V.ele.ACC.3.F.SG+IMP+3+SG
constipe-as	constipar+V.ele.ACC.3.F.PL+IMP+3+SG
constipei-a	constipar+V.ele.ACC.3.F.SG+PRF+1+SG
constipei-as	constipar+V.ele.ACC.3.F.PL+PRF+1+SG
constipei-lhe	constipar+V.ele.DAT.3.SG+PRF+1+SG
constipei-lhes	constipar+V.ele.DAT.3.PL+PRF+1+SG
constipei-me	constipar+V.eu.AD.1.SG+PRF+1+SG
constipei-nos	constipar+nós.AD.1.PL+PRF+1+SG
constipei-o	constipar+V.ele.ACC.3.M.SG+PRF+1+SG
constipei-os	constipar+V.ele.ACC.3.M.PL+PRF+1+SG
constipei-te	constipar+V.tu.AD.2.SG+PRF+1+SG
constipei-vos	constipar+V.vós.AD.2.PL+PRF+1+SG
constipe-lhe	constipar+V.ele.DAT.3.SG+IMP+3+SG
constipe-lhes	constipar+V.ele.DAT.3.PL+IMP+3+SG
constipe-me	constipar+V.eu.AD.1.SG+IMP+3+SG
constipem-lhe	constipar+V.ele.DAT.3.SG+IMP+3+PL
constipem-lhes	constipar+V.ele.DAT.3.PL+IMP+3+PL
constipem-me	constipar+V.eu.AD.1.SG+IMP+3+PL
constipem-na	constipar+V.ele.ACC.3.F.SG+IMP+3+PL
constipem-nas	constipar+V.ele.ACC.3.F.PL+IMP+3+PL
constipem-no	constipar+V.ele.ACC.3.M.SG+IMP+3+PL
constipem-nos	constipar+V.ele.ACC.3.M.PL+IMP+3+PL
constipem-nos	constipar+V.nós.AD.1.PL+IMP+3+PL
constipemo-la	constipar+V.ele.ACC.3.F.SG+IMP+1+PL
constipemo-las	constipar+V.ele.ACC.3.F.PL+IMP+1+PL
constipemo-lo	constipar+V.ele.ACC.3.M.SG+IMP+1+PL
constipemo-los	constipar+V.ele.ACC.3.M.PL+IMP+1+PL
constipemo-nos	constipar+nós.AD.1.PL+IMP+1+PL
constipemos-lhe	constipar+V.ele.DAT.3.SG+IMP+1+PL
constipemos-lhes	constipar+V.ele.DAT.3.PL+IMP+1+PL
constipemos-me	constipar+V.eu.AD.1.SG+IMP+1+PL
constipemos-te	constipar+V.tu.AD.2.SG+IMP+1+PL
constipemos-vos	constipar+V.vós.AD.2.PL+IMP+1+PL
constipem-se	constipar+V.ele.REFL+IMP+3+PL
constipem-te	constipar+V.tu.AD.2.SG+IMP+3+PL
constipem-vos	constipar+V.vós.AD.2.PL+IMP+3+PL
constipe-nos	constipar+nós.AD.1.PL+IMP+3+SG
constipe-o	constipar+V.ele.ACC.3.M.SG+IMP+3+SG
constipe-os	constipar+V.ele.ACC.3.M.PL+IMP+3+SG
constipe-se	constipar+V.ele.REFL+IMP+3+SG
constipe-te	constipar+V.tu.AD.2.SG+IMP+3+SG
constipe-vos	constipar+V.vós.AD.2.PL+IMP+3+SG
constipo-a	constipar+V.ele.ACC.3.F.SG+PRS+1+SG
constipo-as	constipar+V.ele.ACC.3.F.PL+PRS+1+SG
constipo-lhe	constipar+V.ele.DAT.3.SG+PRS+1+SG
constipo-lhes	constipar+V.ele.DAT.3.PL+PRS+1+SG
constipo-me	constipar+V.eu.AD.1.SG+PRS+1+SG
constipo-nos	constipar+nós.AD.1.PL+PRS+1+SG
constipo-o	constipar+V.ele.ACC.3.M.SG+PRS+1+SG
constipo-os	constipar+V.ele.ACC.3.M.PL+PRS+1+SG
constipo-te	constipar+V.tu.AD.2.SG+PRS+1+SG
constipou-a	constipar+V.ele.ACC.3.F.SG+PRF+3+SG
constipou-as	constipar+V.ele.ACC.3.F.PL+PRF+3+SG
constipou-lhe	constipar+V.ele.DAT.3.SG+PRF+3+SG
constipou-lhes	constipar+V.ele.DAT.3.PL+PRF+3+SG
constipou-me	constipar+V.eu.AD.1.SG+PRF+3+SG
constipou-nos	constipar+nós.AD.1.PL+PRF+3+SG
constipou-o	constipar+V.ele.ACC.3.M.SG+PRF+3+SG
constipou-os	constipar+V.ele.ACC.3.M.PL+PRF+3+SG
constipou-se	constipar+V.ele.REFL+PRF+3+SG
constipou-te	constipar+V.tu.AD.2.SG+PRF+3+SG
constipou-vos	constipar+V.vós.AD.2.PL+PRF+3+SG
constipo-vos	constipar+V.vós.AD.2.PL+PRS+1+SG
constitua-a	constituir+V.ele.ACC.3.F.SG+IMP+3+SG
constitua-as	constituir+V.ele.ACC.3.F.PL+IMP+3+SG
constitua-lhe	constituir+V.ele.DAT.3.SG+IMP+3+SG
constitua-lhes	constituir+V.ele.DAT.3.PL+IMP+3+SG
constitua-me	constituir+V.eu.AD.1.SG+IMP+3+SG
constituam-lhe	constituir+V.ele.DAT.3.SG+IMP+3+PL
constituam-lhes	constituir+V.ele.DAT.3.PL+IMP+3+PL
constituam-me	constituir+V.eu.AD.1.SG+IMP+3+PL
constituam-na	constituir+V.ele.ACC.3.F.SG+IMP+3+PL
constituam-nas	constituir+V.ele.ACC.3.F.PL+IMP+3+PL
constituam-no	constituir+V.ele.ACC.3.M.SG+IMP+3+PL
constituam-nos	constituir+V.ele.ACC.3.M.PL+IMP+3+PL
constituam-nos	constituir+V.nós.AD.1.PL+IMP+3+PL
constituamo-la	constituir+V.ele.ACC.3.F.SG+IMP+1+PL
constituamo-las	constituir+V.ele.ACC.3.F.PL+IMP+1+PL
constituamo-lo	constituir+V.ele.ACC.3.M.SG+IMP+1+PL
constituamo-los	constituir+V.ele.ACC.3.M.PL+IMP+1+PL
constituamo-nos	constituir+nós.AD.1.PL+IMP+1+PL
constituamos-lhe	constituir+V.ele.DAT.3.SG+IMP+1+PL
constituamos-lhes	constituir+V.ele.DAT.3.PL+IMP+1+PL
constituamos-me	constituir+V.eu.AD.1.SG+IMP+1+PL
constituamos-te	constituir+V.tu.AD.2.SG+IMP+1+PL
constituamos-vos	constituir+V.vós.AD.2.PL+IMP+1+PL
constituam-se	constituir+V.ele.REFL+IMP+3+PL
constituam-te	constituir+V.tu.AD.2.SG+IMP+3+PL
constituam-vos	constituir+V.vós.AD.2.PL+IMP+3+PL
constitua-nos	constituir+nós.AD.1.PL+IMP+3+SG
constitua-o	constituir+V.ele.ACC.3.M.SG+IMP+3+SG
constitua-os	constituir+V.ele.ACC.3.M.PL+IMP+3+SG
constitua-se	constituir+V.ele.REFL+IMP+3+SG
constitua-te	constituir+V.tu.AD.2.SG+IMP+3+SG
constitua-vos	constituir+V.vós.AD.2.PL+IMP+3+SG
constitucionaliza-a	constitucionalizar+V.ele.ACC.3.F.SG+PRS+3+SG
constitucionaliza-as	constitucionalizar+V.ele.ACC.3.F.PL+PRS+3+SG
constitucionalizai-la	constitucionalizar+V.ele.ACC.3.F.SG+PRS+2+PL
constitucionalizai-las	constitucionalizar+V.ele.ACC.3.F.PL+PRS+2+PL
constitucionalizai-lo	constitucionalizar+V.ele.ACC.3.M.SG+PRS+2+PL
constitucionalizai-los	constitucionalizar+V.ele.ACC.3.M.PL+PRS+2+PL
constitucionalizai-nos	constitucionalizar+nós.AD.1.PL+PRS+2+PL
constitucionalizais-lhe	constitucionalizar+V.ele.DAT.3.SG+PRS+2+PL
constitucionalizais-lhes	constitucionalizar+V.ele.DAT.3.PL+PRS+2+PL
constitucionalizais-me	constitucionalizar+V.eu.AD.1.SG+PRS+2+PL
constitucionalizais-te	constitucionalizar+V.tu.AD.2.SG+PRS+2+PL
constitucionalizais-vos	constitucionalizar+V.vós.AD.2.PL+PRS+2+PL
constitucionalizá-la-á	constitucionalizar+V.ele.ACC.3.F.SG+FUT+3+SG
constitucionalizá-la-ão	constitucionalizar+V.ele.ACC.3.F.SG+FUT+3+PL
constitucionalizá-la-ás	constitucionalizar+V.ele.ACC.3.F.SG+FUT+2+SG
constitucionalizá-la	constitucionalizar+V.ele.ACC.3.F.SG+INF+1+SG
constitucionalizá-la	constitucionalizar+V.ele.ACC.3.F.SG+INF+3+SG
constitucionaliza-la	constitucionalizar+V.ele.ACC.3.F.SG+PRS+2+SG
constitucionalizá-la	constitucionalizar+V.ele.ACC.3.F.SG+SBJF+1+SG
constitucionalizá-la	constitucionalizar+V.ele.ACC.3.F.SG+SBJF+3+SG
constitucionalizá-la-ei	constitucionalizar+V.ele.ACC.3.F.SG+FUT+1+SG
constitucionalizá-la-eis	constitucionalizar+V.ele.ACC.3.F.SG+FUT+2+PL
constitucionalizá-la-emos	constitucionalizar+V.ele.ACC.3.F.SG+FUT+1+PL
constitucionalizá-la-ia	constitucionalizar+V.ele.ACC.3.F.SG+COND+1+SG
constitucionalizá-la-ia	constitucionalizar+V.ele.ACC.3.F.SG+COND+3+SG
constitucionalizá-la-iam	constitucionalizar+V.ele.ACC.3.F.SG+COND+3+PL
constitucionalizá-la-íamos	constitucionalizar+V.ele.ACC.3.F.SG+COND+1+PL
constitucionalizá-la-ias	constitucionalizar+V.ele.ACC.3.F.SG+COND+2+SG
constitucionalizá-la-íeis	constitucionalizar+V.ele.ACC.3.F.SG+COND+2+PL
constitucionalizá-las-á	constitucionalizar+V.ele.ACC.3.F.PL+FUT+3+SG
constitucionalizá-las-ão	constitucionalizar+V.ele.ACC.3.F.PL+FUT+3+PL
constitucionalizá-las-ás	constitucionalizar+V.ele.ACC.3.F.PL+FUT+2+SG
constitucionalizá-las	constitucionalizar+V.ele.ACC.3.F.PL+INF+1+SG
constitucionalizá-las	constitucionalizar+V.ele.ACC.3.F.PL+INF+3+SG
constitucionaliza-las	constitucionalizar+V.ele.ACC.3.F.PL+PRS+2+SG
constitucionalizá-las	constitucionalizar+V.ele.ACC.3.F.PL+SBJF+1+SG
constitucionalizá-las	constitucionalizar+V.ele.ACC.3.F.PL+SBJF+3+SG
constitucionalizá-las-ei	constitucionalizar+V.ele.ACC.3.F.PL+FUT+1+SG
constitucionalizá-las-eis	constitucionalizar+V.ele.ACC.3.F.PL+FUT+2+PL
constitucionalizá-las-emos	constitucionalizar+V.ele.ACC.3.F.PL+FUT+1+PL
constitucionalizá-las-ia	constitucionalizar+V.ele.ACC.3.F.PL+COND+1+SG
constitucionalizá-las-ia	constitucionalizar+V.ele.ACC.3.F.PL+COND+3+SG
constitucionalizá-las-iam	constitucionalizar+V.ele.ACC.3.F.PL+COND+3+PL
constitucionalizá-las-íamos	constitucionalizar+V.ele.ACC.3.F.PL+COND+1+PL
constitucionalizá-las-ias	constitucionalizar+V.ele.ACC.3.F.PL+COND+2+SG
constitucionalizá-las-íeis	constitucionalizar+V.ele.ACC.3.F.PL+COND+2+PL
constitucionaliza-lhe	constitucionalizar+V.ele.DAT.3.SG+PRS+3+SG
constitucionaliza-lhes	constitucionalizar+V.ele.DAT.3.PL+PRS+3+SG
constitucionalizá-lo-á	constitucionalizar+V.ele.ACC.3.M.SG+FUT+3+SG
constitucionalizá-lo-ão	constitucionalizar+V.ele.ACC.3.M.SG+FUT+3+PL
constitucionalizá-lo-ás	constitucionalizar+V.ele.ACC.3.M.SG+FUT+2+SG
constitucionalizá-lo	constitucionalizar+V.ele.ACC.3.M.SG+INF+1+SG
constitucionalizá-lo	constitucionalizar+V.ele.ACC.3.M.SG+INF+3+SG
constitucionaliza-lo	constitucionalizar+V.ele.ACC.3.M.SG+PRS+2+SG
constitucionalizá-lo	constitucionalizar+V.ele.ACC.3.M.SG+SBJF+1+SG
constitucionalizá-lo	constitucionalizar+V.ele.ACC.3.M.SG+SBJF+3+SG
constitucionalizá-lo-ei	constitucionalizar+V.ele.ACC.3.M.SG+FUT+1+SG
constitucionalizá-lo-eis	constitucionalizar+V.ele.ACC.3.M.SG+FUT+2+PL
constitucionalizá-lo-emos	constitucionalizar+V.ele.ACC.3.M.SG+FUT+1+PL
constitucionalizá-lo-ia	constitucionalizar+V.ele.ACC.3.M.SG+COND+1+SG
constitucionalizá-lo-ia	constitucionalizar+V.ele.ACC.3.M.SG+COND+3+SG
constitucionalizá-lo-iam	constitucionalizar+V.ele.ACC.3.M.SG+COND+3+PL
constitucionalizá-lo-íamos	constitucionalizar+V.ele.ACC.3.M.SG+COND+1+PL
constitucionalizá-lo-ias	constitucionalizar+V.ele.ACC.3.M.SG+COND+2+SG
constitucionalizá-lo-íeis	constitucionalizar+V.ele.ACC.3.M.SG+COND+2+PL
constitucionalizá-los-á	constitucionalizar+V.ele.ACC.3.M.PL+FUT+3+SG
constitucionalizá-los-ão	constitucionalizar+V.ele.ACC.3.M.PL+FUT+3+PL
constitucionalizá-los-ás	constitucionalizar+V.ele.ACC.3.M.PL+FUT+2+SG
constitucionalizá-los	constitucionalizar+V.ele.ACC.3.M.PL+INF+1+SG
constitucionalizá-los	constitucionalizar+V.ele.ACC.3.M.PL+INF+3+SG
constitucionaliza-los	constitucionalizar+V.ele.ACC.3.M.PL+PRS+2+SG
constitucionalizá-los	constitucionalizar+V.ele.ACC.3.M.PL+SBJF+1+SG
constitucionalizá-los	constitucionalizar+V.ele.ACC.3.M.PL+SBJF+3+SG
constitucionalizá-los-ei	constitucionalizar+V.ele.ACC.3.M.PL+FUT+1+SG
constitucionalizá-los-eis	constitucionalizar+V.ele.ACC.3.M.PL+FUT+2+PL
constitucionalizá-los-emos	constitucionalizar+V.ele.ACC.3.M.PL+FUT+1+PL
constitucionalizá-los-ia	constitucionalizar+V.ele.ACC.3.M.PL+COND+1+SG
constitucionalizá-los-ia	constitucionalizar+V.ele.ACC.3.M.PL+COND+3+SG
constitucionalizá-los-iam	constitucionalizar+V.ele.ACC.3.M.PL+COND+3+PL
constitucionalizá-los-íamos	constitucionalizar+V.ele.ACC.3.M.PL+COND+1+PL
constitucionalizá-los-ias	constitucionalizar+V.ele.ACC.3.M.PL+COND+2+SG
constitucionalizá-los-íeis	constitucionalizar+V.ele.ACC.3.M.PL+COND+2+PL
constitucionaliza-me	constitucionalizar+V.eu.AD.1.SG+PRS+3+SG
constitucionalizam-lhe	constitucionalizar+V.ele.DAT.3.SG+PRS+3+PL
constitucionalizam-lhes	constitucionalizar+V.ele.DAT.3.PL+PRS+3+PL
constitucionalizam-me	constitucionalizar+V.eu.AD.1.SG+PRS+3+PL
constitucionalizam-na	constitucionalizar+V.ele.ACC.3.F.SG+PRS+3+PL
constitucionalizam-nas	constitucionalizar+V.ele.ACC.3.F.PL+PRS+3+PL
constitucionalizam-no	constitucionalizar+V.ele.ACC.3.M.SG+PRS+3+PL
constitucionalizam-nos	constitucionalizar+V.ele.ACC.3.M.PL+PRS+3+PL
constitucionalizam-nos	constitucionalizar+V.nós.AD.1.PL+PRS+3+PL
constitucionalizamo-la	constitucionalizar+V.ele.ACC.3.F.SG+PRF+1+PL
constitucionalizamo-la	constitucionalizar+V.ele.ACC.3.F.SG+PRS+1+PL
constitucionalizamo-las	constitucionalizar+V.ele.ACC.3.F.PL+PRF+1+PL
constitucionalizamo-las	constitucionalizar+V.ele.ACC.3.F.PL+PRS+1+PL
constitucionalizamo-lo	constitucionalizar+V.ele.ACC.3.M.SG+PRF+1+PL
constitucionalizamo-lo	constitucionalizar+V.ele.ACC.3.M.SG+PRS+1+PL
constitucionalizamo-los	constitucionalizar+V.ele.ACC.3.M.PL+PRF+1+PL
constitucionalizamo-los	constitucionalizar+V.ele.ACC.3.M.PL+PRS+1+PL
constitucionalizamo-nos	constitucionalizar+nós.AD.1.PL+PRF+1+PL
constitucionalizamo-nos	constitucionalizar+nós.AD.1.PL+PRS+1+PL
constitucionalizamos-lhe	constitucionalizar+V.ele.DAT.3.SG+PRF+1+PL
constitucionalizamos-lhe	constitucionalizar+V.ele.DAT.3.SG+PRS+1+PL
constitucionalizamos-lhes	constitucionalizar+V.ele.DAT.3.PL+PRF+1+PL
constitucionalizamos-lhes	constitucionalizar+V.ele.DAT.3.PL+PRS+1+PL
constitucionalizamos-me	constitucionalizar+V.eu.AD.1.SG+PRF+1+PL
constitucionalizamos-me	constitucionalizar+V.eu.AD.1.SG+PRS+1+PL
constitucionalizamos-te	constitucionalizar+V.tu.AD.2.SG+PRF+1+PL
constitucionalizamos-te	constitucionalizar+V.tu.AD.2.SG+PRS+1+PL
constitucionalizamos-vos	constitucionalizar+V.vós.AD.2.PL+PRF+1+PL
constitucionalizamos-vos	constitucionalizar+V.vós.AD.2.PL+PRS+1+PL
constitucionalizam-se	constitucionalizar+V.ele.REFL+PRS+3+PL
constitucionalizam-te	constitucionalizar+V.tu.AD.2.SG+PRS+3+PL
constitucionalizam-vos	constitucionalizar+V.vós.AD.2.PL+PRS+3+PL
constitucionalizando-a	constitucionalizar+V.ele.ACC.3.F.SG+GRD
constitucionalizando-as	constitucionalizar+V.ele.ACC.3.F.PL+GRD
constitucionalizando-lhe	constitucionalizar+V.ele.DAT.3.SG+GRD
constitucionalizando-lhes	constitucionalizar+V.ele.DAT.3.PL+GRD
constitucionalizando-me	constitucionalizar+V.eu.AD.1.SG+GRD
constitucionalizando-nos	constitucionalizar+nós.AD.1.PL+GRD
constitucionalizando-o	constitucionalizar+V.ele.ACC.3.M.SG+GRD
constitucionalizando-os	constitucionalizar+V.ele.ACC.3.M.PL+GRD
constitucionalizando-se	constitucionalizar+V.ele.REFL+GRD
constitucionalizando-te	constitucionalizar+V.tu.AD.2.SG+GRD
constitucionalizando-vos	constitucionalizar+V.vós.AD.2.PL+GRD
constitucionaliza-nos	constitucionalizar+nós.AD.1.PL+PRS+2+SG
constitucionaliza-nos	constitucionalizar+nós.AD.1.PL+PRS+3+SG
constitucionaliza-o	constitucionalizar+V.ele.ACC.3.M.SG+PRS+3+SG
constitucionaliza-os	constitucionalizar+V.ele.ACC.3.M.PL+PRS+3+SG
constitucionalizara-a	constitucionalizar+V.ele.ACC.3.F.SG+PQP+1+SG
constitucionalizara-a	constitucionalizar+V.ele.ACC.3.F.SG+PQP+3+SG
constitucionalizara-as	constitucionalizar+V.ele.ACC.3.F.PL+PQP+1+SG
constitucionalizara-as	constitucionalizar+V.ele.ACC.3.F.PL+PQP+3+SG
constitucionalizara-la	constitucionalizar+V.ele.ACC.3.F.SG+PQP+2+SG
constitucionalizara-las	constitucionalizar+V.ele.ACC.3.F.PL+PQP+2+SG
constitucionalizara-lhe	constitucionalizar+V.ele.DAT.3.SG+PQP+1+SG
constitucionalizara-lhe	constitucionalizar+V.ele.DAT.3.SG+PQP+3+SG
constitucionalizara-lhes	constitucionalizar+V.ele.DAT.3.PL+PQP+1+SG
constitucionalizara-lhes	constitucionalizar+V.ele.DAT.3.PL+PQP+3+SG
constitucionalizara-lo	constitucionalizar+V.ele.ACC.3.M.SG+PQP+2+SG
constitucionalizara-los	constitucionalizar+V.ele.ACC.3.M.PL+PQP+2+SG
constitucionalizara-me	constitucionalizar+V.eu.AD.1.SG+PQP+1+SG
constitucionalizara-me	constitucionalizar+V.eu.AD.1.SG+PQP+3+SG
constitucionalizaram-lhe	constitucionalizar+V.ele.DAT.3.SG+PQP+3+PL
constitucionalizaram-lhe	constitucionalizar+V.ele.DAT.3.SG+PRF+3+PL
constitucionalizaram-lhes	constitucionalizar+V.ele.DAT.3.PL+PQP+3+PL
constitucionalizaram-lhes	constitucionalizar+V.ele.DAT.3.PL+PRF+3+PL
constitucionalizaram-me	constitucionalizar+V.eu.AD.1.SG+PQP+3+PL
constitucionalizaram-me	constitucionalizar+V.eu.AD.1.SG+PRF+3+PL
constitucionalizaram-na	constitucionalizar+V.ele.ACC.3.F.SG+PQP+3+PL
constitucionalizaram-na	constitucionalizar+V.ele.ACC.3.F.SG+PRF+3+PL
constitucionalizaram-nas	constitucionalizar+V.ele.ACC.3.F.PL+PQP+3+PL
constitucionalizaram-nas	constitucionalizar+V.ele.ACC.3.F.PL+PRF+3+PL
constitucionalizaram-no	constitucionalizar+V.ele.ACC.3.M.SG+PQP+3+PL
constitucionalizaram-no	constitucionalizar+V.ele.ACC.3.M.SG+PRF+3+PL
constitucionalizaram-nos	constitucionalizar+V.ele.ACC.3.M.PL+PQP+3+PL
constitucionalizaram-nos	constitucionalizar+V.ele.ACC.3.M.PL+PRF+3+PL
constitucionalizaram-nos	constitucionalizar+V.nós.AD.1.PL+PQP+3+PL
constitucionalizaram-nos	constitucionalizar+V.nós.AD.1.PL+PRF+3+PL
constitucionalizáramo-la	constitucionalizar+V.ele.ACC.3.F.SG+PQP+1+PL
constitucionalizáramo-las	constitucionalizar+V.ele.ACC.3.F.PL+PQP+1+PL
constitucionalizáramo-lo	constitucionalizar+V.ele.ACC.3.M.SG+PQP+1+PL
constitucionalizáramo-los	constitucionalizar+V.ele.ACC.3.M.PL+PQP+1+PL
constitucionalizáramo-nos	constitucionalizar+nós.AD.1.PL+PQP+1+PL
constitucionalizáramos-lhe	constitucionalizar+V.ele.DAT.3.SG+PQP+1+PL
constitucionalizáramos-lhes	constitucionalizar+V.ele.DAT.3.PL+PQP+1+PL
constitucionalizáramos-me	constitucionalizar+V.eu.AD.1.SG+PQP+1+PL
constitucionalizáramos-te	constitucionalizar+V.tu.AD.2.SG+PQP+1+PL
constitucionalizáramos-vos	constitucionalizar+V.vós.AD.2.PL+PQP+1+PL
constitucionalizaram-se	constitucionalizar+V.ele.REFL+PQP+3+PL
constitucionalizaram-se	constitucionalizar+V.ele.REFL+PRF+3+PL
constitucionalizaram-te	constitucionalizar+V.tu.AD.2.SG+PQP+3+PL
constitucionalizaram-te	constitucionalizar+V.tu.AD.2.SG+PRF+3+PL
constitucionalizaram-vos	constitucionalizar+V.vós.AD.2.PL+PQP+3+PL
constitucionalizaram-vos	constitucionalizar+V.vós.AD.2.PL+PRF+3+PL
constitucionalizara-nos	constitucionalizar+nós.AD.1.PL+PQP+1+SG
constitucionalizara-nos	constitucionalizar+nós.AD.1.PL+PQP+2+SG
constitucionalizara-nos	constitucionalizar+nós.AD.1.PL+PQP+3+SG
constitucionalizara-o	constitucionalizar+V.ele.ACC.3.M.SG+PQP+1+SG
constitucionalizara-o	constitucionalizar+V.ele.ACC.3.M.SG+PQP+3+SG
constitucionalizara-os	constitucionalizar+V.ele.ACC.3.M.PL+PQP+1+SG
constitucionalizara-os	constitucionalizar+V.ele.ACC.3.M.PL+PQP+3+SG
constitucionalizara-se	constitucionalizar+V.ele.REFL+PQP+1+SG
constitucionalizara-se	constitucionalizar+V.ele.REFL+PQP+3+SG
constitucionalizaras-lhe	constitucionalizar+V.ele.DAT.3.SG+PQP+2+SG
constitucionalizaras-lhes	constitucionalizar+V.ele.DAT.3.PL+PQP+2+SG
constitucionalizaras-me	constitucionalizar+V.eu.AD.1.SG+PQP+2+SG
constitucionalizaras-te	constitucionalizar+V.tu.AD.2.SG+PQP+2+SG
constitucionalizaras-vos	constitucionalizar+V.vós.AD.2.PL+PQP+2+SG
constitucionalizara-te	constitucionalizar+V.tu.AD.2.SG+PQP+1+SG
constitucionalizara-te	constitucionalizar+V.tu.AD.2.SG+PQP+3+SG
constitucionalizara-vos	constitucionalizar+V.vós.AD.2.PL+PQP+1+SG
constitucionalizara-vos	constitucionalizar+V.vós.AD.2.PL+PQP+3+SG
constitucionalizarde-la	constitucionalizar+V.ele.ACC.3.F.SG+INF+2+PL
constitucionalizarde-la	constitucionalizar+V.ele.ACC.3.F.SG+SBJF+2+PL
constitucionalizarde-las	constitucionalizar+V.ele.ACC.3.F.PL+INF+2+PL
constitucionalizarde-las	constitucionalizar+V.ele.ACC.3.F.PL+SBJF+2+PL
constitucionalizarde-lo	constitucionalizar+V.ele.ACC.3.M.SG+INF+2+PL
constitucionalizarde-lo	constitucionalizar+V.ele.ACC.3.M.SG+SBJF+2+PL
constitucionalizarde-los	constitucionalizar+V.ele.ACC.3.M.PL+INF+2+PL
constitucionalizarde-los	constitucionalizar+V.ele.ACC.3.M.PL+SBJF+2+PL
constitucionalizarde-nos	constitucionalizar+nós.AD.1.PL+INF+2+PL
constitucionalizarde-nos	constitucionalizar+nós.AD.1.PL+SBJF+2+PL
constitucionalizardes-lhe	constitucionalizar+V.ele.DAT.3.SG+INF+2+PL
constitucionalizardes-lhe	constitucionalizar+V.ele.DAT.3.SG+SBJF+2+PL
constitucionalizardes-lhes	constitucionalizar+V.ele.DAT.3.PL+INF+2+PL
constitucionalizardes-lhes	constitucionalizar+V.ele.DAT.3.PL+SBJF+2+PL
constitucionalizardes-me	constitucionalizar+V.eu.AD.1.SG+INF+2+PL
constitucionalizardes-me	constitucionalizar+V.eu.AD.1.SG+SBJF+2+PL
constitucionalizardes-te	constitucionalizar+V.tu.AD.2.SG+INF+2+PL
constitucionalizardes-te	constitucionalizar+V.tu.AD.2.SG+SBJF+2+PL
constitucionalizardes-vos	constitucionalizar+V.vós.AD.2.PL+INF+2+PL
constitucionalizardes-vos	constitucionalizar+V.vós.AD.2.PL+SBJF+2+PL
constitucionalizárei-la	constitucionalizar+V.ele.ACC.3.F.SG+PQP+2+PL
constitucionalizárei-las	constitucionalizar+V.ele.ACC.3.F.PL+PQP+2+PL
constitucionalizárei-lo	constitucionalizar+V.ele.ACC.3.M.SG+PQP+2+PL
constitucionalizárei-los	constitucionalizar+V.ele.ACC.3.M.PL+PQP+2+PL
constitucionalizárei-nos	constitucionalizar+nós.AD.1.PL+PQP+2+PL
constitucionalizáreis-lhe	constitucionalizar+V.ele.DAT.3.SG+PQP+2+PL
constitucionalizáreis-lhes	constitucionalizar+V.ele.DAT.3.PL+PQP+2+PL
constitucionalizáreis-me	constitucionalizar+V.eu.AD.1.SG+PQP+2+PL
constitucionalizáreis-te	constitucionalizar+V.tu.AD.2.SG+PQP+2+PL
constitucionalizáreis-vos	constitucionalizar+V.vós.AD.2.PL+PQP+2+PL
constitucionalizare-la	constitucionalizar+V.ele.ACC.3.F.SG+INF+2+SG
constitucionalizare-la	constitucionalizar+V.ele.ACC.3.F.SG+SBJF+2+SG
constitucionalizare-las	constitucionalizar+V.ele.ACC.3.F.PL+INF+2+SG
constitucionalizare-las	constitucionalizar+V.ele.ACC.3.F.PL+SBJF+2+SG
constitucionalizare-lo	constitucionalizar+V.ele.ACC.3.M.SG+INF+2+SG
constitucionalizare-lo	constitucionalizar+V.ele.ACC.3.M.SG+SBJF+2+SG
constitucionalizare-los	constitucionalizar+V.ele.ACC.3.M.PL+INF+2+SG
constitucionalizare-los	constitucionalizar+V.ele.ACC.3.M.PL+SBJF+2+SG
constitucionalizarem-lhe	constitucionalizar+V.ele.DAT.3.SG+INF+3+PL
constitucionalizarem-lhe	constitucionalizar+V.ele.DAT.3.SG+SBJF+3+PL
constitucionalizarem-lhes	constitucionalizar+V.ele.DAT.3.PL+INF+3+PL
constitucionalizarem-lhes	constitucionalizar+V.ele.DAT.3.PL+SBJF+3+PL
constitucionalizarem-me	constitucionalizar+V.eu.AD.1.SG+INF+3+PL
constitucionalizarem-me	constitucionalizar+V.eu.AD.1.SG+SBJF+3+PL
constitucionalizarem-na	constitucionalizar+V.ele.ACC.3.F.SG+INF+3+PL
constitucionalizarem-na	constitucionalizar+V.ele.ACC.3.F.SG+SBJF+3+PL
constitucionalizarem-nas	constitucionalizar+V.ele.ACC.3.F.PL+INF+3+PL
constitucionalizarem-nas	constitucionalizar+V.ele.ACC.3.F.PL+SBJF+3+PL
constitucionalizarem-no	constitucionalizar+V.ele.ACC.3.M.SG+INF+3+PL
constitucionalizarem-no	constitucionalizar+V.ele.ACC.3.M.SG+SBJF+3+PL
constitucionalizarem-nos	constitucionalizar+V.ele.ACC.3.M.PL+INF+3+PL
constitucionalizarem-nos	constitucionalizar+V.ele.ACC.3.M.PL+SBJF+3+PL
constitucionalizarem-nos	constitucionalizar+V.nós.AD.1.PL+INF+3+PL
constitucionalizarem-nos	constitucionalizar+V.nós.AD.1.PL+SBJF+3+PL
constitucionalizarem-se	constitucionalizar+V.ele.REFL+INF+3+PL
constitucionalizarem-se	constitucionalizar+V.ele.REFL+SBJF+3+PL
constitucionalizarem-te	constitucionalizar+V.tu.AD.2.SG+INF+3+PL
constitucionalizarem-te	constitucionalizar+V.tu.AD.2.SG+SBJF+3+PL
constitucionalizarem-vos	constitucionalizar+V.vós.AD.2.PL+INF+3+PL
constitucionalizarem-vos	constitucionalizar+V.vós.AD.2.PL+SBJF+3+PL
constitucionalizare-nos	constitucionalizar+nós.AD.1.PL+INF+2+SG
constitucionalizare-nos	constitucionalizar+nós.AD.1.PL+SBJF+2+SG
constitucionalizares-lhe	constitucionalizar+V.ele.DAT.3.SG+INF+2+SG
constitucionalizares-lhe	constitucionalizar+V.ele.DAT.3.SG+SBJF+2+SG
constitucionalizares-lhes	constitucionalizar+V.ele.DAT.3.PL+INF+2+SG
constitucionalizares-lhes	constitucionalizar+V.ele.DAT.3.PL+SBJF+2+SG
constitucionalizares-me	constitucionalizar+V.eu.AD.1.SG+INF+2+SG
constitucionalizares-me	constitucionalizar+V.eu.AD.1.SG+SBJF+2+SG
constitucionalizares-te	constitucionalizar+V.tu.AD.2.SG+INF+2+SG
constitucionalizares-te	constitucionalizar+V.tu.AD.2.SG+SBJF+2+SG
constitucionalizares-vos	constitucionalizar+V.vós.AD.2.PL+INF+2+SG
constitucionalizares-vos	constitucionalizar+V.vós.AD.2.PL+SBJF+2+SG
constitucionalizar-lhe-á	constitucionalizar+V.ele.DAT.3.SG+FUT+3+SG
constitucionalizar-lhe-ão	constitucionalizar+V.ele.DAT.3.SG+FUT+3+PL
constitucionalizar-lhe-ás	constitucionalizar+V.ele.DAT.3.SG+FUT+2+SG
constitucionalizar-lhe	constitucionalizar+V.ele.DAT.3.SG+INF
constitucionalizar-lhe	constitucionalizar+V.ele.DAT.3.SG+INF+1+SG
constitucionalizar-lhe	constitucionalizar+V.ele.DAT.3.SG+INF+3+SG
constitucionalizar-lhe	constitucionalizar+V.ele.DAT.3.SG+SBJF+1+SG
constitucionalizar-lhe	constitucionalizar+V.ele.DAT.3.SG+SBJF+3+SG
constitucionalizar-lhe-ei	constitucionalizar+V.ele.DAT.3.SG+FUT+1+SG
constitucionalizar-lhe-eis	constitucionalizar+V.ele.DAT.3.SG+FUT+2+PL
constitucionalizar-lhe-emos	constitucionalizar+V.ele.DAT.3.SG+FUT+1+PL
constitucionalizar-lhe-ia	constitucionalizar+V.ele.DAT.3.SG+COND+1+SG
constitucionalizar-lhe-ia	constitucionalizar+V.ele.DAT.3.SG+COND+3+SG
constitucionalizar-lhe-iam	constitucionalizar+V.ele.DAT.3.SG+COND+3+PL
constitucionalizar-lhe-íamos	constitucionalizar+V.ele.DAT.3.SG+COND+1+PL
constitucionalizar-lhe-ias	constitucionalizar+V.ele.DAT.3.SG+COND+2+SG
constitucionalizar-lhe-íeis	constitucionalizar+V.ele.DAT.3.SG+COND+2+PL
constitucionalizar-lhes-á	constitucionalizar+V.ele.DAT.3.PL+FUT+3+SG
constitucionalizar-lhes-ão	constitucionalizar+V.ele.DAT.3.PL+FUT+3+PL
constitucionalizar-lhes-ás	constitucionalizar+V.ele.DAT.3.PL+FUT+2+SG
constitucionalizar-lhes	constitucionalizar+V.ele.DAT.3.PL+INF
constitucionalizar-lhes	constitucionalizar+V.ele.DAT.3.PL+INF+1+SG
constitucionalizar-lhes	constitucionalizar+V.ele.DAT.3.PL+INF+3+SG
constitucionalizar-lhes	constitucionalizar+V.ele.DAT.3.PL+SBJF+1+SG
constitucionalizar-lhes	constitucionalizar+V.ele.DAT.3.PL+SBJF+3+SG
constitucionalizar-lhes-ei	constitucionalizar+V.ele.DAT.3.PL+FUT+1+SG
constitucionalizar-lhes-eis	constitucionalizar+V.ele.DAT.3.PL+FUT+2+PL
constitucionalizar-lhes-emos	constitucionalizar+V.ele.DAT.3.PL+FUT+1+PL
constitucionalizar-lhes-ia	constitucionalizar+V.ele.DAT.3.PL+COND+1+SG
constitucionalizar-lhes-ia	constitucionalizar+V.ele.DAT.3.PL+COND+3+SG
constitucionalizar-lhes-iam	constitucionalizar+V.ele.DAT.3.PL+COND+3+PL
constitucionalizar-lhes-íamos	constitucionalizar+V.ele.DAT.3.PL+COND+1+PL
constitucionalizar-lhes-ias	constitucionalizar+V.ele.DAT.3.PL+COND+2+SG
constitucionalizar-lhes-íeis	constitucionalizar+V.ele.DAT.3.PL+COND+2+PL
constitucionalizar-me-á	constitucionalizar+V.eu.AD.1.SG+FUT+3+SG
constitucionalizar-me-ão	constitucionalizar+V.eu.AD.1.SG+FUT+3+PL
constitucionalizar-me-ás	constitucionalizar+V.eu.AD.1.SG+FUT+2+SG
constitucionalizar-me	constitucionalizar+V.eu.AD.1.SG+INF
constitucionalizar-me	constitucionalizar+V.eu.AD.1.SG+INF+1+SG
constitucionalizar-me	constitucionalizar+V.eu.AD.1.SG+INF+3+SG
constitucionalizar-me	constitucionalizar+V.eu.AD.1.SG+SBJF+1+SG
constitucionalizar-me	constitucionalizar+V.eu.AD.1.SG+SBJF+3+SG
constitucionalizar-me-ei	constitucionalizar+V.eu.AD.1.SG+FUT+1+SG
constitucionalizar-me-eis	constitucionalizar+V.eu.AD.1.SG+FUT+2+PL
constitucionalizar-me-emos	constitucionalizar+V.eu.AD.1.SG+FUT+1+PL
constitucionalizar-me-ia	constitucionalizar+V.eu.AD.1.SG+COND+1+SG
constitucionalizar-me-ia	constitucionalizar+V.eu.AD.1.SG+COND+3+SG
constitucionalizar-me-iam	constitucionalizar+V.eu.AD.1.SG+COND+3+PL
constitucionalizar-me-íamos	constitucionalizar+V.eu.AD.1.SG+COND+1+PL
constitucionalizar-me-ias	constitucionalizar+V.eu.AD.1.SG+COND+2+SG
constitucionalizar-me-íeis	constitucionalizar+V.eu.AD.1.SG+COND+2+PL
constitucionalizarmo-la	constitucionalizar+V.ele.ACC.3.F.SG+INF+1+PL
constitucionalizarmo-la	constitucionalizar+V.ele.ACC.3.F.SG+SBJF+1+PL
constitucionalizarmo-las	constitucionalizar+V.ele.ACC.3.F.PL+INF+1+PL
constitucionalizarmo-las	constitucionalizar+V.ele.ACC.3.F.PL+SBJF+1+PL
constitucionalizarmo-lo	constitucionalizar+V.ele.ACC.3.M.SG+INF+1+PL
constitucionalizarmo-lo	constitucionalizar+V.ele.ACC.3.M.SG+SBJF+1+PL
constitucionalizarmo-los	constitucionalizar+V.ele.ACC.3.M.PL+INF+1+PL
constitucionalizarmo-los	constitucionalizar+V.ele.ACC.3.M.PL+SBJF+1+PL
constitucionalizarmo-nos	constitucionalizar+nós.AD.1.PL+INF+1+PL
constitucionalizarmo-nos	constitucionalizar+nós.AD.1.PL+SBJF+1+PL
constitucionalizarmos-lhe	constitucionalizar+V.ele.DAT.3.SG+INF+1+PL
constitucionalizarmos-lhe	constitucionalizar+V.ele.DAT.3.SG+SBJF+1+PL
constitucionalizarmos-lhes	constitucionalizar+V.ele.DAT.3.PL+INF+1+PL
constitucionalizarmos-lhes	constitucionalizar+V.ele.DAT.3.PL+SBJF+1+PL
constitucionalizarmos-me	constitucionalizar+V.eu.AD.1.SG+INF+1+PL
constitucionalizarmos-me	constitucionalizar+V.eu.AD.1.SG+SBJF+1+PL
constitucionalizarmos-te	constitucionalizar+V.tu.AD.2.SG+INF+1+PL
constitucionalizarmos-te	constitucionalizar+V.tu.AD.2.SG+SBJF+1+PL
constitucionalizarmos-vos	constitucionalizar+V.vós.AD.2.PL+INF+1+PL
constitucionalizarmos-vos	constitucionalizar+V.vós.AD.2.PL+SBJF+1+PL
constitucionalizar-nos-á	constitucionalizar+nós.AD.1.PL+FUT+3+SG
constitucionalizar-nos-ão	constitucionalizar+nós.AD.1.PL+FUT+3+PL
constitucionalizar-nos-ás	constitucionalizar+nós.AD.1.PL+FUT+2+SG
constitucionalizar-nos	constitucionalizar+nós.AD.1.PL+INF
constitucionalizar-nos	constitucionalizar+nós.AD.1.PL+INF+1+SG
constitucionalizar-nos	constitucionalizar+nós.AD.1.PL+INF+3+SG
constitucionalizar-nos	constitucionalizar+nós.AD.1.PL+SBJF+1+SG
constitucionalizar-nos	constitucionalizar+nós.AD.1.PL+SBJF+3+SG
constitucionalizar-nos-ei	constitucionalizar+nós.AD.1.PL+FUT+1+SG
constitucionalizar-nos-eis	constitucionalizar+nós.AD.1.PL+FUT+2+PL
constitucionalizar-nos-emos	constitucionalizar+nós.AD.1.PL+FUT+1+PL
constitucionalizar-nos-ia	constitucionalizar+nós.AD.1.PL+COND+1+SG
constitucionalizar-nos-ia	constitucionalizar+nós.AD.1.PL+COND+3+SG
constitucionalizar-nos-iam	constitucionalizar+nós.AD.1.PL+COND+3+PL
constitucionalizar-nos-íamos	constitucionalizar+nós.AD.1.PL+COND+1+PL
constitucionalizar-nos-ias	constitucionalizar+nós.AD.1.PL+COND+2+SG
constitucionalizar-nos-íeis	constitucionalizar+nós.AD.1.PL+COND+2+PL
constitucionalizar-se-á	constitucionalizar+V.ele.REFL+FUT+3+SG
constitucionalizar-se-ão	constitucionalizar+V.ele.REFL+FUT+3+PL
constitucionalizar-se	constitucionalizar+V.ele.REFL+INF
constitucionalizar-se	constitucionalizar+V.ele.REFL+INF+3+SG
constitucionalizar-se	constitucionalizar+V.ele.REFL+SBJF+3+SG
constitucionalizar-se-ia	constitucionalizar+V.ele.REFL+COND+3+SG
constitucionalizar-se-iam	constitucionalizar+V.ele.REFL+COND+3+PL
constitucionalizar-te-á	constitucionalizar+V.tu.AD.2.SG+FUT+3+SG
constitucionalizar-te-ão	constitucionalizar+V.tu.AD.2.SG+FUT+3+PL
constitucionalizar-te-ás	constitucionalizar+V.tu.AD.2.SG+FUT+2+SG
constitucionalizar-te	constitucionalizar+V.tu.AD.2.SG+INF
constitucionalizar-te	constitucionalizar+V.tu.AD.2.SG+INF+1+SG
constitucionalizar-te	constitucionalizar+V.tu.AD.2.SG+INF+3+SG
constitucionalizar-te	constitucionalizar+V.tu.AD.2.SG+SBJF+1+SG
constitucionalizar-te	constitucionalizar+V.tu.AD.2.SG+SBJF+3+SG
constitucionalizar-te-ei	constitucionalizar+V.tu.AD.2.SG+FUT+1+SG
constitucionalizar-te-eis	constitucionalizar+V.tu.AD.2.SG+FUT+2+PL
constitucionalizar-te-emos	constitucionalizar+V.tu.AD.2.SG+FUT+1+PL
constitucionalizar-te-ia	constitucionalizar+V.tu.AD.2.SG+COND+1+SG
constitucionalizar-te-ia	constitucionalizar+V.tu.AD.2.SG+COND+3+SG
constitucionalizar-te-iam	constitucionalizar+V.tu.AD.2.SG+COND+3+PL
constitucionalizar-te-íamos	constitucionalizar+V.tu.AD.2.SG+COND+1+PL
constitucionalizar-te-ias	constitucionalizar+V.tu.AD.2.SG+COND+2+SG
constitucionalizar-te-íeis	constitucionalizar+V.tu.AD.2.SG+COND+2+PL
constitucionalizar-vos-á	constitucionalizar+V.vós.AD.2.PL+FUT+3+SG
constitucionalizar-vos-ão	constitucionalizar+V.vós.AD.2.PL+FUT+3+PL
constitucionalizar-vos-ás	constitucionalizar+V.vós.AD.2.PL+FUT+2+SG
constitucionalizar-vos	constitucionalizar+V.vós.AD.2.PL+INF
constitucionalizar-vos	constitucionalizar+V.vós.AD.2.PL+INF+1+SG
constitucionalizar-vos	constitucionalizar+V.vós.AD.2.PL+INF+3+SG
constitucionalizar-vos	constitucionalizar+V.vós.AD.2.PL+SBJF+1+SG
constitucionalizar-vos	constitucionalizar+V.vós.AD.2.PL+SBJF+3+SG
constitucionalizar-vos-ei	constitucionalizar+V.vós.AD.2.PL+FUT+1+SG
constitucionalizar-vos-eis	constitucionalizar+V.vós.AD.2.PL+FUT+2+PL
constitucionalizar-vos-emos	constitucionalizar+V.vós.AD.2.PL+FUT+1+PL
constitucionalizar-vos-ia	constitucionalizar+V.vós.AD.2.PL+COND+1+SG
constitucionalizar-vos-ia	constitucionalizar+V.vós.AD.2.PL+COND+3+SG
constitucionalizar-vos-iam	constitucionalizar+V.vós.AD.2.PL+COND+3+PL
constitucionalizar-vos-íamos	constitucionalizar+V.vós.AD.2.PL+COND+1+PL
constitucionalizar-vos-ias	constitucionalizar+V.vós.AD.2.PL+COND+2+SG
constitucionalizar-vos-íeis	constitucionalizar+V.vós.AD.2.PL+COND+2+PL
constitucionaliza-se	constitucionalizar+V.ele.REFL+PRS+3+SG
constitucionalizas-lhe	constitucionalizar+V.ele.DAT.3.SG+PRS+2+SG
constitucionalizas-lhes	constitucionalizar+V.ele.DAT.3.PL+PRS+2+SG
constitucionalizas-me	constitucionalizar+V.eu.AD.1.SG+PRS+2+SG
constitucionalizaste-a	constitucionalizar+V.ele.ACC.3.F.SG+PRF+2+SG
constitucionalizaste-as	constitucionalizar+V.ele.ACC.3.F.PL+PRF+2+SG
constitucionalizas-te	constitucionalizar+V.tu.AD.2.SG+PRS+2+SG
constitucionalizaste-la	constitucionalizar+V.ele.ACC.3.F.SG+PRF+2+PL
constitucionalizaste-las	constitucionalizar+V.ele.ACC.3.F.PL+PRF+2+PL
constitucionalizaste-lhe	constitucionalizar+V.ele.DAT.3.SG+PRF+2+SG
constitucionalizaste-lhes	constitucionalizar+V.ele.DAT.3.PL+PRF+2+SG
constitucionalizaste-lo	constitucionalizar+V.ele.ACC.3.M.SG+PRF+2+PL
constitucionalizaste-los	constitucionalizar+V.ele.ACC.3.M.PL+PRF+2+PL
constitucionalizaste-me	constitucionalizar+V.eu.AD.1.SG+PRF+2+SG
constitucionalizaste-nos	constitucionalizar+nós.AD.1.PL+PRF+2+PL
constitucionalizaste-nos	constitucionalizar+nós.AD.1.PL+PRF+2+SG
constitucionalizaste-o	constitucionalizar+V.ele.ACC.3.M.SG+PRF+2+SG
constitucionalizaste-os	constitucionalizar+V.ele.ACC.3.M.PL+PRF+2+SG
constitucionalizastes-lhe	constitucionalizar+V.ele.DAT.3.SG+PRF+2+PL
constitucionalizastes-lhes	constitucionalizar+V.ele.DAT.3.PL+PRF+2+PL
constitucionalizastes-me	constitucionalizar+V.eu.AD.1.SG+PRF+2+PL
constitucionalizastes-te	constitucionalizar+V.tu.AD.2.SG+PRF+2+PL
constitucionalizastes-vos	constitucionalizar+V.vós.AD.2.PL+PRF+2+PL
constitucionalizaste-te	constitucionalizar+V.tu.AD.2.SG+PRF+2+SG
constitucionalizaste-vos	constitucionalizar+V.vós.AD.2.PL+PRF+2+SG
constitucionalizas-vos	constitucionalizar+V.vós.AD.2.PL+PRS+2+SG
constitucionaliza-te	constitucionalizar+V.tu.AD.2.SG+PRS+3+SG
constitucionalizava-a	constitucionalizar+V.ele.ACC.3.F.SG+IMPF+1+SG
constitucionalizava-a	constitucionalizar+V.ele.ACC.3.F.SG+IMPF+3+SG
constitucionalizava-as	constitucionalizar+V.ele.ACC.3.F.PL+IMPF+1+SG
constitucionalizava-as	constitucionalizar+V.ele.ACC.3.F.PL+IMPF+3+SG
constitucionalizava-la	constitucionalizar+V.ele.ACC.3.F.SG+IMPF+2+SG
constitucionalizava-las	constitucionalizar+V.ele.ACC.3.F.PL+IMPF+2+SG
constitucionalizava-lhe	constitucionalizar+V.ele.DAT.3.SG+IMPF+1+SG
constitucionalizava-lhe	constitucionalizar+V.ele.DAT.3.SG+IMPF+3+SG
constitucionalizava-lhes	constitucionalizar+V.ele.DAT.3.PL+IMPF+1+SG
constitucionalizava-lhes	constitucionalizar+V.ele.DAT.3.PL+IMPF+3+SG
constitucionalizava-lo	constitucionalizar+V.ele.ACC.3.M.SG+IMPF+2+SG
constitucionalizava-los	constitucionalizar+V.ele.ACC.3.M.PL+IMPF+2+SG
constitucionalizava-me	constitucionalizar+V.eu.AD.1.SG+IMPF+1+SG
constitucionalizava-me	constitucionalizar+V.eu.AD.1.SG+IMPF+3+SG
constitucionalizavam-lhe	constitucionalizar+V.ele.DAT.3.SG+IMPF+3+PL
constitucionalizavam-lhes	constitucionalizar+V.ele.DAT.3.PL+IMPF+3+PL
constitucionalizavam-me	constitucionalizar+V.eu.AD.1.SG+IMPF+3+PL
constitucionalizavam-na	constitucionalizar+V.ele.ACC.3.F.SG+IMPF+3+PL
constitucionalizavam-nas	constitucionalizar+V.ele.ACC.3.F.PL+IMPF+3+PL
constitucionalizavam-no	constitucionalizar+V.ele.ACC.3.M.SG+IMPF+3+PL
constitucionalizavam-nos	constitucionalizar+V.ele.ACC.3.M.PL+IMPF+3+PL
constitucionalizavam-nos	constitucionalizar+V.nós.AD.1.PL+IMPF+3+PL
constitucionalizávamo-la	constitucionalizar+V.ele.ACC.3.F.SG+IMPF+1+PL
constitucionalizávamo-las	constitucionalizar+V.ele.ACC.3.F.PL+IMPF+1+PL
constitucionalizávamo-lo	constitucionalizar+V.ele.ACC.3.M.SG+IMPF+1+PL
constitucionalizávamo-los	constitucionalizar+V.ele.ACC.3.M.PL+IMPF+1+PL
constitucionalizávamo-nos	constitucionalizar+nós.AD.1.PL+IMPF+1+PL
constitucionalizávamos-lhe	constitucionalizar+V.ele.DAT.3.SG+IMPF+1+PL
constitucionalizávamos-lhes	constitucionalizar+V.ele.DAT.3.PL+IMPF+1+PL
constitucionalizávamos-me	constitucionalizar+V.eu.AD.1.SG+IMPF+1+PL
constitucionalizávamos-te	constitucionalizar+V.tu.AD.2.SG+IMPF+1+PL
constitucionalizávamos-vos	constitucionalizar+V.vós.AD.2.PL+IMPF+1+PL
constitucionalizavam-se	constitucionalizar+V.ele.REFL+IMPF+3+PL
constitucionalizavam-te	constitucionalizar+V.tu.AD.2.SG+IMPF+3+PL
constitucionalizavam-vos	constitucionalizar+V.vós.AD.2.PL+IMPF+3+PL
constitucionalizava-nos	constitucionalizar+nós.AD.1.PL+IMPF+1+SG
constitucionalizava-nos	constitucionalizar+nós.AD.1.PL+IMPF+2+SG
constitucionalizava-nos	constitucionalizar+nós.AD.1.PL+IMPF+3+SG
constitucionalizava-o	constitucionalizar+V.ele.ACC.3.M.SG+IMPF+1+SG
constitucionalizava-o	constitucionalizar+V.ele.ACC.3.M.SG+IMPF+3+SG
constitucionalizava-os	constitucionalizar+V.ele.ACC.3.M.PL+IMPF+1+SG
constitucionalizava-os	constitucionalizar+V.ele.ACC.3.M.PL+IMPF+3+SG
constitucionalizava-se	constitucionalizar+V.ele.REFL+IMPF+1+SG
constitucionalizava-se	constitucionalizar+V.ele.REFL+IMPF+3+SG
constitucionalizavas-lhe	constitucionalizar+V.ele.DAT.3.SG+IMPF+2+SG
constitucionalizavas-lhes	constitucionalizar+V.ele.DAT.3.PL+IMPF+2+SG
constitucionalizavas-me	constitucionalizar+V.eu.AD.1.SG+IMPF+2+SG
constitucionalizavas-te	constitucionalizar+V.tu.AD.2.SG+IMPF+2+SG
constitucionalizavas-vos	constitucionalizar+V.vós.AD.2.PL+IMPF+2+SG
constitucionalizava-te	constitucionalizar+V.tu.AD.2.SG+IMPF+1+SG
constitucionalizava-te	constitucionalizar+V.tu.AD.2.SG+IMPF+3+SG
constitucionalizava-vos	constitucionalizar+V.vós.AD.2.PL+IMPF+1+SG
constitucionalizava-vos	constitucionalizar+V.vós.AD.2.PL+IMPF+3+SG
constitucionalizávei-la	constitucionalizar+V.ele.ACC.3.F.SG+IMPF+2+PL
constitucionalizávei-las	constitucionalizar+V.ele.ACC.3.F.PL+IMPF+2+PL
constitucionalizávei-lo	constitucionalizar+V.ele.ACC.3.M.SG+IMPF+2+PL
constitucionalizávei-los	constitucionalizar+V.ele.ACC.3.M.PL+IMPF+2+PL
constitucionalizávei-nos	constitucionalizar+nós.AD.1.PL+IMPF+2+PL
constitucionalizáveis-lhe	constitucionalizar+V.ele.DAT.3.SG+IMPF+2+PL
constitucionalizáveis-lhes	constitucionalizar+V.ele.DAT.3.PL+IMPF+2+PL
constitucionalizáveis-me	constitucionalizar+V.eu.AD.1.SG+IMPF+2+PL
constitucionalizáveis-te	constitucionalizar+V.tu.AD.2.SG+IMPF+2+PL
constitucionalizáveis-vos	constitucionalizar+V.vós.AD.2.PL+IMPF+2+PL
constitucionaliza-vos	constitucionalizar+V.vós.AD.2.PL+PRS+3+SG
constitucionalize-a	constitucionalizar+V.ele.ACC.3.F.SG+IMP+3+SG
constitucionalize-as	constitucionalizar+V.ele.ACC.3.F.PL+IMP+3+SG
constitucionalizei-a	constitucionalizar+V.ele.ACC.3.F.SG+PRF+1+SG
constitucionalizei-as	constitucionalizar+V.ele.ACC.3.F.PL+PRF+1+SG
constitucionalizei-lhe	constitucionalizar+V.ele.DAT.3.SG+PRF+1+SG
constitucionalizei-lhes	constitucionalizar+V.ele.DAT.3.PL+PRF+1+SG
constitucionalizei-me	constitucionalizar+V.eu.AD.1.SG+PRF+1+SG
constitucionalizei-nos	constitucionalizar+nós.AD.1.PL+PRF+1+SG
constitucionalizei-o	constitucionalizar+V.ele.ACC.3.M.SG+PRF+1+SG
constitucionalizei-os	constitucionalizar+V.ele.ACC.3.M.PL+PRF+1+SG
constitucionalizei-te	constitucionalizar+V.tu.AD.2.SG+PRF+1+SG
constitucionalizei-vos	constitucionalizar+V.vós.AD.2.PL+PRF+1+SG
constitucionalize-lhe	constitucionalizar+V.ele.DAT.3.SG+IMP+3+SG
constitucionalize-lhes	constitucionalizar+V.ele.DAT.3.PL+IMP+3+SG
constitucionalize-me	constitucionalizar+V.eu.AD.1.SG+IMP+3+SG
constitucionalizem-lhe	constitucionalizar+V.ele.DAT.3.SG+IMP+3+PL
constitucionalizem-lhes	constitucionalizar+V.ele.DAT.3.PL+IMP+3+PL
constitucionalizem-me	constitucionalizar+V.eu.AD.1.SG+IMP+3+PL
constitucionalizem-na	constitucionalizar+V.ele.ACC.3.F.SG+IMP+3+PL
constitucionalizem-nas	constitucionalizar+V.ele.ACC.3.F.PL+IMP+3+PL
constitucionalizem-no	constitucionalizar+V.ele.ACC.3.M.SG+IMP+3+PL
constitucionalizem-nos	constitucionalizar+V.ele.ACC.3.M.PL+IMP+3+PL
constitucionalizem-nos	constitucionalizar+V.nós.AD.1.PL+IMP+3+PL
constitucionalizemo-la	constitucionalizar+V.ele.ACC.3.F.SG+IMP+1+PL
constitucionalizemo-las	constitucionalizar+V.ele.ACC.3.F.PL+IMP+1+PL
constitucionalizemo-lo	constitucionalizar+V.ele.ACC.3.M.SG+IMP+1+PL
constitucionalizemo-los	constitucionalizar+V.ele.ACC.3.M.PL+IMP+1+PL
constitucionalizemo-nos	constitucionalizar+nós.AD.1.PL+IMP+1+PL
constitucionalizemos-lhe	constitucionalizar+V.ele.DAT.3.SG+IMP+1+PL
constitucionalizemos-lhes	constitucionalizar+V.ele.DAT.3.PL+IMP+1+PL
constitucionalizemos-me	constitucionalizar+V.eu.AD.1.SG+IMP+1+PL
constitucionalizemos-te	constitucionalizar+V.tu.AD.2.SG+IMP+1+PL
constitucionalizemos-vos	constitucionalizar+V.vós.AD.2.PL+IMP+1+PL
constitucionalizem-se	constitucionalizar+V.ele.REFL+IMP+3+PL
constitucionalizem-te	constitucionalizar+V.tu.AD.2.SG+IMP+3+PL
constitucionalizem-vos	constitucionalizar+V.vós.AD.2.PL+IMP+3+PL
constitucionalize-nos	constitucionalizar+nós.AD.1.PL+IMP+3+SG
constitucionalize-o	constitucionalizar+V.ele.ACC.3.M.SG+IMP+3+SG
constitucionalize-os	constitucionalizar+V.ele.ACC.3.M.PL+IMP+3+SG
constitucionalize-se	constitucionalizar+V.ele.REFL+IMP+3+SG
constitucionalize-te	constitucionalizar+V.tu.AD.2.SG+IMP+3+SG
constitucionalize-vos	constitucionalizar+V.vós.AD.2.PL+IMP+3+SG
constitucionalizo-a	constitucionalizar+V.ele.ACC.3.F.SG+PRS+1+SG
constitucionalizo-as	constitucionalizar+V.ele.ACC.3.F.PL+PRS+1+SG
constitucionalizo-lhe	constitucionalizar+V.ele.DAT.3.SG+PRS+1+SG
constitucionalizo-lhes	constitucionalizar+V.ele.DAT.3.PL+PRS+1+SG
constitucionalizo-me	constitucionalizar+V.eu.AD.1.SG+PRS+1+SG
constitucionalizo-nos	constitucionalizar+nós.AD.1.PL+PRS+1+SG
constitucionalizo-o	constitucionalizar+V.ele.ACC.3.M.SG+PRS+1+SG
constitucionalizo-os	constitucionalizar+V.ele.ACC.3.M.PL+PRS+1+SG
constitucionalizo-te	constitucionalizar+V.tu.AD.2.SG+PRS+1+SG
constitucionalizou-a	constitucionalizar+V.ele.ACC.3.F.SG+PRF+3+SG
constitucionalizou-as	constitucionalizar+V.ele.ACC.3.F.PL+PRF+3+SG
constitucionalizou-lhe	constitucionalizar+V.ele.DAT.3.SG+PRF+3+SG
constitucionalizou-lhes	constitucionalizar+V.ele.DAT.3.PL+PRF+3+SG
constitucionalizou-me	constitucionalizar+V.eu.AD.1.SG+PRF+3+SG
constitucionalizou-nos	constitucionalizar+nós.AD.1.PL+PRF+3+SG
constitucionalizou-o	constitucionalizar+V.ele.ACC.3.M.SG+PRF+3+SG
constitucionalizou-os	constitucionalizar+V.ele.ACC.3.M.PL+PRF+3+SG
constitucionalizou-se	constitucionalizar+V.ele.REFL+PRF+3+SG
constitucionalizou-te	constitucionalizar+V.tu.AD.2.SG+PRF+3+SG
constitucionalizou-vos	constitucionalizar+V.vós.AD.2.PL+PRF+3+SG
constitucionalizo-vos	constitucionalizar+V.vós.AD.2.PL+PRS+1+SG
constituem-lhe	constituir+V.ele.DAT.3.SG+PRS+3+PL
constituem-lhes	constituir+V.ele.DAT.3.PL+PRS+3+PL
constituem-me	constituir+V.eu.AD.1.SG+PRS+3+PL
constituem-na	constituir+V.ele.ACC.3.F.SG+PRS+3+PL
constituem-nas	constituir+V.ele.ACC.3.F.PL+PRS+3+PL
constituem-no	constituir+V.ele.ACC.3.M.SG+PRS+3+PL
constituem-nos	constituir+V.ele.ACC.3.M.PL+PRS+3+PL
constituem-nos	constituir+V.nós.AD.1.PL+PRS+3+PL
constituem-se	constituir+V.ele.REFL+PRS+3+PL
constituem-te	constituir+V.tu.AD.2.SG+PRS+3+PL
constituem-vos	constituir+V.vós.AD.2.PL+PRS+3+PL
constituía-a	constituir+V.ele.ACC.3.F.SG+IMPF+1+SG
constituía-a	constituir+V.ele.ACC.3.F.SG+IMPF+3+SG
constituía-as	constituir+V.ele.ACC.3.F.PL+IMPF+1+SG
constituía-as	constituir+V.ele.ACC.3.F.PL+IMPF+3+SG
constituí-a	constituir+V.ele.ACC.3.F.SG+PRF+1+SG
constitui-a	constituir+V.ele.ACC.3.F.SG+PRS+3+SG
constituía-la	constituir+V.ele.ACC.3.F.SG+IMPF+2+SG
constituía-las	constituir+V.ele.ACC.3.F.PL+IMPF+2+SG
constituía-lhe	constituir+V.ele.DAT.3.SG+IMPF+1+SG
constituía-lhe	constituir+V.ele.DAT.3.SG+IMPF+3+SG
constituía-lhes	constituir+V.ele.DAT.3.PL+IMPF+1+SG
constituía-lhes	constituir+V.ele.DAT.3.PL+IMPF+3+SG
constituía-lo	constituir+V.ele.ACC.3.M.SG+IMPF+2+SG
constituía-los	constituir+V.ele.ACC.3.M.PL+IMPF+2+SG
constituía-me	constituir+V.eu.AD.1.SG+IMPF+1+SG
constituía-me	constituir+V.eu.AD.1.SG+IMPF+3+SG
constituíam-lhe	constituir+V.ele.DAT.3.SG+IMPF+3+PL
constituíam-lhes	constituir+V.ele.DAT.3.PL+IMPF+3+PL
constituíam-me	constituir+V.eu.AD.1.SG+IMPF+3+PL
constituíam-na	constituir+V.ele.ACC.3.F.SG+IMPF+3+PL
constituíam-nas	constituir+V.ele.ACC.3.F.PL+IMPF+3+PL
constituíam-no	constituir+V.ele.ACC.3.M.SG+IMPF+3+PL
constituíam-nos	constituir+nós.AD.1.PL+IMPF+3+PL
constituíamo-la	constituir+V.ele.ACC.3.F.SG+IMPF+1+PL
constituíamo-las	constituir+V.ele.ACC.3.F.PL+IMPF+1+PL
constituíamo-lo	constituir+V.ele.ACC.3.M.SG+IMPF+1+PL
constituíamo-los	constituir+V.ele.ACC.3.M.PL+IMPF+1+PL
constituíamo-nos	constituir+nós.AD.1.PL+IMPF+1+PL
constituíamos-lhe	constituir+V.ele.DAT.3.SG+IMPF+1+PL
constituíamos-lhes	constituir+V.ele.DAT.3.PL+IMPF+1+PL
constituíamos-me	constituir+V.eu.AD.1.SG+IMPF+1+PL
constituíamos-te	constituir+V.tu.AD.2.SG+IMPF+1+PL
constituíamos-vos	constituir+V.vós.AD.2.PL+IMPF+1+PL
constituíam-se	constituir+V.ele.REFL+IMPF+3+PL
constituíam-te	constituir+V.tu.AD.2.SG+IMPF+3+PL
constituíam-vos	constituir+V.vós.AD.2.PL+IMPF+3+PL
constituía-nos	constituir+nós.AD.1.PL+IMPF+1+SG
constituía-nos	constituir+nós.AD.1.PL+IMPF+2+SG
constituía-nos	constituir+nós.AD.1.PL+IMPF+3+SG
constituía-o	constituir+V.ele.ACC.3.M.SG+IMPF+1+SG
constituía-o	constituir+V.ele.ACC.3.M.SG+IMPF+3+SG
constituía-os	constituir+V.ele.ACC.3.M.PL+IMPF+1+SG
constituía-os	constituir+V.ele.ACC.3.M.PL+IMPF+3+SG
constituí-as	constituir+V.ele.ACC.3.F.PL+PRF+1+SG
constitui-as	constituir+V.ele.ACC.3.F.PL+PRS+3+SG
constituía-se	constituir+V.ele.REFL+IMPF+3+SG
constituías-lhe	constituir+V.ele.DAT.3.SG+IMPF+2+SG
constituías-lhes	constituir+V.ele.DAT.3.PL+IMPF+2+SG
constituías-me	constituir+V.eu.AD.1.SG+IMPF+2+SG
constituías-te	constituir+V.tu.AD.2.SG+IMPF+2+SG
constituías-vos	constituir+V.vós.AD.2.PL+IMPF+2+SG
constituía-te	constituir+V.tu.AD.2.SG+IMPF+1+SG
constituía-te	constituir+V.tu.AD.2.SG+IMPF+3+SG
constituía-vos	constituir+V.vós.AD.2.PL+IMPF+1+SG
constituía-vos	constituir+V.vós.AD.2.PL+IMPF+3+SG
constituíei-la	constituir+V.ele.ACC.3.F.SG+IMPF+2+PL
constituíei-las	constituir+V.ele.ACC.3.F.PL+IMPF+2+PL
constituíei-lo	constituir+V.ele.ACC.3.M.SG+IMPF+2+PL
constituíei-los	constituir+V.ele.ACC.3.M.PL+IMPF+2+PL
constituíei-nos	constituir+nós.AD.1.PL+IMPF+2+PL
constituíeis-lhe	constituir+V.ele.DAT.3.SG+IMPF+2+PL
constituíeis-lhes	constituir+V.ele.DAT.3.PL+IMPF+2+PL
constituíeis-me	constituir+V.eu.AD.1.SG+IMPF+2+PL
constituíeis-te	constituir+V.tu.AD.2.SG+IMPF+2+PL
constituíeis-vos	constituir+V.vós.AD.2.PL+IMPF+2+PL
constitui-la-á	constituir+V.ele.ACC.3.F.SG+FUT+3+SG
constitui-la-ão	constituir+V.ele.ACC.3.F.SG+FUT+3+PL
constitui-la-ás	constituir+V.ele.ACC.3.F.SG+FUT+2+SG
constitui-la	constituir+V.ele.ACC.3.F.SG+INF+1+SG
constitui-la	constituir+V.ele.ACC.3.F.SG+INF+3+SG
constituí-la	constituir+V.ele.ACC.3.F.SG+PRS+2+PL
constitui-la	constituir+V.ele.ACC.3.F.SG+PRS+2+SG
constitui-la	constituir+V.ele.ACC.3.F.SG+SBJF+1+SG
constitui-la	constituir+V.ele.ACC.3.F.SG+SBJF+3+SG
constitui-la-ei	constituir+V.ele.ACC.3.F.SG+FUT+1+SG
constitui-la-eis	constituir+V.ele.ACC.3.F.SG+FUT+2+PL
constitui-la-emos	constituir+V.ele.ACC.3.F.SG+FUT+1+PL
constitui-la-ia	constituir+V.ele.ACC.3.F.SG+COND+1+SG
constitui-la-ia	constituir+V.ele.ACC.3.F.SG+COND+3+SG
constitui-la-iam	constituir+V.ele.ACC.3.F.SG+COND+3+PL
constitui-la-íamos	constituir+V.ele.ACC.3.F.SG+COND+1+PL
constitui-la-ias	constituir+V.ele.ACC.3.F.SG+COND+2+SG
constitui-la-íeis	constituir+V.ele.ACC.3.F.SG+COND+2+PL
constitui-las-á	constituir+V.ele.ACC.3.F.PL+FUT+3+SG
constitui-las-ão	constituir+V.ele.ACC.3.F.PL+FUT+3+PL
constitui-las-ás	constituir+V.ele.ACC.3.F.PL+FUT+2+SG
constitui-las	constituir+V.ele.ACC.3.F.PL+INF+1+SG
constitui-las	constituir+V.ele.ACC.3.F.PL+INF+3+SG
constituí-las	constituir+V.ele.ACC.3.F.PL+PRS+2+PL
constitui-las	constituir+V.ele.ACC.3.F.PL+PRS+2+SG
constitui-las	constituir+V.ele.ACC.3.F.PL+SBJF+1+SG
constitui-las	constituir+V.ele.ACC.3.F.PL+SBJF+3+SG
constitui-las-ei	constituir+V.ele.ACC.3.F.PL+FUT+1+SG
constitui-las-eis	constituir+V.ele.ACC.3.F.PL+FUT+2+PL
constitui-las-emos	constituir+V.ele.ACC.3.F.PL+FUT+1+PL
constitui-las-ia	constituir+V.ele.ACC.3.F.PL+COND+1+SG
constitui-las-ia	constituir+V.ele.ACC.3.F.PL+COND+3+SG
constitui-las-iam	constituir+V.ele.ACC.3.F.PL+COND+3+PL
constitui-las-íamos	constituir+V.ele.ACC.3.F.PL+COND+1+PL
constitui-las-ias	constituir+V.ele.ACC.3.F.PL+COND+2+SG
constitui-las-íeis	constituir+V.ele.ACC.3.F.PL+COND+2+PL
constituí-lhe	constituir+V.ele.DAT.3.SG+PRF+1+SG
constitui-lhe	constituir+V.ele.DAT.3.SG+PRS+3+SG
constituí-lhes	constituir+V.ele.DAT.3.PL+PRF+1+SG
constitui-lhes	constituir+V.ele.DAT.3.PL+PRS+3+SG
constitui-lo-á	constituir+V.ele.ACC.3.M.SG+FUT+3+SG
constitui-lo-ão	constituir+V.ele.ACC.3.M.SG+FUT+3+PL
constitui-lo-ás	constituir+V.ele.ACC.3.M.SG+FUT+2+SG
constitui-lo	constituir+V.ele.ACC.3.M.SG+INF+1+SG
constitui-lo	constituir+V.ele.ACC.3.M.SG+INF+3+SG
constituí-lo	constituir+V.ele.ACC.3.M.SG+PRS+2+PL
constitui-lo	constituir+V.ele.ACC.3.M.SG+PRS+2+SG
constitui-lo	constituir+V.ele.ACC.3.M.SG+SBJF+1+SG
constitui-lo	constituir+V.ele.ACC.3.M.SG+SBJF+3+SG
constitui-lo-ei	constituir+V.ele.ACC.3.M.SG+FUT+1+SG
constitui-lo-eis	constituir+V.ele.ACC.3.M.SG+FUT+2+PL
constitui-lo-emos	constituir+V.ele.ACC.3.M.SG+FUT+1+PL
constitui-lo-ia	constituir+V.ele.ACC.3.M.SG+COND+1+SG
constitui-lo-ia	constituir+V.ele.ACC.3.M.SG+COND+3+SG
constitui-lo-iam	constituir+V.ele.ACC.3.M.SG+COND+3+PL
constitui-lo-íamos	constituir+V.ele.ACC.3.M.SG+COND+1+PL
constitui-lo-ias	constituir+V.ele.ACC.3.M.SG+COND+2+SG
constitui-lo-íeis	constituir+V.ele.ACC.3.M.SG+COND+2+PL
constitui-los-á	constituir+V.ele.ACC.3.M.PL+FUT+3+SG
constitui-los-ão	constituir+V.ele.ACC.3.M.PL+FUT+3+PL
constitui-los-ás	constituir+V.ele.ACC.3.M.PL+FUT+2+SG
constitui-los	constituir+V.ele.ACC.3.M.PL+INF+1+SG
constitui-los	constituir+V.ele.ACC.3.M.PL+INF+3+SG
constituí-los	constituir+V.ele.ACC.3.M.PL+PRS+2+PL
constitui-los	constituir+V.ele.ACC.3.M.PL+PRS+2+SG
constitui-los	constituir+V.ele.ACC.3.M.PL+SBJF+1+SG
constitui-los	constituir+V.ele.ACC.3.M.PL+SBJF+3+SG
constitui-los-ei	constituir+V.ele.ACC.3.M.PL+FUT+1+SG
constitui-los-eis	constituir+V.ele.ACC.3.M.PL+FUT+2+PL
constitui-los-emos	constituir+V.ele.ACC.3.M.PL+FUT+1+PL
constitui-los-ia	constituir+V.ele.ACC.3.M.PL+COND+1+SG
constitui-los-ia	constituir+V.ele.ACC.3.M.PL+COND+3+SG
constitui-los-iam	constituir+V.ele.ACC.3.M.PL+COND+3+PL
constitui-los-íamos	constituir+V.ele.ACC.3.M.PL+COND+1+PL
constitui-los-ias	constituir+V.ele.ACC.3.M.PL+COND+2+SG
constitui-los-íeis	constituir+V.ele.ACC.3.M.PL+COND+2+PL
constituí-me	constituir+V.eu.AD.1.SG+PRF+1+SG
constitui-me	constituir+V.eu.AD.1.SG+PRS+3+SG
constituímo-la	constituir+V.ele.ACC.3.F.SG+PRF+1+PL
constituímo-la	constituir+V.ele.ACC.3.F.SG+PRS+1+PL
constituímo-las	constituir+V.ele.ACC.3.F.PL+PRF+1+PL
constituímo-las	constituir+V.ele.ACC.3.F.PL+PRS+1+PL
constituímo-lo	constituir+V.ele.ACC.3.M.SG+PRF+1+PL
constituímo-lo	constituir+V.ele.ACC.3.M.SG+PRS+1+PL
constituímo-los	constituir+V.ele.ACC.3.M.PL+PRF+1+PL
constituímo-los	constituir+V.ele.ACC.3.M.PL+PRS+1+PL
constituímo-nos	constituir+nós.AD.1.PL+PRF+1+PL
constituímo-nos	constituir+nós.AD.1.PL+PRS+1+PL
constituímos-lhe	constituir+V.ele.DAT.3.SG+PRF+1+PL
constituímos-lhe	constituir+V.ele.DAT.3.SG+PRS+1+PL
constituímos-lhes	constituir+V.ele.DAT.3.PL+PRF+1+PL
constituímos-lhes	constituir+V.ele.DAT.3.PL+PRS+1+PL
constituímos-me	constituir+V.eu.AD.1.SG+PRF+1+PL
constituímos-me	constituir+V.eu.AD.1.SG+PRS+1+PL
constituímos-te	constituir+V.tu.AD.2.SG+PRF+1+PL
constituímos-te	constituir+V.tu.AD.2.SG+PRS+1+PL
constituímos-vos	constituir+V.vós.AD.2.PL+PRF+1+PL
constituímos-vos	constituir+V.vós.AD.2.PL+PRS+1+PL
constituindo-a	constituir+V.ele.ACC.3.F.SG+GRD
constituindo-as	constituir+V.ele.ACC.3.F.PL+GRD
constituindo-lhe	constituir+V.ele.DAT.3.SG+GRD
constituindo-lhes	constituir+V.ele.DAT.3.PL+GRD
constituindo-me	constituir+V.eu.AD.1.SG+GRD
constituindo-nos	constituir+nós.AD.1.PL+GRD
constituindo-o	constituir+V.ele.ACC.3.M.SG+GRD
constituindo-os	constituir+V.ele.ACC.3.M.PL+GRD
constituindo-se	constituir+V.ele.REFL+GRD
constituindo-te	constituir+V.tu.AD.2.SG+GRD
constituindo-vos	constituir+V.vós.AD.2.PL+GRD
constituí-nos	constituir+nós.AD.1.PL+PRF+1+SG
constituí-nos	constituir+nós.AD.1.PL+PRS+2+PL
constitui-nos	constituir+nós.AD.1.PL+PRS+2+SG
constitui-nos	constituir+nós.AD.1.PL+PRS+3+SG
constituí-o	constituir+V.ele.ACC.3.M.SG+PRF+1+SG
constitui-o	constituir+V.ele.ACC.3.M.SG+PRS+3+SG
constituí-os	constituir+V.ele.ACC.3.M.PL+PRF+1+SG
constitui-os	constituir+V.ele.ACC.3.M.PL+PRS+3+SG
constituíra-a	constituir+V.ele.ACC.3.F.SG+PQP+1+SG
constituíra-a	constituir+V.ele.ACC.3.F.SG+PQP+3+SG
constituíra-as	constituir+V.ele.ACC.3.F.PL+PQP+1+SG
constituíra-as	constituir+V.ele.ACC.3.F.PL+PQP+3+SG
constituíra-la	constituir+V.ele.ACC.3.F.SG+PQP+2+SG
constituíra-las	constituir+V.ele.ACC.3.F.PL+PQP+2+SG
constituíra-lhe	constituir+V.ele.DAT.3.SG+PQP+1+SG
constituíra-lhe	constituir+V.ele.DAT.3.SG+PQP+3+SG
constituíra-lhes	constituir+V.ele.DAT.3.PL+PQP+1+SG
constituíra-lhes	constituir+V.ele.DAT.3.PL+PQP+3+SG
constituíra-lo	constituir+V.ele.ACC.3.M.SG+PQP+2+SG
constituíra-los	constituir+V.ele.ACC.3.M.PL+PQP+2+SG
constituíra-me	constituir+V.eu.AD.1.SG+PQP+1+SG
constituíra-me	constituir+V.eu.AD.1.SG+PQP+3+SG
constituíram-lhe	constituir+V.ele.DAT.3.SG+PQP+3+PL
constituíram-lhe	constituir+V.ele.DAT.3.SG+PRF+3+PL
constituíram-lhes	constituir+V.ele.DAT.3.PL+PQP+3+PL
constituíram-lhes	constituir+V.ele.DAT.3.PL+PRF+3+PL
constituíram-me	constituir+V.eu.AD.1.SG+PQP+3+PL
constituíram-me	constituir+V.eu.AD.1.SG+PRF+3+PL
constituíram-na	constituir+V.ele.ACC.3.F.SG+PQP+3+PL
constituíram-na	constituir+V.ele.ACC.3.F.SG+PRF+3+PL
constituíram-nas	constituir+V.ele.ACC.3.F.PL+PQP+3+PL
constituíram-nas	constituir+V.ele.ACC.3.F.PL+PRF+3+PL
constituíram-no	constituir+V.ele.ACC.3.M.SG+PQP+3+PL
constituíram-no	constituir+V.ele.ACC.3.M.SG+PRF+3+PL
constituíram-nos	constituir+nós.AD.1.PL+PQP+3+PL
constituíram-nos	constituir+nós.AD.1.PL+PRF+3+PL
constituíramo-la	constituir+V.ele.ACC.3.F.SG+PQP+1+PL
constituíramo-las	constituir+V.ele.ACC.3.F.PL+PQP+1+PL
constituíramo-lo	constituir+V.ele.ACC.3.M.SG+PQP+1+PL
constituíramo-los	constituir+V.ele.ACC.3.M.PL+PQP+1+PL
constituíramo-nos	constituir+nós.AD.1.PL+PQP+1+PL
constituíramos-lhe	constituir+V.ele.DAT.3.SG+PQP+1+PL
constituíramos-lhes	constituir+V.ele.DAT.3.PL+PQP+1+PL
constituíramos-me	constituir+V.eu.AD.1.SG+PQP+1+PL
constituíramos-te	constituir+V.tu.AD.2.SG+PQP+1+PL
constituíramos-vos	constituir+V.vós.AD.2.PL+PQP+1+PL
constituíram-se	constituir+V.ele.REFL+PQP+3+PL
constituíram-se	constituir+V.ele.REFL+PRF+3+PL
constituíram-te	constituir+V.tu.AD.2.SG+PQP+3+PL
constituíram-te	constituir+V.tu.AD.2.SG+PRF+3+PL
constituíram-vos	constituir+V.vós.AD.2.PL+PQP+3+PL
constituíram-vos	constituir+V.vós.AD.2.PL+PRF+3+PL
constituíra-nos	constituir+nós.AD.1.PL+PQP+1+SG
constituíra-nos	constituir+nós.AD.1.PL+PQP+2+SG
constituíra-nos	constituir+nós.AD.1.PL+PQP+3+SG
constituíra-o	constituir+V.ele.ACC.3.M.SG+PQP+1+SG
constituíra-o	constituir+V.ele.ACC.3.M.SG+PQP+3+SG
constituíra-os	constituir+V.ele.ACC.3.M.PL+PQP+1+SG
constituíra-os	constituir+V.ele.ACC.3.M.PL+PQP+3+SG
constituíra-se	constituir+V.ele.REFL+PQP+3+SG
constituíras-lhe	constituir+V.ele.DAT.3.SG+PQP+2+SG
constituíras-lhes	constituir+V.ele.DAT.3.PL+PQP+2+SG
constituíras-me	constituir+V.eu.AD.1.SG+PQP+2+SG
constituíras-te	constituir+V.tu.AD.2.SG+PQP+2+SG
constituíras-vos	constituir+V.vós.AD.2.PL+PQP+2+SG
constituíra-te	constituir+V.tu.AD.2.SG+PQP+1+SG
constituíra-te	constituir+V.tu.AD.2.SG+PQP+3+SG
constituíra-vos	constituir+V.vós.AD.2.PL+PQP+1+SG
constituíra-vos	constituir+V.vós.AD.2.PL+PQP+3+SG
constituirde-la	constituir+V.ele.ACC.3.F.SG+INF+2+PL
constituirde-la	constituir+V.ele.ACC.3.F.SG+SBJF+2+PL
constituirde-las	constituir+V.ele.ACC.3.F.PL+INF+2+PL
constituirde-las	constituir+V.ele.ACC.3.F.PL+SBJF+2+PL
constituirde-lo	constituir+V.ele.ACC.3.M.SG+INF+2+PL
constituirde-lo	constituir+V.ele.ACC.3.M.SG+SBJF+2+PL
constituirde-los	constituir+V.ele.ACC.3.M.PL+INF+2+PL
constituirde-los	constituir+V.ele.ACC.3.M.PL+SBJF+2+PL
constituirde-nos	constituir+nós.AD.1.PL+INF+2+PL
constituirde-nos	constituir+nós.AD.1.PL+SBJF+2+PL
constituirdes-lhe	constituir+V.ele.DAT.3.SG+INF+2+PL
constituirdes-lhe	constituir+V.ele.DAT.3.SG+SBJF+2+PL
constituirdes-lhes	constituir+V.ele.DAT.3.PL+INF+2+PL
constituirdes-lhes	constituir+V.ele.DAT.3.PL+SBJF+2+PL
constituirdes-me	constituir+V.eu.AD.1.SG+INF+2+PL
constituirdes-me	constituir+V.eu.AD.1.SG+SBJF+2+PL
constituirdes-te	constituir+V.tu.AD.2.SG+INF+2+PL
constituirdes-te	constituir+V.tu.AD.2.SG+SBJF+2+PL
constituirdes-vos	constituir+V.vós.AD.2.PL+INF+2+PL
constituirdes-vos	constituir+V.vós.AD.2.PL+SBJF+2+PL
constituírei-la	constituir+V.ele.ACC.3.F.SG+PQP+2+PL
constituírei-las	constituir+V.ele.ACC.3.F.PL+PQP+2+PL
constituírei-lo	constituir+V.ele.ACC.3.M.SG+PQP+2+PL
constituírei-los	constituir+V.ele.ACC.3.M.PL+PQP+2+PL
constituírei-nos	constituir+nós.AD.1.PL+PQP+2+PL
constituíreis-lhe	constituir+V.ele.DAT.3.SG+PQP+2+PL
constituíreis-lhes	constituir+V.ele.DAT.3.PL+PQP+2+PL
constituíreis-me	constituir+V.eu.AD.1.SG+PQP+2+PL
constituíreis-te	constituir+V.tu.AD.2.SG+PQP+2+PL
constituíreis-vos	constituir+V.vós.AD.2.PL+PQP+2+PL
constituíre-la	constituir+V.ele.ACC.3.F.SG+INF+2+SG
constituíre-la	constituir+V.ele.ACC.3.F.SG+SBJF+2+SG
constituíre-las	constituir+V.ele.ACC.3.F.PL+INF+2+SG
constituíre-las	constituir+V.ele.ACC.3.F.PL+SBJF+2+SG
constituíre-lo	constituir+V.ele.ACC.3.M.SG+INF+2+SG
constituíre-lo	constituir+V.ele.ACC.3.M.SG+SBJF+2+SG
constituíre-los	constituir+V.ele.ACC.3.M.PL+INF+2+SG
constituíre-los	constituir+V.ele.ACC.3.M.PL+SBJF+2+SG
constituírem-lhe	constituir+V.ele.DAT.3.SG+INF+3+PL
constituírem-lhe	constituir+V.ele.DAT.3.SG+SBJF+3+PL
constituírem-lhes	constituir+V.ele.DAT.3.PL+INF+3+PL
constituírem-lhes	constituir+V.ele.DAT.3.PL+SBJF+3+PL
constituírem-me	constituir+V.eu.AD.1.SG+INF+3+PL
constituírem-me	constituir+V.eu.AD.1.SG+SBJF+3+PL
constituírem-na	constituir+V.ele.ACC.3.F.SG+INF+3+PL
constituírem-na	constituir+V.ele.ACC.3.F.SG+SBJF+3+PL
constituírem-nas	constituir+V.ele.ACC.3.F.PL+INF+3+PL
constituírem-nas	constituir+V.ele.ACC.3.F.PL+SBJF+3+PL
constituírem-no	constituir+V.ele.ACC.3.M.SG+INF+3+PL
constituírem-no	constituir+V.ele.ACC.3.M.SG+SBJF+3+PL
constituírem-nos	constituir+nós.AD.1.PL+INF+3+PL
constituírem-nos	constituir+nós.AD.1.PL+SBJF+3+PL
