convidou-vos	convidar+V.vós.AD.2.PL+PRF+3+SG
convido-vos	convidar+V.vós.AD.2.PL+PRS+1+SG
convié-la	convir+V.ele.ACC.3.F.SG+SBJF+1+SG
convié-la	convir+V.ele.ACC.3.F.SG+SBJF+3+SG
convié-las	convir+V.ele.ACC.3.F.PL+SBJF+1+SG
convié-las	convir+V.ele.ACC.3.F.PL+SBJF+3+SG
convié-lo	convir+V.ele.ACC.3.M.SG+SBJF+1+SG
convié-lo	convir+V.ele.ACC.3.M.SG+SBJF+3+SG
convié-los	convir+V.ele.ACC.3.M.PL+SBJF+1+SG
convié-los	convir+V.ele.ACC.3.M.PL+SBJF+3+SG
conviemo-la	convir+V.ele.ACC.3.F.SG+PRF+1+PL
conviemo-las	convir+V.ele.ACC.3.F.PL+PRF+1+PL
conviemo-lo	convir+V.ele.ACC.3.M.SG+PRF+1+PL
conviemo-los	convir+V.ele.ACC.3.M.PL+PRF+1+PL
conviemo-nos	convir+nós.AD.1.PL+PRF+1+PL
conviemos-lhe	convir+V.ele.DAT.3.SG+PRF+1+PL
conviemos-lhes	convir+V.ele.DAT.3.PL+PRF+1+PL
conviemos-me	convir+V.eu.AD.1.SG+PRF+1+PL
conviemos-te	convir+V.tu.AD.2.SG+PRF+1+PL
conviemos-vos	convir+V.vós.AD.2.PL+PRF+1+PL
conviera-a	convir+V.ele.ACC.3.F.SG+PQP+1+SG
conviera-a	convir+V.ele.ACC.3.F.SG+PQP+3+SG
conviera-as	convir+V.ele.ACC.3.F.PL+PQP+1+SG
conviera-as	convir+V.ele.ACC.3.F.PL+PQP+3+SG
conviera-la	convir+V.ele.ACC.3.F.SG+PQP+2+SG
conviera-las	convir+V.ele.ACC.3.F.PL+PQP+2+SG
conviera-lhe	convir+V.ele.DAT.3.SG+PQP+1+SG
conviera-lhe	convir+V.ele.DAT.3.SG+PQP+3+SG
conviera-lhes	convir+V.ele.DAT.3.PL+PQP+1+SG
conviera-lhes	convir+V.ele.DAT.3.PL+PQP+3+SG
conviera-lo	convir+V.ele.ACC.3.M.SG+PQP+2+SG
conviera-los	convir+V.ele.ACC.3.M.PL+PQP+2+SG
conviera-me	convir+V.eu.AD.1.SG+PQP+1+SG
conviera-me	convir+V.eu.AD.1.SG+PQP+3+SG
convieram-lhe	convir+V.ele.DAT.3.SG+PQP+3+PL
convieram-lhe	convir+V.ele.DAT.3.SG+PRF+3+PL
convieram-lhes	convir+V.ele.DAT.3.PL+PQP+3+PL
convieram-lhes	convir+V.ele.DAT.3.PL+PRF+3+PL
convieram-me	convir+V.eu.AD.1.SG+PQP+3+PL
convieram-me	convir+V.eu.AD.1.SG+PRF+3+PL
convieram-na	convir+V.ele.ACC.3.F.SG+PQP+3+PL
convieram-na	convir+V.ele.ACC.3.F.SG+PRF+3+PL
convieram-nas	convir+V.ele.ACC.3.F.PL+PQP+3+PL
convieram-nas	convir+V.ele.ACC.3.F.PL+PRF+3+PL
convieram-no	convir+V.ele.ACC.3.M.SG+PQP+3+PL
convieram-no	convir+V.ele.ACC.3.M.SG+PRF+3+PL
convieram-nos	convir+V.ele.ACC.3.M.PL+PQP+3+PL
convieram-nos	convir+V.ele.ACC.3.M.PL+PRF+3+PL
convieram-nos	convir+V.nós.AD.1.PL+PQP+3+PL
convieram-nos	convir+V.nós.AD.1.PL+PRF+3+PL
conviéramo-la	convir+V.ele.ACC.3.F.SG+PQP+1+PL
conviéramo-las	convir+V.ele.ACC.3.F.PL+PQP+1+PL
conviéramo-lo	convir+V.ele.ACC.3.M.SG+PQP+1+PL
conviéramo-los	convir+V.ele.ACC.3.M.PL+PQP+1+PL
conviéramo-nos	convir+nós.AD.1.PL+PQP+1+PL
conviéramos-lhe	convir+V.ele.DAT.3.SG+PQP+1+PL
conviéramos-lhes	convir+V.ele.DAT.3.PL+PQP+1+PL
conviéramos-me	convir+V.eu.AD.1.SG+PQP+1+PL
conviéramos-te	convir+V.tu.AD.2.SG+PQP+1+PL
conviéramos-vos	convir+V.vós.AD.2.PL+PQP+1+PL
convieram-se	convir+V.ele.REFL+PQP+3+PL
convieram-se	convir+V.ele.REFL+PRF+3+PL
convieram-te	convir+V.tu.AD.2.SG+PQP+3+PL
convieram-te	convir+V.tu.AD.2.SG+PRF+3+PL
convieram-vos	convir+V.vós.AD.2.PL+PQP+3+PL
convieram-vos	convir+V.vós.AD.2.PL+PRF+3+PL
conviera-nos	convir+nós.AD.1.PL+PQP+1+SG
conviera-nos	convir+nós.AD.1.PL+PQP+2+SG
conviera-nos	convir+nós.AD.1.PL+PQP+3+SG
conviera-o	convir+V.ele.ACC.3.M.SG+PQP+1+SG
conviera-o	convir+V.ele.ACC.3.M.SG+PQP+3+SG
conviera-os	convir+V.ele.ACC.3.M.PL+PQP+1+SG
conviera-os	convir+V.ele.ACC.3.M.PL+PQP+3+SG
conviera-se	convir+V.ele.REFL+PQP+3+SG
convieras-lhe	convir+V.ele.DAT.3.SG+PQP+2+SG
convieras-lhes	convir+V.ele.DAT.3.PL+PQP+2+SG
convieras-me	convir+V.eu.AD.1.SG+PQP+2+SG
convieras-te	convir+V.tu.AD.2.SG+PQP+2+SG
convieras-vos	convir+V.vós.AD.2.PL+PQP+2+SG
conviera-te	convir+V.tu.AD.2.SG+PQP+1+SG
conviera-te	convir+V.tu.AD.2.SG+PQP+3+SG
conviera-vos	convir+V.vós.AD.2.PL+PQP+1+SG
conviera-vos	convir+V.vós.AD.2.PL+PQP+3+SG
convierde-la	convir+V.ele.ACC.3.F.SG+SBJF+2+PL
convierde-las	convir+V.ele.ACC.3.F.PL+SBJF+2+PL
convierde-lo	convir+V.ele.ACC.3.M.SG+SBJF+2+PL
convierde-los	convir+V.ele.ACC.3.M.PL+SBJF+2+PL
convierde-nos	convir+nós.AD.1.PL+SBJF+2+PL
convierdes-lhe	convir+V.ele.DAT.3.SG+SBJF+2+PL
convierdes-lhes	convir+V.ele.DAT.3.PL+SBJF+2+PL
convierdes-me	convir+V.eu.AD.1.SG+SBJF+2+PL
convierdes-te	convir+V.tu.AD.2.SG+SBJF+2+PL
convierdes-vos	convir+V.vós.AD.2.PL+SBJF+2+PL
conviérei-la	convir+V.ele.ACC.3.F.SG+PQP+2+PL
conviérei-las	convir+V.ele.ACC.3.F.PL+PQP+2+PL
conviérei-lo	convir+V.ele.ACC.3.M.SG+PQP+2+PL
conviérei-los	convir+V.ele.ACC.3.M.PL+PQP+2+PL
conviérei-nos	convir+nós.AD.1.PL+PQP+2+PL
conviéreis-lhe	convir+V.ele.DAT.3.SG+PQP+2+PL
conviéreis-lhes	convir+V.ele.DAT.3.PL+PQP+2+PL
conviéreis-me	convir+V.eu.AD.1.SG+PQP+2+PL
conviéreis-te	convir+V.tu.AD.2.SG+PQP+2+PL
conviéreis-vos	convir+V.vós.AD.2.PL+PQP+2+PL
conviere-la	convir+V.ele.ACC.3.F.SG+SBJF+2+SG
conviere-las	convir+V.ele.ACC.3.F.PL+SBJF+2+SG
conviere-lo	convir+V.ele.ACC.3.M.SG+SBJF+2+SG
conviere-los	convir+V.ele.ACC.3.M.PL+SBJF+2+SG
convierem-lhe	convir+V.ele.DAT.3.SG+SBJF+3+PL
convierem-lhes	convir+V.ele.DAT.3.PL+SBJF+3+PL
convierem-me	convir+V.eu.AD.1.SG+SBJF+3+PL
convierem-na	convir+V.ele.ACC.3.F.SG+SBJF+3+PL
convierem-nas	convir+V.ele.ACC.3.F.PL+SBJF+3+PL
convierem-no	convir+V.ele.ACC.3.M.SG+SBJF+3+PL
convierem-nos	convir+V.ele.ACC.3.M.PL+SBJF+3+PL
convierem-nos	convir+V.nós.AD.1.PL+SBJF+3+PL
convierem-se	convir+V.ele.REFL+SBJF+3+PL
convierem-te	convir+V.tu.AD.2.SG+SBJF+3+PL
convierem-vos	convir+V.vós.AD.2.PL+SBJF+3+PL
conviere-nos	convir+nós.AD.1.PL+SBJF+2+SG
convieres-lhe	convir+V.ele.DAT.3.SG+SBJF+2+SG
convieres-lhes	convir+V.ele.DAT.3.PL+SBJF+2+SG
convieres-me	convir+V.eu.AD.1.SG+SBJF+2+SG
convieres-te	convir+V.tu.AD.2.SG+SBJF+2+SG
convieres-vos	convir+V.vós.AD.2.PL+SBJF+2+SG
conviermo-la	convir+V.ele.ACC.3.F.SG+SBJF+1+PL
conviermo-las	convir+V.ele.ACC.3.F.PL+SBJF+1+PL
conviermo-lo	convir+V.ele.ACC.3.M.SG+SBJF+1+PL
conviermo-los	convir+V.ele.ACC.3.M.PL+SBJF+1+PL
conviermo-nos	convir+nós.AD.1.PL+SBJF+1+PL
conviermos-lhe	convir+V.ele.DAT.3.SG+SBJF+1+PL
conviermos-lhes	convir+V.ele.DAT.3.PL+SBJF+1+PL
conviermos-me	convir+V.eu.AD.1.SG+SBJF+1+PL
conviermos-te	convir+V.tu.AD.2.SG+SBJF+1+PL
conviermos-vos	convir+V.vós.AD.2.PL+SBJF+1+PL
convieste-a	convir+V.ele.ACC.3.F.SG+PRF+2+SG
convieste-as	convir+V.ele.ACC.3.F.PL+PRF+2+SG
convieste-la	convir+V.ele.ACC.3.F.SG+PRF+2+PL
convieste-las	convir+V.ele.ACC.3.F.PL+PRF+2+PL
convieste-lhe	convir+V.ele.DAT.3.SG+PRF+2+SG
convieste-lhes	convir+V.ele.DAT.3.PL+PRF+2+SG
convieste-lo	convir+V.ele.ACC.3.M.SG+PRF+2+PL
convieste-los	convir+V.ele.ACC.3.M.PL+PRF+2+PL
convieste-me	convir+V.eu.AD.1.SG+PRF+2+SG
convieste-nos	convir+nós.AD.1.PL+PRF+2+PL
convieste-nos	convir+nós.AD.1.PL+PRF+2+SG
convieste-o	convir+V.ele.ACC.3.M.SG+PRF+2+SG
convieste-os	convir+V.ele.ACC.3.M.PL+PRF+2+SG
conviestes-lhe	convir+V.ele.DAT.3.SG+PRF+2+PL
conviestes-lhes	convir+V.ele.DAT.3.PL+PRF+2+PL
conviestes-me	convir+V.eu.AD.1.SG+PRF+2+PL
conviestes-te	convir+V.tu.AD.2.SG+PRF+2+PL
conviestes-vos	convir+V.vós.AD.2.PL+PRF+2+PL
convieste-te	convir+V.tu.AD.2.SG+PRF+2+SG
convieste-vos	convir+V.vós.AD.2.PL+PRF+2+SG
convila-a	convelir+V.ele.ACC.3.F.SG+IMP+3+SG
convi-la-á	convir+V.ele.ACC.3.F.SG+FUT+3+SG
convi-la-ão	convir+V.ele.ACC.3.F.SG+FUT+3+PL
convila-as	convelir+V.ele.ACC.3.F.PL+IMP+3+SG
convi-la-ás	convir+V.ele.ACC.3.F.SG+FUT+2+SG
convi-la	convir+V.ele.ACC.3.F.SG+INF+1+SG
convi-la	convir+V.ele.ACC.3.F.SG+INF+3+SG
convi-la-ei	convir+V.ele.ACC.3.F.SG+FUT+1+SG
convi-la-eis	convir+V.ele.ACC.3.F.SG+FUT+2+PL
convi-la-emos	convir+V.ele.ACC.3.F.SG+FUT+1+PL
convi-la-ia	convir+V.ele.ACC.3.F.SG+COND+1+SG
convi-la-ia	convir+V.ele.ACC.3.F.SG+COND+3+SG
convi-la-iam	convir+V.ele.ACC.3.F.SG+COND+3+PL
convi-la-íamos	convir+V.ele.ACC.3.F.SG+COND+1+PL
convi-la-ias	convir+V.ele.ACC.3.F.SG+COND+2+SG
convi-la-íeis	convir+V.ele.ACC.3.F.SG+COND+2+PL
convila-lhe	convelir+V.ele.DAT.3.SG+IMP+3+SG
convila-lhes	convelir+V.ele.DAT.3.PL+IMP+3+SG
convila-me	convelir+V.eu.AD.1.SG+IMP+3+SG
convilam-lhe	convelir+V.ele.DAT.3.SG+IMP+3+PL
convilam-lhes	convelir+V.ele.DAT.3.PL+IMP+3+PL
convilam-me	convelir+V.eu.AD.1.SG+IMP+3+PL
convilam-na	convelir+V.ele.ACC.3.F.SG+IMP+3+PL
convilam-nas	convelir+V.ele.ACC.3.F.PL+IMP+3+PL
convilam-no	convelir+V.ele.ACC.3.M.SG+IMP+3+PL
convilam-nos	convelir+V.ele.ACC.3.M.PL+IMP+3+PL
convilam-nos	convelir+V.nós.AD.1.PL+IMP+3+PL
convilamo-la	convelir+V.ele.ACC.3.F.SG+IMP+1+PL
convilamo-las	convelir+V.ele.ACC.3.F.PL+IMP+1+PL
convilamo-lo	convelir+V.ele.ACC.3.M.SG+IMP+1+PL
convilamo-los	convelir+V.ele.ACC.3.M.PL+IMP+1+PL
convilamo-nos	convelir+nós.AD.1.PL+IMP+1+PL
convilamos-lhe	convelir+V.ele.DAT.3.SG+IMP+1+PL
convilamos-lhes	convelir+V.ele.DAT.3.PL+IMP+1+PL
convilamos-me	convelir+V.eu.AD.1.SG+IMP+1+PL
convilamos-te	convelir+V.tu.AD.2.SG+IMP+1+PL
convilamos-vos	convelir+V.vós.AD.2.PL+IMP+1+PL
convilam-se	convelir+V.ele.REFL+IMP+3+PL
convilam-te	convelir+V.tu.AD.2.SG+IMP+3+PL
convilam-vos	convelir+V.vós.AD.2.PL+IMP+3+PL
convila-nos	convelir+nós.AD.1.PL+IMP+3+SG
convila-o	convelir+V.ele.ACC.3.M.SG+IMP+3+SG
convila-os	convelir+V.ele.ACC.3.M.PL+IMP+3+SG
convi-las-á	convir+V.ele.ACC.3.F.PL+FUT+3+SG
convi-las-ão	convir+V.ele.ACC.3.F.PL+FUT+3+PL
convi-las-ás	convir+V.ele.ACC.3.F.PL+FUT+2+SG
convi-las	convir+V.ele.ACC.3.F.PL+INF+1+SG
convi-las	convir+V.ele.ACC.3.F.PL+INF+3+SG
convila-se	convelir+V.ele.REFL+IMP+3+SG
convi-las-ei	convir+V.ele.ACC.3.F.PL+FUT+1+SG
convi-las-eis	convir+V.ele.ACC.3.F.PL+FUT+2+PL
convi-las-emos	convir+V.ele.ACC.3.F.PL+FUT+1+PL
convi-las-ia	convir+V.ele.ACC.3.F.PL+COND+1+SG
convi-las-ia	convir+V.ele.ACC.3.F.PL+COND+3+SG
convi-las-iam	convir+V.ele.ACC.3.F.PL+COND+3+PL
convi-las-íamos	convir+V.ele.ACC.3.F.PL+COND+1+PL
convi-las-ias	convir+V.ele.ACC.3.F.PL+COND+2+SG
convi-las-íeis	convir+V.ele.ACC.3.F.PL+COND+2+PL
convila-te	convelir+V.tu.AD.2.SG+IMP+3+SG
convila-vos	convelir+V.vós.AD.2.PL+IMP+3+SG
convilo-a	convelir+V.ele.ACC.3.F.SG+PRS+1+SG
convi-lo-á	convir+V.ele.ACC.3.M.SG+FUT+3+SG
convi-lo-ão	convir+V.ele.ACC.3.M.SG+FUT+3+PL
convilo-as	convelir+V.ele.ACC.3.F.PL+PRS+1+SG
convi-lo-ás	convir+V.ele.ACC.3.M.SG+FUT+2+SG
convi-lo	convir+V.ele.ACC.3.M.SG+INF+1+SG
convi-lo	convir+V.ele.ACC.3.M.SG+INF+3+SG
convi-lo-ei	convir+V.ele.ACC.3.M.SG+FUT+1+SG
convi-lo-eis	convir+V.ele.ACC.3.M.SG+FUT+2+PL
convi-lo-emos	convir+V.ele.ACC.3.M.SG+FUT+1+PL
convi-lo-ia	convir+V.ele.ACC.3.M.SG+COND+1+SG
convi-lo-ia	convir+V.ele.ACC.3.M.SG+COND+3+SG
convi-lo-iam	convir+V.ele.ACC.3.M.SG+COND+3+PL
convi-lo-íamos	convir+V.ele.ACC.3.M.SG+COND+1+PL
convi-lo-ias	convir+V.ele.ACC.3.M.SG+COND+2+SG
convi-lo-íeis	convir+V.ele.ACC.3.M.SG+COND+2+PL
convilo-lhe	convelir+V.ele.DAT.3.SG+PRS+1+SG
convilo-lhes	convelir+V.ele.DAT.3.PL+PRS+1+SG
convilo-me	convelir+V.eu.AD.1.SG+PRS+1+SG
convilo-nos	convelir+nós.AD.1.PL+PRS+1+SG
convilo-o	convelir+V.ele.ACC.3.M.SG+PRS+1+SG
convilo-os	convelir+V.ele.ACC.3.M.PL+PRS+1+SG
convi-los-á	convir+V.ele.ACC.3.M.PL+FUT+3+SG
convi-los-ão	convir+V.ele.ACC.3.M.PL+FUT+3+PL
convi-los-ás	convir+V.ele.ACC.3.M.PL+FUT+2+SG
convi-los	convir+V.ele.ACC.3.M.PL+INF+1+SG
convi-los	convir+V.ele.ACC.3.M.PL+INF+3+SG
convi-los-ei	convir+V.ele.ACC.3.M.PL+FUT+1+SG
convi-los-eis	convir+V.ele.ACC.3.M.PL+FUT+2+PL
convi-los-emos	convir+V.ele.ACC.3.M.PL+FUT+1+PL
convi-los-ia	convir+V.ele.ACC.3.M.PL+COND+1+SG
convi-los-ia	convir+V.ele.ACC.3.M.PL+COND+3+SG
convi-los-iam	convir+V.ele.ACC.3.M.PL+COND+3+PL
convi-los-íamos	convir+V.ele.ACC.3.M.PL+COND+1+PL
convi-los-ias	convir+V.ele.ACC.3.M.PL+COND+2+SG
convi-los-íeis	convir+V.ele.ACC.3.M.PL+COND+2+PL
convilo-te	convelir+V.tu.AD.2.SG+PRS+1+SG
convilo-vos	convelir+V.vós.AD.2.PL+PRS+1+SG
convim-lhe	convir+V.ele.DAT.3.SG+PRF+1+SG
convim-lhes	convir+V.ele.DAT.3.PL+PRF+1+SG
convim-me	convir+V.eu.AD.1.SG+PRF+1+SG
convim-na	convir+V.ele.ACC.3.F.SG+PRF+1+SG
convim-nas	convir+V.ele.ACC.3.F.PL+PRF+1+SG
convim-no	convir+V.ele.ACC.3.M.SG+PRF+1+SG
convim-nos	convir+V.ele.ACC.3.M.PL+PRF+1+SG
convim-nos	convir+V.nós.AD.1.PL+PRF+1+SG
convim-te	convir+V.tu.AD.2.SG+PRF+1+SG
convim-vos	convir+V.vós.AD.2.PL+PRF+1+SG
convindo-a	convir+V.ele.ACC.3.F.SG+GRD
convindo-a	convir+V.ele.ACC.3.F.SG+PTPASS
convindo-as	convir+V.ele.ACC.3.F.PL+GRD
convindo-as	convir+V.ele.ACC.3.F.PL+PTPASS
convindo-lhe	convir+V.ele.DAT.3.SG+GRD
convindo-lhe	convir+V.ele.DAT.3.SG+PTPASS
convindo-lhes	convir+V.ele.DAT.3.PL+GRD
convindo-lhes	convir+V.ele.DAT.3.PL+PTPASS
convindo-me	convir+V.eu.AD.1.SG+GRD
convindo-me	convir+V.eu.AD.1.SG+PTPASS
convindo-nos	convir+nós.AD.1.PL+GRD
convindo-nos	convir+nós.AD.1.PL+PTPASS
convindo-o	convir+V.ele.ACC.3.M.SG+GRD
convindo-o	convir+V.ele.ACC.3.M.SG+PTPASS
convindo-os	convir+V.ele.ACC.3.M.PL+GRD
convindo-os	convir+V.ele.ACC.3.M.PL+PTPASS
convindo-se	convir+V.ele.REFL+GRD
convindo-se	convir+V.ele.REFL+PTPASS
convindo-te	convir+V.tu.AD.2.SG+GRD
convindo-te	convir+V.tu.AD.2.SG+PTPASS
convindo-vos	convir+V.vós.AD.2.PL+GRD
convindo-vos	convir+V.vós.AD.2.PL+PTPASS
convinha-a	convir+V.ele.ACC.3.F.SG+IMPF+1+SG
convinha-a	convir+V.ele.ACC.3.F.SG+IMPF+3+SG
convinha-as	convir+V.ele.ACC.3.F.PL+IMPF+1+SG
convinha-as	convir+V.ele.ACC.3.F.PL+IMPF+3+SG
convinha-lhe	convir+V.ele.DAT.3.SG+IMPF+1+SG
convinha-lhe	convir+V.ele.DAT.3.SG+IMPF+3+SG
convinha-lhes	convir+V.ele.DAT.3.PL+IMPF+1+SG
convinha-lhes	convir+V.ele.DAT.3.PL+IMPF+3+SG
convinha-me	convir+V.eu.AD.1.SG+IMPF+1+SG
convinha-me	convir+V.eu.AD.1.SG+IMPF+3+SG
convinham-lhe	convir+V.ele.DAT.3.SG+IMPF+3+PL
convinham-lhes	convir+V.ele.DAT.3.PL+IMPF+3+PL
convinham-me	convir+V.eu.AD.1.SG+IMPF+3+PL
convinham-na	convir+V.ele.ACC.3.F.SG+IMPF+3+PL
convinham-nas	convir+V.ele.ACC.3.F.PL+IMPF+3+PL
convinham-no	convir+V.ele.ACC.3.M.SG+IMPF+3+PL
convinham-nos	convir+V.ele.ACC.3.M.PL+IMPF+3+PL
convinham-nos	convir+V.nós.AD.1.PL+IMPF+3+PL
convínhamo-la	convir+V.ele.ACC.3.F.SG+IMPF+1+PL
convínhamo-las	convir+V.ele.ACC.3.F.PL+IMPF+1+PL
convínhamo-lo	convir+V.ele.ACC.3.M.SG+IMPF+1+PL
convínhamo-los	convir+V.ele.ACC.3.M.PL+IMPF+1+PL
convínhamo-nos	convir+nós.AD.1.PL+IMPF+1+PL
convínhamos-lhe	convir+V.ele.DAT.3.SG+IMPF+1+PL
convínhamos-lhes	convir+V.ele.DAT.3.PL+IMPF+1+PL
convínhamos-me	convir+V.eu.AD.1.SG+IMPF+1+PL
convínhamos-te	convir+V.tu.AD.2.SG+IMPF+1+PL
convínhamos-vos	convir+V.vós.AD.2.PL+IMPF+1+PL
convinham-se	convir+V.ele.REFL+IMPF+3+PL
convinham-te	convir+V.tu.AD.2.SG+IMPF+3+PL
convinham-vos	convir+V.vós.AD.2.PL+IMPF+3+PL
convinha-nos	convir+nós.AD.1.PL+IMPF+1+SG
convinha-nos	convir+nós.AD.1.PL+IMPF+3+SG
convinha-o	convir+V.ele.ACC.3.M.SG+IMPF+1+SG
convinha-o	convir+V.ele.ACC.3.M.SG+IMPF+3+SG
convinha-os	convir+V.ele.ACC.3.M.PL+IMPF+1+SG
convinha-os	convir+V.ele.ACC.3.M.PL+IMPF+3+SG
convinha-se	convir+V.ele.REFL+IMPF+3+SG
convinhas-la	convir+V.ele.ACC.3.F.SG+IMPF+2+SG
convinhas-las	convir+V.ele.ACC.3.F.PL+IMPF+2+SG
convinhas-lhe	convir+V.ele.DAT.3.SG+IMPF+2+SG
convinhas-lhes	convir+V.ele.DAT.3.PL+IMPF+2+SG
convinhas-lo	convir+V.ele.ACC.3.M.SG+IMPF+2+SG
convinhas-los	convir+V.ele.ACC.3.M.PL+IMPF+2+SG
convinhas-me	convir+V.eu.AD.1.SG+IMPF+2+SG
convinhas-nos	convir+nós.AD.1.PL+IMPF+2+SG
convinhas-te	convir+V.tu.AD.2.SG+IMPF+2+SG
convinhas-vos	convir+V.vós.AD.2.PL+IMPF+2+SG
convinha-te	convir+V.tu.AD.2.SG+IMPF+1+SG
convinha-te	convir+V.tu.AD.2.SG+IMPF+3+SG
convinha-vos	convir+V.vós.AD.2.PL+IMPF+1+SG
convinha-vos	convir+V.vós.AD.2.PL+IMPF+3+SG
convínhei-la	convir+V.ele.ACC.3.F.SG+IMPF+2+PL
convínhei-las	convir+V.ele.ACC.3.F.PL+IMPF+2+PL
convínhei-lo	convir+V.ele.ACC.3.M.SG+IMPF+2+PL
convínhei-los	convir+V.ele.ACC.3.M.PL+IMPF+2+PL
convínhei-nos	convir+nós.AD.1.PL+IMPF+2+PL
convínheis-lhe	convir+V.ele.DAT.3.SG+IMPF+2+PL
convínheis-lhes	convir+V.ele.DAT.3.PL+IMPF+2+PL
convínheis-me	convir+V.eu.AD.1.SG+IMPF+2+PL
convínheis-te	convir+V.tu.AD.2.SG+IMPF+2+PL
convínheis-vos	convir+V.vós.AD.2.PL+IMPF+2+PL
convirde-la	convir+V.ele.ACC.3.F.SG+INF+2+PL
convirde-las	convir+V.ele.ACC.3.F.PL+INF+2+PL
convirde-lo	convir+V.ele.ACC.3.M.SG+INF+2+PL
convirde-los	convir+V.ele.ACC.3.M.PL+INF+2+PL
convirde-nos	convir+nós.AD.1.PL+INF+2+PL
convirdes-lhe	convir+V.ele.DAT.3.SG+INF+2+PL
convirdes-lhes	convir+V.ele.DAT.3.PL+INF+2+PL
convirdes-me	convir+V.eu.AD.1.SG+INF+2+PL
convirdes-te	convir+V.tu.AD.2.SG+INF+2+PL
convirdes-vos	convir+V.vós.AD.2.PL+INF+2+PL
convire-la	convir+V.ele.ACC.3.F.SG+INF+2+SG
convire-las	convir+V.ele.ACC.3.F.PL+INF+2+SG
convire-lo	convir+V.ele.ACC.3.M.SG+INF+2+SG
convire-los	convir+V.ele.ACC.3.M.PL+INF+2+SG
convirem-lhe	convir+V.ele.DAT.3.SG+INF+3+PL
convirem-lhes	convir+V.ele.DAT.3.PL+INF+3+PL
convirem-me	convir+V.eu.AD.1.SG+INF+3+PL
convirem-na	convir+V.ele.ACC.3.F.SG+INF+3+PL
convirem-nas	convir+V.ele.ACC.3.F.PL+INF+3+PL
convirem-no	convir+V.ele.ACC.3.M.SG+INF+3+PL
convirem-nos	convir+V.ele.ACC.3.M.PL+INF+3+PL
convirem-nos	convir+V.nós.AD.1.PL+INF+3+PL
convirem-se	convir+V.ele.REFL+INF+3+PL
convirem-te	convir+V.tu.AD.2.SG+INF+3+PL
convirem-vos	convir+V.vós.AD.2.PL+INF+3+PL
convire-nos	convir+nós.AD.1.PL+INF+2+SG
convires-lhe	convir+V.ele.DAT.3.SG+INF+2+SG
convires-lhes	convir+V.ele.DAT.3.PL+INF+2+SG
convires-me	convir+V.eu.AD.1.SG+INF+2+SG
convires-te	convir+V.tu.AD.2.SG+INF+2+SG
convires-vos	convir+V.vós.AD.2.PL+INF+2+SG
convirja-a	convergir+V.ele.ACC.3.F.SG+IMP+3+SG
convirja-as	convergir+V.ele.ACC.3.F.PL+IMP+3+SG
convirja-lhe	convergir+V.ele.DAT.3.SG+IMP+3+SG
convirja-lhes	convergir+V.ele.DAT.3.PL+IMP+3+SG
convirja-me	convergir+V.eu.AD.1.SG+IMP+3+SG
convirjam-lhe	convergir+V.ele.DAT.3.SG+IMP+3+PL
convirjam-lhes	convergir+V.ele.DAT.3.PL+IMP+3+PL
convirjam-me	convergir+V.eu.AD.1.SG+IMP+3+PL
convirjam-na	convergir+V.ele.ACC.3.F.SG+IMP+3+PL
convirjam-nas	convergir+V.ele.ACC.3.F.PL+IMP+3+PL
convirjam-no	convergir+V.ele.ACC.3.M.SG+IMP+3+PL
convirjam-nos	convergir+V.ele.ACC.3.M.PL+IMP+3+PL
convirjam-nos	convergir+V.nós.AD.1.PL+IMP+3+PL
convirjamo-la	convergir+V.ele.ACC.3.F.SG+IMP+1+PL
convirjamo-las	convergir+V.ele.ACC.3.F.PL+IMP+1+PL
convirjamo-lo	convergir+V.ele.ACC.3.M.SG+IMP+1+PL
convirjamo-los	convergir+V.ele.ACC.3.M.PL+IMP+1+PL
convirjamo-nos	convergir+nós.AD.1.PL+IMP+1+PL
convirjamos-lhe	convergir+V.ele.DAT.3.SG+IMP+1+PL
convirjamos-lhes	convergir+V.ele.DAT.3.PL+IMP+1+PL
convirjamos-me	convergir+V.eu.AD.1.SG+IMP+1+PL
convirjamos-te	convergir+V.tu.AD.2.SG+IMP+1+PL
convirjamos-vos	convergir+V.vós.AD.2.PL+IMP+1+PL
convirjam-se	convergir+V.ele.REFL+IMP+3+PL
convirjam-te	convergir+V.tu.AD.2.SG+IMP+3+PL
convirjam-vos	convergir+V.vós.AD.2.PL+IMP+3+PL
convirja-nos	convergir+nós.AD.1.PL+IMP+3+SG
convirja-o	convergir+V.ele.ACC.3.M.SG+IMP+3+SG
convirja-os	convergir+V.ele.ACC.3.M.PL+IMP+3+SG
convirja-se	convergir+V.ele.REFL+IMP+3+SG
convirja-te	convergir+V.tu.AD.2.SG+IMP+3+SG
convirja-vos	convergir+V.vós.AD.2.PL+IMP+3+SG
convirjo-a	convergir+V.ele.ACC.3.F.SG+PRS+1+SG
convirjo-as	convergir+V.ele.ACC.3.F.PL+PRS+1+SG
convirjo-lhe	convergir+V.ele.DAT.3.SG+PRS+1+SG
convirjo-lhes	convergir+V.ele.DAT.3.PL+PRS+1+SG
convirjo-me	convergir+V.eu.AD.1.SG+PRS+1+SG
convirjo-nos	convergir+nós.AD.1.PL+PRS+1+SG
convirjo-o	convergir+V.ele.ACC.3.M.SG+PRS+1+SG
convirjo-os	convergir+V.ele.ACC.3.M.PL+PRS+1+SG
convirjo-te	convergir+V.tu.AD.2.SG+PRS+1+SG
convirjo-vos	convergir+V.vós.AD.2.PL+PRS+1+SG
convir-lhe-á	convir+V.ele.DAT.3.SG+FUT+3+SG
convir-lhe-ão	convir+V.ele.DAT.3.SG+FUT+3+PL
convir-lhe-ás	convir+V.ele.DAT.3.SG+FUT+2+SG
convir-lhe	convir+V.ele.DAT.3.SG+INF
convir-lhe	convir+V.ele.DAT.3.SG+INF+1+SG
convir-lhe	convir+V.ele.DAT.3.SG+INF+3+SG
convir-lhe-ei	convir+V.ele.DAT.3.SG+FUT+1+SG
convir-lhe-eis	convir+V.ele.DAT.3.SG+FUT+2+PL
convir-lhe-emos	convir+V.ele.DAT.3.SG+FUT+1+PL
convir-lhe-ia	convir+V.ele.DAT.3.SG+COND+1+SG
convir-lhe-ia	convir+V.ele.DAT.3.SG+COND+3+SG
convir-lhe-iam	convir+V.ele.DAT.3.SG+COND+3+PL
convir-lhe-íamos	convir+V.ele.DAT.3.SG+COND+1+PL
convir-lhe-ias	convir+V.ele.DAT.3.SG+COND+2+SG
convir-lhe-íeis	convir+V.ele.DAT.3.SG+COND+2+PL
convir-lhes-á	convir+V.ele.DAT.3.PL+FUT+3+SG
convir-lhes-ão	convir+V.ele.DAT.3.PL+FUT+3+PL
convir-lhes-ás	convir+V.ele.DAT.3.PL+FUT+2+SG
convir-lhes	convir+V.ele.DAT.3.PL+INF
convir-lhes	convir+V.ele.DAT.3.PL+INF+1+SG
convir-lhes	convir+V.ele.DAT.3.PL+INF+3+SG
convir-lhes-ei	convir+V.ele.DAT.3.PL+FUT+1+SG
convir-lhes-eis	convir+V.ele.DAT.3.PL+FUT+2+PL
convir-lhes-emos	convir+V.ele.DAT.3.PL+FUT+1+PL
convir-lhes-ia	convir+V.ele.DAT.3.PL+COND+1+SG
convir-lhes-ia	convir+V.ele.DAT.3.PL+COND+3+SG
convir-lhes-iam	convir+V.ele.DAT.3.PL+COND+3+PL
convir-lhes-íamos	convir+V.ele.DAT.3.PL+COND+1+PL
convir-lhes-ias	convir+V.ele.DAT.3.PL+COND+2+SG
convir-lhes-íeis	convir+V.ele.DAT.3.PL+COND+2+PL
convir-me-á	convir+V.eu.AD.1.SG+FUT+3+SG
convir-me-ão	convir+V.eu.AD.1.SG+FUT+3+PL
convir-me-ás	convir+V.eu.AD.1.SG+FUT+2+SG
convir-me	convir+V.eu.AD.1.SG+INF
convir-me	convir+V.eu.AD.1.SG+INF+1+SG
convir-me	convir+V.eu.AD.1.SG+INF+3+SG
convir-me-ei	convir+V.eu.AD.1.SG+FUT+1+SG
convir-me-eis	convir+V.eu.AD.1.SG+FUT+2+PL
convir-me-emos	convir+V.eu.AD.1.SG+FUT+1+PL
convir-me-ia	convir+V.eu.AD.1.SG+COND+1+SG
convir-me-ia	convir+V.eu.AD.1.SG+COND+3+SG
convir-me-iam	convir+V.eu.AD.1.SG+COND+3+PL
convir-me-íamos	convir+V.eu.AD.1.SG+COND+1+PL
convir-me-ias	convir+V.eu.AD.1.SG+COND+2+SG
convir-me-íeis	convir+V.eu.AD.1.SG+COND+2+PL
convirmo-la	convir+V.ele.ACC.3.F.SG+INF+1+PL
convirmo-las	convir+V.ele.ACC.3.F.PL+INF+1+PL
convirmo-lo	convir+V.ele.ACC.3.M.SG+INF+1+PL
convirmo-los	convir+V.ele.ACC.3.M.PL+INF+1+PL
convirmo-nos	convir+nós.AD.1.PL+INF+1+PL
convirmos-lhe	convir+V.ele.DAT.3.SG+INF+1+PL
convirmos-lhes	convir+V.ele.DAT.3.PL+INF+1+PL
convirmos-me	convir+V.eu.AD.1.SG+INF+1+PL
convirmos-te	convir+V.tu.AD.2.SG+INF+1+PL
convirmos-vos	convir+V.vós.AD.2.PL+INF+1+PL
convir-nos-á	convir+nós.AD.1.PL+FUT+3+SG
convir-nos-ão	convir+nós.AD.1.PL+FUT+3+PL
convir-nos-ás	convir+nós.AD.1.PL+FUT+2+SG
convir-nos	convir+nós.AD.1.PL+INF
convir-nos	convir+nós.AD.1.PL+INF+1+SG
convir-nos	convir+nós.AD.1.PL+INF+3+SG
convir-nos-ei	convir+nós.AD.1.PL+FUT+1+SG
convir-nos-eis	convir+nós.AD.1.PL+FUT+2+PL
convir-nos-emos	convir+nós.AD.1.PL+FUT+1+PL
convir-nos-ia	convir+nós.AD.1.PL+COND+1+SG
convir-nos-ia	convir+nós.AD.1.PL+COND+3+SG
convir-nos-iam	convir+nós.AD.1.PL+COND+3+PL
convir-nos-íamos	convir+nós.AD.1.PL+COND+1+PL
convir-nos-ias	convir+nós.AD.1.PL+COND+2+SG
convir-nos-íeis	convir+nós.AD.1.PL+COND+2+PL
convir-se-á	convir+V.ele.REFL+FUT+3+SG
convir-se-ão	convir+V.ele.REFL+FUT+3+PL
convir-se	convir+V.ele.REFL+INF
convir-se	convir+V.ele.REFL+INF+3+SG
convir-se-ia	convir+V.ele.REFL+COND+3+SG
convir-se-iam	convir+V.ele.REFL+COND+3+PL
convir-te-á	convir+V.tu.AD.2.SG+FUT+3+SG
convir-te-ão	convir+V.tu.AD.2.SG+FUT+3+PL
convir-te-ás	convir+V.tu.AD.2.SG+FUT+2+SG
convir-te	convir+V.tu.AD.2.SG+INF
convir-te	convir+V.tu.AD.2.SG+INF+1+SG
convir-te	convir+V.tu.AD.2.SG+INF+3+SG
convir-te-ei	convir+V.tu.AD.2.SG+FUT+1+SG
convir-te-eis	convir+V.tu.AD.2.SG+FUT+2+PL
convir-te-emos	convir+V.tu.AD.2.SG+FUT+1+PL
convir-te-ia	convir+V.tu.AD.2.SG+COND+1+SG
convir-te-ia	convir+V.tu.AD.2.SG+COND+3+SG
convir-te-iam	convir+V.tu.AD.2.SG+COND+3+PL
convir-te-íamos	convir+V.tu.AD.2.SG+COND+1+PL
convir-te-ias	convir+V.tu.AD.2.SG+COND+2+SG
convir-te-íeis	convir+V.tu.AD.2.SG+COND+2+PL
convir-vos-á	convir+V.vós.AD.2.PL+FUT+3+SG
convir-vos-ão	convir+V.vós.AD.2.PL+FUT+3+PL
convir-vos-ás	convir+V.vós.AD.2.PL+FUT+2+SG
convir-vos	convir+V.vós.AD.2.PL+INF
convir-vos	convir+V.vós.AD.2.PL+INF+1+SG
convir-vos	convir+V.vós.AD.2.PL+INF+3+SG
convir-vos-ei	convir+V.vós.AD.2.PL+FUT+1+SG
convir-vos-eis	convir+V.vós.AD.2.PL+FUT+2+PL
convir-vos-emos	convir+V.vós.AD.2.PL+FUT+1+PL
convir-vos-ia	convir+V.vós.AD.2.PL+COND+1+SG
convir-vos-ia	convir+V.vós.AD.2.PL+COND+3+SG
convir-vos-iam	convir+V.vós.AD.2.PL+COND+3+PL
convir-vos-íamos	convir+V.vós.AD.2.PL+COND+1+PL
convir-vos-ias	convir+V.vós.AD.2.PL+COND+2+SG
convir-vos-íeis	convir+V.vós.AD.2.PL+COND+2+PL
conviva-a	conviver+V.ele.ACC.3.F.SG+IMP+3+SG
conviva-as	conviver+V.ele.ACC.3.F.PL+IMP+3+SG
conviva-lhe	conviver+V.ele.DAT.3.SG+IMP+3+SG
conviva-lhes	conviver+V.ele.DAT.3.PL+IMP+3+SG
conviva-me	conviver+V.eu.AD.1.SG+IMP+3+SG
convivam-lhe	conviver+V.ele.DAT.3.SG+IMP+3+PL
convivam-lhes	conviver+V.ele.DAT.3.PL+IMP+3+PL
convivam-me	conviver+V.eu.AD.1.SG+IMP+3+PL
convivam-na	conviver+V.ele.ACC.3.F.SG+IMP+3+PL
convivam-nas	conviver+V.ele.ACC.3.F.PL+IMP+3+PL
convivam-no	conviver+V.ele.ACC.3.M.SG+IMP+3+PL
convivam-nos	conviver+V.ele.ACC.3.M.PL+IMP+3+PL
convivam-nos	conviver+V.nós.AD.1.PL+IMP+3+PL
convivamo-la	conviver+V.ele.ACC.3.F.SG+IMP+1+PL
convivamo-las	conviver+V.ele.ACC.3.F.PL+IMP+1+PL
convivamo-lo	conviver+V.ele.ACC.3.M.SG+IMP+1+PL
convivamo-los	conviver+V.ele.ACC.3.M.PL+IMP+1+PL
convivamo-nos	conviver+nós.AD.1.PL+IMP+1+PL
convivamos-lhe	conviver+V.ele.DAT.3.SG+IMP+1+PL
convivamos-lhes	conviver+V.ele.DAT.3.PL+IMP+1+PL
convivamos-me	conviver+V.eu.AD.1.SG+IMP+1+PL
convivamos-te	conviver+V.tu.AD.2.SG+IMP+1+PL
convivamos-vos	conviver+V.vós.AD.2.PL+IMP+1+PL
convivam-se	conviver+V.ele.REFL+IMP+3+PL
convivam-te	conviver+V.tu.AD.2.SG+IMP+3+PL
convivam-vos	conviver+V.vós.AD.2.PL+IMP+3+PL
conviva-nos	conviver+nós.AD.1.PL+IMP+3+SG
conviva-o	conviver+V.ele.ACC.3.M.SG+IMP+3+SG
conviva-os	conviver+V.ele.ACC.3.M.PL+IMP+3+SG
conviva-se	conviver+V.ele.REFL+IMP+3+SG
conviva-te	conviver+V.tu.AD.2.SG+IMP+3+SG
conviva-vos	conviver+V.vós.AD.2.PL+IMP+3+SG
convive-a	conviver+V.ele.ACC.3.F.SG+PRS+3+SG
convive-as	conviver+V.ele.ACC.3.F.PL+PRS+3+SG
convivei-la	conviver+V.ele.ACC.3.F.SG+PRS+2+PL
convivei-las	conviver+V.ele.ACC.3.F.PL+PRS+2+PL
convivei-lo	conviver+V.ele.ACC.3.M.SG+PRS+2+PL
convivei-los	conviver+V.ele.ACC.3.M.PL+PRS+2+PL
convivei-nos	conviver+nós.AD.1.PL+PRS+2+PL
conviveis-lhe	conviver+V.ele.DAT.3.SG+PRS+2+PL
conviveis-lhes	conviver+V.ele.DAT.3.PL+PRS+2+PL
conviveis-me	conviver+V.eu.AD.1.SG+PRS+2+PL
conviveis-te	conviver+V.tu.AD.2.SG+PRS+2+PL
conviveis-vos	conviver+V.vós.AD.2.PL+PRS+2+PL
convivê-la-á	conviver+V.ele.ACC.3.F.SG+FUT+3+SG
convivê-la-ão	conviver+V.ele.ACC.3.F.SG+FUT+3+PL
convivê-la-ás	conviver+V.ele.ACC.3.F.SG+FUT+2+SG
convivê-la	conviver+V.ele.ACC.3.F.SG+INF
convivê-la	conviver+V.ele.ACC.3.F.SG+INF+1+SG
convivê-la	conviver+V.ele.ACC.3.F.SG+INF+3+SG
convive-la	conviver+V.ele.ACC.3.F.SG+PRS+2+SG
convivê-la	conviver+V.ele.ACC.3.F.SG+SBJF+1+SG
convivê-la	conviver+V.ele.ACC.3.F.SG+SBJF+3+SG
convivê-la-ei	conviver+V.ele.ACC.3.F.SG+FUT+1+SG
convivê-la-eis	conviver+V.ele.ACC.3.F.SG+FUT+2+PL
convivê-la-emos	conviver+V.ele.ACC.3.F.SG+FUT+1+PL
convivê-la-ia	conviver+V.ele.ACC.3.F.SG+COND+1+SG
convivê-la-ia	conviver+V.ele.ACC.3.F.SG+COND+3+SG
convivê-la-iam	conviver+V.ele.ACC.3.F.SG+COND+3+PL
convivê-la-íamos	conviver+V.ele.ACC.3.F.SG+COND+1+PL
convivê-la-ias	conviver+V.ele.ACC.3.F.SG+COND+2+SG
convivê-la-íeis	conviver+V.ele.ACC.3.F.SG+COND+2+PL
convivê-las-á	conviver+V.ele.ACC.3.F.PL+FUT+3+SG
convivê-las-ão	conviver+V.ele.ACC.3.F.PL+FUT+3+PL
convivê-las-ás	conviver+V.ele.ACC.3.F.PL+FUT+2+SG
convivê-las	conviver+V.ele.ACC.3.F.PL+INF
convivê-las	conviver+V.ele.ACC.3.F.PL+INF+1+SG
convivê-las	conviver+V.ele.ACC.3.F.PL+INF+3+SG
convive-las	conviver+V.ele.ACC.3.F.PL+PRS+2+SG
convivê-las	conviver+V.ele.ACC.3.F.PL+SBJF+1+SG
convivê-las	conviver+V.ele.ACC.3.F.PL+SBJF+3+SG
convivê-las-ei	conviver+V.ele.ACC.3.F.PL+FUT+1+SG
convivê-las-eis	conviver+V.ele.ACC.3.F.PL+FUT+2+PL
convivê-las-emos	conviver+V.ele.ACC.3.F.PL+FUT+1+PL
convivê-las-ia	conviver+V.ele.ACC.3.F.PL+COND+1+SG
convivê-las-ia	conviver+V.ele.ACC.3.F.PL+COND+3+SG
convivê-las-iam	conviver+V.ele.ACC.3.F.PL+COND+3+PL
convivê-las-íamos	conviver+V.ele.ACC.3.F.PL+COND+1+PL
convivê-las-ias	conviver+V.ele.ACC.3.F.PL+COND+2+SG
convivê-las-íeis	conviver+V.ele.ACC.3.F.PL+COND+2+PL
convive-lhe	conviver+V.ele.DAT.3.SG+PRS+3+SG
convive-lhes	conviver+V.ele.DAT.3.PL+PRS+3+SG
convivê-lo-á	conviver+V.ele.ACC.3.M.SG+FUT+3+SG
convivê-lo-ão	conviver+V.ele.ACC.3.M.SG+FUT+3+PL
convivê-lo-ás	conviver+V.ele.ACC.3.M.SG+FUT+2+SG
convivê-lo	conviver+V.ele.ACC.3.M.SG+INF
convivê-lo	conviver+V.ele.ACC.3.M.SG+INF+1+SG
convivê-lo	conviver+V.ele.ACC.3.M.SG+INF+3+SG
convive-lo	conviver+V.ele.ACC.3.M.SG+PRS+2+SG
convivê-lo	conviver+V.ele.ACC.3.M.SG+SBJF+1+SG
convivê-lo	conviver+V.ele.ACC.3.M.SG+SBJF+3+SG
convivê-lo-ei	conviver+V.ele.ACC.3.M.SG+FUT+1+SG
convivê-lo-eis	conviver+V.ele.ACC.3.M.SG+FUT+2+PL
convivê-lo-emos	conviver+V.ele.ACC.3.M.SG+FUT+1+PL
convivê-lo-ia	conviver+V.ele.ACC.3.M.SG+COND+1+SG
convivê-lo-ia	conviver+V.ele.ACC.3.M.SG+COND+3+SG
convivê-lo-iam	conviver+V.ele.ACC.3.M.SG+COND+3+PL
convivê-lo-íamos	conviver+V.ele.ACC.3.M.SG+COND+1+PL
convivê-lo-ias	conviver+V.ele.ACC.3.M.SG+COND+2+SG
convivê-lo-íeis	conviver+V.ele.ACC.3.M.SG+COND+2+PL
convivê-los-á	conviver+V.ele.ACC.3.M.PL+FUT+3+SG
convivê-los-ão	conviver+V.ele.ACC.3.M.PL+FUT+3+PL
convivê-los-ás	conviver+V.ele.ACC.3.M.PL+FUT+2+SG
convivê-los	conviver+V.ele.ACC.3.M.PL+INF
convivê-los	conviver+V.ele.ACC.3.M.PL+INF+1+SG
convivê-los	conviver+V.ele.ACC.3.M.PL+INF+3+SG
convive-los	conviver+V.ele.ACC.3.M.PL+PRS+2+SG
convivê-los	conviver+V.ele.ACC.3.M.PL+SBJF+1+SG
convivê-los	conviver+V.ele.ACC.3.M.PL+SBJF+3+SG
convivê-los-ei	conviver+V.ele.ACC.3.M.PL+FUT+1+SG
convivê-los-eis	conviver+V.ele.ACC.3.M.PL+FUT+2+PL
convivê-los-emos	conviver+V.ele.ACC.3.M.PL+FUT+1+PL
convivê-los-ia	conviver+V.ele.ACC.3.M.PL+COND+1+SG
convivê-los-ia	conviver+V.ele.ACC.3.M.PL+COND+3+SG
convivê-los-iam	conviver+V.ele.ACC.3.M.PL+COND+3+PL
convivê-los-íamos	conviver+V.ele.ACC.3.M.PL+COND+1+PL
convivê-los-ias	conviver+V.ele.ACC.3.M.PL+COND+2+SG
convivê-los-íeis	conviver+V.ele.ACC.3.M.PL+COND+2+PL
convive-me	conviver+V.eu.AD.1.SG+PRS+3+SG
convivem-lhe	conviver+V.ele.DAT.3.SG+PRS+3+PL
convivem-lhes	conviver+V.ele.DAT.3.PL+PRS+3+PL
convivem-me	conviver+V.eu.AD.1.SG+PRS+3+PL
convivem-na	conviver+V.ele.ACC.3.F.SG+PRS+3+PL
convivem-nas	conviver+V.ele.ACC.3.F.PL+PRS+3+PL
convivem-no	conviver+V.ele.ACC.3.M.SG+PRS+3+PL
convivem-nos	conviver+V.ele.ACC.3.M.PL+PRS+3+PL
convivem-nos	conviver+V.nós.AD.1.PL+PRS+3+PL
convivemo-la	conviver+V.ele.ACC.3.F.SG+PRF+1+PL
convivemo-la	conviver+V.ele.ACC.3.F.SG+PRS+1+PL
convivemo-las	conviver+V.ele.ACC.3.F.PL+PRF+1+PL
convivemo-las	conviver+V.ele.ACC.3.F.PL+PRS+1+PL
convivemo-lo	conviver+V.ele.ACC.3.M.SG+PRF+1+PL
convivemo-lo	conviver+V.ele.ACC.3.M.SG+PRS+1+PL
convivemo-los	conviver+V.ele.ACC.3.M.PL+PRF+1+PL
convivemo-los	conviver+V.ele.ACC.3.M.PL+PRS+1+PL
convivemo-nos	conviver+nós.AD.1.PL+PRF+1+PL
convivemo-nos	conviver+nós.AD.1.PL+PRS+1+PL
convivemos-lhe	conviver+V.ele.DAT.3.SG+PRF+1+PL
convivemos-lhe	conviver+V.ele.DAT.3.SG+PRS+1+PL
convivemos-lhes	conviver+V.ele.DAT.3.PL+PRF+1+PL
convivemos-lhes	conviver+V.ele.DAT.3.PL+PRS+1+PL
convivemos-me	conviver+V.eu.AD.1.SG+PRF+1+PL
convivemos-me	conviver+V.eu.AD.1.SG+PRS+1+PL
convivemos-te	conviver+V.tu.AD.2.SG+PRF+1+PL
convivemos-te	conviver+V.tu.AD.2.SG+PRS+1+PL
convivemos-vos	conviver+V.vós.AD.2.PL+PRF+1+PL
convivemos-vos	conviver+V.vós.AD.2.PL+PRS+1+PL
convivem-se	conviver+V.ele.REFL+PRS+3+PL
convivem-te	conviver+V.tu.AD.2.SG+PRS+3+PL
convivem-vos	conviver+V.vós.AD.2.PL+PRS+3+PL
convivendo-a	conviver+V.ele.ACC.3.F.SG+GRD
convivendo-as	conviver+V.ele.ACC.3.F.PL+GRD
convivendo-lhe	conviver+V.ele.DAT.3.SG+GRD
convivendo-lhes	conviver+V.ele.DAT.3.PL+GRD
convivendo-me	conviver+V.eu.AD.1.SG+GRD
convivendo-nos	conviver+nós.AD.1.PL+GRD
convivendo-o	conviver+V.ele.ACC.3.M.SG+GRD
convivendo-os	conviver+V.ele.ACC.3.M.PL+GRD
convivendo-se	conviver+V.ele.REFL+GRD
convivendo-te	conviver+V.tu.AD.2.SG+GRD
convivendo-vos	conviver+V.vós.AD.2.PL+GRD
convive-nos	conviver+nós.AD.1.PL+PRS+2+SG
convive-nos	conviver+nós.AD.1.PL+PRS+3+SG
convive-o	conviver+V.ele.ACC.3.M.SG+PRS+3+SG
convive-os	conviver+V.ele.ACC.3.M.PL+PRS+3+SG
convivera-a	conviver+V.ele.ACC.3.F.SG+PQP+1+SG
convivera-a	conviver+V.ele.ACC.3.F.SG+PQP+3+SG
convivera-as	conviver+V.ele.ACC.3.F.PL+PQP+1+SG
convivera-as	conviver+V.ele.ACC.3.F.PL+PQP+3+SG
convivera-la	conviver+V.ele.ACC.3.F.SG+PQP+2+SG
convivera-las	conviver+V.ele.ACC.3.F.PL+PQP+2+SG
convivera-lhe	conviver+V.ele.DAT.3.SG+PQP+1+SG
convivera-lhe	conviver+V.ele.DAT.3.SG+PQP+3+SG
convivera-lhes	conviver+V.ele.DAT.3.PL+PQP+1+SG
convivera-lhes	conviver+V.ele.DAT.3.PL+PQP+3+SG
convivera-lo	conviver+V.ele.ACC.3.M.SG+PQP+2+SG
convivera-los	conviver+V.ele.ACC.3.M.PL+PQP+2+SG
convivera-me	conviver+V.eu.AD.1.SG+PQP+1+SG
convivera-me	conviver+V.eu.AD.1.SG+PQP+3+SG
conviveram-lhe	conviver+V.ele.DAT.3.SG+PQP+3+PL
conviveram-lhe	conviver+V.ele.DAT.3.SG+PRF+3+PL
conviveram-lhes	conviver+V.ele.DAT.3.PL+PQP+3+PL
conviveram-lhes	conviver+V.ele.DAT.3.PL+PRF+3+PL
conviveram-me	conviver+V.eu.AD.1.SG+PQP+3+PL
conviveram-me	conviver+V.eu.AD.1.SG+PRF+3+PL
conviveram-na	conviver+V.ele.ACC.3.F.SG+PQP+3+PL
conviveram-na	conviver+V.ele.ACC.3.F.SG+PRF+3+PL
conviveram-nas	conviver+V.ele.ACC.3.F.PL+PQP+3+PL
conviveram-nas	conviver+V.ele.ACC.3.F.PL+PRF+3+PL
conviveram-no	conviver+V.ele.ACC.3.M.SG+PQP+3+PL
conviveram-no	conviver+V.ele.ACC.3.M.SG+PRF+3+PL
conviveram-nos	conviver+V.ele.ACC.3.M.PL+PQP+3+PL
conviveram-nos	conviver+V.ele.ACC.3.M.PL+PRF+3+PL
conviveram-nos	conviver+V.nós.AD.1.PL+PQP+3+PL
conviveram-nos	conviver+V.nós.AD.1.PL+PRF+3+PL
convivêramo-la	conviver+V.ele.ACC.3.F.SG+PQP+1+PL
convivêramo-las	conviver+V.ele.ACC.3.F.PL+PQP+1+PL
convivêramo-lo	conviver+V.ele.ACC.3.M.SG+PQP+1+PL
convivêramo-los	conviver+V.ele.ACC.3.M.PL+PQP+1+PL
convivêramo-nos	conviver+nós.AD.1.PL+PQP+1+PL
convivêramos-lhe	conviver+V.ele.DAT.3.SG+PQP+1+PL
convivêramos-lhes	conviver+V.ele.DAT.3.PL+PQP+1+PL
convivêramos-me	conviver+V.eu.AD.1.SG+PQP+1+PL
convivêramos-te	conviver+V.tu.AD.2.SG+PQP+1+PL
convivêramos-vos	conviver+V.vós.AD.2.PL+PQP+1+PL
conviveram-se	conviver+V.ele.REFL+PQP+3+PL
conviveram-se	conviver+V.ele.REFL+PRF+3+PL
conviveram-te	conviver+V.tu.AD.2.SG+PQP+3+PL
conviveram-te	conviver+V.tu.AD.2.SG+PRF+3+PL
conviveram-vos	conviver+V.vós.AD.2.PL+PQP+3+PL
conviveram-vos	conviver+V.vós.AD.2.PL+PRF+3+PL
convivera-nos	conviver+nós.AD.1.PL+PQP+1+SG
convivera-nos	conviver+nós.AD.1.PL+PQP+2+SG
convivera-nos	conviver+nós.AD.1.PL+PQP+3+SG
convivera-o	conviver+V.ele.ACC.3.M.SG+PQP+1+SG
convivera-o	conviver+V.ele.ACC.3.M.SG+PQP+3+SG
convivera-os	conviver+V.ele.ACC.3.M.PL+PQP+1+SG
convivera-os	conviver+V.ele.ACC.3.M.PL+PQP+3+SG
convivera-se	conviver+V.ele.REFL+PQP+3+SG
conviveras-lhe	conviver+V.ele.DAT.3.SG+PQP+2+SG
conviveras-lhes	conviver+V.ele.DAT.3.PL+PQP+2+SG
conviveras-me	conviver+V.eu.AD.1.SG+PQP+2+SG
conviveras-te	conviver+V.tu.AD.2.SG+PQP+2+SG
conviveras-vos	conviver+V.vós.AD.2.PL+PQP+2+SG
convivera-te	conviver+V.tu.AD.2.SG+PQP+1+SG
convivera-te	conviver+V.tu.AD.2.SG+PQP+3+SG
convivera-vos	conviver+V.vós.AD.2.PL+PQP+1+SG
convivera-vos	conviver+V.vós.AD.2.PL+PQP+3+SG
conviverde-la	conviver+V.ele.ACC.3.F.SG+INF+2+PL
conviverde-la	conviver+V.ele.ACC.3.F.SG+SBJF+2+PL
conviverde-las	conviver+V.ele.ACC.3.F.PL+INF+2+PL
conviverde-las	conviver+V.ele.ACC.3.F.PL+SBJF+2+PL
conviverde-lo	conviver+V.ele.ACC.3.M.SG+INF+2+PL
conviverde-lo	conviver+V.ele.ACC.3.M.SG+SBJF+2+PL
conviverde-los	conviver+V.ele.ACC.3.M.PL+INF+2+PL
conviverde-los	conviver+V.ele.ACC.3.M.PL+SBJF+2+PL
conviverde-nos	conviver+nós.AD.1.PL+INF+2+PL
conviverde-nos	conviver+nós.AD.1.PL+SBJF+2+PL
conviverdes-lhe	conviver+V.ele.DAT.3.SG+INF+2+PL
conviverdes-lhe	conviver+V.ele.DAT.3.SG+SBJF+2+PL
conviverdes-lhes	conviver+V.ele.DAT.3.PL+INF+2+PL
conviverdes-lhes	conviver+V.ele.DAT.3.PL+SBJF+2+PL
conviverdes-me	conviver+V.eu.AD.1.SG+INF+2+PL
conviverdes-me	conviver+V.eu.AD.1.SG+SBJF+2+PL
conviverdes-te	conviver+V.tu.AD.2.SG+INF+2+PL
conviverdes-te	conviver+V.tu.AD.2.SG+SBJF+2+PL
conviverdes-vos	conviver+V.vós.AD.2.PL+INF+2+PL
conviverdes-vos	conviver+V.vós.AD.2.PL+SBJF+2+PL
convivêrei-la	conviver+V.ele.ACC.3.F.SG+PQP+2+PL
convivêrei-las	conviver+V.ele.ACC.3.F.PL+PQP+2+PL
convivêrei-lo	conviver+V.ele.ACC.3.M.SG+PQP+2+PL
convivêrei-los	conviver+V.ele.ACC.3.M.PL+PQP+2+PL
convivêrei-nos	conviver+nós.AD.1.PL+PQP+2+PL
convivêreis-lhe	conviver+V.ele.DAT.3.SG+PQP+2+PL
convivêreis-lhes	conviver+V.ele.DAT.3.PL+PQP+2+PL
convivêreis-me	conviver+V.eu.AD.1.SG+PQP+2+PL
convivêreis-te	conviver+V.tu.AD.2.SG+PQP+2+PL
convivêreis-vos	conviver+V.vós.AD.2.PL+PQP+2+PL
convivere-la	conviver+V.ele.ACC.3.F.SG+INF+2+SG
convivere-la	conviver+V.ele.ACC.3.F.SG+SBJF+2+SG
convivere-las	conviver+V.ele.ACC.3.F.PL+INF+2+SG
convivere-las	conviver+V.ele.ACC.3.F.PL+SBJF+2+SG
convivere-lo	conviver+V.ele.ACC.3.M.SG+INF+2+SG
convivere-lo	conviver+V.ele.ACC.3.M.SG+SBJF+2+SG
convivere-los	conviver+V.ele.ACC.3.M.PL+INF+2+SG
convivere-los	conviver+V.ele.ACC.3.M.PL+SBJF+2+SG
conviverem-lhe	conviver+V.ele.DAT.3.SG+INF+3+PL
conviverem-lhe	conviver+V.ele.DAT.3.SG+SBJF+3+PL
conviverem-lhes	conviver+V.ele.DAT.3.PL+INF+3+PL
conviverem-lhes	conviver+V.ele.DAT.3.PL+SBJF+3+PL
conviverem-me	conviver+V.eu.AD.1.SG+INF+3+PL
conviverem-me	conviver+V.eu.AD.1.SG+SBJF+3+PL
conviverem-na	conviver+V.ele.ACC.3.F.SG+INF+3+PL
conviverem-na	conviver+V.ele.ACC.3.F.SG+SBJF+3+PL
conviverem-nas	conviver+V.ele.ACC.3.F.PL+INF+3+PL
conviverem-nas	conviver+V.ele.ACC.3.F.PL+SBJF+3+PL
conviverem-no	conviver+V.ele.ACC.3.M.SG+INF+3+PL
conviverem-no	conviver+V.ele.ACC.3.M.SG+SBJF+3+PL
conviverem-nos	conviver+V.ele.ACC.3.M.PL+INF+3+PL
conviverem-nos	conviver+V.ele.ACC.3.M.PL+SBJF+3+PL
conviverem-nos	conviver+V.nós.AD.1.PL+INF+3+PL
conviverem-nos	conviver+V.nós.AD.1.PL+SBJF+3+PL
conviverem-se	conviver+V.ele.REFL+INF+3+PL
conviverem-se	conviver+V.ele.REFL+SBJF+3+PL
conviverem-te	conviver+V.tu.AD.2.SG+INF+3+PL
conviverem-te	conviver+V.tu.AD.2.SG+SBJF+3+PL
conviverem-vos	conviver+V.vós.AD.2.PL+INF+3+PL
conviverem-vos	conviver+V.vós.AD.2.PL+SBJF+3+PL
convivere-nos	conviver+nós.AD.1.PL+INF+2+SG
convivere-nos	conviver+nós.AD.1.PL+SBJF+2+SG
conviveres-lhe	conviver+V.ele.DAT.3.SG+INF+2+SG
conviveres-lhe	conviver+V.ele.DAT.3.SG+SBJF+2+SG
conviveres-lhes	conviver+V.ele.DAT.3.PL+INF+2+SG
conviveres-lhes	conviver+V.ele.DAT.3.PL+SBJF+2+SG
conviveres-me	conviver+V.eu.AD.1.SG+INF+2+SG
conviveres-me	conviver+V.eu.AD.1.SG+SBJF+2+SG
conviveres-te	conviver+V.tu.AD.2.SG+INF+2+SG
conviveres-te	conviver+V.tu.AD.2.SG+SBJF+2+SG
conviveres-vos	conviver+V.vós.AD.2.PL+INF+2+SG
conviveres-vos	conviver+V.vós.AD.2.PL+SBJF+2+SG
conviver-lhe-á	conviver+V.ele.DAT.3.SG+FUT+3+SG
conviver-lhe-ão	conviver+V.ele.DAT.3.SG+FUT+3+PL
conviver-lhe-ás	conviver+V.ele.DAT.3.SG+FUT+2+SG
conviver-lhe	conviver+V.ele.DAT.3.SG+INF
conviver-lhe	conviver+V.ele.DAT.3.SG+INF+1+SG
conviver-lhe	conviver+V.ele.DAT.3.SG+INF+3+SG
conviver-lhe	conviver+V.ele.DAT.3.SG+SBJF+1+SG
conviver-lhe	conviver+V.ele.DAT.3.SG+SBJF+3+SG
conviver-lhe-ei	conviver+V.ele.DAT.3.SG+FUT+1+SG
conviver-lhe-eis	conviver+V.ele.DAT.3.SG+FUT+2+PL
conviver-lhe-emos	conviver+V.ele.DAT.3.SG+FUT+1+PL
conviver-lhe-ia	conviver+V.ele.DAT.3.SG+COND+1+SG
conviver-lhe-ia	conviver+V.ele.DAT.3.SG+COND+3+SG
conviver-lhe-iam	conviver+V.ele.DAT.3.SG+COND+3+PL
conviver-lhe-íamos	conviver+V.ele.DAT.3.SG+COND+1+PL
conviver-lhe-ias	conviver+V.ele.DAT.3.SG+COND+2+SG
conviver-lhe-íeis	conviver+V.ele.DAT.3.SG+COND+2+PL
conviver-lhes-á	conviver+V.ele.DAT.3.PL+FUT+3+SG
conviver-lhes-ão	conviver+V.ele.DAT.3.PL+FUT+3+PL
conviver-lhes-ás	conviver+V.ele.DAT.3.PL+FUT+2+SG
conviver-lhes	conviver+V.ele.DAT.3.PL+INF
conviver-lhes	conviver+V.ele.DAT.3.PL+INF+1+SG
conviver-lhes	conviver+V.ele.DAT.3.PL+INF+3+SG
conviver-lhes	conviver+V.ele.DAT.3.PL+SBJF+1+SG
conviver-lhes	conviver+V.ele.DAT.3.PL+SBJF+3+SG
conviver-lhes-ei	conviver+V.ele.DAT.3.PL+FUT+1+SG
conviver-lhes-eis	conviver+V.ele.DAT.3.PL+FUT+2+PL
conviver-lhes-emos	conviver+V.ele.DAT.3.PL+FUT+1+PL
conviver-lhes-ia	conviver+V.ele.DAT.3.PL+COND+1+SG
conviver-lhes-ia	conviver+V.ele.DAT.3.PL+COND+3+SG
conviver-lhes-iam	conviver+V.ele.DAT.3.PL+COND+3+PL
conviver-lhes-íamos	conviver+V.ele.DAT.3.PL+COND+1+PL
conviver-lhes-ias	conviver+V.ele.DAT.3.PL+COND+2+SG
conviver-lhes-íeis	conviver+V.ele.DAT.3.PL+COND+2+PL
conviver-me-á	conviver+V.eu.AD.1.SG+FUT+3+SG
conviver-me-ão	conviver+V.eu.AD.1.SG+FUT+3+PL
conviver-me-ás	conviver+V.eu.AD.1.SG+FUT+2+SG
conviver-me	conviver+V.eu.AD.1.SG+INF
conviver-me	conviver+V.eu.AD.1.SG+INF+1+SG
conviver-me	conviver+V.eu.AD.1.SG+INF+3+SG
conviver-me	conviver+V.eu.AD.1.SG+SBJF+1+SG
conviver-me	conviver+V.eu.AD.1.SG+SBJF+3+SG
conviver-me-ei	conviver+V.eu.AD.1.SG+FUT+1+SG
conviver-me-eis	conviver+V.eu.AD.1.SG+FUT+2+PL
conviver-me-emos	conviver+V.eu.AD.1.SG+FUT+1+PL
conviver-me-ia	conviver+V.eu.AD.1.SG+COND+1+SG
conviver-me-ia	conviver+V.eu.AD.1.SG+COND+3+SG
conviver-me-iam	conviver+V.eu.AD.1.SG+COND+3+PL
conviver-me-íamos	conviver+V.eu.AD.1.SG+COND+1+PL
conviver-me-ias	conviver+V.eu.AD.1.SG+COND+2+SG
conviver-me-íeis	conviver+V.eu.AD.1.SG+COND+2+PL
convivermo-la	conviver+V.ele.ACC.3.F.SG+INF+1+PL
convivermo-la	conviver+V.ele.ACC.3.F.SG+SBJF+1+PL
convivermo-las	conviver+V.ele.ACC.3.F.PL+INF+1+PL
convivermo-las	conviver+V.ele.ACC.3.F.PL+SBJF+1+PL
convivermo-lo	conviver+V.ele.ACC.3.M.SG+INF+1+PL
convivermo-lo	conviver+V.ele.ACC.3.M.SG+SBJF+1+PL
convivermo-los	conviver+V.ele.ACC.3.M.PL+INF+1+PL
convivermo-los	conviver+V.ele.ACC.3.M.PL+SBJF+1+PL
convivermo-nos	conviver+nós.AD.1.PL+INF+1+PL
convivermo-nos	conviver+nós.AD.1.PL+SBJF+1+PL
convivermos-lhe	conviver+V.ele.DAT.3.SG+INF+1+PL
convivermos-lhe	conviver+V.ele.DAT.3.SG+SBJF+1+PL
convivermos-lhes	conviver+V.ele.DAT.3.PL+INF+1+PL
convivermos-lhes	conviver+V.ele.DAT.3.PL+SBJF+1+PL
convivermos-me	conviver+V.eu.AD.1.SG+INF+1+PL
convivermos-me	conviver+V.eu.AD.1.SG+SBJF+1+PL
convivermos-te	conviver+V.tu.AD.2.SG+INF+1+PL
convivermos-te	conviver+V.tu.AD.2.SG+SBJF+1+PL
convivermos-vos	conviver+V.vós.AD.2.PL+INF+1+PL
convivermos-vos	conviver+V.vós.AD.2.PL+SBJF+1+PL
conviver-nos-á	conviver+nós.AD.1.PL+FUT+3+SG
conviver-nos-ão	conviver+nós.AD.1.PL+FUT+3+PL
conviver-nos-ás	conviver+nós.AD.1.PL+FUT+2+SG
conviver-nos	conviver+nós.AD.1.PL+INF
conviver-nos	conviver+nós.AD.1.PL+INF+1+SG
conviver-nos	conviver+nós.AD.1.PL+INF+3+SG
conviver-nos	conviver+nós.AD.1.PL+SBJF+1+SG
conviver-nos	conviver+nós.AD.1.PL+SBJF+3+SG
conviver-nos-ei	conviver+nós.AD.1.PL+FUT+1+SG
conviver-nos-eis	conviver+nós.AD.1.PL+FUT+2+PL
conviver-nos-emos	conviver+nós.AD.1.PL+FUT+1+PL
conviver-nos-ia	conviver+nós.AD.1.PL+COND+1+SG
conviver-nos-ia	conviver+nós.AD.1.PL+COND+3+SG
conviver-nos-iam	conviver+nós.AD.1.PL+COND+3+PL
conviver-nos-íamos	conviver+nós.AD.1.PL+COND+1+PL
conviver-nos-ias	conviver+nós.AD.1.PL+COND+2+SG
conviver-nos-íeis	conviver+nós.AD.1.PL+COND+2+PL
conviver-se-á	conviver+V.ele.REFL+FUT+3+SG
conviver-se-ão	conviver+V.ele.REFL+FUT+3+PL
conviver-se	conviver+V.ele.REFL+INF
conviver-se	conviver+V.ele.REFL+INF+3+SG
conviver-se	conviver+V.ele.REFL+SBJF+3+SG
conviver-se-ia	conviver+V.ele.REFL+COND+3+SG
conviver-se-iam	conviver+V.ele.REFL+COND+3+PL
conviver-te-á	conviver+V.tu.AD.2.SG+FUT+3+SG
conviver-te-ão	conviver+V.tu.AD.2.SG+FUT+3+PL
conviver-te-ás	conviver+V.tu.AD.2.SG+FUT+2+SG
conviver-te	conviver+V.tu.AD.2.SG+INF
conviver-te	conviver+V.tu.AD.2.SG+INF+1+SG
conviver-te	conviver+V.tu.AD.2.SG+INF+3+SG
conviver-te	conviver+V.tu.AD.2.SG+SBJF+1+SG
conviver-te	conviver+V.tu.AD.2.SG+SBJF+3+SG
conviver-te-ei	conviver+V.tu.AD.2.SG+FUT+1+SG
conviver-te-eis	conviver+V.tu.AD.2.SG+FUT+2+PL
conviver-te-emos	conviver+V.tu.AD.2.SG+FUT+1+PL
conviver-te-ia	conviver+V.tu.AD.2.SG+COND+1+SG
conviver-te-ia	conviver+V.tu.AD.2.SG+COND+3+SG
conviver-te-iam	conviver+V.tu.AD.2.SG+COND+3+PL
conviver-te-íamos	conviver+V.tu.AD.2.SG+COND+1+PL
conviver-te-ias	conviver+V.tu.AD.2.SG+COND+2+SG
conviver-te-íeis	conviver+V.tu.AD.2.SG+COND+2+PL
conviver-vos-á	conviver+V.vós.AD.2.PL+FUT+3+SG
conviver-vos-ão	conviver+V.vós.AD.2.PL+FUT+3+PL
conviver-vos-ás	conviver+V.vós.AD.2.PL+FUT+2+SG
conviver-vos	conviver+V.vós.AD.2.PL+INF
conviver-vos	conviver+V.vós.AD.2.PL+INF+1+SG
conviver-vos	conviver+V.vós.AD.2.PL+INF+3+SG
conviver-vos	conviver+V.vós.AD.2.PL+SBJF+1+SG
conviver-vos	conviver+V.vós.AD.2.PL+SBJF+3+SG
conviver-vos-ei	conviver+V.vós.AD.2.PL+FUT+1+SG
conviver-vos-eis	conviver+V.vós.AD.2.PL+FUT+2+PL
conviver-vos-emos	conviver+V.vós.AD.2.PL+FUT+1+PL
conviver-vos-ia	conviver+V.vós.AD.2.PL+COND+1+SG
conviver-vos-ia	conviver+V.vós.AD.2.PL+COND+3+SG
conviver-vos-iam	conviver+V.vós.AD.2.PL+COND+3+PL
conviver-vos-íamos	conviver+V.vós.AD.2.PL+COND+1+PL
conviver-vos-ias	conviver+V.vós.AD.2.PL+COND+2+SG
conviver-vos-íeis	conviver+V.vós.AD.2.PL+COND+2+PL
convive-se	conviver+V.ele.REFL+PRS+3+SG
convives-lhe	conviver+V.ele.DAT.3.SG+PRS+2+SG
convives-lhes	conviver+V.ele.DAT.3.PL+PRS+2+SG
convives-me	conviver+V.eu.AD.1.SG+PRS+2+SG
conviveste-a	conviver+V.ele.ACC.3.F.SG+PRF+2+SG
conviveste-as	conviver+V.ele.ACC.3.F.PL+PRF+2+SG
convives-te	conviver+V.tu.AD.2.SG+PRS+2+SG
conviveste-la	conviver+V.ele.ACC.3.F.SG+PRF+2+PL
conviveste-las	conviver+V.ele.ACC.3.F.PL+PRF+2+PL
conviveste-lhe	conviver+V.ele.DAT.3.SG+PRF+2+SG
conviveste-lhes	conviver+V.ele.DAT.3.PL+PRF+2+SG
conviveste-lo	conviver+V.ele.ACC.3.M.SG+PRF+2+PL
conviveste-los	conviver+V.ele.ACC.3.M.PL+PRF+2+PL
conviveste-me	conviver+V.eu.AD.1.SG+PRF+2+SG
conviveste-nos	conviver+nós.AD.1.PL+PRF+2+PL
conviveste-nos	conviver+nós.AD.1.PL+PRF+2+SG
conviveste-o	conviver+V.ele.ACC.3.M.SG+PRF+2+SG
conviveste-os	conviver+V.ele.ACC.3.M.PL+PRF+2+SG
convivestes-lhe	conviver+V.ele.DAT.3.SG+PRF+2+PL
convivestes-lhes	conviver+V.ele.DAT.3.PL+PRF+2+PL
convivestes-me	conviver+V.eu.AD.1.SG+PRF+2+PL
convivestes-te	conviver+V.tu.AD.2.SG+PRF+2+PL
convivestes-vos	conviver+V.vós.AD.2.PL+PRF+2+PL
conviveste-te	conviver+V.tu.AD.2.SG+PRF+2+SG
conviveste-vos	conviver+V.vós.AD.2.PL+PRF+2+SG
convives-vos	conviver+V.vós.AD.2.PL+PRS+2+SG
convive-te	conviver+V.tu.AD.2.SG+PRS+3+SG
conviveu-a	conviver+V.ele.ACC.3.F.SG+PRF+3+SG
conviveu-as	conviver+V.ele.ACC.3.F.PL+PRF+3+SG
conviveu-lhe	conviver+V.ele.DAT.3.SG+PRF+3+SG
conviveu-lhes	conviver+V.ele.DAT.3.PL+PRF+3+SG
conviveu-me	conviver+V.eu.AD.1.SG+PRF+3+SG
conviveu-nos	conviver+nós.AD.1.PL+PRF+3+SG
conviveu-o	conviver+V.ele.ACC.3.M.SG+PRF+3+SG
conviveu-os	conviver+V.ele.ACC.3.M.PL+PRF+3+SG
conviveu-se	conviver+V.ele.REFL+PRF+3+SG
conviveu-te	conviver+V.tu.AD.2.SG+PRF+3+SG
conviveu-vos	conviver+V.vós.AD.2.PL+PRF+3+SG
convive-vos	conviver+V.vós.AD.2.PL+PRS+3+SG
convivia-a	conviver+V.ele.ACC.3.F.SG+IMPF+1+SG
convivia-a	conviver+V.ele.ACC.3.F.SG+IMPF+3+SG
convivia-as	conviver+V.ele.ACC.3.F.PL+IMPF+1+SG
convivia-as	conviver+V.ele.ACC.3.F.PL+IMPF+3+SG
convivi-a	conviver+V.ele.ACC.3.F.SG+PRF+1+SG
convivia-la	conviver+V.ele.ACC.3.F.SG+IMPF+2+SG
convivia-las	conviver+V.ele.ACC.3.F.PL+IMPF+2+SG
