cortejar-nos	cortejar+nós.AD.1.PL+INF
cortejar-nos	cortejar+nós.AD.1.PL+INF+1+SG
cortejar-nos	cortejar+nós.AD.1.PL+INF+3+SG
cortejar-nos	cortejar+nós.AD.1.PL+SBJF+1+SG
cortejar-nos	cortejar+nós.AD.1.PL+SBJF+3+SG
cortejar-nos-ei	cortejar+nós.AD.1.PL+FUT+1+SG
cortejar-nos-eis	cortejar+nós.AD.1.PL+FUT+2+PL
cortejar-nos-emos	cortejar+nós.AD.1.PL+FUT+1+PL
cortejar-nos-ia	cortejar+nós.AD.1.PL+COND+1+SG
cortejar-nos-ia	cortejar+nós.AD.1.PL+COND+3+SG
cortejar-nos-iam	cortejar+nós.AD.1.PL+COND+3+PL
cortejar-nos-íamos	cortejar+nós.AD.1.PL+COND+1+PL
cortejar-nos-ias	cortejar+nós.AD.1.PL+COND+2+SG
cortejar-nos-íeis	cortejar+nós.AD.1.PL+COND+2+PL
cortejar-se-á	cortejar+V.ele.REFL+FUT+3+SG
cortejar-se-ão	cortejar+V.ele.REFL+FUT+3+PL
cortejar-se	cortejar+V.ele.REFL+INF
cortejar-se	cortejar+V.ele.REFL+INF+3+SG
cortejar-se	cortejar+V.ele.REFL+SBJF+3+SG
cortejar-se-ia	cortejar+V.ele.REFL+COND+3+SG
cortejar-se-iam	cortejar+V.ele.REFL+COND+3+PL
cortejar-te-á	cortejar+V.tu.AD.2.SG+FUT+3+SG
cortejar-te-ão	cortejar+V.tu.AD.2.SG+FUT+3+PL
cortejar-te-ás	cortejar+V.tu.AD.2.SG+FUT+2+SG
cortejar-te	cortejar+V.tu.AD.2.SG+INF
cortejar-te	cortejar+V.tu.AD.2.SG+INF+1+SG
cortejar-te	cortejar+V.tu.AD.2.SG+INF+3+SG
cortejar-te	cortejar+V.tu.AD.2.SG+SBJF+1+SG
cortejar-te	cortejar+V.tu.AD.2.SG+SBJF+3+SG
cortejar-te-ei	cortejar+V.tu.AD.2.SG+FUT+1+SG
cortejar-te-eis	cortejar+V.tu.AD.2.SG+FUT+2+PL
cortejar-te-emos	cortejar+V.tu.AD.2.SG+FUT+1+PL
cortejar-te-ia	cortejar+V.tu.AD.2.SG+COND+1+SG
cortejar-te-ia	cortejar+V.tu.AD.2.SG+COND+3+SG
cortejar-te-iam	cortejar+V.tu.AD.2.SG+COND+3+PL
cortejar-te-íamos	cortejar+V.tu.AD.2.SG+COND+1+PL
cortejar-te-ias	cortejar+V.tu.AD.2.SG+COND+2+SG
cortejar-te-íeis	cortejar+V.tu.AD.2.SG+COND+2+PL
cortejar-vos-á	cortejar+V.vós.AD.2.PL+FUT+3+SG
cortejar-vos-ão	cortejar+V.vós.AD.2.PL+FUT+3+PL
cortejar-vos-ás	cortejar+V.vós.AD.2.PL+FUT+2+SG
cortejar-vos	cortejar+V.vós.AD.2.PL+INF
cortejar-vos	cortejar+V.vós.AD.2.PL+INF+1+SG
cortejar-vos	cortejar+V.vós.AD.2.PL+INF+3+SG
cortejar-vos	cortejar+V.vós.AD.2.PL+SBJF+1+SG
cortejar-vos	cortejar+V.vós.AD.2.PL+SBJF+3+SG
cortejar-vos-ei	cortejar+V.vós.AD.2.PL+FUT+1+SG
cortejar-vos-eis	cortejar+V.vós.AD.2.PL+FUT+2+PL
cortejar-vos-emos	cortejar+V.vós.AD.2.PL+FUT+1+PL
cortejar-vos-ia	cortejar+V.vós.AD.2.PL+COND+1+SG
cortejar-vos-ia	cortejar+V.vós.AD.2.PL+COND+3+SG
cortejar-vos-iam	cortejar+V.vós.AD.2.PL+COND+3+PL
cortejar-vos-íamos	cortejar+V.vós.AD.2.PL+COND+1+PL
cortejar-vos-ias	cortejar+V.vós.AD.2.PL+COND+2+SG
cortejar-vos-íeis	cortejar+V.vós.AD.2.PL+COND+2+PL
corteja-se	cortejar+V.ele.REFL+PRS+3+SG
cortejas-lhe	cortejar+V.ele.DAT.3.SG+PRS+2+SG
cortejas-lhes	cortejar+V.ele.DAT.3.PL+PRS+2+SG
cortejas-me	cortejar+V.eu.AD.1.SG+PRS+2+SG
cortejaste-a	cortejar+V.ele.ACC.3.F.SG+PRF+2+SG
cortejaste-as	cortejar+V.ele.ACC.3.F.PL+PRF+2+SG
cortejas-te	cortejar+V.tu.AD.2.SG+PRS+2+SG
cortejaste-la	cortejar+V.ele.ACC.3.F.SG+PRF+2+PL
cortejaste-las	cortejar+V.ele.ACC.3.F.PL+PRF+2+PL
cortejaste-lhe	cortejar+V.ele.DAT.3.SG+PRF+2+SG
cortejaste-lhes	cortejar+V.ele.DAT.3.PL+PRF+2+SG
cortejaste-lo	cortejar+V.ele.ACC.3.M.SG+PRF+2+PL
cortejaste-los	cortejar+V.ele.ACC.3.M.PL+PRF+2+PL
cortejaste-me	cortejar+V.eu.AD.1.SG+PRF+2+SG
cortejaste-nos	cortejar+nós.AD.1.PL+PRF+2+PL
cortejaste-nos	cortejar+nós.AD.1.PL+PRF+2+SG
cortejaste-o	cortejar+V.ele.ACC.3.M.SG+PRF+2+SG
cortejaste-os	cortejar+V.ele.ACC.3.M.PL+PRF+2+SG
cortejastes-lhe	cortejar+V.ele.DAT.3.SG+PRF+2+PL
cortejastes-lhes	cortejar+V.ele.DAT.3.PL+PRF+2+PL
cortejastes-me	cortejar+V.eu.AD.1.SG+PRF+2+PL
cortejastes-te	cortejar+V.tu.AD.2.SG+PRF+2+PL
cortejastes-vos	cortejar+V.vós.AD.2.PL+PRF+2+PL
cortejaste-te	cortejar+V.tu.AD.2.SG+PRF+2+SG
cortejaste-vos	cortejar+V.vós.AD.2.PL+PRF+2+SG
cortejas-vos	cortejar+V.vós.AD.2.PL+PRS+2+SG
corteja-te	cortejar+V.tu.AD.2.SG+PRS+3+SG
cortejava-a	cortejar+V.ele.ACC.3.F.SG+IMPF+1+SG
cortejava-a	cortejar+V.ele.ACC.3.F.SG+IMPF+3+SG
cortejava-as	cortejar+V.ele.ACC.3.F.PL+IMPF+1+SG
cortejava-as	cortejar+V.ele.ACC.3.F.PL+IMPF+3+SG
cortejava-la	cortejar+V.ele.ACC.3.F.SG+IMPF+2+SG
cortejava-las	cortejar+V.ele.ACC.3.F.PL+IMPF+2+SG
cortejava-lhe	cortejar+V.ele.DAT.3.SG+IMPF+1+SG
cortejava-lhe	cortejar+V.ele.DAT.3.SG+IMPF+3+SG
cortejava-lhes	cortejar+V.ele.DAT.3.PL+IMPF+1+SG
cortejava-lhes	cortejar+V.ele.DAT.3.PL+IMPF+3+SG
cortejava-lo	cortejar+V.ele.ACC.3.M.SG+IMPF+2+SG
cortejava-los	cortejar+V.ele.ACC.3.M.PL+IMPF+2+SG
cortejava-me	cortejar+V.eu.AD.1.SG+IMPF+1+SG
cortejava-me	cortejar+V.eu.AD.1.SG+IMPF+3+SG
cortejavam-lhe	cortejar+V.ele.DAT.3.SG+IMPF+3+PL
cortejavam-lhes	cortejar+V.ele.DAT.3.PL+IMPF+3+PL
cortejavam-me	cortejar+V.eu.AD.1.SG+IMPF+3+PL
cortejavam-na	cortejar+V.ele.ACC.3.F.SG+IMPF+3+PL
cortejavam-nas	cortejar+V.ele.ACC.3.F.PL+IMPF+3+PL
cortejavam-no	cortejar+V.ele.ACC.3.M.SG+IMPF+3+PL
cortejavam-nos	cortejar+V.ele.ACC.3.M.PL+IMPF+3+PL
cortejavam-nos	cortejar+V.nós.AD.1.PL+IMPF+3+PL
cortejávamo-la	cortejar+V.ele.ACC.3.F.SG+IMPF+1+PL
cortejávamo-las	cortejar+V.ele.ACC.3.F.PL+IMPF+1+PL
cortejávamo-lo	cortejar+V.ele.ACC.3.M.SG+IMPF+1+PL
cortejávamo-los	cortejar+V.ele.ACC.3.M.PL+IMPF+1+PL
cortejávamo-nos	cortejar+nós.AD.1.PL+IMPF+1+PL
cortejávamos-lhe	cortejar+V.ele.DAT.3.SG+IMPF+1+PL
cortejávamos-lhes	cortejar+V.ele.DAT.3.PL+IMPF+1+PL
cortejávamos-me	cortejar+V.eu.AD.1.SG+IMPF+1+PL
cortejávamos-te	cortejar+V.tu.AD.2.SG+IMPF+1+PL
cortejávamos-vos	cortejar+V.vós.AD.2.PL+IMPF+1+PL
cortejavam-se	cortejar+V.ele.REFL+IMPF+3+PL
cortejavam-te	cortejar+V.tu.AD.2.SG+IMPF+3+PL
cortejavam-vos	cortejar+V.vós.AD.2.PL+IMPF+3+PL
cortejava-nos	cortejar+nós.AD.1.PL+IMPF+1+SG
cortejava-nos	cortejar+nós.AD.1.PL+IMPF+2+SG
cortejava-nos	cortejar+nós.AD.1.PL+IMPF+3+SG
cortejava-o	cortejar+V.ele.ACC.3.M.SG+IMPF+1+SG
cortejava-o	cortejar+V.ele.ACC.3.M.SG+IMPF+3+SG
cortejava-os	cortejar+V.ele.ACC.3.M.PL+IMPF+1+SG
cortejava-os	cortejar+V.ele.ACC.3.M.PL+IMPF+3+SG
cortejava-se	cortejar+V.ele.REFL+IMPF+1+SG
cortejava-se	cortejar+V.ele.REFL+IMPF+3+SG
cortejavas-lhe	cortejar+V.ele.DAT.3.SG+IMPF+2+SG
cortejavas-lhes	cortejar+V.ele.DAT.3.PL+IMPF+2+SG
cortejavas-me	cortejar+V.eu.AD.1.SG+IMPF+2+SG
cortejavas-te	cortejar+V.tu.AD.2.SG+IMPF+2+SG
cortejavas-vos	cortejar+V.vós.AD.2.PL+IMPF+2+SG
cortejava-te	cortejar+V.tu.AD.2.SG+IMPF+1+SG
cortejava-te	cortejar+V.tu.AD.2.SG+IMPF+3+SG
cortejava-vos	cortejar+V.vós.AD.2.PL+IMPF+1+SG
cortejava-vos	cortejar+V.vós.AD.2.PL+IMPF+3+SG
cortejávei-la	cortejar+V.ele.ACC.3.F.SG+IMPF+2+PL
cortejávei-las	cortejar+V.ele.ACC.3.F.PL+IMPF+2+PL
cortejávei-lo	cortejar+V.ele.ACC.3.M.SG+IMPF+2+PL
cortejávei-los	cortejar+V.ele.ACC.3.M.PL+IMPF+2+PL
cortejávei-nos	cortejar+nós.AD.1.PL+IMPF+2+PL
cortejáveis-lhe	cortejar+V.ele.DAT.3.SG+IMPF+2+PL
cortejáveis-lhes	cortejar+V.ele.DAT.3.PL+IMPF+2+PL
cortejáveis-me	cortejar+V.eu.AD.1.SG+IMPF+2+PL
cortejáveis-te	cortejar+V.tu.AD.2.SG+IMPF+2+PL
cortejáveis-vos	cortejar+V.vós.AD.2.PL+IMPF+2+PL
corteja-vos	cortejar+V.vós.AD.2.PL+PRS+3+SG
corteje-a	cortejar+V.ele.ACC.3.F.SG+IMP+3+SG
corteje-as	cortejar+V.ele.ACC.3.F.PL+IMP+3+SG
cortejei-a	cortejar+V.ele.ACC.3.F.SG+PRF+1+SG
cortejei-as	cortejar+V.ele.ACC.3.F.PL+PRF+1+SG
cortejei-lhe	cortejar+V.ele.DAT.3.SG+PRF+1+SG
cortejei-lhes	cortejar+V.ele.DAT.3.PL+PRF+1+SG
cortejei-me	cortejar+V.eu.AD.1.SG+PRF+1+SG
cortejei-nos	cortejar+nós.AD.1.PL+PRF+1+SG
cortejei-o	cortejar+V.ele.ACC.3.M.SG+PRF+1+SG
cortejei-os	cortejar+V.ele.ACC.3.M.PL+PRF+1+SG
cortejei-te	cortejar+V.tu.AD.2.SG+PRF+1+SG
cortejei-vos	cortejar+V.vós.AD.2.PL+PRF+1+SG
corteje-lhe	cortejar+V.ele.DAT.3.SG+IMP+3+SG
corteje-lhes	cortejar+V.ele.DAT.3.PL+IMP+3+SG
corteje-me	cortejar+V.eu.AD.1.SG+IMP+3+SG
cortejem-lhe	cortejar+V.ele.DAT.3.SG+IMP+3+PL
cortejem-lhes	cortejar+V.ele.DAT.3.PL+IMP+3+PL
cortejem-me	cortejar+V.eu.AD.1.SG+IMP+3+PL
cortejem-na	cortejar+V.ele.ACC.3.F.SG+IMP+3+PL
cortejem-nas	cortejar+V.ele.ACC.3.F.PL+IMP+3+PL
cortejem-no	cortejar+V.ele.ACC.3.M.SG+IMP+3+PL
cortejem-nos	cortejar+V.ele.ACC.3.M.PL+IMP+3+PL
cortejem-nos	cortejar+V.nós.AD.1.PL+IMP+3+PL
cortejemo-la	cortejar+V.ele.ACC.3.F.SG+IMP+1+PL
cortejemo-las	cortejar+V.ele.ACC.3.F.PL+IMP+1+PL
cortejemo-lo	cortejar+V.ele.ACC.3.M.SG+IMP+1+PL
cortejemo-los	cortejar+V.ele.ACC.3.M.PL+IMP+1+PL
cortejemo-nos	cortejar+nós.AD.1.PL+IMP+1+PL
cortejemos-lhe	cortejar+V.ele.DAT.3.SG+IMP+1+PL
cortejemos-lhes	cortejar+V.ele.DAT.3.PL+IMP+1+PL
cortejemos-me	cortejar+V.eu.AD.1.SG+IMP+1+PL
cortejemos-te	cortejar+V.tu.AD.2.SG+IMP+1+PL
cortejemos-vos	cortejar+V.vós.AD.2.PL+IMP+1+PL
cortejem-se	cortejar+V.ele.REFL+IMP+3+PL
cortejem-te	cortejar+V.tu.AD.2.SG+IMP+3+PL
cortejem-vos	cortejar+V.vós.AD.2.PL+IMP+3+PL
corteje-nos	cortejar+nós.AD.1.PL+IMP+3+SG
corteje-o	cortejar+V.ele.ACC.3.M.SG+IMP+3+SG
corteje-os	cortejar+V.ele.ACC.3.M.PL+IMP+3+SG
corteje-se	cortejar+V.ele.REFL+IMP+3+SG
corteje-te	cortejar+V.tu.AD.2.SG+IMP+3+SG
corteje-vos	cortejar+V.vós.AD.2.PL+IMP+3+SG
cortejo-a	cortejar+V.ele.ACC.3.F.SG+PRS+1+SG
cortejo-as	cortejar+V.ele.ACC.3.F.PL+PRS+1+SG
cortejo-lhe	cortejar+V.ele.DAT.3.SG+PRS+1+SG
cortejo-lhes	cortejar+V.ele.DAT.3.PL+PRS+1+SG
cortejo-me	cortejar+V.eu.AD.1.SG+PRS+1+SG
cortejo-nos	cortejar+nós.AD.1.PL+PRS+1+SG
cortejo-o	cortejar+V.ele.ACC.3.M.SG+PRS+1+SG
cortejo-os	cortejar+V.ele.ACC.3.M.PL+PRS+1+SG
cortejo-te	cortejar+V.tu.AD.2.SG+PRS+1+SG
cortejou-a	cortejar+V.ele.ACC.3.F.SG+PRF+3+SG
cortejou-as	cortejar+V.ele.ACC.3.F.PL+PRF+3+SG
cortejou-lhe	cortejar+V.ele.DAT.3.SG+PRF+3+SG
cortejou-lhes	cortejar+V.ele.DAT.3.PL+PRF+3+SG
cortejou-me	cortejar+V.eu.AD.1.SG+PRF+3+SG
cortejou-nos	cortejar+nós.AD.1.PL+PRF+3+SG
cortejou-o	cortejar+V.ele.ACC.3.M.SG+PRF+3+SG
cortejou-os	cortejar+V.ele.ACC.3.M.PL+PRF+3+SG
cortejou-se	cortejar+V.ele.REFL+PRF+3+SG
cortejou-te	cortejar+V.tu.AD.2.SG+PRF+3+SG
cortejou-vos	cortejar+V.vós.AD.2.PL+PRF+3+SG
cortejo-vos	cortejar+V.vós.AD.2.PL+PRS+1+SG
corte-lhe	cortar+V.ele.DAT.3.SG+IMP+3+SG
corte-lhes	cortar+V.ele.DAT.3.PL+IMP+3+SG
corte-me	cortar+V.eu.AD.1.SG+IMP+3+SG
cortem-lhe	cortar+V.ele.DAT.3.SG+IMP+3+PL
cortem-lhes	cortar+V.ele.DAT.3.PL+IMP+3+PL
cortem-me	cortar+V.eu.AD.1.SG+IMP+3+PL
cortem-na	cortar+V.ele.ACC.3.F.SG+IMP+3+PL
cortem-nas	cortar+V.ele.ACC.3.F.PL+IMP+3+PL
cortem-no	cortar+V.ele.ACC.3.M.SG+IMP+3+PL
cortem-nos	cortar+V.ele.ACC.3.M.PL+IMP+3+PL
cortem-nos	cortar+V.nós.AD.1.PL+IMP+3+PL
cortemo-la	cortar+V.ele.ACC.3.F.SG+IMP+1+PL
cortemo-las	cortar+V.ele.ACC.3.F.PL+IMP+1+PL
cortemo-lo	cortar+V.ele.ACC.3.M.SG+IMP+1+PL
cortemo-los	cortar+V.ele.ACC.3.M.PL+IMP+1+PL
cortemo-nos	cortar+nós.AD.1.PL+IMP+1+PL
cortemos-lhe	cortar+V.ele.DAT.3.SG+IMP+1+PL
cortemos-lhes	cortar+V.ele.DAT.3.PL+IMP+1+PL
cortemos-me	cortar+V.eu.AD.1.SG+IMP+1+PL
cortemos-te	cortar+V.tu.AD.2.SG+IMP+1+PL
cortemos-vos	cortar+V.vós.AD.2.PL+IMP+1+PL
cortem-se	cortar+V.ele.REFL+IMP+3+PL
cortem-te	cortar+V.tu.AD.2.SG+IMP+3+PL
cortem-vos	cortar+V.vós.AD.2.PL+IMP+3+PL
corte-nos	cortar+nós.AD.1.PL+IMP+3+SG
corte-o	cortar+V.ele.ACC.3.M.SG+IMP+3+SG
corte-os	cortar+V.ele.ACC.3.M.PL+IMP+3+SG
corte-se	cortar+V.ele.REFL+IMP+3+SG
corte-te	cortar+V.tu.AD.2.SG+IMP+3+SG
corte-vos	cortar+V.vós.AD.2.PL+IMP+3+SG
cortilha-a	cortilhar+V.ele.ACC.3.F.SG+PRS+3+SG
cortilha-as	cortilhar+V.ele.ACC.3.F.PL+PRS+3+SG
cortilhai-la	cortilhar+V.ele.ACC.3.F.SG+PRS+2+PL
cortilhai-las	cortilhar+V.ele.ACC.3.F.PL+PRS+2+PL
cortilhai-lo	cortilhar+V.ele.ACC.3.M.SG+PRS+2+PL
cortilhai-los	cortilhar+V.ele.ACC.3.M.PL+PRS+2+PL
cortilhai-nos	cortilhar+nós.AD.1.PL+PRS+2+PL
cortilhais-lhe	cortilhar+V.ele.DAT.3.SG+PRS+2+PL
cortilhais-lhes	cortilhar+V.ele.DAT.3.PL+PRS+2+PL
cortilhais-me	cortilhar+V.eu.AD.1.SG+PRS+2+PL
cortilhais-te	cortilhar+V.tu.AD.2.SG+PRS+2+PL
cortilhais-vos	cortilhar+V.vós.AD.2.PL+PRS+2+PL
cortilhá-la-á	cortilhar+V.ele.ACC.3.F.SG+FUT+3+SG
cortilhá-la-ão	cortilhar+V.ele.ACC.3.F.SG+FUT+3+PL
cortilhá-la-ás	cortilhar+V.ele.ACC.3.F.SG+FUT+2+SG
cortilhá-la	cortilhar+V.ele.ACC.3.F.SG+INF+1+SG
cortilhá-la	cortilhar+V.ele.ACC.3.F.SG+INF+3+SG
cortilha-la	cortilhar+V.ele.ACC.3.F.SG+PRS+2+SG
cortilhá-la	cortilhar+V.ele.ACC.3.F.SG+SBJF+1+SG
cortilhá-la	cortilhar+V.ele.ACC.3.F.SG+SBJF+3+SG
cortilhá-la-ei	cortilhar+V.ele.ACC.3.F.SG+FUT+1+SG
cortilhá-la-eis	cortilhar+V.ele.ACC.3.F.SG+FUT+2+PL
cortilhá-la-emos	cortilhar+V.ele.ACC.3.F.SG+FUT+1+PL
cortilhá-la-ia	cortilhar+V.ele.ACC.3.F.SG+COND+1+SG
cortilhá-la-ia	cortilhar+V.ele.ACC.3.F.SG+COND+3+SG
cortilhá-la-iam	cortilhar+V.ele.ACC.3.F.SG+COND+3+PL
cortilhá-la-íamos	cortilhar+V.ele.ACC.3.F.SG+COND+1+PL
cortilhá-la-ias	cortilhar+V.ele.ACC.3.F.SG+COND+2+SG
cortilhá-la-íeis	cortilhar+V.ele.ACC.3.F.SG+COND+2+PL
cortilhá-las-á	cortilhar+V.ele.ACC.3.F.PL+FUT+3+SG
cortilhá-las-ão	cortilhar+V.ele.ACC.3.F.PL+FUT+3+PL
cortilhá-las-ás	cortilhar+V.ele.ACC.3.F.PL+FUT+2+SG
cortilhá-las	cortilhar+V.ele.ACC.3.F.PL+INF+1+SG
cortilhá-las	cortilhar+V.ele.ACC.3.F.PL+INF+3+SG
cortilha-las	cortilhar+V.ele.ACC.3.F.PL+PRS+2+SG
cortilhá-las	cortilhar+V.ele.ACC.3.F.PL+SBJF+1+SG
cortilhá-las	cortilhar+V.ele.ACC.3.F.PL+SBJF+3+SG
cortilhá-las-ei	cortilhar+V.ele.ACC.3.F.PL+FUT+1+SG
cortilhá-las-eis	cortilhar+V.ele.ACC.3.F.PL+FUT+2+PL
cortilhá-las-emos	cortilhar+V.ele.ACC.3.F.PL+FUT+1+PL
cortilhá-las-ia	cortilhar+V.ele.ACC.3.F.PL+COND+1+SG
cortilhá-las-ia	cortilhar+V.ele.ACC.3.F.PL+COND+3+SG
cortilhá-las-iam	cortilhar+V.ele.ACC.3.F.PL+COND+3+PL
cortilhá-las-íamos	cortilhar+V.ele.ACC.3.F.PL+COND+1+PL
cortilhá-las-ias	cortilhar+V.ele.ACC.3.F.PL+COND+2+SG
cortilhá-las-íeis	cortilhar+V.ele.ACC.3.F.PL+COND+2+PL
cortilha-lhe	cortilhar+V.ele.DAT.3.SG+PRS+3+SG
cortilha-lhes	cortilhar+V.ele.DAT.3.PL+PRS+3+SG
cortilhá-lo-á	cortilhar+V.ele.ACC.3.M.SG+FUT+3+SG
cortilhá-lo-ão	cortilhar+V.ele.ACC.3.M.SG+FUT+3+PL
cortilhá-lo-ás	cortilhar+V.ele.ACC.3.M.SG+FUT+2+SG
cortilhá-lo	cortilhar+V.ele.ACC.3.M.SG+INF+1+SG
cortilhá-lo	cortilhar+V.ele.ACC.3.M.SG+INF+3+SG
cortilha-lo	cortilhar+V.ele.ACC.3.M.SG+PRS+2+SG
cortilhá-lo	cortilhar+V.ele.ACC.3.M.SG+SBJF+1+SG
cortilhá-lo	cortilhar+V.ele.ACC.3.M.SG+SBJF+3+SG
cortilhá-lo-ei	cortilhar+V.ele.ACC.3.M.SG+FUT+1+SG
cortilhá-lo-eis	cortilhar+V.ele.ACC.3.M.SG+FUT+2+PL
cortilhá-lo-emos	cortilhar+V.ele.ACC.3.M.SG+FUT+1+PL
cortilhá-lo-ia	cortilhar+V.ele.ACC.3.M.SG+COND+1+SG
cortilhá-lo-ia	cortilhar+V.ele.ACC.3.M.SG+COND+3+SG
cortilhá-lo-iam	cortilhar+V.ele.ACC.3.M.SG+COND+3+PL
cortilhá-lo-íamos	cortilhar+V.ele.ACC.3.M.SG+COND+1+PL
cortilhá-lo-ias	cortilhar+V.ele.ACC.3.M.SG+COND+2+SG
cortilhá-lo-íeis	cortilhar+V.ele.ACC.3.M.SG+COND+2+PL
cortilhá-los-á	cortilhar+V.ele.ACC.3.M.PL+FUT+3+SG
cortilhá-los-ão	cortilhar+V.ele.ACC.3.M.PL+FUT+3+PL
cortilhá-los-ás	cortilhar+V.ele.ACC.3.M.PL+FUT+2+SG
cortilhá-los	cortilhar+V.ele.ACC.3.M.PL+INF+1+SG
cortilhá-los	cortilhar+V.ele.ACC.3.M.PL+INF+3+SG
cortilha-los	cortilhar+V.ele.ACC.3.M.PL+PRS+2+SG
cortilhá-los	cortilhar+V.ele.ACC.3.M.PL+SBJF+1+SG
cortilhá-los	cortilhar+V.ele.ACC.3.M.PL+SBJF+3+SG
cortilhá-los-ei	cortilhar+V.ele.ACC.3.M.PL+FUT+1+SG
cortilhá-los-eis	cortilhar+V.ele.ACC.3.M.PL+FUT+2+PL
cortilhá-los-emos	cortilhar+V.ele.ACC.3.M.PL+FUT+1+PL
cortilhá-los-ia	cortilhar+V.ele.ACC.3.M.PL+COND+1+SG
cortilhá-los-ia	cortilhar+V.ele.ACC.3.M.PL+COND+3+SG
cortilhá-los-iam	cortilhar+V.ele.ACC.3.M.PL+COND+3+PL
cortilhá-los-íamos	cortilhar+V.ele.ACC.3.M.PL+COND+1+PL
cortilhá-los-ias	cortilhar+V.ele.ACC.3.M.PL+COND+2+SG
cortilhá-los-íeis	cortilhar+V.ele.ACC.3.M.PL+COND+2+PL
cortilha-me	cortilhar+V.eu.AD.1.SG+PRS+3+SG
cortilham-lhe	cortilhar+V.ele.DAT.3.SG+PRS+3+PL
cortilham-lhes	cortilhar+V.ele.DAT.3.PL+PRS+3+PL
cortilham-me	cortilhar+V.eu.AD.1.SG+PRS+3+PL
cortilham-na	cortilhar+V.ele.ACC.3.F.SG+PRS+3+PL
cortilham-nas	cortilhar+V.ele.ACC.3.F.PL+PRS+3+PL
cortilham-no	cortilhar+V.ele.ACC.3.M.SG+PRS+3+PL
cortilham-nos	cortilhar+V.ele.ACC.3.M.PL+PRS+3+PL
cortilham-nos	cortilhar+V.nós.AD.1.PL+PRS+3+PL
cortilhamo-la	cortilhar+V.ele.ACC.3.F.SG+PRF+1+PL
cortilhamo-la	cortilhar+V.ele.ACC.3.F.SG+PRS+1+PL
cortilhamo-las	cortilhar+V.ele.ACC.3.F.PL+PRF+1+PL
cortilhamo-las	cortilhar+V.ele.ACC.3.F.PL+PRS+1+PL
cortilhamo-lo	cortilhar+V.ele.ACC.3.M.SG+PRF+1+PL
cortilhamo-lo	cortilhar+V.ele.ACC.3.M.SG+PRS+1+PL
cortilhamo-los	cortilhar+V.ele.ACC.3.M.PL+PRF+1+PL
cortilhamo-los	cortilhar+V.ele.ACC.3.M.PL+PRS+1+PL
cortilhamo-nos	cortilhar+nós.AD.1.PL+PRF+1+PL
cortilhamo-nos	cortilhar+nós.AD.1.PL+PRS+1+PL
cortilhamos-lhe	cortilhar+V.ele.DAT.3.SG+PRF+1+PL
cortilhamos-lhe	cortilhar+V.ele.DAT.3.SG+PRS+1+PL
cortilhamos-lhes	cortilhar+V.ele.DAT.3.PL+PRF+1+PL
cortilhamos-lhes	cortilhar+V.ele.DAT.3.PL+PRS+1+PL
cortilhamos-me	cortilhar+V.eu.AD.1.SG+PRF+1+PL
cortilhamos-me	cortilhar+V.eu.AD.1.SG+PRS+1+PL
cortilhamos-te	cortilhar+V.tu.AD.2.SG+PRF+1+PL
cortilhamos-te	cortilhar+V.tu.AD.2.SG+PRS+1+PL
cortilhamos-vos	cortilhar+V.vós.AD.2.PL+PRF+1+PL
cortilhamos-vos	cortilhar+V.vós.AD.2.PL+PRS+1+PL
cortilham-se	cortilhar+V.ele.REFL+PRS+3+PL
cortilham-te	cortilhar+V.tu.AD.2.SG+PRS+3+PL
cortilham-vos	cortilhar+V.vós.AD.2.PL+PRS+3+PL
cortilhando-a	cortilhar+V.ele.ACC.3.F.SG+GRD
cortilhando-as	cortilhar+V.ele.ACC.3.F.PL+GRD
cortilhando-lhe	cortilhar+V.ele.DAT.3.SG+GRD
cortilhando-lhes	cortilhar+V.ele.DAT.3.PL+GRD
cortilhando-me	cortilhar+V.eu.AD.1.SG+GRD
cortilhando-nos	cortilhar+nós.AD.1.PL+GRD
cortilhando-o	cortilhar+V.ele.ACC.3.M.SG+GRD
cortilhando-os	cortilhar+V.ele.ACC.3.M.PL+GRD
cortilhando-se	cortilhar+V.ele.REFL+GRD
cortilhando-te	cortilhar+V.tu.AD.2.SG+GRD
cortilhando-vos	cortilhar+V.vós.AD.2.PL+GRD
cortilha-nos	cortilhar+nós.AD.1.PL+PRS+2+SG
cortilha-nos	cortilhar+nós.AD.1.PL+PRS+3+SG
cortilha-o	cortilhar+V.ele.ACC.3.M.SG+PRS+3+SG
cortilha-os	cortilhar+V.ele.ACC.3.M.PL+PRS+3+SG
cortilhara-a	cortilhar+V.ele.ACC.3.F.SG+PQP+1+SG
cortilhara-a	cortilhar+V.ele.ACC.3.F.SG+PQP+3+SG
cortilhara-as	cortilhar+V.ele.ACC.3.F.PL+PQP+1+SG
cortilhara-as	cortilhar+V.ele.ACC.3.F.PL+PQP+3+SG
cortilhara-la	cortilhar+V.ele.ACC.3.F.SG+PQP+2+SG
cortilhara-las	cortilhar+V.ele.ACC.3.F.PL+PQP+2+SG
cortilhara-lhe	cortilhar+V.ele.DAT.3.SG+PQP+1+SG
cortilhara-lhe	cortilhar+V.ele.DAT.3.SG+PQP+3+SG
cortilhara-lhes	cortilhar+V.ele.DAT.3.PL+PQP+1+SG
cortilhara-lhes	cortilhar+V.ele.DAT.3.PL+PQP+3+SG
cortilhara-lo	cortilhar+V.ele.ACC.3.M.SG+PQP+2+SG
cortilhara-los	cortilhar+V.ele.ACC.3.M.PL+PQP+2+SG
cortilhara-me	cortilhar+V.eu.AD.1.SG+PQP+1+SG
cortilhara-me	cortilhar+V.eu.AD.1.SG+PQP+3+SG
cortilharam-lhe	cortilhar+V.ele.DAT.3.SG+PQP+3+PL
cortilharam-lhe	cortilhar+V.ele.DAT.3.SG+PRF+3+PL
cortilharam-lhes	cortilhar+V.ele.DAT.3.PL+PQP+3+PL
cortilharam-lhes	cortilhar+V.ele.DAT.3.PL+PRF+3+PL
cortilharam-me	cortilhar+V.eu.AD.1.SG+PQP+3+PL
cortilharam-me	cortilhar+V.eu.AD.1.SG+PRF+3+PL
cortilharam-na	cortilhar+V.ele.ACC.3.F.SG+PQP+3+PL
cortilharam-na	cortilhar+V.ele.ACC.3.F.SG+PRF+3+PL
cortilharam-nas	cortilhar+V.ele.ACC.3.F.PL+PQP+3+PL
cortilharam-nas	cortilhar+V.ele.ACC.3.F.PL+PRF+3+PL
cortilharam-no	cortilhar+V.ele.ACC.3.M.SG+PQP+3+PL
cortilharam-no	cortilhar+V.ele.ACC.3.M.SG+PRF+3+PL
cortilharam-nos	cortilhar+V.ele.ACC.3.M.PL+PQP+3+PL
cortilharam-nos	cortilhar+V.ele.ACC.3.M.PL+PRF+3+PL
cortilharam-nos	cortilhar+V.nós.AD.1.PL+PQP+3+PL
cortilharam-nos	cortilhar+V.nós.AD.1.PL+PRF+3+PL
cortilháramo-la	cortilhar+V.ele.ACC.3.F.SG+PQP+1+PL
cortilháramo-las	cortilhar+V.ele.ACC.3.F.PL+PQP+1+PL
cortilháramo-lo	cortilhar+V.ele.ACC.3.M.SG+PQP+1+PL
cortilháramo-los	cortilhar+V.ele.ACC.3.M.PL+PQP+1+PL
cortilháramo-nos	cortilhar+nós.AD.1.PL+PQP+1+PL
cortilháramos-lhe	cortilhar+V.ele.DAT.3.SG+PQP+1+PL
cortilháramos-lhes	cortilhar+V.ele.DAT.3.PL+PQP+1+PL
cortilháramos-me	cortilhar+V.eu.AD.1.SG+PQP+1+PL
cortilháramos-te	cortilhar+V.tu.AD.2.SG+PQP+1+PL
cortilháramos-vos	cortilhar+V.vós.AD.2.PL+PQP+1+PL
cortilharam-se	cortilhar+V.ele.REFL+PQP+3+PL
cortilharam-se	cortilhar+V.ele.REFL+PRF+3+PL
cortilharam-te	cortilhar+V.tu.AD.2.SG+PQP+3+PL
cortilharam-te	cortilhar+V.tu.AD.2.SG+PRF+3+PL
cortilharam-vos	cortilhar+V.vós.AD.2.PL+PQP+3+PL
cortilharam-vos	cortilhar+V.vós.AD.2.PL+PRF+3+PL
cortilhara-nos	cortilhar+nós.AD.1.PL+PQP+1+SG
cortilhara-nos	cortilhar+nós.AD.1.PL+PQP+2+SG
cortilhara-nos	cortilhar+nós.AD.1.PL+PQP+3+SG
cortilhara-o	cortilhar+V.ele.ACC.3.M.SG+PQP+1+SG
cortilhara-o	cortilhar+V.ele.ACC.3.M.SG+PQP+3+SG
cortilhara-os	cortilhar+V.ele.ACC.3.M.PL+PQP+1+SG
cortilhara-os	cortilhar+V.ele.ACC.3.M.PL+PQP+3+SG
cortilhara-se	cortilhar+V.ele.REFL+PQP+1+SG
cortilhara-se	cortilhar+V.ele.REFL+PQP+3+SG
cortilharas-lhe	cortilhar+V.ele.DAT.3.SG+PQP+2+SG
cortilharas-lhes	cortilhar+V.ele.DAT.3.PL+PQP+2+SG
cortilharas-me	cortilhar+V.eu.AD.1.SG+PQP+2+SG
cortilharas-te	cortilhar+V.tu.AD.2.SG+PQP+2+SG
cortilharas-vos	cortilhar+V.vós.AD.2.PL+PQP+2+SG
cortilhara-te	cortilhar+V.tu.AD.2.SG+PQP+1+SG
cortilhara-te	cortilhar+V.tu.AD.2.SG+PQP+3+SG
cortilhara-vos	cortilhar+V.vós.AD.2.PL+PQP+1+SG
cortilhara-vos	cortilhar+V.vós.AD.2.PL+PQP+3+SG
cortilharde-la	cortilhar+V.ele.ACC.3.F.SG+INF+2+PL
cortilharde-la	cortilhar+V.ele.ACC.3.F.SG+SBJF+2+PL
cortilharde-las	cortilhar+V.ele.ACC.3.F.PL+INF+2+PL
cortilharde-las	cortilhar+V.ele.ACC.3.F.PL+SBJF+2+PL
cortilharde-lo	cortilhar+V.ele.ACC.3.M.SG+INF+2+PL
cortilharde-lo	cortilhar+V.ele.ACC.3.M.SG+SBJF+2+PL
cortilharde-los	cortilhar+V.ele.ACC.3.M.PL+INF+2+PL
cortilharde-los	cortilhar+V.ele.ACC.3.M.PL+SBJF+2+PL
cortilharde-nos	cortilhar+nós.AD.1.PL+INF+2+PL
cortilharde-nos	cortilhar+nós.AD.1.PL+SBJF+2+PL
cortilhardes-lhe	cortilhar+V.ele.DAT.3.SG+INF+2+PL
cortilhardes-lhe	cortilhar+V.ele.DAT.3.SG+SBJF+2+PL
cortilhardes-lhes	cortilhar+V.ele.DAT.3.PL+INF+2+PL
cortilhardes-lhes	cortilhar+V.ele.DAT.3.PL+SBJF+2+PL
cortilhardes-me	cortilhar+V.eu.AD.1.SG+INF+2+PL
cortilhardes-me	cortilhar+V.eu.AD.1.SG+SBJF+2+PL
cortilhardes-te	cortilhar+V.tu.AD.2.SG+INF+2+PL
cortilhardes-te	cortilhar+V.tu.AD.2.SG+SBJF+2+PL
cortilhardes-vos	cortilhar+V.vós.AD.2.PL+INF+2+PL
cortilhardes-vos	cortilhar+V.vós.AD.2.PL+SBJF+2+PL
cortilhárei-la	cortilhar+V.ele.ACC.3.F.SG+PQP+2+PL
cortilhárei-las	cortilhar+V.ele.ACC.3.F.PL+PQP+2+PL
cortilhárei-lo	cortilhar+V.ele.ACC.3.M.SG+PQP+2+PL
cortilhárei-los	cortilhar+V.ele.ACC.3.M.PL+PQP+2+PL
cortilhárei-nos	cortilhar+nós.AD.1.PL+PQP+2+PL
cortilháreis-lhe	cortilhar+V.ele.DAT.3.SG+PQP+2+PL
cortilháreis-lhes	cortilhar+V.ele.DAT.3.PL+PQP+2+PL
cortilháreis-me	cortilhar+V.eu.AD.1.SG+PQP+2+PL
cortilháreis-te	cortilhar+V.tu.AD.2.SG+PQP+2+PL
cortilháreis-vos	cortilhar+V.vós.AD.2.PL+PQP+2+PL
cortilhare-la	cortilhar+V.ele.ACC.3.F.SG+INF+2+SG
cortilhare-la	cortilhar+V.ele.ACC.3.F.SG+SBJF+2+SG
cortilhare-las	cortilhar+V.ele.ACC.3.F.PL+INF+2+SG
cortilhare-las	cortilhar+V.ele.ACC.3.F.PL+SBJF+2+SG
cortilhare-lo	cortilhar+V.ele.ACC.3.M.SG+INF+2+SG
cortilhare-lo	cortilhar+V.ele.ACC.3.M.SG+SBJF+2+SG
cortilhare-los	cortilhar+V.ele.ACC.3.M.PL+INF+2+SG
cortilhare-los	cortilhar+V.ele.ACC.3.M.PL+SBJF+2+SG
cortilharem-lhe	cortilhar+V.ele.DAT.3.SG+INF+3+PL
cortilharem-lhe	cortilhar+V.ele.DAT.3.SG+SBJF+3+PL
cortilharem-lhes	cortilhar+V.ele.DAT.3.PL+INF+3+PL
cortilharem-lhes	cortilhar+V.ele.DAT.3.PL+SBJF+3+PL
cortilharem-me	cortilhar+V.eu.AD.1.SG+INF+3+PL
cortilharem-me	cortilhar+V.eu.AD.1.SG+SBJF+3+PL
cortilharem-na	cortilhar+V.ele.ACC.3.F.SG+INF+3+PL
cortilharem-na	cortilhar+V.ele.ACC.3.F.SG+SBJF+3+PL
cortilharem-nas	cortilhar+V.ele.ACC.3.F.PL+INF+3+PL
cortilharem-nas	cortilhar+V.ele.ACC.3.F.PL+SBJF+3+PL
cortilharem-no	cortilhar+V.ele.ACC.3.M.SG+INF+3+PL
cortilharem-no	cortilhar+V.ele.ACC.3.M.SG+SBJF+3+PL
cortilharem-nos	cortilhar+V.ele.ACC.3.M.PL+INF+3+PL
cortilharem-nos	cortilhar+V.ele.ACC.3.M.PL+SBJF+3+PL
cortilharem-nos	cortilhar+V.nós.AD.1.PL+INF+3+PL
cortilharem-nos	cortilhar+V.nós.AD.1.PL+SBJF+3+PL
cortilharem-se	cortilhar+V.ele.REFL+INF+3+PL
cortilharem-se	cortilhar+V.ele.REFL+SBJF+3+PL
cortilharem-te	cortilhar+V.tu.AD.2.SG+INF+3+PL
cortilharem-te	cortilhar+V.tu.AD.2.SG+SBJF+3+PL
cortilharem-vos	cortilhar+V.vós.AD.2.PL+INF+3+PL
cortilharem-vos	cortilhar+V.vós.AD.2.PL+SBJF+3+PL
cortilhare-nos	cortilhar+nós.AD.1.PL+INF+2+SG
cortilhare-nos	cortilhar+nós.AD.1.PL+SBJF+2+SG
cortilhares-lhe	cortilhar+V.ele.DAT.3.SG+INF+2+SG
cortilhares-lhe	cortilhar+V.ele.DAT.3.SG+SBJF+2+SG
cortilhares-lhes	cortilhar+V.ele.DAT.3.PL+INF+2+SG
cortilhares-lhes	cortilhar+V.ele.DAT.3.PL+SBJF+2+SG
cortilhares-me	cortilhar+V.eu.AD.1.SG+INF+2+SG
cortilhares-me	cortilhar+V.eu.AD.1.SG+SBJF+2+SG
cortilhares-te	cortilhar+V.tu.AD.2.SG+INF+2+SG
cortilhares-te	cortilhar+V.tu.AD.2.SG+SBJF+2+SG
cortilhares-vos	cortilhar+V.vós.AD.2.PL+INF+2+SG
cortilhares-vos	cortilhar+V.vós.AD.2.PL+SBJF+2+SG
cortilhar-lhe-á	cortilhar+V.ele.DAT.3.SG+FUT+3+SG
cortilhar-lhe-ão	cortilhar+V.ele.DAT.3.SG+FUT+3+PL
cortilhar-lhe-ás	cortilhar+V.ele.DAT.3.SG+FUT+2+SG
cortilhar-lhe	cortilhar+V.ele.DAT.3.SG+INF
cortilhar-lhe	cortilhar+V.ele.DAT.3.SG+INF+1+SG
cortilhar-lhe	cortilhar+V.ele.DAT.3.SG+INF+3+SG
cortilhar-lhe	cortilhar+V.ele.DAT.3.SG+SBJF+1+SG
cortilhar-lhe	cortilhar+V.ele.DAT.3.SG+SBJF+3+SG
cortilhar-lhe-ei	cortilhar+V.ele.DAT.3.SG+FUT+1+SG
cortilhar-lhe-eis	cortilhar+V.ele.DAT.3.SG+FUT+2+PL
cortilhar-lhe-emos	cortilhar+V.ele.DAT.3.SG+FUT+1+PL
cortilhar-lhe-ia	cortilhar+V.ele.DAT.3.SG+COND+1+SG
cortilhar-lhe-ia	cortilhar+V.ele.DAT.3.SG+COND+3+SG
cortilhar-lhe-iam	cortilhar+V.ele.DAT.3.SG+COND+3+PL
cortilhar-lhe-íamos	cortilhar+V.ele.DAT.3.SG+COND+1+PL
cortilhar-lhe-ias	cortilhar+V.ele.DAT.3.SG+COND+2+SG
cortilhar-lhe-íeis	cortilhar+V.ele.DAT.3.SG+COND+2+PL
cortilhar-lhes-á	cortilhar+V.ele.DAT.3.PL+FUT+3+SG
cortilhar-lhes-ão	cortilhar+V.ele.DAT.3.PL+FUT+3+PL
cortilhar-lhes-ás	cortilhar+V.ele.DAT.3.PL+FUT+2+SG
cortilhar-lhes	cortilhar+V.ele.DAT.3.PL+INF
cortilhar-lhes	cortilhar+V.ele.DAT.3.PL+INF+1+SG
cortilhar-lhes	cortilhar+V.ele.DAT.3.PL+INF+3+SG
cortilhar-lhes	cortilhar+V.ele.DAT.3.PL+SBJF+1+SG
cortilhar-lhes	cortilhar+V.ele.DAT.3.PL+SBJF+3+SG
cortilhar-lhes-ei	cortilhar+V.ele.DAT.3.PL+FUT+1+SG
cortilhar-lhes-eis	cortilhar+V.ele.DAT.3.PL+FUT+2+PL
cortilhar-lhes-emos	cortilhar+V.ele.DAT.3.PL+FUT+1+PL
cortilhar-lhes-ia	cortilhar+V.ele.DAT.3.PL+COND+1+SG
cortilhar-lhes-ia	cortilhar+V.ele.DAT.3.PL+COND+3+SG
cortilhar-lhes-iam	cortilhar+V.ele.DAT.3.PL+COND+3+PL
cortilhar-lhes-íamos	cortilhar+V.ele.DAT.3.PL+COND+1+PL
cortilhar-lhes-ias	cortilhar+V.ele.DAT.3.PL+COND+2+SG
cortilhar-lhes-íeis	cortilhar+V.ele.DAT.3.PL+COND+2+PL
cortilhar-me-á	cortilhar+V.eu.AD.1.SG+FUT+3+SG
cortilhar-me-ão	cortilhar+V.eu.AD.1.SG+FUT+3+PL
cortilhar-me-ás	cortilhar+V.eu.AD.1.SG+FUT+2+SG
cortilhar-me	cortilhar+V.eu.AD.1.SG+INF
cortilhar-me	cortilhar+V.eu.AD.1.SG+INF+1+SG
cortilhar-me	cortilhar+V.eu.AD.1.SG+INF+3+SG
cortilhar-me	cortilhar+V.eu.AD.1.SG+SBJF+1+SG
cortilhar-me	cortilhar+V.eu.AD.1.SG+SBJF+3+SG
cortilhar-me-ei	cortilhar+V.eu.AD.1.SG+FUT+1+SG
cortilhar-me-eis	cortilhar+V.eu.AD.1.SG+FUT+2+PL
cortilhar-me-emos	cortilhar+V.eu.AD.1.SG+FUT+1+PL
cortilhar-me-ia	cortilhar+V.eu.AD.1.SG+COND+1+SG
cortilhar-me-ia	cortilhar+V.eu.AD.1.SG+COND+3+SG
cortilhar-me-iam	cortilhar+V.eu.AD.1.SG+COND+3+PL
cortilhar-me-íamos	cortilhar+V.eu.AD.1.SG+COND+1+PL
cortilhar-me-ias	cortilhar+V.eu.AD.1.SG+COND+2+SG
cortilhar-me-íeis	cortilhar+V.eu.AD.1.SG+COND+2+PL
cortilharmo-la	cortilhar+V.ele.ACC.3.F.SG+INF+1+PL
cortilharmo-la	cortilhar+V.ele.ACC.3.F.SG+SBJF+1+PL
cortilharmo-las	cortilhar+V.ele.ACC.3.F.PL+INF+1+PL
cortilharmo-las	cortilhar+V.ele.ACC.3.F.PL+SBJF+1+PL
cortilharmo-lo	cortilhar+V.ele.ACC.3.M.SG+INF+1+PL
cortilharmo-lo	cortilhar+V.ele.ACC.3.M.SG+SBJF+1+PL
cortilharmo-los	cortilhar+V.ele.ACC.3.M.PL+INF+1+PL
cortilharmo-los	cortilhar+V.ele.ACC.3.M.PL+SBJF+1+PL
cortilharmo-nos	cortilhar+nós.AD.1.PL+INF+1+PL
cortilharmo-nos	cortilhar+nós.AD.1.PL+SBJF+1+PL
cortilharmos-lhe	cortilhar+V.ele.DAT.3.SG+INF+1+PL
cortilharmos-lhe	cortilhar+V.ele.DAT.3.SG+SBJF+1+PL
cortilharmos-lhes	cortilhar+V.ele.DAT.3.PL+INF+1+PL
cortilharmos-lhes	cortilhar+V.ele.DAT.3.PL+SBJF+1+PL
cortilharmos-me	cortilhar+V.eu.AD.1.SG+INF+1+PL
cortilharmos-me	cortilhar+V.eu.AD.1.SG+SBJF+1+PL
cortilharmos-te	cortilhar+V.tu.AD.2.SG+INF+1+PL
cortilharmos-te	cortilhar+V.tu.AD.2.SG+SBJF+1+PL
cortilharmos-vos	cortilhar+V.vós.AD.2.PL+INF+1+PL
cortilharmos-vos	cortilhar+V.vós.AD.2.PL+SBJF+1+PL
cortilhar-nos-á	cortilhar+nós.AD.1.PL+FUT+3+SG
cortilhar-nos-ão	cortilhar+nós.AD.1.PL+FUT+3+PL
cortilhar-nos-ás	cortilhar+nós.AD.1.PL+FUT+2+SG
cortilhar-nos	cortilhar+nós.AD.1.PL+INF
cortilhar-nos	cortilhar+nós.AD.1.PL+INF+1+SG
cortilhar-nos	cortilhar+nós.AD.1.PL+INF+3+SG
cortilhar-nos	cortilhar+nós.AD.1.PL+SBJF+1+SG
cortilhar-nos	cortilhar+nós.AD.1.PL+SBJF+3+SG
cortilhar-nos-ei	cortilhar+nós.AD.1.PL+FUT+1+SG
cortilhar-nos-eis	cortilhar+nós.AD.1.PL+FUT+2+PL
cortilhar-nos-emos	cortilhar+nós.AD.1.PL+FUT+1+PL
cortilhar-nos-ia	cortilhar+nós.AD.1.PL+COND+1+SG
cortilhar-nos-ia	cortilhar+nós.AD.1.PL+COND+3+SG
cortilhar-nos-iam	cortilhar+nós.AD.1.PL+COND+3+PL
cortilhar-nos-íamos	cortilhar+nós.AD.1.PL+COND+1+PL
cortilhar-nos-ias	cortilhar+nós.AD.1.PL+COND+2+SG
cortilhar-nos-íeis	cortilhar+nós.AD.1.PL+COND+2+PL
cortilhar-se-á	cortilhar+V.ele.REFL+FUT+3+SG
cortilhar-se-ão	cortilhar+V.ele.REFL+FUT+3+PL
cortilhar-se	cortilhar+V.ele.REFL+INF
cortilhar-se	cortilhar+V.ele.REFL+INF+3+SG
cortilhar-se	cortilhar+V.ele.REFL+SBJF+3+SG
cortilhar-se-ia	cortilhar+V.ele.REFL+COND+3+SG
cortilhar-se-iam	cortilhar+V.ele.REFL+COND+3+PL
cortilhar-te-á	cortilhar+V.tu.AD.2.SG+FUT+3+SG
cortilhar-te-ão	cortilhar+V.tu.AD.2.SG+FUT+3+PL
cortilhar-te-ás	cortilhar+V.tu.AD.2.SG+FUT+2+SG
cortilhar-te	cortilhar+V.tu.AD.2.SG+INF
cortilhar-te	cortilhar+V.tu.AD.2.SG+INF+1+SG
cortilhar-te	cortilhar+V.tu.AD.2.SG+INF+3+SG
cortilhar-te	cortilhar+V.tu.AD.2.SG+SBJF+1+SG
cortilhar-te	cortilhar+V.tu.AD.2.SG+SBJF+3+SG
cortilhar-te-ei	cortilhar+V.tu.AD.2.SG+FUT+1+SG
cortilhar-te-eis	cortilhar+V.tu.AD.2.SG+FUT+2+PL
cortilhar-te-emos	cortilhar+V.tu.AD.2.SG+FUT+1+PL
cortilhar-te-ia	cortilhar+V.tu.AD.2.SG+COND+1+SG
cortilhar-te-ia	cortilhar+V.tu.AD.2.SG+COND+3+SG
cortilhar-te-iam	cortilhar+V.tu.AD.2.SG+COND+3+PL
cortilhar-te-íamos	cortilhar+V.tu.AD.2.SG+COND+1+PL
cortilhar-te-ias	cortilhar+V.tu.AD.2.SG+COND+2+SG
cortilhar-te-íeis	cortilhar+V.tu.AD.2.SG+COND+2+PL
cortilhar-vos-á	cortilhar+V.vós.AD.2.PL+FUT+3+SG
cortilhar-vos-ão	cortilhar+V.vós.AD.2.PL+FUT+3+PL
cortilhar-vos-ás	cortilhar+V.vós.AD.2.PL+FUT+2+SG
cortilhar-vos	cortilhar+V.vós.AD.2.PL+INF
cortilhar-vos	cortilhar+V.vós.AD.2.PL+INF+1+SG
cortilhar-vos	cortilhar+V.vós.AD.2.PL+INF+3+SG
cortilhar-vos	cortilhar+V.vós.AD.2.PL+SBJF+1+SG
cortilhar-vos	cortilhar+V.vós.AD.2.PL+SBJF+3+SG
cortilhar-vos-ei	cortilhar+V.vós.AD.2.PL+FUT+1+SG
cortilhar-vos-eis	cortilhar+V.vós.AD.2.PL+FUT+2+PL
cortilhar-vos-emos	cortilhar+V.vós.AD.2.PL+FUT+1+PL
cortilhar-vos-ia	cortilhar+V.vós.AD.2.PL+COND+1+SG
cortilhar-vos-ia	cortilhar+V.vós.AD.2.PL+COND+3+SG
cortilhar-vos-iam	cortilhar+V.vós.AD.2.PL+COND+3+PL
cortilhar-vos-íamos	cortilhar+V.vós.AD.2.PL+COND+1+PL
cortilhar-vos-ias	cortilhar+V.vós.AD.2.PL+COND+2+SG
cortilhar-vos-íeis	cortilhar+V.vós.AD.2.PL+COND+2+PL
cortilha-se	cortilhar+V.ele.REFL+PRS+3+SG
cortilhas-lhe	cortilhar+V.ele.DAT.3.SG+PRS+2+SG
cortilhas-lhes	cortilhar+V.ele.DAT.3.PL+PRS+2+SG
cortilhas-me	cortilhar+V.eu.AD.1.SG+PRS+2+SG
cortilhaste-a	cortilhar+V.ele.ACC.3.F.SG+PRF+2+SG
cortilhaste-as	cortilhar+V.ele.ACC.3.F.PL+PRF+2+SG
cortilhas-te	cortilhar+V.tu.AD.2.SG+PRS+2+SG
cortilhaste-la	cortilhar+V.ele.ACC.3.F.SG+PRF+2+PL
cortilhaste-las	cortilhar+V.ele.ACC.3.F.PL+PRF+2+PL
cortilhaste-lhe	cortilhar+V.ele.DAT.3.SG+PRF+2+SG
cortilhaste-lhes	cortilhar+V.ele.DAT.3.PL+PRF+2+SG
cortilhaste-lo	cortilhar+V.ele.ACC.3.M.SG+PRF+2+PL
cortilhaste-los	cortilhar+V.ele.ACC.3.M.PL+PRF+2+PL
cortilhaste-me	cortilhar+V.eu.AD.1.SG+PRF+2+SG
cortilhaste-nos	cortilhar+nós.AD.1.PL+PRF+2+PL
cortilhaste-nos	cortilhar+nós.AD.1.PL+PRF+2+SG
cortilhaste-o	cortilhar+V.ele.ACC.3.M.SG+PRF+2+SG
cortilhaste-os	cortilhar+V.ele.ACC.3.M.PL+PRF+2+SG
cortilhastes-lhe	cortilhar+V.ele.DAT.3.SG+PRF+2+PL
cortilhastes-lhes	cortilhar+V.ele.DAT.3.PL+PRF+2+PL
cortilhastes-me	cortilhar+V.eu.AD.1.SG+PRF+2+PL
cortilhastes-te	cortilhar+V.tu.AD.2.SG+PRF+2+PL
cortilhastes-vos	cortilhar+V.vós.AD.2.PL+PRF+2+PL
cortilhaste-te	cortilhar+V.tu.AD.2.SG+PRF+2+SG
cortilhaste-vos	cortilhar+V.vós.AD.2.PL+PRF+2+SG
cortilhas-vos	cortilhar+V.vós.AD.2.PL+PRS+2+SG
cortilha-te	cortilhar+V.tu.AD.2.SG+PRS+3+SG
cortilhava-a	cortilhar+V.ele.ACC.3.F.SG+IMPF+1+SG
cortilhava-a	cortilhar+V.ele.ACC.3.F.SG+IMPF+3+SG
cortilhava-as	cortilhar+V.ele.ACC.3.F.PL+IMPF+1+SG
cortilhava-as	cortilhar+V.ele.ACC.3.F.PL+IMPF+3+SG
cortilhava-la	cortilhar+V.ele.ACC.3.F.SG+IMPF+2+SG
cortilhava-las	cortilhar+V.ele.ACC.3.F.PL+IMPF+2+SG
cortilhava-lhe	cortilhar+V.ele.DAT.3.SG+IMPF+1+SG
cortilhava-lhe	cortilhar+V.ele.DAT.3.SG+IMPF+3+SG
cortilhava-lhes	cortilhar+V.ele.DAT.3.PL+IMPF+1+SG
cortilhava-lhes	cortilhar+V.ele.DAT.3.PL+IMPF+3+SG
cortilhava-lo	cortilhar+V.ele.ACC.3.M.SG+IMPF+2+SG
cortilhava-los	cortilhar+V.ele.ACC.3.M.PL+IMPF+2+SG
cortilhava-me	cortilhar+V.eu.AD.1.SG+IMPF+1+SG
cortilhava-me	cortilhar+V.eu.AD.1.SG+IMPF+3+SG
cortilhavam-lhe	cortilhar+V.ele.DAT.3.SG+IMPF+3+PL
cortilhavam-lhes	cortilhar+V.ele.DAT.3.PL+IMPF+3+PL
cortilhavam-me	cortilhar+V.eu.AD.1.SG+IMPF+3+PL
cortilhavam-na	cortilhar+V.ele.ACC.3.F.SG+IMPF+3+PL
cortilhavam-nas	cortilhar+V.ele.ACC.3.F.PL+IMPF+3+PL
cortilhavam-no	cortilhar+V.ele.ACC.3.M.SG+IMPF+3+PL
cortilhavam-nos	cortilhar+V.ele.ACC.3.M.PL+IMPF+3+PL
cortilhavam-nos	cortilhar+V.nós.AD.1.PL+IMPF+3+PL
cortilhávamo-la	cortilhar+V.ele.ACC.3.F.SG+IMPF+1+PL
cortilhávamo-las	cortilhar+V.ele.ACC.3.F.PL+IMPF+1+PL
cortilhávamo-lo	cortilhar+V.ele.ACC.3.M.SG+IMPF+1+PL
cortilhávamo-los	cortilhar+V.ele.ACC.3.M.PL+IMPF+1+PL
cortilhávamo-nos	cortilhar+nós.AD.1.PL+IMPF+1+PL
cortilhávamos-lhe	cortilhar+V.ele.DAT.3.SG+IMPF+1+PL
cortilhávamos-lhes	cortilhar+V.ele.DAT.3.PL+IMPF+1+PL
cortilhávamos-me	cortilhar+V.eu.AD.1.SG+IMPF+1+PL
cortilhávamos-te	cortilhar+V.tu.AD.2.SG+IMPF+1+PL
cortilhávamos-vos	cortilhar+V.vós.AD.2.PL+IMPF+1+PL
cortilhavam-se	cortilhar+V.ele.REFL+IMPF+3+PL
cortilhavam-te	cortilhar+V.tu.AD.2.SG+IMPF+3+PL
cortilhavam-vos	cortilhar+V.vós.AD.2.PL+IMPF+3+PL
cortilhava-nos	cortilhar+nós.AD.1.PL+IMPF+1+SG
cortilhava-nos	cortilhar+nós.AD.1.PL+IMPF+2+SG
cortilhava-nos	cortilhar+nós.AD.1.PL+IMPF+3+SG
cortilhava-o	cortilhar+V.ele.ACC.3.M.SG+IMPF+1+SG
cortilhava-o	cortilhar+V.ele.ACC.3.M.SG+IMPF+3+SG
cortilhava-os	cortilhar+V.ele.ACC.3.M.PL+IMPF+1+SG
cortilhava-os	cortilhar+V.ele.ACC.3.M.PL+IMPF+3+SG
cortilhava-se	cortilhar+V.ele.REFL+IMPF+1+SG
cortilhava-se	cortilhar+V.ele.REFL+IMPF+3+SG
cortilhavas-lhe	cortilhar+V.ele.DAT.3.SG+IMPF+2+SG
cortilhavas-lhes	cortilhar+V.ele.DAT.3.PL+IMPF+2+SG
cortilhavas-me	cortilhar+V.eu.AD.1.SG+IMPF+2+SG
cortilhavas-te	cortilhar+V.tu.AD.2.SG+IMPF+2+SG
cortilhavas-vos	cortilhar+V.vós.AD.2.PL+IMPF+2+SG
cortilhava-te	cortilhar+V.tu.AD.2.SG+IMPF+1+SG
cortilhava-te	cortilhar+V.tu.AD.2.SG+IMPF+3+SG
cortilhava-vos	cortilhar+V.vós.AD.2.PL+IMPF+1+SG
cortilhava-vos	cortilhar+V.vós.AD.2.PL+IMPF+3+SG
cortilhávei-la	cortilhar+V.ele.ACC.3.F.SG+IMPF+2+PL
cortilhávei-las	cortilhar+V.ele.ACC.3.F.PL+IMPF+2+PL
cortilhávei-lo	cortilhar+V.ele.ACC.3.M.SG+IMPF+2+PL
cortilhávei-los	cortilhar+V.ele.ACC.3.M.PL+IMPF+2+PL
cortilhávei-nos	cortilhar+nós.AD.1.PL+IMPF+2+PL
cortilháveis-lhe	cortilhar+V.ele.DAT.3.SG+IMPF+2+PL
cortilháveis-lhes	cortilhar+V.ele.DAT.3.PL+IMPF+2+PL
cortilháveis-me	cortilhar+V.eu.AD.1.SG+IMPF+2+PL
cortilháveis-te	cortilhar+V.tu.AD.2.SG+IMPF+2+PL
cortilháveis-vos	cortilhar+V.vós.AD.2.PL+IMPF+2+PL
cortilha-vos	cortilhar+V.vós.AD.2.PL+PRS+3+SG
cortilhe-a	cortilhar+V.ele.ACC.3.F.SG+IMP+3+SG
cortilhe-as	cortilhar+V.ele.ACC.3.F.PL+IMP+3+SG
cortilhei-a	cortilhar+V.ele.ACC.3.F.SG+PRF+1+SG
cortilhei-as	cortilhar+V.ele.ACC.3.F.PL+PRF+1+SG
cortilhei-lhe	cortilhar+V.ele.DAT.3.SG+PRF+1+SG
cortilhei-lhes	cortilhar+V.ele.DAT.3.PL+PRF+1+SG
cortilhei-me	cortilhar+V.eu.AD.1.SG+PRF+1+SG
cortilhei-nos	cortilhar+nós.AD.1.PL+PRF+1+SG
cortilhei-o	cortilhar+V.ele.ACC.3.M.SG+PRF+1+SG
cortilhei-os	cortilhar+V.ele.ACC.3.M.PL+PRF+1+SG
cortilhei-te	cortilhar+V.tu.AD.2.SG+PRF+1+SG
cortilhei-vos	cortilhar+V.vós.AD.2.PL+PRF+1+SG
cortilhe-lhe	cortilhar+V.ele.DAT.3.SG+IMP+3+SG
cortilhe-lhes	cortilhar+V.ele.DAT.3.PL+IMP+3+SG
cortilhe-me	cortilhar+V.eu.AD.1.SG+IMP+3+SG
cortilhem-lhe	cortilhar+V.ele.DAT.3.SG+IMP+3+PL
cortilhem-lhes	cortilhar+V.ele.DAT.3.PL+IMP+3+PL
cortilhem-me	cortilhar+V.eu.AD.1.SG+IMP+3+PL
cortilhem-na	cortilhar+V.ele.ACC.3.F.SG+IMP+3+PL
cortilhem-nas	cortilhar+V.ele.ACC.3.F.PL+IMP+3+PL
cortilhem-no	cortilhar+V.ele.ACC.3.M.SG+IMP+3+PL
cortilhem-nos	cortilhar+V.ele.ACC.3.M.PL+IMP+3+PL
cortilhem-nos	cortilhar+V.nós.AD.1.PL+IMP+3+PL
cortilhemo-la	cortilhar+V.ele.ACC.3.F.SG+IMP+1+PL
cortilhemo-las	cortilhar+V.ele.ACC.3.F.PL+IMP+1+PL
cortilhemo-lo	cortilhar+V.ele.ACC.3.M.SG+IMP+1+PL
cortilhemo-los	cortilhar+V.ele.ACC.3.M.PL+IMP+1+PL
cortilhemo-nos	cortilhar+nós.AD.1.PL+IMP+1+PL
cortilhemos-lhe	cortilhar+V.ele.DAT.3.SG+IMP+1+PL
cortilhemos-lhes	cortilhar+V.ele.DAT.3.PL+IMP+1+PL
cortilhemos-me	cortilhar+V.eu.AD.1.SG+IMP+1+PL
cortilhemos-te	cortilhar+V.tu.AD.2.SG+IMP+1+PL
cortilhemos-vos	cortilhar+V.vós.AD.2.PL+IMP+1+PL
cortilhem-se	cortilhar+V.ele.REFL+IMP+3+PL
cortilhem-te	cortilhar+V.tu.AD.2.SG+IMP+3+PL
cortilhem-vos	cortilhar+V.vós.AD.2.PL+IMP+3+PL
cortilhe-nos	cortilhar+nós.AD.1.PL+IMP+3+SG
cortilhe-o	cortilhar+V.ele.ACC.3.M.SG+IMP+3+SG
cortilhe-os	cortilhar+V.ele.ACC.3.M.PL+IMP+3+SG
cortilhe-se	cortilhar+V.ele.REFL+IMP+3+SG
cortilhe-te	cortilhar+V.tu.AD.2.SG+IMP+3+SG
cortilhe-vos	cortilhar+V.vós.AD.2.PL+IMP+3+SG
cortilho-a	cortilhar+V.ele.ACC.3.F.SG+PRS+1+SG
cortilho-as	cortilhar+V.ele.ACC.3.F.PL+PRS+1+SG
cortilho-lhe	cortilhar+V.ele.DAT.3.SG+PRS+1+SG
cortilho-lhes	cortilhar+V.ele.DAT.3.PL+PRS+1+SG
cortilho-me	cortilhar+V.eu.AD.1.SG+PRS+1+SG
cortilho-nos	cortilhar+nós.AD.1.PL+PRS+1+SG
cortilho-o	cortilhar+V.ele.ACC.3.M.SG+PRS+1+SG
cortilho-os	cortilhar+V.ele.ACC.3.M.PL+PRS+1+SG
cortilho-te	cortilhar+V.tu.AD.2.SG+PRS+1+SG
cortilhou-a	cortilhar+V.ele.ACC.3.F.SG+PRF+3+SG
cortilhou-as	cortilhar+V.ele.ACC.3.F.PL+PRF+3+SG
cortilhou-lhe	cortilhar+V.ele.DAT.3.SG+PRF+3+SG
cortilhou-lhes	cortilhar+V.ele.DAT.3.PL+PRF+3+SG
cortilhou-me	cortilhar+V.eu.AD.1.SG+PRF+3+SG
cortilhou-nos	cortilhar+nós.AD.1.PL+PRF+3+SG
cortilhou-o	cortilhar+V.ele.ACC.3.M.SG+PRF+3+SG
cortilhou-os	cortilhar+V.ele.ACC.3.M.PL+PRF+3+SG
cortilhou-se	cortilhar+V.ele.REFL+PRF+3+SG
cortilhou-te	cortilhar+V.tu.AD.2.SG+PRF+3+SG
cortilhou-vos	cortilhar+V.vós.AD.2.PL+PRF+3+SG
cortilho-vos	cortilhar+V.vós.AD.2.PL+PRS+1+SG
cortina-a	cortinar+V.ele.ACC.3.F.SG+PRS+3+SG
cortina-as	cortinar+V.ele.ACC.3.F.PL+PRS+3+SG
cortinai-la	cortinar+V.ele.ACC.3.F.SG+PRS+2+PL
cortinai-las	cortinar+V.ele.ACC.3.F.PL+PRS+2+PL
cortinai-lo	cortinar+V.ele.ACC.3.M.SG+PRS+2+PL
cortinai-los	cortinar+V.ele.ACC.3.M.PL+PRS+2+PL
cortinai-nos	cortinar+nós.AD.1.PL+PRS+2+PL
cortinais-lhe	cortinar+V.ele.DAT.3.SG+PRS+2+PL
cortinais-lhes	cortinar+V.ele.DAT.3.PL+PRS+2+PL
cortinais-me	cortinar+V.eu.AD.1.SG+PRS+2+PL
cortinais-te	cortinar+V.tu.AD.2.SG+PRS+2+PL
cortinais-vos	cortinar+V.vós.AD.2.PL+PRS+2+PL
cortiná-la-á	cortinar+V.ele.ACC.3.F.SG+FUT+3+SG
cortiná-la-ão	cortinar+V.ele.ACC.3.F.SG+FUT+3+PL
cortiná-la-ás	cortinar+V.ele.ACC.3.F.SG+FUT+2+SG
cortiná-la	cortinar+V.ele.ACC.3.F.SG+INF+1+SG
cortiná-la	cortinar+V.ele.ACC.3.F.SG+INF+3+SG
cortina-la	cortinar+V.ele.ACC.3.F.SG+PRS+2+SG
cortiná-la	cortinar+V.ele.ACC.3.F.SG+SBJF+1+SG
cortiná-la	cortinar+V.ele.ACC.3.F.SG+SBJF+3+SG
cortiná-la-ei	cortinar+V.ele.ACC.3.F.SG+FUT+1+SG
cortiná-la-eis	cortinar+V.ele.ACC.3.F.SG+FUT+2+PL
cortiná-la-emos	cortinar+V.ele.ACC.3.F.SG+FUT+1+PL
cortiná-la-ia	cortinar+V.ele.ACC.3.F.SG+COND+1+SG
cortiná-la-ia	cortinar+V.ele.ACC.3.F.SG+COND+3+SG
cortiná-la-iam	cortinar+V.ele.ACC.3.F.SG+COND+3+PL
cortiná-la-íamos	cortinar+V.ele.ACC.3.F.SG+COND+1+PL
cortiná-la-ias	cortinar+V.ele.ACC.3.F.SG+COND+2+SG
cortiná-la-íeis	cortinar+V.ele.ACC.3.F.SG+COND+2+PL
cortiná-las-á	cortinar+V.ele.ACC.3.F.PL+FUT+3+SG
cortiná-las-ão	cortinar+V.ele.ACC.3.F.PL+FUT+3+PL
cortiná-las-ás	cortinar+V.ele.ACC.3.F.PL+FUT+2+SG
cortiná-las	cortinar+V.ele.ACC.3.F.PL+INF+1+SG
cortiná-las	cortinar+V.ele.ACC.3.F.PL+INF+3+SG
cortina-las	cortinar+V.ele.ACC.3.F.PL+PRS+2+SG
cortiná-las	cortinar+V.ele.ACC.3.F.PL+SBJF+1+SG
cortiná-las	cortinar+V.ele.ACC.3.F.PL+SBJF+3+SG
cortiná-las-ei	cortinar+V.ele.ACC.3.F.PL+FUT+1+SG
cortiná-las-eis	cortinar+V.ele.ACC.3.F.PL+FUT+2+PL
cortiná-las-emos	cortinar+V.ele.ACC.3.F.PL+FUT+1+PL
cortiná-las-ia	cortinar+V.ele.ACC.3.F.PL+COND+1+SG
cortiná-las-ia	cortinar+V.ele.ACC.3.F.PL+COND+3+SG
cortiná-las-iam	cortinar+V.ele.ACC.3.F.PL+COND+3+PL
cortiná-las-íamos	cortinar+V.ele.ACC.3.F.PL+COND+1+PL
cortiná-las-ias	cortinar+V.ele.ACC.3.F.PL+COND+2+SG
cortiná-las-íeis	cortinar+V.ele.ACC.3.F.PL+COND+2+PL
cortina-lhe	cortinar+V.ele.DAT.3.SG+PRS+3+SG
cortina-lhes	cortinar+V.ele.DAT.3.PL+PRS+3+SG
cortiná-lo-á	cortinar+V.ele.ACC.3.M.SG+FUT+3+SG
cortiná-lo-ão	cortinar+V.ele.ACC.3.M.SG+FUT+3+PL
cortiná-lo-ás	cortinar+V.ele.ACC.3.M.SG+FUT+2+SG
cortiná-lo	cortinar+V.ele.ACC.3.M.SG+INF+1+SG
cortiná-lo	cortinar+V.ele.ACC.3.M.SG+INF+3+SG
cortina-lo	cortinar+V.ele.ACC.3.M.SG+PRS+2+SG
cortiná-lo	cortinar+V.ele.ACC.3.M.SG+SBJF+1+SG
cortiná-lo	cortinar+V.ele.ACC.3.M.SG+SBJF+3+SG
cortiná-lo-ei	cortinar+V.ele.ACC.3.M.SG+FUT+1+SG
cortiná-lo-eis	cortinar+V.ele.ACC.3.M.SG+FUT+2+PL
cortiná-lo-emos	cortinar+V.ele.ACC.3.M.SG+FUT+1+PL
cortiná-lo-ia	cortinar+V.ele.ACC.3.M.SG+COND+1+SG
cortiná-lo-ia	cortinar+V.ele.ACC.3.M.SG+COND+3+SG
cortiná-lo-iam	cortinar+V.ele.ACC.3.M.SG+COND+3+PL
cortiná-lo-íamos	cortinar+V.ele.ACC.3.M.SG+COND+1+PL
cortiná-lo-ias	cortinar+V.ele.ACC.3.M.SG+COND+2+SG
cortiná-lo-íeis	cortinar+V.ele.ACC.3.M.SG+COND+2+PL
cortiná-los-á	cortinar+V.ele.ACC.3.M.PL+FUT+3+SG
cortiná-los-ão	cortinar+V.ele.ACC.3.M.PL+FUT+3+PL
cortiná-los-ás	cortinar+V.ele.ACC.3.M.PL+FUT+2+SG
cortiná-los	cortinar+V.ele.ACC.3.M.PL+INF+1+SG
cortiná-los	cortinar+V.ele.ACC.3.M.PL+INF+3+SG
cortina-los	cortinar+V.ele.ACC.3.M.PL+PRS+2+SG
cortiná-los	cortinar+V.ele.ACC.3.M.PL+SBJF+1+SG
cortiná-los	cortinar+V.ele.ACC.3.M.PL+SBJF+3+SG
cortiná-los-ei	cortinar+V.ele.ACC.3.M.PL+FUT+1+SG
cortiná-los-eis	cortinar+V.ele.ACC.3.M.PL+FUT+2+PL
cortiná-los-emos	cortinar+V.ele.ACC.3.M.PL+FUT+1+PL
cortiná-los-ia	cortinar+V.ele.ACC.3.M.PL+COND+1+SG
cortiná-los-ia	cortinar+V.ele.ACC.3.M.PL+COND+3+SG
cortiná-los-iam	cortinar+V.ele.ACC.3.M.PL+COND+3+PL
cortiná-los-íamos	cortinar+V.ele.ACC.3.M.PL+COND+1+PL
cortiná-los-ias	cortinar+V.ele.ACC.3.M.PL+COND+2+SG
cortiná-los-íeis	cortinar+V.ele.ACC.3.M.PL+COND+2+PL
cortina-me	cortinar+V.eu.AD.1.SG+PRS+3+SG
cortinam-lhe	cortinar+V.ele.DAT.3.SG+PRS+3+PL
cortinam-lhes	cortinar+V.ele.DAT.3.PL+PRS+3+PL
cortinam-me	cortinar+V.eu.AD.1.SG+PRS+3+PL
cortinam-na	cortinar+V.ele.ACC.3.F.SG+PRS+3+PL
cortinam-nas	cortinar+V.ele.ACC.3.F.PL+PRS+3+PL
cortinam-no	cortinar+V.ele.ACC.3.M.SG+PRS+3+PL
cortinam-nos	cortinar+V.ele.ACC.3.M.PL+PRS+3+PL
cortinam-nos	cortinar+V.nós.AD.1.PL+PRS+3+PL
cortinamo-la	cortinar+V.ele.ACC.3.F.SG+PRF+1+PL
cortinamo-la	cortinar+V.ele.ACC.3.F.SG+PRS+1+PL
cortinamo-las	cortinar+V.ele.ACC.3.F.PL+PRF+1+PL
cortinamo-las	cortinar+V.ele.ACC.3.F.PL+PRS+1+PL
cortinamo-lo	cortinar+V.ele.ACC.3.M.SG+PRF+1+PL
cortinamo-lo	cortinar+V.ele.ACC.3.M.SG+PRS+1+PL
cortinamo-los	cortinar+V.ele.ACC.3.M.PL+PRF+1+PL
cortinamo-los	cortinar+V.ele.ACC.3.M.PL+PRS+1+PL
cortinamo-nos	cortinar+nós.AD.1.PL+PRF+1+PL
cortinamo-nos	cortinar+nós.AD.1.PL+PRS+1+PL
cortinamos-lhe	cortinar+V.ele.DAT.3.SG+PRF+1+PL
cortinamos-lhe	cortinar+V.ele.DAT.3.SG+PRS+1+PL
cortinamos-lhes	cortinar+V.ele.DAT.3.PL+PRF+1+PL
cortinamos-lhes	cortinar+V.ele.DAT.3.PL+PRS+1+PL
cortinamos-me	cortinar+V.eu.AD.1.SG+PRF+1+PL
cortinamos-me	cortinar+V.eu.AD.1.SG+PRS+1+PL
cortinamos-te	cortinar+V.tu.AD.2.SG+PRF+1+PL
cortinamos-te	cortinar+V.tu.AD.2.SG+PRS+1+PL
cortinamos-vos	cortinar+V.vós.AD.2.PL+PRF+1+PL
cortinamos-vos	cortinar+V.vós.AD.2.PL+PRS+1+PL
cortinam-se	cortinar+V.ele.REFL+PRS+3+PL
cortinam-te	cortinar+V.tu.AD.2.SG+PRS+3+PL
cortinam-vos	cortinar+V.vós.AD.2.PL+PRS+3+PL
cortinando-a	cortinar+V.ele.ACC.3.F.SG+GRD
cortinando-as	cortinar+V.ele.ACC.3.F.PL+GRD
cortinando-lhe	cortinar+V.ele.DAT.3.SG+GRD
cortinando-lhes	cortinar+V.ele.DAT.3.PL+GRD
cortinando-me	cortinar+V.eu.AD.1.SG+GRD
cortinando-nos	cortinar+nós.AD.1.PL+GRD
cortinando-o	cortinar+V.ele.ACC.3.M.SG+GRD
cortinando-os	cortinar+V.ele.ACC.3.M.PL+GRD
cortinando-se	cortinar+V.ele.REFL+GRD
cortinando-te	cortinar+V.tu.AD.2.SG+GRD
cortinando-vos	cortinar+V.vós.AD.2.PL+GRD
cortina-nos	cortinar+nós.AD.1.PL+PRS+2+SG
cortina-nos	cortinar+nós.AD.1.PL+PRS+3+SG
cortina-o	cortinar+V.ele.ACC.3.M.SG+PRS+3+SG
cortina-os	cortinar+V.ele.ACC.3.M.PL+PRS+3+SG
cortinara-a	cortinar+V.ele.ACC.3.F.SG+PQP+1+SG
cortinara-a	cortinar+V.ele.ACC.3.F.SG+PQP+3+SG
cortinara-as	cortinar+V.ele.ACC.3.F.PL+PQP+1+SG
cortinara-as	cortinar+V.ele.ACC.3.F.PL+PQP+3+SG
cortinara-la	cortinar+V.ele.ACC.3.F.SG+PQP+2+SG
cortinara-las	cortinar+V.ele.ACC.3.F.PL+PQP+2+SG
cortinara-lhe	cortinar+V.ele.DAT.3.SG+PQP+1+SG
cortinara-lhe	cortinar+V.ele.DAT.3.SG+PQP+3+SG
cortinara-lhes	cortinar+V.ele.DAT.3.PL+PQP+1+SG
cortinara-lhes	cortinar+V.ele.DAT.3.PL+PQP+3+SG
cortinara-lo	cortinar+V.ele.ACC.3.M.SG+PQP+2+SG
cortinara-los	cortinar+V.ele.ACC.3.M.PL+PQP+2+SG
cortinara-me	cortinar+V.eu.AD.1.SG+PQP+1+SG
cortinara-me	cortinar+V.eu.AD.1.SG+PQP+3+SG
cortinaram-lhe	cortinar+V.ele.DAT.3.SG+PQP+3+PL
cortinaram-lhe	cortinar+V.ele.DAT.3.SG+PRF+3+PL
cortinaram-lhes	cortinar+V.ele.DAT.3.PL+PQP+3+PL
cortinaram-lhes	cortinar+V.ele.DAT.3.PL+PRF+3+PL
cortinaram-me	cortinar+V.eu.AD.1.SG+PQP+3+PL
cortinaram-me	cortinar+V.eu.AD.1.SG+PRF+3+PL
cortinaram-na	cortinar+V.ele.ACC.3.F.SG+PQP+3+PL
cortinaram-na	cortinar+V.ele.ACC.3.F.SG+PRF+3+PL
cortinaram-nas	cortinar+V.ele.ACC.3.F.PL+PQP+3+PL
cortinaram-nas	cortinar+V.ele.ACC.3.F.PL+PRF+3+PL
cortinaram-no	cortinar+V.ele.ACC.3.M.SG+PQP+3+PL
cortinaram-no	cortinar+V.ele.ACC.3.M.SG+PRF+3+PL
cortinaram-nos	cortinar+V.ele.ACC.3.M.PL+PQP+3+PL
cortinaram-nos	cortinar+V.ele.ACC.3.M.PL+PRF+3+PL
cortinaram-nos	cortinar+V.nós.AD.1.PL+PQP+3+PL
cortinaram-nos	cortinar+V.nós.AD.1.PL+PRF+3+PL
cortináramo-la	cortinar+V.ele.ACC.3.F.SG+PQP+1+PL
cortináramo-las	cortinar+V.ele.ACC.3.F.PL+PQP+1+PL
cortináramo-lo	cortinar+V.ele.ACC.3.M.SG+PQP+1+PL
cortináramo-los	cortinar+V.ele.ACC.3.M.PL+PQP+1+PL
cortináramo-nos	cortinar+nós.AD.1.PL+PQP+1+PL
cortináramos-lhe	cortinar+V.ele.DAT.3.SG+PQP+1+PL
cortináramos-lhes	cortinar+V.ele.DAT.3.PL+PQP+1+PL
cortináramos-me	cortinar+V.eu.AD.1.SG+PQP+1+PL
cortináramos-te	cortinar+V.tu.AD.2.SG+PQP+1+PL
cortináramos-vos	cortinar+V.vós.AD.2.PL+PQP+1+PL
cortinaram-se	cortinar+V.ele.REFL+PQP+3+PL
cortinaram-se	cortinar+V.ele.REFL+PRF+3+PL
cortinaram-te	cortinar+V.tu.AD.2.SG+PQP+3+PL
cortinaram-te	cortinar+V.tu.AD.2.SG+PRF+3+PL
cortinaram-vos	cortinar+V.vós.AD.2.PL+PQP+3+PL
cortinaram-vos	cortinar+V.vós.AD.2.PL+PRF+3+PL
cortinara-nos	cortinar+nós.AD.1.PL+PQP+1+SG
cortinara-nos	cortinar+nós.AD.1.PL+PQP+2+SG
cortinara-nos	cortinar+nós.AD.1.PL+PQP+3+SG
cortinara-o	cortinar+V.ele.ACC.3.M.SG+PQP+1+SG
cortinara-o	cortinar+V.ele.ACC.3.M.SG+PQP+3+SG
cortinara-os	cortinar+V.ele.ACC.3.M.PL+PQP+1+SG
cortinara-os	cortinar+V.ele.ACC.3.M.PL+PQP+3+SG
cortinara-se	cortinar+V.ele.REFL+PQP+1+SG
cortinara-se	cortinar+V.ele.REFL+PQP+3+SG
cortinaras-lhe	cortinar+V.ele.DAT.3.SG+PQP+2+SG
cortinaras-lhes	cortinar+V.ele.DAT.3.PL+PQP+2+SG
cortinaras-me	cortinar+V.eu.AD.1.SG+PQP+2+SG
cortinaras-te	cortinar+V.tu.AD.2.SG+PQP+2+SG
cortinaras-vos	cortinar+V.vós.AD.2.PL+PQP+2+SG
cortinara-te	cortinar+V.tu.AD.2.SG+PQP+1+SG
cortinara-te	cortinar+V.tu.AD.2.SG+PQP+3+SG
cortinara-vos	cortinar+V.vós.AD.2.PL+PQP+1+SG
cortinara-vos	cortinar+V.vós.AD.2.PL+PQP+3+SG
cortinarde-la	cortinar+V.ele.ACC.3.F.SG+INF+2+PL
cortinarde-la	cortinar+V.ele.ACC.3.F.SG+SBJF+2+PL
cortinarde-las	cortinar+V.ele.ACC.3.F.PL+INF+2+PL
cortinarde-las	cortinar+V.ele.ACC.3.F.PL+SBJF+2+PL
cortinarde-lo	cortinar+V.ele.ACC.3.M.SG+INF+2+PL
cortinarde-lo	cortinar+V.ele.ACC.3.M.SG+SBJF+2+PL
cortinarde-los	cortinar+V.ele.ACC.3.M.PL+INF+2+PL
cortinarde-los	cortinar+V.ele.ACC.3.M.PL+SBJF+2+PL
cortinarde-nos	cortinar+nós.AD.1.PL+INF+2+PL
cortinarde-nos	cortinar+nós.AD.1.PL+SBJF+2+PL
cortinardes-lhe	cortinar+V.ele.DAT.3.SG+INF+2+PL
cortinardes-lhe	cortinar+V.ele.DAT.3.SG+SBJF+2+PL
cortinardes-lhes	cortinar+V.ele.DAT.3.PL+INF+2+PL
cortinardes-lhes	cortinar+V.ele.DAT.3.PL+SBJF+2+PL
cortinardes-me	cortinar+V.eu.AD.1.SG+INF+2+PL
cortinardes-me	cortinar+V.eu.AD.1.SG+SBJF+2+PL
cortinardes-te	cortinar+V.tu.AD.2.SG+INF+2+PL
cortinardes-te	cortinar+V.tu.AD.2.SG+SBJF+2+PL
cortinardes-vos	cortinar+V.vós.AD.2.PL+INF+2+PL
cortinardes-vos	cortinar+V.vós.AD.2.PL+SBJF+2+PL
