desadunarmo-las	desadunar+V.ele.ACC.3.F.PL+SBJF+1+PL
desadunarmo-lo	desadunar+V.ele.ACC.3.M.SG+INF+1+PL
desadunarmo-lo	desadunar+V.ele.ACC.3.M.SG+SBJF+1+PL
desadunarmo-los	desadunar+V.ele.ACC.3.M.PL+INF+1+PL
desadunarmo-los	desadunar+V.ele.ACC.3.M.PL+SBJF+1+PL
desadunarmo-nos	desadunar+nós.AD.1.PL+INF+1+PL
desadunarmo-nos	desadunar+nós.AD.1.PL+SBJF+1+PL
desadunarmos-lhe	desadunar+V.ele.DAT.3.SG+INF+1+PL
desadunarmos-lhe	desadunar+V.ele.DAT.3.SG+SBJF+1+PL
desadunarmos-lhes	desadunar+V.ele.DAT.3.PL+INF+1+PL
desadunarmos-lhes	desadunar+V.ele.DAT.3.PL+SBJF+1+PL
desadunarmos-me	desadunar+V.eu.AD.1.SG+INF+1+PL
desadunarmos-me	desadunar+V.eu.AD.1.SG+SBJF+1+PL
desadunarmos-te	desadunar+V.tu.AD.2.SG+INF+1+PL
desadunarmos-te	desadunar+V.tu.AD.2.SG+SBJF+1+PL
desadunarmos-vos	desadunar+V.vós.AD.2.PL+INF+1+PL
desadunarmos-vos	desadunar+V.vós.AD.2.PL+SBJF+1+PL
desadunar-nos-á	desadunar+nós.AD.1.PL+FUT+3+SG
desadunar-nos-ão	desadunar+nós.AD.1.PL+FUT+3+PL
desadunar-nos-ás	desadunar+nós.AD.1.PL+FUT+2+SG
desadunar-nos	desadunar+nós.AD.1.PL+INF
desadunar-nos	desadunar+nós.AD.1.PL+INF+1+SG
desadunar-nos	desadunar+nós.AD.1.PL+INF+3+SG
desadunar-nos	desadunar+nós.AD.1.PL+SBJF+1+SG
desadunar-nos	desadunar+nós.AD.1.PL+SBJF+3+SG
desadunar-nos-ei	desadunar+nós.AD.1.PL+FUT+1+SG
desadunar-nos-eis	desadunar+nós.AD.1.PL+FUT+2+PL
desadunar-nos-emos	desadunar+nós.AD.1.PL+FUT+1+PL
desadunar-nos-ia	desadunar+nós.AD.1.PL+COND+1+SG
desadunar-nos-ia	desadunar+nós.AD.1.PL+COND+3+SG
desadunar-nos-iam	desadunar+nós.AD.1.PL+COND+3+PL
desadunar-nos-íamos	desadunar+nós.AD.1.PL+COND+1+PL
desadunar-nos-ias	desadunar+nós.AD.1.PL+COND+2+SG
desadunar-nos-íeis	desadunar+nós.AD.1.PL+COND+2+PL
desadunar-se-á	desadunar+V.ele.REFL+FUT+3+SG
desadunar-se-ão	desadunar+V.ele.REFL+FUT+3+PL
desadunar-se	desadunar+V.ele.REFL+INF
desadunar-se	desadunar+V.ele.REFL+INF+3+SG
desadunar-se	desadunar+V.ele.REFL+SBJF+3+SG
desadunar-se-ia	desadunar+V.ele.REFL+COND+3+SG
desadunar-se-iam	desadunar+V.ele.REFL+COND+3+PL
desadunar-te-á	desadunar+V.tu.AD.2.SG+FUT+3+SG
desadunar-te-ão	desadunar+V.tu.AD.2.SG+FUT+3+PL
desadunar-te-ás	desadunar+V.tu.AD.2.SG+FUT+2+SG
desadunar-te	desadunar+V.tu.AD.2.SG+INF
desadunar-te	desadunar+V.tu.AD.2.SG+INF+1+SG
desadunar-te	desadunar+V.tu.AD.2.SG+INF+3+SG
desadunar-te	desadunar+V.tu.AD.2.SG+SBJF+1+SG
desadunar-te	desadunar+V.tu.AD.2.SG+SBJF+3+SG
desadunar-te-ei	desadunar+V.tu.AD.2.SG+FUT+1+SG
desadunar-te-eis	desadunar+V.tu.AD.2.SG+FUT+2+PL
desadunar-te-emos	desadunar+V.tu.AD.2.SG+FUT+1+PL
desadunar-te-ia	desadunar+V.tu.AD.2.SG+COND+1+SG
desadunar-te-ia	desadunar+V.tu.AD.2.SG+COND+3+SG
desadunar-te-iam	desadunar+V.tu.AD.2.SG+COND+3+PL
desadunar-te-íamos	desadunar+V.tu.AD.2.SG+COND+1+PL
desadunar-te-ias	desadunar+V.tu.AD.2.SG+COND+2+SG
desadunar-te-íeis	desadunar+V.tu.AD.2.SG+COND+2+PL
desadunar-vos-á	desadunar+V.vós.AD.2.PL+FUT+3+SG
desadunar-vos-ão	desadunar+V.vós.AD.2.PL+FUT+3+PL
desadunar-vos-ás	desadunar+V.vós.AD.2.PL+FUT+2+SG
desadunar-vos	desadunar+V.vós.AD.2.PL+INF
desadunar-vos	desadunar+V.vós.AD.2.PL+INF+1+SG
desadunar-vos	desadunar+V.vós.AD.2.PL+INF+3+SG
desadunar-vos	desadunar+V.vós.AD.2.PL+SBJF+1+SG
desadunar-vos	desadunar+V.vós.AD.2.PL+SBJF+3+SG
desadunar-vos-ei	desadunar+V.vós.AD.2.PL+FUT+1+SG
desadunar-vos-eis	desadunar+V.vós.AD.2.PL+FUT+2+PL
desadunar-vos-emos	desadunar+V.vós.AD.2.PL+FUT+1+PL
desadunar-vos-ia	desadunar+V.vós.AD.2.PL+COND+1+SG
desadunar-vos-ia	desadunar+V.vós.AD.2.PL+COND+3+SG
desadunar-vos-iam	desadunar+V.vós.AD.2.PL+COND+3+PL
desadunar-vos-íamos	desadunar+V.vós.AD.2.PL+COND+1+PL
desadunar-vos-ias	desadunar+V.vós.AD.2.PL+COND+2+SG
desadunar-vos-íeis	desadunar+V.vós.AD.2.PL+COND+2+PL
desaduna-se	desadunar+V.ele.REFL+PRS+3+SG
desadunas-lhe	desadunar+V.ele.DAT.3.SG+PRS+2+SG
desadunas-lhes	desadunar+V.ele.DAT.3.PL+PRS+2+SG
desadunas-me	desadunar+V.eu.AD.1.SG+PRS+2+SG
desadunaste-a	desadunar+V.ele.ACC.3.F.SG+PRF+2+SG
desadunaste-as	desadunar+V.ele.ACC.3.F.PL+PRF+2+SG
desadunas-te	desadunar+V.tu.AD.2.SG+PRS+2+SG
desadunaste-la	desadunar+V.ele.ACC.3.F.SG+PRF+2+PL
desadunaste-las	desadunar+V.ele.ACC.3.F.PL+PRF+2+PL
desadunaste-lhe	desadunar+V.ele.DAT.3.SG+PRF+2+SG
desadunaste-lhes	desadunar+V.ele.DAT.3.PL+PRF+2+SG
desadunaste-lo	desadunar+V.ele.ACC.3.M.SG+PRF+2+PL
desadunaste-los	desadunar+V.ele.ACC.3.M.PL+PRF+2+PL
desadunaste-me	desadunar+V.eu.AD.1.SG+PRF+2+SG
desadunaste-nos	desadunar+nós.AD.1.PL+PRF+2+PL
desadunaste-nos	desadunar+nós.AD.1.PL+PRF+2+SG
desadunaste-o	desadunar+V.ele.ACC.3.M.SG+PRF+2+SG
desadunaste-os	desadunar+V.ele.ACC.3.M.PL+PRF+2+SG
desadunastes-lhe	desadunar+V.ele.DAT.3.SG+PRF+2+PL
desadunastes-lhes	desadunar+V.ele.DAT.3.PL+PRF+2+PL
desadunastes-me	desadunar+V.eu.AD.1.SG+PRF+2+PL
desadunastes-te	desadunar+V.tu.AD.2.SG+PRF+2+PL
desadunastes-vos	desadunar+V.vós.AD.2.PL+PRF+2+PL
desadunaste-te	desadunar+V.tu.AD.2.SG+PRF+2+SG
desadunaste-vos	desadunar+V.vós.AD.2.PL+PRF+2+SG
desadunas-vos	desadunar+V.vós.AD.2.PL+PRS+2+SG
desaduna-te	desadunar+V.tu.AD.2.SG+PRS+3+SG
desadunava-a	desadunar+V.ele.ACC.3.F.SG+IMPF+1+SG
desadunava-a	desadunar+V.ele.ACC.3.F.SG+IMPF+3+SG
desadunava-as	desadunar+V.ele.ACC.3.F.PL+IMPF+1+SG
desadunava-as	desadunar+V.ele.ACC.3.F.PL+IMPF+3+SG
desadunava-la	desadunar+V.ele.ACC.3.F.SG+IMPF+2+SG
desadunava-las	desadunar+V.ele.ACC.3.F.PL+IMPF+2+SG
desadunava-lhe	desadunar+V.ele.DAT.3.SG+IMPF+1+SG
desadunava-lhe	desadunar+V.ele.DAT.3.SG+IMPF+3+SG
desadunava-lhes	desadunar+V.ele.DAT.3.PL+IMPF+1+SG
desadunava-lhes	desadunar+V.ele.DAT.3.PL+IMPF+3+SG
desadunava-lo	desadunar+V.ele.ACC.3.M.SG+IMPF+2+SG
desadunava-los	desadunar+V.ele.ACC.3.M.PL+IMPF+2+SG
desadunava-me	desadunar+V.eu.AD.1.SG+IMPF+1+SG
desadunava-me	desadunar+V.eu.AD.1.SG+IMPF+3+SG
desadunavam-lhe	desadunar+V.ele.DAT.3.SG+IMPF+3+PL
desadunavam-lhes	desadunar+V.ele.DAT.3.PL+IMPF+3+PL
desadunavam-me	desadunar+V.eu.AD.1.SG+IMPF+3+PL
desadunavam-na	desadunar+V.ele.ACC.3.F.SG+IMPF+3+PL
desadunavam-nas	desadunar+V.ele.ACC.3.F.PL+IMPF+3+PL
desadunavam-no	desadunar+V.ele.ACC.3.M.SG+IMPF+3+PL
desadunavam-nos	desadunar+V.ele.ACC.3.M.PL+IMPF+3+PL
desadunavam-nos	desadunar+V.nós.AD.1.PL+IMPF+3+PL
desadunávamo-la	desadunar+V.ele.ACC.3.F.SG+IMPF+1+PL
desadunávamo-las	desadunar+V.ele.ACC.3.F.PL+IMPF+1+PL
desadunávamo-lo	desadunar+V.ele.ACC.3.M.SG+IMPF+1+PL
desadunávamo-los	desadunar+V.ele.ACC.3.M.PL+IMPF+1+PL
desadunávamo-nos	desadunar+nós.AD.1.PL+IMPF+1+PL
desadunávamos-lhe	desadunar+V.ele.DAT.3.SG+IMPF+1+PL
desadunávamos-lhes	desadunar+V.ele.DAT.3.PL+IMPF+1+PL
desadunávamos-me	desadunar+V.eu.AD.1.SG+IMPF+1+PL
desadunávamos-te	desadunar+V.tu.AD.2.SG+IMPF+1+PL
desadunávamos-vos	desadunar+V.vós.AD.2.PL+IMPF+1+PL
desadunavam-se	desadunar+V.ele.REFL+IMPF+3+PL
desadunavam-te	desadunar+V.tu.AD.2.SG+IMPF+3+PL
desadunavam-vos	desadunar+V.vós.AD.2.PL+IMPF+3+PL
desadunava-nos	desadunar+nós.AD.1.PL+IMPF+1+SG
desadunava-nos	desadunar+nós.AD.1.PL+IMPF+2+SG
desadunava-nos	desadunar+nós.AD.1.PL+IMPF+3+SG
desadunava-o	desadunar+V.ele.ACC.3.M.SG+IMPF+1+SG
desadunava-o	desadunar+V.ele.ACC.3.M.SG+IMPF+3+SG
desadunava-os	desadunar+V.ele.ACC.3.M.PL+IMPF+1+SG
desadunava-os	desadunar+V.ele.ACC.3.M.PL+IMPF+3+SG
desadunava-se	desadunar+V.ele.REFL+IMPF+1+SG
desadunava-se	desadunar+V.ele.REFL+IMPF+3+SG
desadunavas-lhe	desadunar+V.ele.DAT.3.SG+IMPF+2+SG
desadunavas-lhes	desadunar+V.ele.DAT.3.PL+IMPF+2+SG
desadunavas-me	desadunar+V.eu.AD.1.SG+IMPF+2+SG
desadunavas-te	desadunar+V.tu.AD.2.SG+IMPF+2+SG
desadunavas-vos	desadunar+V.vós.AD.2.PL+IMPF+2+SG
desadunava-te	desadunar+V.tu.AD.2.SG+IMPF+1+SG
desadunava-te	desadunar+V.tu.AD.2.SG+IMPF+3+SG
desadunava-vos	desadunar+V.vós.AD.2.PL+IMPF+1+SG
desadunava-vos	desadunar+V.vós.AD.2.PL+IMPF+3+SG
desadunávei-la	desadunar+V.ele.ACC.3.F.SG+IMPF+2+PL
desadunávei-las	desadunar+V.ele.ACC.3.F.PL+IMPF+2+PL
desadunávei-lo	desadunar+V.ele.ACC.3.M.SG+IMPF+2+PL
desadunávei-los	desadunar+V.ele.ACC.3.M.PL+IMPF+2+PL
desadunávei-nos	desadunar+nós.AD.1.PL+IMPF+2+PL
desadunáveis-lhe	desadunar+V.ele.DAT.3.SG+IMPF+2+PL
desadunáveis-lhes	desadunar+V.ele.DAT.3.PL+IMPF+2+PL
desadunáveis-me	desadunar+V.eu.AD.1.SG+IMPF+2+PL
desadunáveis-te	desadunar+V.tu.AD.2.SG+IMPF+2+PL
desadunáveis-vos	desadunar+V.vós.AD.2.PL+IMPF+2+PL
desaduna-vos	desadunar+V.vós.AD.2.PL+PRS+3+SG
desadune-a	desadunar+V.ele.ACC.3.F.SG+IMP+3+SG
desadune-as	desadunar+V.ele.ACC.3.F.PL+IMP+3+SG
desadunei-a	desadunar+V.ele.ACC.3.F.SG+PRF+1+SG
desadunei-as	desadunar+V.ele.ACC.3.F.PL+PRF+1+SG
desadunei-lhe	desadunar+V.ele.DAT.3.SG+PRF+1+SG
desadunei-lhes	desadunar+V.ele.DAT.3.PL+PRF+1+SG
desadunei-me	desadunar+V.eu.AD.1.SG+PRF+1+SG
desadunei-nos	desadunar+nós.AD.1.PL+PRF+1+SG
desadunei-o	desadunar+V.ele.ACC.3.M.SG+PRF+1+SG
desadunei-os	desadunar+V.ele.ACC.3.M.PL+PRF+1+SG
desadunei-te	desadunar+V.tu.AD.2.SG+PRF+1+SG
desadunei-vos	desadunar+V.vós.AD.2.PL+PRF+1+SG
desadune-lhe	desadunar+V.ele.DAT.3.SG+IMP+3+SG
desadune-lhes	desadunar+V.ele.DAT.3.PL+IMP+3+SG
desadune-me	desadunar+V.eu.AD.1.SG+IMP+3+SG
desadunem-lhe	desadunar+V.ele.DAT.3.SG+IMP+3+PL
desadunem-lhes	desadunar+V.ele.DAT.3.PL+IMP+3+PL
desadunem-me	desadunar+V.eu.AD.1.SG+IMP+3+PL
desadunem-na	desadunar+V.ele.ACC.3.F.SG+IMP+3+PL
desadunem-nas	desadunar+V.ele.ACC.3.F.PL+IMP+3+PL
desadunem-no	desadunar+V.ele.ACC.3.M.SG+IMP+3+PL
desadunem-nos	desadunar+V.ele.ACC.3.M.PL+IMP+3+PL
desadunem-nos	desadunar+V.nós.AD.1.PL+IMP+3+PL
desadunemo-la	desadunar+V.ele.ACC.3.F.SG+IMP+1+PL
desadunemo-las	desadunar+V.ele.ACC.3.F.PL+IMP+1+PL
desadunemo-lo	desadunar+V.ele.ACC.3.M.SG+IMP+1+PL
desadunemo-los	desadunar+V.ele.ACC.3.M.PL+IMP+1+PL
desadunemo-nos	desadunar+nós.AD.1.PL+IMP+1+PL
desadunemos-lhe	desadunar+V.ele.DAT.3.SG+IMP+1+PL
desadunemos-lhes	desadunar+V.ele.DAT.3.PL+IMP+1+PL
desadunemos-me	desadunar+V.eu.AD.1.SG+IMP+1+PL
desadunemos-te	desadunar+V.tu.AD.2.SG+IMP+1+PL
desadunemos-vos	desadunar+V.vós.AD.2.PL+IMP+1+PL
desadunem-se	desadunar+V.ele.REFL+IMP+3+PL
desadunem-te	desadunar+V.tu.AD.2.SG+IMP+3+PL
desadunem-vos	desadunar+V.vós.AD.2.PL+IMP+3+PL
desadune-nos	desadunar+nós.AD.1.PL+IMP+3+SG
desadune-o	desadunar+V.ele.ACC.3.M.SG+IMP+3+SG
desadune-os	desadunar+V.ele.ACC.3.M.PL+IMP+3+SG
desadune-se	desadunar+V.ele.REFL+IMP+3+SG
desadune-te	desadunar+V.tu.AD.2.SG+IMP+3+SG
desadune-vos	desadunar+V.vós.AD.2.PL+IMP+3+SG
desaduno-a	desadunar+V.ele.ACC.3.F.SG+PRS+1+SG
desaduno-as	desadunar+V.ele.ACC.3.F.PL+PRS+1+SG
desaduno-lhe	desadunar+V.ele.DAT.3.SG+PRS+1+SG
desaduno-lhes	desadunar+V.ele.DAT.3.PL+PRS+1+SG
desaduno-me	desadunar+V.eu.AD.1.SG+PRS+1+SG
desaduno-nos	desadunar+nós.AD.1.PL+PRS+1+SG
desaduno-o	desadunar+V.ele.ACC.3.M.SG+PRS+1+SG
desaduno-os	desadunar+V.ele.ACC.3.M.PL+PRS+1+SG
desaduno-te	desadunar+V.tu.AD.2.SG+PRS+1+SG
desadunou-a	desadunar+V.ele.ACC.3.F.SG+PRF+3+SG
desadunou-as	desadunar+V.ele.ACC.3.F.PL+PRF+3+SG
desadunou-lhe	desadunar+V.ele.DAT.3.SG+PRF+3+SG
desadunou-lhes	desadunar+V.ele.DAT.3.PL+PRF+3+SG
desadunou-me	desadunar+V.eu.AD.1.SG+PRF+3+SG
desadunou-nos	desadunar+nós.AD.1.PL+PRF+3+SG
desadunou-o	desadunar+V.ele.ACC.3.M.SG+PRF+3+SG
desadunou-os	desadunar+V.ele.ACC.3.M.PL+PRF+3+SG
desadunou-se	desadunar+V.ele.REFL+PRF+3+SG
desadunou-te	desadunar+V.tu.AD.2.SG+PRF+3+SG
desadunou-vos	desadunar+V.vós.AD.2.PL+PRF+3+SG
desaduno-vos	desadunar+V.vós.AD.2.PL+PRS+1+SG
desafaça-a	desafazer+V.ele.ACC.3.F.SG+IMP+3+SG
desafaça-as	desafazer+V.ele.ACC.3.F.PL+IMP+3+SG
desafaça-lhe	desafazer+V.ele.DAT.3.SG+IMP+3+SG
desafaça-lhes	desafazer+V.ele.DAT.3.PL+IMP+3+SG
desafaça-me	desafazer+V.eu.AD.1.SG+IMP+3+SG
desafaçam-lhe	desafazer+V.ele.DAT.3.SG+IMP+3+PL
desafaçam-lhes	desafazer+V.ele.DAT.3.PL+IMP+3+PL
desafaçam-me	desafazer+V.eu.AD.1.SG+IMP+3+PL
desafaçam-na	desafazer+V.ele.ACC.3.F.SG+IMP+3+PL
desafaçam-nas	desafazer+V.ele.ACC.3.F.PL+IMP+3+PL
desafaçam-no	desafazer+V.ele.ACC.3.M.SG+IMP+3+PL
desafaçam-nos	desafazer+nós.AD.1.PL+IMP+3+PL
desafaçamo-la	desafazer+V.ele.ACC.3.F.SG+IMP+1+PL
desafaçamo-las	desafazer+V.ele.ACC.3.F.PL+IMP+1+PL
desafaçamo-lo	desafazer+V.ele.ACC.3.M.SG+IMP+1+PL
desafaçamo-los	desafazer+V.ele.ACC.3.M.PL+IMP+1+PL
desafaçamo-nos	desafazer+nós.AD.1.PL+IMP+1+PL
desafaçamos-lhe	desafazer+V.ele.DAT.3.SG+IMP+1+PL
desafaçamos-lhes	desafazer+V.ele.DAT.3.PL+IMP+1+PL
desafaçamos-me	desafazer+V.eu.AD.1.SG+IMP+1+PL
desafaçamos-te	desafazer+V.tu.AD.2.SG+IMP+1+PL
desafaçamos-vos	desafazer+V.vós.AD.2.PL+IMP+1+PL
desafaçam-se	desafazer+V.ele.REFL+IMP+3+PL
desafaçam-te	desafazer+V.tu.AD.2.SG+IMP+3+PL
desafaçam-vos	desafazer+V.vós.AD.2.PL+IMP+3+PL
desafaça-nos	desafazer+nós.AD.1.PL+IMP+3+SG
desafaça-o	desafazer+V.ele.ACC.3.M.SG+IMP+3+SG
desafaça-os	desafazer+V.ele.ACC.3.M.PL+IMP+3+SG
desafaça-se	desafazer+V.ele.REFL+IMP+3+SG
desafaça-te	desafazer+V.tu.AD.2.SG+IMP+3+SG
desafaça-vos	desafazer+V.vós.AD.2.PL+IMP+3+SG
desafaço-a	desafazer+V.ele.ACC.3.F.SG+PRS+1+SG
desafaço-as	desafazer+V.ele.ACC.3.F.PL+PRS+1+SG
desafaço-lhe	desafazer+V.ele.DAT.3.SG+PRS+1+SG
desafaço-lhes	desafazer+V.ele.DAT.3.PL+PRS+1+SG
desafaço-me	desafazer+V.eu.AD.1.SG+PRS+1+SG
desafaço-nos	desafazer+nós.AD.1.PL+PRS+1+SG
desafaço-o	desafazer+V.ele.ACC.3.M.SG+PRS+1+SG
desafaço-os	desafazer+V.ele.ACC.3.M.PL+PRS+1+SG
desafaço-te	desafazer+V.tu.AD.2.SG+PRS+1+SG
desafaço-vos	desafazer+V.vós.AD.2.PL+PRS+1+SG
desafaima-a	desafaimar+V.ele.ACC.3.F.SG+PRS+3+SG
desafaima-as	desafaimar+V.ele.ACC.3.F.PL+PRS+3+SG
desafaimai-la	desafaimar+V.ele.ACC.3.F.SG+PRS+2+PL
desafaimai-las	desafaimar+V.ele.ACC.3.F.PL+PRS+2+PL
desafaimai-lo	desafaimar+V.ele.ACC.3.M.SG+PRS+2+PL
desafaimai-los	desafaimar+V.ele.ACC.3.M.PL+PRS+2+PL
desafaimai-nos	desafaimar+nós.AD.1.PL+PRS+2+PL
desafaimais-lhe	desafaimar+V.ele.DAT.3.SG+PRS+2+PL
desafaimais-lhes	desafaimar+V.ele.DAT.3.PL+PRS+2+PL
desafaimais-me	desafaimar+V.eu.AD.1.SG+PRS+2+PL
desafaimais-te	desafaimar+V.tu.AD.2.SG+PRS+2+PL
desafaimais-vos	desafaimar+V.vós.AD.2.PL+PRS+2+PL
desafaimá-la-á	desafaimar+V.ele.ACC.3.F.SG+FUT+3+SG
desafaimá-la-ão	desafaimar+V.ele.ACC.3.F.SG+FUT+3+PL
desafaimá-la-ás	desafaimar+V.ele.ACC.3.F.SG+FUT+2+SG
desafaimá-la	desafaimar+V.ele.ACC.3.F.SG+INF+1+SG
desafaimá-la	desafaimar+V.ele.ACC.3.F.SG+INF+3+SG
desafaima-la	desafaimar+V.ele.ACC.3.F.SG+PRS+2+SG
desafaimá-la	desafaimar+V.ele.ACC.3.F.SG+SBJF+1+SG
desafaimá-la	desafaimar+V.ele.ACC.3.F.SG+SBJF+3+SG
desafaimá-la-ei	desafaimar+V.ele.ACC.3.F.SG+FUT+1+SG
desafaimá-la-eis	desafaimar+V.ele.ACC.3.F.SG+FUT+2+PL
desafaimá-la-emos	desafaimar+V.ele.ACC.3.F.SG+FUT+1+PL
desafaimá-la-ia	desafaimar+V.ele.ACC.3.F.SG+COND+1+SG
desafaimá-la-ia	desafaimar+V.ele.ACC.3.F.SG+COND+3+SG
desafaimá-la-iam	desafaimar+V.ele.ACC.3.F.SG+COND+3+PL
desafaimá-la-íamos	desafaimar+V.ele.ACC.3.F.SG+COND+1+PL
desafaimá-la-ias	desafaimar+V.ele.ACC.3.F.SG+COND+2+SG
desafaimá-la-íeis	desafaimar+V.ele.ACC.3.F.SG+COND+2+PL
desafaimá-las-á	desafaimar+V.ele.ACC.3.F.PL+FUT+3+SG
desafaimá-las-ão	desafaimar+V.ele.ACC.3.F.PL+FUT+3+PL
desafaimá-las-ás	desafaimar+V.ele.ACC.3.F.PL+FUT+2+SG
desafaimá-las	desafaimar+V.ele.ACC.3.F.PL+INF+1+SG
desafaimá-las	desafaimar+V.ele.ACC.3.F.PL+INF+3+SG
desafaima-las	desafaimar+V.ele.ACC.3.F.PL+PRS+2+SG
desafaimá-las	desafaimar+V.ele.ACC.3.F.PL+SBJF+1+SG
desafaimá-las	desafaimar+V.ele.ACC.3.F.PL+SBJF+3+SG
desafaimá-las-ei	desafaimar+V.ele.ACC.3.F.PL+FUT+1+SG
desafaimá-las-eis	desafaimar+V.ele.ACC.3.F.PL+FUT+2+PL
desafaimá-las-emos	desafaimar+V.ele.ACC.3.F.PL+FUT+1+PL
desafaimá-las-ia	desafaimar+V.ele.ACC.3.F.PL+COND+1+SG
desafaimá-las-ia	desafaimar+V.ele.ACC.3.F.PL+COND+3+SG
desafaimá-las-iam	desafaimar+V.ele.ACC.3.F.PL+COND+3+PL
desafaimá-las-íamos	desafaimar+V.ele.ACC.3.F.PL+COND+1+PL
desafaimá-las-ias	desafaimar+V.ele.ACC.3.F.PL+COND+2+SG
desafaimá-las-íeis	desafaimar+V.ele.ACC.3.F.PL+COND+2+PL
desafaima-lhe	desafaimar+V.ele.DAT.3.SG+PRS+3+SG
desafaima-lhes	desafaimar+V.ele.DAT.3.PL+PRS+3+SG
desafaimá-lo-á	desafaimar+V.ele.ACC.3.M.SG+FUT+3+SG
desafaimá-lo-ão	desafaimar+V.ele.ACC.3.M.SG+FUT+3+PL
desafaimá-lo-ás	desafaimar+V.ele.ACC.3.M.SG+FUT+2+SG
desafaimá-lo	desafaimar+V.ele.ACC.3.M.SG+INF+1+SG
desafaimá-lo	desafaimar+V.ele.ACC.3.M.SG+INF+3+SG
desafaima-lo	desafaimar+V.ele.ACC.3.M.SG+PRS+2+SG
desafaimá-lo	desafaimar+V.ele.ACC.3.M.SG+SBJF+1+SG
desafaimá-lo	desafaimar+V.ele.ACC.3.M.SG+SBJF+3+SG
desafaimá-lo-ei	desafaimar+V.ele.ACC.3.M.SG+FUT+1+SG
desafaimá-lo-eis	desafaimar+V.ele.ACC.3.M.SG+FUT+2+PL
desafaimá-lo-emos	desafaimar+V.ele.ACC.3.M.SG+FUT+1+PL
desafaimá-lo-ia	desafaimar+V.ele.ACC.3.M.SG+COND+1+SG
desafaimá-lo-ia	desafaimar+V.ele.ACC.3.M.SG+COND+3+SG
desafaimá-lo-iam	desafaimar+V.ele.ACC.3.M.SG+COND+3+PL
desafaimá-lo-íamos	desafaimar+V.ele.ACC.3.M.SG+COND+1+PL
desafaimá-lo-ias	desafaimar+V.ele.ACC.3.M.SG+COND+2+SG
desafaimá-lo-íeis	desafaimar+V.ele.ACC.3.M.SG+COND+2+PL
desafaimá-los-á	desafaimar+V.ele.ACC.3.M.PL+FUT+3+SG
desafaimá-los-ão	desafaimar+V.ele.ACC.3.M.PL+FUT+3+PL
desafaimá-los-ás	desafaimar+V.ele.ACC.3.M.PL+FUT+2+SG
desafaimá-los	desafaimar+V.ele.ACC.3.M.PL+INF+1+SG
desafaimá-los	desafaimar+V.ele.ACC.3.M.PL+INF+3+SG
desafaima-los	desafaimar+V.ele.ACC.3.M.PL+PRS+2+SG
desafaimá-los	desafaimar+V.ele.ACC.3.M.PL+SBJF+1+SG
desafaimá-los	desafaimar+V.ele.ACC.3.M.PL+SBJF+3+SG
desafaimá-los-ei	desafaimar+V.ele.ACC.3.M.PL+FUT+1+SG
desafaimá-los-eis	desafaimar+V.ele.ACC.3.M.PL+FUT+2+PL
desafaimá-los-emos	desafaimar+V.ele.ACC.3.M.PL+FUT+1+PL
desafaimá-los-ia	desafaimar+V.ele.ACC.3.M.PL+COND+1+SG
desafaimá-los-ia	desafaimar+V.ele.ACC.3.M.PL+COND+3+SG
desafaimá-los-iam	desafaimar+V.ele.ACC.3.M.PL+COND+3+PL
desafaimá-los-íamos	desafaimar+V.ele.ACC.3.M.PL+COND+1+PL
desafaimá-los-ias	desafaimar+V.ele.ACC.3.M.PL+COND+2+SG
desafaimá-los-íeis	desafaimar+V.ele.ACC.3.M.PL+COND+2+PL
desafaima-me	desafaimar+V.eu.AD.1.SG+PRS+3+SG
desafaimam-lhe	desafaimar+V.ele.DAT.3.SG+PRS+3+PL
desafaimam-lhes	desafaimar+V.ele.DAT.3.PL+PRS+3+PL
desafaimam-me	desafaimar+V.eu.AD.1.SG+PRS+3+PL
desafaimam-na	desafaimar+V.ele.ACC.3.F.SG+PRS+3+PL
desafaimam-nas	desafaimar+V.ele.ACC.3.F.PL+PRS+3+PL
desafaimam-no	desafaimar+V.ele.ACC.3.M.SG+PRS+3+PL
desafaimam-nos	desafaimar+V.ele.ACC.3.M.PL+PRS+3+PL
desafaimam-nos	desafaimar+V.nós.AD.1.PL+PRS+3+PL
desafaimamo-la	desafaimar+V.ele.ACC.3.F.SG+PRF+1+PL
desafaimamo-la	desafaimar+V.ele.ACC.3.F.SG+PRS+1+PL
desafaimamo-las	desafaimar+V.ele.ACC.3.F.PL+PRF+1+PL
desafaimamo-las	desafaimar+V.ele.ACC.3.F.PL+PRS+1+PL
desafaimamo-lo	desafaimar+V.ele.ACC.3.M.SG+PRF+1+PL
desafaimamo-lo	desafaimar+V.ele.ACC.3.M.SG+PRS+1+PL
desafaimamo-los	desafaimar+V.ele.ACC.3.M.PL+PRF+1+PL
desafaimamo-los	desafaimar+V.ele.ACC.3.M.PL+PRS+1+PL
desafaimamo-nos	desafaimar+nós.AD.1.PL+PRF+1+PL
desafaimamo-nos	desafaimar+nós.AD.1.PL+PRS+1+PL
desafaimamos-lhe	desafaimar+V.ele.DAT.3.SG+PRF+1+PL
desafaimamos-lhe	desafaimar+V.ele.DAT.3.SG+PRS+1+PL
desafaimamos-lhes	desafaimar+V.ele.DAT.3.PL+PRF+1+PL
desafaimamos-lhes	desafaimar+V.ele.DAT.3.PL+PRS+1+PL
desafaimamos-me	desafaimar+V.eu.AD.1.SG+PRF+1+PL
desafaimamos-me	desafaimar+V.eu.AD.1.SG+PRS+1+PL
desafaimamos-te	desafaimar+V.tu.AD.2.SG+PRF+1+PL
desafaimamos-te	desafaimar+V.tu.AD.2.SG+PRS+1+PL
desafaimamos-vos	desafaimar+V.vós.AD.2.PL+PRF+1+PL
desafaimamos-vos	desafaimar+V.vós.AD.2.PL+PRS+1+PL
desafaimam-se	desafaimar+V.ele.REFL+PRS+3+PL
desafaimam-te	desafaimar+V.tu.AD.2.SG+PRS+3+PL
desafaimam-vos	desafaimar+V.vós.AD.2.PL+PRS+3+PL
desafaimando-a	desafaimar+V.ele.ACC.3.F.SG+GRD
desafaimando-as	desafaimar+V.ele.ACC.3.F.PL+GRD
desafaimando-lhe	desafaimar+V.ele.DAT.3.SG+GRD
desafaimando-lhes	desafaimar+V.ele.DAT.3.PL+GRD
desafaimando-me	desafaimar+V.eu.AD.1.SG+GRD
desafaimando-nos	desafaimar+nós.AD.1.PL+GRD
desafaimando-o	desafaimar+V.ele.ACC.3.M.SG+GRD
desafaimando-os	desafaimar+V.ele.ACC.3.M.PL+GRD
desafaimando-se	desafaimar+V.ele.REFL+GRD
desafaimando-te	desafaimar+V.tu.AD.2.SG+GRD
desafaimando-vos	desafaimar+V.vós.AD.2.PL+GRD
desafaima-nos	desafaimar+nós.AD.1.PL+PRS+2+SG
desafaima-nos	desafaimar+nós.AD.1.PL+PRS+3+SG
desafaima-o	desafaimar+V.ele.ACC.3.M.SG+PRS+3+SG
desafaima-os	desafaimar+V.ele.ACC.3.M.PL+PRS+3+SG
desafaimara-a	desafaimar+V.ele.ACC.3.F.SG+PQP+1+SG
desafaimara-a	desafaimar+V.ele.ACC.3.F.SG+PQP+3+SG
desafaimara-as	desafaimar+V.ele.ACC.3.F.PL+PQP+1+SG
desafaimara-as	desafaimar+V.ele.ACC.3.F.PL+PQP+3+SG
desafaimara-la	desafaimar+V.ele.ACC.3.F.SG+PQP+2+SG
desafaimara-las	desafaimar+V.ele.ACC.3.F.PL+PQP+2+SG
desafaimara-lhe	desafaimar+V.ele.DAT.3.SG+PQP+1+SG
desafaimara-lhe	desafaimar+V.ele.DAT.3.SG+PQP+3+SG
desafaimara-lhes	desafaimar+V.ele.DAT.3.PL+PQP+1+SG
desafaimara-lhes	desafaimar+V.ele.DAT.3.PL+PQP+3+SG
desafaimara-lo	desafaimar+V.ele.ACC.3.M.SG+PQP+2+SG
desafaimara-los	desafaimar+V.ele.ACC.3.M.PL+PQP+2+SG
desafaimara-me	desafaimar+V.eu.AD.1.SG+PQP+1+SG
desafaimara-me	desafaimar+V.eu.AD.1.SG+PQP+3+SG
desafaimaram-lhe	desafaimar+V.ele.DAT.3.SG+PQP+3+PL
desafaimaram-lhe	desafaimar+V.ele.DAT.3.SG+PRF+3+PL
desafaimaram-lhes	desafaimar+V.ele.DAT.3.PL+PQP+3+PL
desafaimaram-lhes	desafaimar+V.ele.DAT.3.PL+PRF+3+PL
desafaimaram-me	desafaimar+V.eu.AD.1.SG+PQP+3+PL
desafaimaram-me	desafaimar+V.eu.AD.1.SG+PRF+3+PL
desafaimaram-na	desafaimar+V.ele.ACC.3.F.SG+PQP+3+PL
desafaimaram-na	desafaimar+V.ele.ACC.3.F.SG+PRF+3+PL
desafaimaram-nas	desafaimar+V.ele.ACC.3.F.PL+PQP+3+PL
desafaimaram-nas	desafaimar+V.ele.ACC.3.F.PL+PRF+3+PL
desafaimaram-no	desafaimar+V.ele.ACC.3.M.SG+PQP+3+PL
desafaimaram-no	desafaimar+V.ele.ACC.3.M.SG+PRF+3+PL
desafaimaram-nos	desafaimar+V.ele.ACC.3.M.PL+PQP+3+PL
desafaimaram-nos	desafaimar+V.ele.ACC.3.M.PL+PRF+3+PL
desafaimaram-nos	desafaimar+V.nós.AD.1.PL+PQP+3+PL
desafaimaram-nos	desafaimar+V.nós.AD.1.PL+PRF+3+PL
desafaimáramo-la	desafaimar+V.ele.ACC.3.F.SG+PQP+1+PL
desafaimáramo-las	desafaimar+V.ele.ACC.3.F.PL+PQP+1+PL
desafaimáramo-lo	desafaimar+V.ele.ACC.3.M.SG+PQP+1+PL
desafaimáramo-los	desafaimar+V.ele.ACC.3.M.PL+PQP+1+PL
desafaimáramo-nos	desafaimar+V.ele.ACC.3.M.PL+PQP+1+PL
desafaimáramo-nos	desafaimar+V.nós.AD.1.PL+PQP+1+PL
desafaimáramos-lhe	desafaimar+V.ele.DAT.3.SG+PQP+1+PL
desafaimáramos-lhes	desafaimar+V.ele.DAT.3.PL+PQP+1+PL
desafaimáramos-me	desafaimar+V.eu.AD.1.SG+PQP+1+PL
desafaimáramos-te	desafaimar+V.tu.AD.2.SG+PQP+1+PL
desafaimáramos-vos	desafaimar+V.vós.AD.2.PL+PQP+1+PL
desafaimaram-se	desafaimar+V.ele.REFL+PQP+3+PL
desafaimaram-se	desafaimar+V.ele.REFL+PRF+3+PL
desafaimaram-te	desafaimar+V.tu.AD.2.SG+PQP+3+PL
desafaimaram-te	desafaimar+V.tu.AD.2.SG+PRF+3+PL
desafaimaram-vos	desafaimar+V.vós.AD.2.PL+PQP+3+PL
desafaimaram-vos	desafaimar+V.vós.AD.2.PL+PRF+3+PL
desafaimara-nos	desafaimar+nós.AD.1.PL+PQP+1+SG
desafaimara-nos	desafaimar+nós.AD.1.PL+PQP+2+SG
desafaimara-nos	desafaimar+nós.AD.1.PL+PQP+3+SG
desafaimara-o	desafaimar+V.ele.ACC.3.M.SG+PQP+1+SG
desafaimara-o	desafaimar+V.ele.ACC.3.M.SG+PQP+3+SG
desafaimara-os	desafaimar+V.ele.ACC.3.M.PL+PQP+1+SG
desafaimara-os	desafaimar+V.ele.ACC.3.M.PL+PQP+3+SG
desafaimara-se	desafaimar+V.ele.REFL+PQP+1+SG
desafaimara-se	desafaimar+V.ele.REFL+PQP+3+SG
desafaimaras-lhe	desafaimar+V.ele.DAT.3.SG+PQP+2+SG
desafaimaras-lhes	desafaimar+V.ele.DAT.3.PL+PQP+2+SG
desafaimaras-me	desafaimar+V.eu.AD.1.SG+PQP+2+SG
desafaimaras-te	desafaimar+V.tu.AD.2.SG+PQP+2+SG
desafaimaras-vos	desafaimar+V.vós.AD.2.PL+PQP+2+SG
desafaimara-te	desafaimar+V.tu.AD.2.SG+PQP+1+SG
desafaimara-te	desafaimar+V.tu.AD.2.SG+PQP+3+SG
desafaimara-vos	desafaimar+V.vós.AD.2.PL+PQP+1+SG
desafaimara-vos	desafaimar+V.vós.AD.2.PL+PQP+3+SG
desafaimarde-la	desafaimar+V.ele.ACC.3.F.SG+INF+2+PL
desafaimarde-la	desafaimar+V.ele.ACC.3.F.SG+SBJF+2+PL
desafaimarde-las	desafaimar+V.ele.ACC.3.F.PL+INF+2+PL
desafaimarde-las	desafaimar+V.ele.ACC.3.F.PL+SBJF+2+PL
desafaimarde-lo	desafaimar+V.ele.ACC.3.M.SG+INF+2+PL
desafaimarde-lo	desafaimar+V.ele.ACC.3.M.SG+SBJF+2+PL
desafaimarde-los	desafaimar+V.ele.ACC.3.M.PL+INF+2+PL
desafaimarde-los	desafaimar+V.ele.ACC.3.M.PL+SBJF+2+PL
desafaimarde-nos	desafaimar+nós.AD.1.PL+INF+2+PL
desafaimarde-nos	desafaimar+nós.AD.1.PL+SBJF+2+PL
desafaimardes-lhe	desafaimar+V.ele.DAT.3.SG+INF+2+PL
desafaimardes-lhe	desafaimar+V.ele.DAT.3.SG+SBJF+2+PL
desafaimardes-lhes	desafaimar+V.ele.DAT.3.PL+INF+2+PL
desafaimardes-lhes	desafaimar+V.ele.DAT.3.PL+SBJF+2+PL
desafaimardes-me	desafaimar+V.eu.AD.1.SG+INF+2+PL
desafaimardes-me	desafaimar+V.eu.AD.1.SG+SBJF+2+PL
desafaimardes-te	desafaimar+V.tu.AD.2.SG+INF+2+PL
desafaimardes-te	desafaimar+V.tu.AD.2.SG+SBJF+2+PL
desafaimardes-vos	desafaimar+V.vós.AD.2.PL+INF+2+PL
desafaimardes-vos	desafaimar+V.vós.AD.2.PL+SBJF+2+PL
desafaimárei-la	desafaimar+V.ele.ACC.3.F.SG+PQP+2+PL
desafaimárei-las	desafaimar+V.ele.ACC.3.F.PL+PQP+2+PL
desafaimárei-lo	desafaimar+V.ele.ACC.3.M.SG+PQP+2+PL
desafaimárei-los	desafaimar+V.ele.ACC.3.M.PL+PQP+2+PL
desafaimárei-nos	desafaimar+V.ele.ACC.3.M.PL+PQP+2+PL
desafaimárei-nos	desafaimar+V.nós.AD.1.PL+PQP+2+PL
desafaimáreis-lhe	desafaimar+V.ele.DAT.3.SG+PQP+2+PL
desafaimáreis-lhes	desafaimar+V.ele.DAT.3.PL+PQP+2+PL
desafaimáreis-me	desafaimar+V.eu.AD.1.SG+PQP+2+PL
desafaimáreis-te	desafaimar+V.tu.AD.2.SG+PQP+2+PL
desafaimáreis-vos	desafaimar+V.vós.AD.2.PL+PQP+2+PL
desafaimare-la	desafaimar+V.ele.ACC.3.F.SG+INF+2+SG
desafaimare-la	desafaimar+V.ele.ACC.3.F.SG+SBJF+2+SG
desafaimare-las	desafaimar+V.ele.ACC.3.F.PL+INF+2+SG
desafaimare-las	desafaimar+V.ele.ACC.3.F.PL+SBJF+2+SG
desafaimare-lo	desafaimar+V.ele.ACC.3.M.SG+INF+2+SG
desafaimare-lo	desafaimar+V.ele.ACC.3.M.SG+SBJF+2+SG
desafaimare-los	desafaimar+V.ele.ACC.3.M.PL+INF+2+SG
desafaimare-los	desafaimar+V.ele.ACC.3.M.PL+SBJF+2+SG
desafaimarem-lhe	desafaimar+V.ele.DAT.3.SG+INF+3+PL
desafaimarem-lhe	desafaimar+V.ele.DAT.3.SG+SBJF+3+PL
desafaimarem-lhes	desafaimar+V.ele.DAT.3.PL+INF+3+PL
desafaimarem-lhes	desafaimar+V.ele.DAT.3.PL+SBJF+3+PL
desafaimarem-me	desafaimar+V.eu.AD.1.SG+INF+3+PL
desafaimarem-me	desafaimar+V.eu.AD.1.SG+SBJF+3+PL
desafaimarem-na	desafaimar+V.ele.ACC.3.F.SG+INF+3+PL
desafaimarem-na	desafaimar+V.ele.ACC.3.F.SG+SBJF+3+PL
desafaimarem-nas	desafaimar+V.ele.ACC.3.F.PL+INF+3+PL
desafaimarem-nas	desafaimar+V.ele.ACC.3.F.PL+SBJF+3+PL
desafaimarem-no	desafaimar+V.ele.ACC.3.M.SG+INF+3+PL
desafaimarem-no	desafaimar+V.ele.ACC.3.M.SG+SBJF+3+PL
desafaimarem-nos	desafaimar+V.ele.ACC.3.M.PL+INF+3+PL
desafaimarem-nos	desafaimar+V.ele.ACC.3.M.PL+SBJF+3+PL
desafaimarem-nos	desafaimar+V.nós.AD.1.PL+INF+3+PL
desafaimarem-nos	desafaimar+V.nós.AD.1.PL+SBJF+3+PL
desafaimarem-se	desafaimar+V.ele.REFL+INF+3+PL
desafaimarem-se	desafaimar+V.ele.REFL+SBJF+3+PL
desafaimarem-te	desafaimar+V.tu.AD.2.SG+INF+3+PL
desafaimarem-te	desafaimar+V.tu.AD.2.SG+SBJF+3+PL
desafaimarem-vos	desafaimar+V.vós.AD.2.PL+INF+3+PL
desafaimarem-vos	desafaimar+V.vós.AD.2.PL+SBJF+3+PL
desafaimare-nos	desafaimar+nós.AD.1.PL+INF+2+SG
desafaimare-nos	desafaimar+nós.AD.1.PL+SBJF+2+SG
desafaimares-lhe	desafaimar+V.ele.DAT.3.SG+INF+2+SG
desafaimares-lhe	desafaimar+V.ele.DAT.3.SG+SBJF+2+SG
desafaimares-lhes	desafaimar+V.ele.DAT.3.PL+INF+2+SG
desafaimares-lhes	desafaimar+V.ele.DAT.3.PL+SBJF+2+SG
desafaimares-me	desafaimar+V.eu.AD.1.SG+INF+2+SG
desafaimares-me	desafaimar+V.eu.AD.1.SG+SBJF+2+SG
desafaimares-te	desafaimar+V.tu.AD.2.SG+INF+2+SG
desafaimares-te	desafaimar+V.tu.AD.2.SG+SBJF+2+SG
desafaimares-vos	desafaimar+V.vós.AD.2.PL+INF+2+SG
desafaimares-vos	desafaimar+V.vós.AD.2.PL+SBJF+2+SG
desafaimar-lhe-á	desafaimar+V.ele.DAT.3.SG+FUT+3+SG
desafaimar-lhe-ão	desafaimar+V.ele.DAT.3.SG+FUT+3+PL
desafaimar-lhe-ás	desafaimar+V.ele.DAT.3.SG+FUT+2+SG
desafaimar-lhe	desafaimar+V.ele.DAT.3.SG+INF
desafaimar-lhe	desafaimar+V.ele.DAT.3.SG+INF+1+SG
desafaimar-lhe	desafaimar+V.ele.DAT.3.SG+INF+3+SG
desafaimar-lhe	desafaimar+V.ele.DAT.3.SG+SBJF+1+SG
desafaimar-lhe	desafaimar+V.ele.DAT.3.SG+SBJF+3+SG
desafaimar-lhe-ei	desafaimar+V.ele.DAT.3.SG+FUT+1+SG
desafaimar-lhe-eis	desafaimar+V.ele.DAT.3.SG+FUT+2+PL
desafaimar-lhe-emos	desafaimar+V.ele.DAT.3.SG+FUT+1+PL
desafaimar-lhe-ia	desafaimar+V.ele.DAT.3.SG+COND+1+SG
desafaimar-lhe-ia	desafaimar+V.ele.DAT.3.SG+COND+3+SG
desafaimar-lhe-iam	desafaimar+V.ele.DAT.3.SG+COND+3+PL
desafaimar-lhe-íamos	desafaimar+V.ele.DAT.3.SG+COND+1+PL
desafaimar-lhe-ias	desafaimar+V.ele.DAT.3.SG+COND+2+SG
desafaimar-lhe-íeis	desafaimar+V.ele.DAT.3.SG+COND+2+PL
desafaimar-lhes-á	desafaimar+V.ele.DAT.3.PL+FUT+3+SG
desafaimar-lhes-ão	desafaimar+V.ele.DAT.3.PL+FUT+3+PL
desafaimar-lhes-ás	desafaimar+V.ele.DAT.3.PL+FUT+2+SG
desafaimar-lhes	desafaimar+V.ele.DAT.3.PL+INF
desafaimar-lhes	desafaimar+V.ele.DAT.3.PL+INF+1+SG
desafaimar-lhes	desafaimar+V.ele.DAT.3.PL+INF+3+SG
desafaimar-lhes	desafaimar+V.ele.DAT.3.PL+SBJF+1+SG
desafaimar-lhes	desafaimar+V.ele.DAT.3.PL+SBJF+3+SG
desafaimar-lhes-ei	desafaimar+V.ele.DAT.3.PL+FUT+1+SG
desafaimar-lhes-eis	desafaimar+V.ele.DAT.3.PL+FUT+2+PL
desafaimar-lhes-emos	desafaimar+V.ele.DAT.3.PL+FUT+1+PL
desafaimar-lhes-ia	desafaimar+V.ele.DAT.3.PL+COND+1+SG
desafaimar-lhes-ia	desafaimar+V.ele.DAT.3.PL+COND+3+SG
desafaimar-lhes-iam	desafaimar+V.ele.DAT.3.PL+COND+3+PL
desafaimar-lhes-íamos	desafaimar+V.ele.DAT.3.PL+COND+1+PL
desafaimar-lhes-ias	desafaimar+V.ele.DAT.3.PL+COND+2+SG
desafaimar-lhes-íeis	desafaimar+V.ele.DAT.3.PL+COND+2+PL
desafaimar-me-á	desafaimar+V.eu.AD.1.SG+FUT+3+SG
desafaimar-me-ão	desafaimar+V.eu.AD.1.SG+FUT+3+PL
desafaimar-me-ás	desafaimar+V.eu.AD.1.SG+FUT+2+SG
desafaimar-me	desafaimar+V.eu.AD.1.SG+INF
desafaimar-me	desafaimar+V.eu.AD.1.SG+INF+1+SG
desafaimar-me	desafaimar+V.eu.AD.1.SG+INF+3+SG
desafaimar-me	desafaimar+V.eu.AD.1.SG+SBJF+1+SG
desafaimar-me	desafaimar+V.eu.AD.1.SG+SBJF+3+SG
desafaimar-me-ei	desafaimar+V.eu.AD.1.SG+FUT+1+SG
desafaimar-me-eis	desafaimar+V.eu.AD.1.SG+FUT+2+PL
desafaimar-me-emos	desafaimar+V.eu.AD.1.SG+FUT+1+PL
desafaimar-me-ia	desafaimar+V.eu.AD.1.SG+COND+1+SG
desafaimar-me-ia	desafaimar+V.eu.AD.1.SG+COND+3+SG
desafaimar-me-iam	desafaimar+V.eu.AD.1.SG+COND+3+PL
desafaimar-me-íamos	desafaimar+V.eu.AD.1.SG+COND+1+PL
desafaimar-me-ias	desafaimar+V.eu.AD.1.SG+COND+2+SG
desafaimar-me-íeis	desafaimar+V.eu.AD.1.SG+COND+2+PL
desafaimarmo-la	desafaimar+V.ele.ACC.3.F.SG+INF+1+PL
desafaimarmo-la	desafaimar+V.ele.ACC.3.F.SG+SBJF+1+PL
desafaimarmo-las	desafaimar+V.ele.ACC.3.F.PL+INF+1+PL
desafaimarmo-las	desafaimar+V.ele.ACC.3.F.PL+SBJF+1+PL
desafaimarmo-lo	desafaimar+V.ele.ACC.3.M.SG+INF+1+PL
desafaimarmo-lo	desafaimar+V.ele.ACC.3.M.SG+SBJF+1+PL
desafaimarmo-los	desafaimar+V.ele.ACC.3.M.PL+INF+1+PL
desafaimarmo-los	desafaimar+V.ele.ACC.3.M.PL+SBJF+1+PL
desafaimarmo-nos	desafaimar+nós.AD.1.PL+INF+1+PL
desafaimarmo-nos	desafaimar+nós.AD.1.PL+SBJF+1+PL
desafaimarmos-lhe	desafaimar+V.ele.DAT.3.SG+INF+1+PL
desafaimarmos-lhe	desafaimar+V.ele.DAT.3.SG+SBJF+1+PL
desafaimarmos-lhes	desafaimar+V.ele.DAT.3.PL+INF+1+PL
desafaimarmos-lhes	desafaimar+V.ele.DAT.3.PL+SBJF+1+PL
desafaimarmos-me	desafaimar+V.eu.AD.1.SG+INF+1+PL
desafaimarmos-me	desafaimar+V.eu.AD.1.SG+SBJF+1+PL
desafaimarmos-te	desafaimar+V.tu.AD.2.SG+INF+1+PL
desafaimarmos-te	desafaimar+V.tu.AD.2.SG+SBJF+1+PL
desafaimarmos-vos	desafaimar+V.vós.AD.2.PL+INF+1+PL
desafaimarmos-vos	desafaimar+V.vós.AD.2.PL+SBJF+1+PL
desafaimar-nos-á	desafaimar+nós.AD.1.PL+FUT+3+SG
desafaimar-nos-ão	desafaimar+nós.AD.1.PL+FUT+3+PL
desafaimar-nos-ás	desafaimar+nós.AD.1.PL+FUT+2+SG
desafaimar-nos	desafaimar+nós.AD.1.PL+INF
desafaimar-nos	desafaimar+nós.AD.1.PL+INF+1+SG
desafaimar-nos	desafaimar+nós.AD.1.PL+INF+3+SG
desafaimar-nos	desafaimar+nós.AD.1.PL+SBJF+1+SG
desafaimar-nos	desafaimar+nós.AD.1.PL+SBJF+3+SG
desafaimar-nos-ei	desafaimar+nós.AD.1.PL+FUT+1+SG
desafaimar-nos-eis	desafaimar+nós.AD.1.PL+FUT+2+PL
desafaimar-nos-emos	desafaimar+nós.AD.1.PL+FUT+1+PL
desafaimar-nos-ia	desafaimar+nós.AD.1.PL+COND+1+SG
desafaimar-nos-ia	desafaimar+nós.AD.1.PL+COND+3+SG
desafaimar-nos-iam	desafaimar+nós.AD.1.PL+COND+3+PL
desafaimar-nos-íamos	desafaimar+nós.AD.1.PL+COND+1+PL
desafaimar-nos-ias	desafaimar+nós.AD.1.PL+COND+2+SG
desafaimar-nos-íeis	desafaimar+nós.AD.1.PL+COND+2+PL
desafaimar-se-á	desafaimar+V.ele.REFL+FUT+3+SG
desafaimar-se-ão	desafaimar+V.ele.REFL+FUT+3+PL
desafaimar-se	desafaimar+V.ele.REFL+INF
desafaimar-se	desafaimar+V.ele.REFL+INF+3+SG
desafaimar-se	desafaimar+V.ele.REFL+SBJF+3+SG
desafaimar-se-ia	desafaimar+V.ele.REFL+COND+3+SG
desafaimar-se-iam	desafaimar+V.ele.REFL+COND+3+PL
desafaimar-te-á	desafaimar+V.tu.AD.2.SG+FUT+3+SG
desafaimar-te-ão	desafaimar+V.tu.AD.2.SG+FUT+3+PL
desafaimar-te-ás	desafaimar+V.tu.AD.2.SG+FUT+2+SG
desafaimar-te	desafaimar+V.tu.AD.2.SG+INF
desafaimar-te	desafaimar+V.tu.AD.2.SG+INF+1+SG
desafaimar-te	desafaimar+V.tu.AD.2.SG+INF+3+SG
desafaimar-te	desafaimar+V.tu.AD.2.SG+SBJF+1+SG
desafaimar-te	desafaimar+V.tu.AD.2.SG+SBJF+3+SG
desafaimar-te-ei	desafaimar+V.tu.AD.2.SG+FUT+1+SG
desafaimar-te-eis	desafaimar+V.tu.AD.2.SG+FUT+2+PL
desafaimar-te-emos	desafaimar+V.tu.AD.2.SG+FUT+1+PL
desafaimar-te-ia	desafaimar+V.tu.AD.2.SG+COND+1+SG
desafaimar-te-ia	desafaimar+V.tu.AD.2.SG+COND+3+SG
desafaimar-te-iam	desafaimar+V.tu.AD.2.SG+COND+3+PL
desafaimar-te-íamos	desafaimar+V.tu.AD.2.SG+COND+1+PL
desafaimar-te-ias	desafaimar+V.tu.AD.2.SG+COND+2+SG
desafaimar-te-íeis	desafaimar+V.tu.AD.2.SG+COND+2+PL
desafaimar-vos-á	desafaimar+V.vós.AD.2.PL+FUT+3+SG
desafaimar-vos-ão	desafaimar+V.vós.AD.2.PL+FUT+3+PL
desafaimar-vos-ás	desafaimar+V.vós.AD.2.PL+FUT+2+SG
desafaimar-vos	desafaimar+V.vós.AD.2.PL+INF
desafaimar-vos	desafaimar+V.vós.AD.2.PL+INF+1+SG
desafaimar-vos	desafaimar+V.vós.AD.2.PL+INF+3+SG
desafaimar-vos	desafaimar+V.vós.AD.2.PL+SBJF+1+SG
desafaimar-vos	desafaimar+V.vós.AD.2.PL+SBJF+3+SG
desafaimar-vos-ei	desafaimar+V.vós.AD.2.PL+FUT+1+SG
desafaimar-vos-eis	desafaimar+V.vós.AD.2.PL+FUT+2+PL
desafaimar-vos-emos	desafaimar+V.vós.AD.2.PL+FUT+1+PL
desafaimar-vos-ia	desafaimar+V.vós.AD.2.PL+COND+1+SG
desafaimar-vos-ia	desafaimar+V.vós.AD.2.PL+COND+3+SG
desafaimar-vos-iam	desafaimar+V.vós.AD.2.PL+COND+3+PL
desafaimar-vos-íamos	desafaimar+V.vós.AD.2.PL+COND+1+PL
desafaimar-vos-ias	desafaimar+V.vós.AD.2.PL+COND+2+SG
desafaimar-vos-íeis	desafaimar+V.vós.AD.2.PL+COND+2+PL
desafaima-se	desafaimar+V.ele.REFL+PRS+3+SG
desafaimas-lhe	desafaimar+V.ele.DAT.3.SG+PRS+2+SG
desafaimas-lhes	desafaimar+V.ele.DAT.3.PL+PRS+2+SG
desafaimas-me	desafaimar+V.eu.AD.1.SG+PRS+2+SG
desafaimaste-a	desafaimar+V.ele.ACC.3.F.SG+PRF+2+SG
desafaimaste-as	desafaimar+V.ele.ACC.3.F.PL+PRF+2+SG
desafaimas-te	desafaimar+V.tu.AD.2.SG+PRS+2+SG
desafaimaste-la	desafaimar+V.ele.ACC.3.F.SG+PRF+2+PL
desafaimaste-las	desafaimar+V.ele.ACC.3.F.PL+PRF+2+PL
desafaimaste-lhe	desafaimar+V.ele.DAT.3.SG+PRF+2+SG
desafaimaste-lhes	desafaimar+V.ele.DAT.3.PL+PRF+2+SG
desafaimaste-lo	desafaimar+V.ele.ACC.3.M.SG+PRF+2+PL
desafaimaste-los	desafaimar+V.ele.ACC.3.M.PL+PRF+2+PL
desafaimaste-me	desafaimar+V.eu.AD.1.SG+PRF+2+SG
desafaimaste-nos	desafaimar+nós.AD.1.PL+PRF+2+PL
desafaimaste-nos	desafaimar+nós.AD.1.PL+PRF+2+SG
desafaimaste-o	desafaimar+V.ele.ACC.3.M.SG+PRF+2+SG
desafaimaste-os	desafaimar+V.ele.ACC.3.M.PL+PRF+2+SG
desafaimastes-lhe	desafaimar+V.ele.DAT.3.SG+PRF+2+PL
desafaimastes-lhes	desafaimar+V.ele.DAT.3.PL+PRF+2+PL
desafaimastes-me	desafaimar+V.eu.AD.1.SG+PRF+2+PL
desafaimastes-te	desafaimar+V.tu.AD.2.SG+PRF+2+PL
desafaimastes-vos	desafaimar+V.vós.AD.2.PL+PRF+2+PL
desafaimaste-te	desafaimar+V.tu.AD.2.SG+PRF+2+SG
desafaimaste-vos	desafaimar+V.vós.AD.2.PL+PRF+2+SG
desafaimas-vos	desafaimar+V.vós.AD.2.PL+PRS+2+SG
desafaima-te	desafaimar+V.tu.AD.2.SG+PRS+3+SG
desafaimava-a	desafaimar+V.ele.ACC.3.F.SG+IMPF+1+SG
desafaimava-a	desafaimar+V.ele.ACC.3.F.SG+IMPF+3+SG
desafaimava-as	desafaimar+V.ele.ACC.3.F.PL+IMPF+1+SG
desafaimava-as	desafaimar+V.ele.ACC.3.F.PL+IMPF+3+SG
desafaimava-la	desafaimar+V.ele.ACC.3.F.SG+IMPF+2+SG
desafaimava-las	desafaimar+V.ele.ACC.3.F.PL+IMPF+2+SG
desafaimava-lhe	desafaimar+V.ele.DAT.3.SG+IMPF+1+SG
desafaimava-lhe	desafaimar+V.ele.DAT.3.SG+IMPF+3+SG
desafaimava-lhes	desafaimar+V.ele.DAT.3.PL+IMPF+1+SG
desafaimava-lhes	desafaimar+V.ele.DAT.3.PL+IMPF+3+SG
desafaimava-lo	desafaimar+V.ele.ACC.3.M.SG+IMPF+2+SG
desafaimava-los	desafaimar+V.ele.ACC.3.M.PL+IMPF+2+SG
desafaimava-me	desafaimar+V.eu.AD.1.SG+IMPF+1+SG
desafaimava-me	desafaimar+V.eu.AD.1.SG+IMPF+3+SG
desafaimavam-lhe	desafaimar+V.ele.DAT.3.SG+IMPF+3+PL
desafaimavam-lhes	desafaimar+V.ele.DAT.3.PL+IMPF+3+PL
desafaimavam-me	desafaimar+V.eu.AD.1.SG+IMPF+3+PL
desafaimavam-na	desafaimar+V.ele.ACC.3.F.SG+IMPF+3+PL
desafaimavam-nas	desafaimar+V.ele.ACC.3.F.PL+IMPF+3+PL
desafaimavam-no	desafaimar+V.ele.ACC.3.M.SG+IMPF+3+PL
desafaimavam-nos	desafaimar+V.ele.ACC.3.M.PL+IMPF+3+PL
desafaimavam-nos	desafaimar+V.nós.AD.1.PL+IMPF+3+PL
desafaimávamo-la	desafaimar+V.ele.ACC.3.F.SG+IMPF+1+PL
desafaimávamo-las	desafaimar+V.ele.ACC.3.F.PL+IMPF+1+PL
desafaimávamo-lo	desafaimar+V.ele.ACC.3.M.SG+IMPF+1+PL
desafaimávamo-los	desafaimar+V.ele.ACC.3.M.PL+IMPF+1+PL
desafaimávamo-nos	desafaimar+V.ele.ACC.3.M.PL+IMPF+1+PL
desafaimávamo-nos	desafaimar+V.nós.AD.1.PL+IMPF+1+PL
desafaimávamos-lhe	desafaimar+V.ele.DAT.3.SG+IMPF+1+PL
desafaimávamos-lhes	desafaimar+V.ele.DAT.3.PL+IMPF+1+PL
desafaimávamos-me	desafaimar+V.eu.AD.1.SG+IMPF+1+PL
desafaimávamos-te	desafaimar+V.tu.AD.2.SG+IMPF+1+PL
desafaimávamos-vos	desafaimar+V.vós.AD.2.PL+IMPF+1+PL
desafaimavam-se	desafaimar+V.ele.REFL+IMPF+3+PL
desafaimavam-te	desafaimar+V.tu.AD.2.SG+IMPF+3+PL
desafaimavam-vos	desafaimar+V.vós.AD.2.PL+IMPF+3+PL
desafaimava-nos	desafaimar+nós.AD.1.PL+IMPF+1+SG
desafaimava-nos	desafaimar+nós.AD.1.PL+IMPF+2+SG
desafaimava-nos	desafaimar+nós.AD.1.PL+IMPF+3+SG
desafaimava-o	desafaimar+V.ele.ACC.3.M.SG+IMPF+1+SG
desafaimava-o	desafaimar+V.ele.ACC.3.M.SG+IMPF+3+SG
desafaimava-os	desafaimar+V.ele.ACC.3.M.PL+IMPF+1+SG
desafaimava-os	desafaimar+V.ele.ACC.3.M.PL+IMPF+3+SG
desafaimava-se	desafaimar+V.ele.REFL+IMPF+1+SG
desafaimava-se	desafaimar+V.ele.REFL+IMPF+3+SG
desafaimavas-lhe	desafaimar+V.ele.DAT.3.SG+IMPF+2+SG
desafaimavas-lhes	desafaimar+V.ele.DAT.3.PL+IMPF+2+SG
desafaimavas-me	desafaimar+V.eu.AD.1.SG+IMPF+2+SG
desafaimavas-te	desafaimar+V.tu.AD.2.SG+IMPF+2+SG
desafaimavas-vos	desafaimar+V.vós.AD.2.PL+IMPF+2+SG
desafaimava-te	desafaimar+V.tu.AD.2.SG+IMPF+1+SG
desafaimava-te	desafaimar+V.tu.AD.2.SG+IMPF+3+SG
desafaimava-vos	desafaimar+V.vós.AD.2.PL+IMPF+1+SG
desafaimava-vos	desafaimar+V.vós.AD.2.PL+IMPF+3+SG
desafaimávei-la	desafaimar+V.ele.ACC.3.F.SG+IMPF+2+PL
desafaimávei-las	desafaimar+V.ele.ACC.3.F.PL+IMPF+2+PL
desafaimávei-lo	desafaimar+V.ele.ACC.3.M.SG+IMPF+2+PL
desafaimávei-los	desafaimar+V.ele.ACC.3.M.PL+IMPF+2+PL
desafaimávei-nos	desafaimar+V.ele.ACC.3.M.PL+IMPF+2+PL
desafaimávei-nos	desafaimar+V.nós.AD.1.PL+IMPF+2+PL
desafaimáveis-lhe	desafaimar+V.ele.DAT.3.SG+IMPF+2+PL
desafaimáveis-lhes	desafaimar+V.ele.DAT.3.PL+IMPF+2+PL
desafaimáveis-me	desafaimar+V.eu.AD.1.SG+IMPF+2+PL
desafaimáveis-te	desafaimar+V.tu.AD.2.SG+IMPF+2+PL
desafaimáveis-vos	desafaimar+V.vós.AD.2.PL+IMPF+2+PL
desafaima-vos	desafaimar+V.vós.AD.2.PL+PRS+3+SG
desafaime-a	desafaimar+V.ele.ACC.3.F.SG+IMP+3+SG
desafaime-as	desafaimar+V.ele.ACC.3.F.PL+IMP+3+SG
desafaimei-a	desafaimar+V.ele.ACC.3.F.SG+PRF+1+SG
desafaimei-as	desafaimar+V.ele.ACC.3.F.PL+PRF+1+SG
desafaimei-lhe	desafaimar+V.ele.DAT.3.SG+PRF+1+SG
desafaimei-lhes	desafaimar+V.ele.DAT.3.PL+PRF+1+SG
desafaimei-me	desafaimar+V.eu.AD.1.SG+PRF+1+SG
desafaimei-nos	desafaimar+nós.AD.1.PL+PRF+1+SG
desafaimei-o	desafaimar+V.ele.ACC.3.M.SG+PRF+1+SG
desafaimei-os	desafaimar+V.ele.ACC.3.M.PL+PRF+1+SG
desafaimei-te	desafaimar+V.tu.AD.2.SG+PRF+1+SG
desafaimei-vos	desafaimar+V.vós.AD.2.PL+PRF+1+SG
desafaime-lhe	desafaimar+V.ele.DAT.3.SG+IMP+3+SG
desafaime-lhes	desafaimar+V.ele.DAT.3.PL+IMP+3+SG
desafaime-me	desafaimar+V.eu.AD.1.SG+IMP+3+SG
desafaimem-lhe	desafaimar+V.ele.DAT.3.SG+IMP+3+PL
desafaimem-lhes	desafaimar+V.ele.DAT.3.PL+IMP+3+PL
desafaimem-me	desafaimar+V.eu.AD.1.SG+IMP+3+PL
desafaimem-na	desafaimar+V.ele.ACC.3.F.SG+IMP+3+PL
desafaimem-nas	desafaimar+V.ele.ACC.3.F.PL+IMP+3+PL
desafaimem-no	desafaimar+V.ele.ACC.3.M.SG+IMP+3+PL
desafaimem-nos	desafaimar+V.ele.ACC.3.M.PL+IMP+3+PL
desafaimem-nos	desafaimar+V.nós.AD.1.PL+IMP+3+PL
desafaimemo-la	desafaimar+V.ele.ACC.3.F.SG+IMP+1+PL
desafaimemo-las	desafaimar+V.ele.ACC.3.F.PL+IMP+1+PL
desafaimemo-lo	desafaimar+V.ele.ACC.3.M.SG+IMP+1+PL
desafaimemo-los	desafaimar+V.ele.ACC.3.M.PL+IMP+1+PL
desafaimemo-nos	desafaimar+nós.AD.1.PL+IMP+1+PL
desafaimemos-lhe	desafaimar+V.ele.DAT.3.SG+IMP+1+PL
desafaimemos-lhes	desafaimar+V.ele.DAT.3.PL+IMP+1+PL
desafaimemos-me	desafaimar+V.eu.AD.1.SG+IMP+1+PL
desafaimemos-te	desafaimar+V.tu.AD.2.SG+IMP+1+PL
desafaimemos-vos	desafaimar+V.vós.AD.2.PL+IMP+1+PL
desafaimem-se	desafaimar+V.ele.REFL+IMP+3+PL
desafaimem-te	desafaimar+V.tu.AD.2.SG+IMP+3+PL
desafaimem-vos	desafaimar+V.vós.AD.2.PL+IMP+3+PL
desafaime-nos	desafaimar+nós.AD.1.PL+IMP+3+SG
desafaime-o	desafaimar+V.ele.ACC.3.M.SG+IMP+3+SG
desafaime-os	desafaimar+V.ele.ACC.3.M.PL+IMP+3+SG
desafaime-se	desafaimar+V.ele.REFL+IMP+3+SG
desafaime-te	desafaimar+V.tu.AD.2.SG+IMP+3+SG
desafaime-vos	desafaimar+V.vós.AD.2.PL+IMP+3+SG
desafaimo-a	desafaimar+V.ele.ACC.3.F.SG+PRS+1+SG
desafaimo-as	desafaimar+V.ele.ACC.3.F.PL+PRS+1+SG
desafaimo-lhe	desafaimar+V.ele.DAT.3.SG+PRS+1+SG
desafaimo-lhes	desafaimar+V.ele.DAT.3.PL+PRS+1+SG
desafaimo-me	desafaimar+V.eu.AD.1.SG+PRS+1+SG
desafaimo-nos	desafaimar+nós.AD.1.PL+PRS+1+SG
desafaimo-o	desafaimar+V.ele.ACC.3.M.SG+PRS+1+SG
desafaimo-os	desafaimar+V.ele.ACC.3.M.PL+PRS+1+SG
desafaimo-te	desafaimar+V.tu.AD.2.SG+PRS+1+SG
desafaimou-a	desafaimar+V.ele.ACC.3.F.SG+PRF+3+SG
desafaimou-as	desafaimar+V.ele.ACC.3.F.PL+PRF+3+SG
desafaimou-lhe	desafaimar+V.ele.DAT.3.SG+PRF+3+SG
desafaimou-lhes	desafaimar+V.ele.DAT.3.PL+PRF+3+SG
desafaimou-me	desafaimar+V.eu.AD.1.SG+PRF+3+SG
desafaimou-nos	desafaimar+nós.AD.1.PL+PRF+3+SG
desafaimou-o	desafaimar+V.ele.ACC.3.M.SG+PRF+3+SG
desafaimou-os	desafaimar+V.ele.ACC.3.M.PL+PRF+3+SG
desafaimou-se	desafaimar+V.ele.REFL+PRF+3+SG
desafaimou-te	desafaimar+V.tu.AD.2.SG+PRF+3+SG
desafaimou-vos	desafaimar+V.vós.AD.2.PL+PRF+3+SG
desafaimo-vos	desafaimar+V.vós.AD.2.PL+PRS+1+SG
desafá-la-á	desafazer+V.ele.ACC.3.F.SG+FUT+3+SG
desafá-la-ão	desafazer+V.ele.ACC.3.F.SG+FUT+3+PL
desafá-la-ás	desafazer+V.ele.ACC.3.F.SG+FUT+2+SG
desafá-la-ei	desafazer+V.ele.ACC.3.F.SG+FUT+1+SG
desafá-la-eis	desafazer+V.ele.ACC.3.F.SG+FUT+2+PL
desafá-la-emos	desafazer+V.ele.ACC.3.F.SG+FUT+1+PL
desafá-la-ia	desafazer+V.ele.ACC.3.F.SG+COND+1+SG
desafá-la-ia	desafazer+V.ele.ACC.3.F.SG+COND+3+SG
desafá-la-iam	desafazer+V.ele.ACC.3.F.SG+COND+3+PL
desafá-la-íamos	desafazer+V.ele.ACC.3.F.SG+COND+1+PL
desafá-la-ias	desafazer+V.ele.ACC.3.F.SG+COND+2+SG
desafá-la-íeis	desafazer+V.ele.ACC.3.F.SG+COND+2+PL
desafá-las-á	desafazer+V.ele.ACC.3.F.PL+FUT+3+SG
desafá-las-ão	desafazer+V.ele.ACC.3.F.PL+FUT+3+PL
desafá-las-ás	desafazer+V.ele.ACC.3.F.PL+FUT+2+SG
desafá-las-ei	desafazer+V.ele.ACC.3.F.PL+FUT+1+SG
desafá-las-eis	desafazer+V.ele.ACC.3.F.PL+FUT+2+PL
desafá-las-emos	desafazer+V.ele.ACC.3.F.PL+FUT+1+PL
desafá-las-ia	desafazer+V.ele.ACC.3.F.PL+COND+1+SG
desafá-las-ia	desafazer+V.ele.ACC.3.F.PL+COND+3+SG
desafá-las-iam	desafazer+V.ele.ACC.3.F.PL+COND+3+PL
desafá-las-íamos	desafazer+V.ele.ACC.3.F.PL+COND+1+PL
desafá-las-ias	desafazer+V.ele.ACC.3.F.PL+COND+2+SG
desafá-las-íeis	desafazer+V.ele.ACC.3.F.PL+COND+2+PL
desafá-lo-á	desafazer+V.ele.ACC.3.M.SG+FUT+3+SG
desafá-lo-ão	desafazer+V.ele.ACC.3.M.SG+FUT+3+PL
desafá-lo-ás	desafazer+V.ele.ACC.3.M.SG+FUT+2+SG
desafá-lo-ei	desafazer+V.ele.ACC.3.M.SG+FUT+1+SG
desafá-lo-eis	desafazer+V.ele.ACC.3.M.SG+FUT+2+PL
desafá-lo-emos	desafazer+V.ele.ACC.3.M.SG+FUT+1+PL
desafá-lo-ia	desafazer+V.ele.ACC.3.M.SG+COND+1+SG
desafá-lo-ia	desafazer+V.ele.ACC.3.M.SG+COND+3+SG
desafá-lo-iam	desafazer+V.ele.ACC.3.M.SG+COND+3+PL
desafá-lo-íamos	desafazer+V.ele.ACC.3.M.SG+COND+1+PL
desafá-lo-ias	desafazer+V.ele.ACC.3.M.SG+COND+2+SG
desafá-lo-íeis	desafazer+V.ele.ACC.3.M.SG+COND+2+PL
desafá-los-á	desafazer+V.ele.ACC.3.M.PL+FUT+3+SG
desafá-los-ão	desafazer+V.ele.ACC.3.M.PL+FUT+3+PL
desafá-los-ás	desafazer+V.ele.ACC.3.M.PL+FUT+2+SG
desafá-los-ei	desafazer+V.ele.ACC.3.M.PL+FUT+1+SG
desafá-los-eis	desafazer+V.ele.ACC.3.M.PL+FUT+2+PL
desafá-los-emos	desafazer+V.ele.ACC.3.M.PL+FUT+1+PL
desafá-los-ia	desafazer+V.ele.ACC.3.M.PL+COND+1+SG
desafá-los-ia	desafazer+V.ele.ACC.3.M.PL+COND+3+SG
desafá-los-iam	desafazer+V.ele.ACC.3.M.PL+COND+3+PL
desafá-los-íamos	desafazer+V.ele.ACC.3.M.PL+COND+1+PL
desafá-los-ias	desafazer+V.ele.ACC.3.M.PL+COND+2+SG
desafá-los-íeis	desafazer+V.ele.ACC.3.M.PL+COND+2+PL
desafama-a	desafamar+V.ele.ACC.3.F.SG+PRS+3+SG
desafama-as	desafamar+V.ele.ACC.3.F.PL+PRS+3+SG
desafamai-la	desafamar+V.ele.ACC.3.F.SG+PRS+2+PL
desafamai-las	desafamar+V.ele.ACC.3.F.PL+PRS+2+PL
desafamai-lo	desafamar+V.ele.ACC.3.M.SG+PRS+2+PL
desafamai-los	desafamar+V.ele.ACC.3.M.PL+PRS+2+PL
desafamai-nos	desafamar+nós.AD.1.PL+PRS+2+PL
desafamais-lhe	desafamar+V.ele.DAT.3.SG+PRS+2+PL
desafamais-lhes	desafamar+V.ele.DAT.3.PL+PRS+2+PL
desafamais-me	desafamar+V.eu.AD.1.SG+PRS+2+PL
desafamais-te	desafamar+V.tu.AD.2.SG+PRS+2+PL
desafamais-vos	desafamar+V.vós.AD.2.PL+PRS+2+PL
desafamá-la-á	desafamar+V.ele.ACC.3.F.SG+FUT+3+SG
desafamá-la-ão	desafamar+V.ele.ACC.3.F.SG+FUT+3+PL
desafamá-la-ás	desafamar+V.ele.ACC.3.F.SG+FUT+2+SG
desafamá-la	desafamar+V.ele.ACC.3.F.SG+INF+1+SG
desafamá-la	desafamar+V.ele.ACC.3.F.SG+INF+3+SG
desafama-la	desafamar+V.ele.ACC.3.F.SG+PRS+2+SG
desafamá-la	desafamar+V.ele.ACC.3.F.SG+SBJF+1+SG
desafamá-la	desafamar+V.ele.ACC.3.F.SG+SBJF+3+SG
desafamá-la-ei	desafamar+V.ele.ACC.3.F.SG+FUT+1+SG
desafamá-la-eis	desafamar+V.ele.ACC.3.F.SG+FUT+2+PL
desafamá-la-emos	desafamar+V.ele.ACC.3.F.SG+FUT+1+PL
desafamá-la-ia	desafamar+V.ele.ACC.3.F.SG+COND+1+SG
desafamá-la-ia	desafamar+V.ele.ACC.3.F.SG+COND+3+SG
desafamá-la-iam	desafamar+V.ele.ACC.3.F.SG+COND+3+PL
desafamá-la-íamos	desafamar+V.ele.ACC.3.F.SG+COND+1+PL
desafamá-la-ias	desafamar+V.ele.ACC.3.F.SG+COND+2+SG
desafamá-la-íeis	desafamar+V.ele.ACC.3.F.SG+COND+2+PL
desafamá-las-á	desafamar+V.ele.ACC.3.F.PL+FUT+3+SG
desafamá-las-ão	desafamar+V.ele.ACC.3.F.PL+FUT+3+PL
desafamá-las-ás	desafamar+V.ele.ACC.3.F.PL+FUT+2+SG
desafamá-las	desafamar+V.ele.ACC.3.F.PL+INF+1+SG
desafamá-las	desafamar+V.ele.ACC.3.F.PL+INF+3+SG
desafama-las	desafamar+V.ele.ACC.3.F.PL+PRS+2+SG
desafamá-las	desafamar+V.ele.ACC.3.F.PL+SBJF+1+SG
desafamá-las	desafamar+V.ele.ACC.3.F.PL+SBJF+3+SG
desafamá-las-ei	desafamar+V.ele.ACC.3.F.PL+FUT+1+SG
desafamá-las-eis	desafamar+V.ele.ACC.3.F.PL+FUT+2+PL
desafamá-las-emos	desafamar+V.ele.ACC.3.F.PL+FUT+1+PL
desafamá-las-ia	desafamar+V.ele.ACC.3.F.PL+COND+1+SG
desafamá-las-ia	desafamar+V.ele.ACC.3.F.PL+COND+3+SG
desafamá-las-iam	desafamar+V.ele.ACC.3.F.PL+COND+3+PL
desafamá-las-íamos	desafamar+V.ele.ACC.3.F.PL+COND+1+PL
desafamá-las-ias	desafamar+V.ele.ACC.3.F.PL+COND+2+SG
desafamá-las-íeis	desafamar+V.ele.ACC.3.F.PL+COND+2+PL
desafama-lhe	desafamar+V.ele.DAT.3.SG+PRS+3+SG
desafama-lhes	desafamar+V.ele.DAT.3.PL+PRS+3+SG
desafamá-lo-á	desafamar+V.ele.ACC.3.M.SG+FUT+3+SG
desafamá-lo-ão	desafamar+V.ele.ACC.3.M.SG+FUT+3+PL
desafamá-lo-ás	desafamar+V.ele.ACC.3.M.SG+FUT+2+SG
desafamá-lo	desafamar+V.ele.ACC.3.M.SG+INF+1+SG
desafamá-lo	desafamar+V.ele.ACC.3.M.SG+INF+3+SG
desafama-lo	desafamar+V.ele.ACC.3.M.SG+PRS+2+SG
desafamá-lo	desafamar+V.ele.ACC.3.M.SG+SBJF+1+SG
desafamá-lo	desafamar+V.ele.ACC.3.M.SG+SBJF+3+SG
desafamá-lo-ei	desafamar+V.ele.ACC.3.M.SG+FUT+1+SG
desafamá-lo-eis	desafamar+V.ele.ACC.3.M.SG+FUT+2+PL
desafamá-lo-emos	desafamar+V.ele.ACC.3.M.SG+FUT+1+PL
desafamá-lo-ia	desafamar+V.ele.ACC.3.M.SG+COND+1+SG
desafamá-lo-ia	desafamar+V.ele.ACC.3.M.SG+COND+3+SG
desafamá-lo-iam	desafamar+V.ele.ACC.3.M.SG+COND+3+PL
desafamá-lo-íamos	desafamar+V.ele.ACC.3.M.SG+COND+1+PL
desafamá-lo-ias	desafamar+V.ele.ACC.3.M.SG+COND+2+SG
desafamá-lo-íeis	desafamar+V.ele.ACC.3.M.SG+COND+2+PL
desafamá-los-á	desafamar+V.ele.ACC.3.M.PL+FUT+3+SG
desafamá-los-ão	desafamar+V.ele.ACC.3.M.PL+FUT+3+PL
desafamá-los-ás	desafamar+V.ele.ACC.3.M.PL+FUT+2+SG
desafamá-los	desafamar+V.ele.ACC.3.M.PL+INF+1+SG
desafamá-los	desafamar+V.ele.ACC.3.M.PL+INF+3+SG
desafama-los	desafamar+V.ele.ACC.3.M.PL+PRS+2+SG
desafamá-los	desafamar+V.ele.ACC.3.M.PL+SBJF+1+SG
desafamá-los	desafamar+V.ele.ACC.3.M.PL+SBJF+3+SG
desafamá-los-ei	desafamar+V.ele.ACC.3.M.PL+FUT+1+SG
desafamá-los-eis	desafamar+V.ele.ACC.3.M.PL+FUT+2+PL
desafamá-los-emos	desafamar+V.ele.ACC.3.M.PL+FUT+1+PL
desafamá-los-ia	desafamar+V.ele.ACC.3.M.PL+COND+1+SG
desafamá-los-ia	desafamar+V.ele.ACC.3.M.PL+COND+3+SG
desafamá-los-iam	desafamar+V.ele.ACC.3.M.PL+COND+3+PL
desafamá-los-íamos	desafamar+V.ele.ACC.3.M.PL+COND+1+PL
desafamá-los-ias	desafamar+V.ele.ACC.3.M.PL+COND+2+SG
desafamá-los-íeis	desafamar+V.ele.ACC.3.M.PL+COND+2+PL
desafama-me	desafamar+V.eu.AD.1.SG+PRS+3+SG
desafamam-lhe	desafamar+V.ele.DAT.3.SG+PRS+3+PL
desafamam-lhes	desafamar+V.ele.DAT.3.PL+PRS+3+PL
desafamam-me	desafamar+V.eu.AD.1.SG+PRS+3+PL
desafamam-na	desafamar+V.ele.ACC.3.F.SG+PRS+3+PL
desafamam-nas	desafamar+V.ele.ACC.3.F.PL+PRS+3+PL
desafamam-no	desafamar+V.ele.ACC.3.M.SG+PRS+3+PL
desafamam-nos	desafamar+V.ele.ACC.3.M.PL+PRS+3+PL
desafamam-nos	desafamar+V.nós.AD.1.PL+PRS+3+PL
desafamamo-la	desafamar+V.ele.ACC.3.F.SG+PRF+1+PL
desafamamo-la	desafamar+V.ele.ACC.3.F.SG+PRS+1+PL
desafamamo-las	desafamar+V.ele.ACC.3.F.PL+PRF+1+PL
desafamamo-las	desafamar+V.ele.ACC.3.F.PL+PRS+1+PL
desafamamo-lo	desafamar+V.ele.ACC.3.M.SG+PRF+1+PL
desafamamo-lo	desafamar+V.ele.ACC.3.M.SG+PRS+1+PL
desafamamo-los	desafamar+V.ele.ACC.3.M.PL+PRF+1+PL
desafamamo-los	desafamar+V.ele.ACC.3.M.PL+PRS+1+PL
desafamamo-nos	desafamar+nós.AD.1.PL+PRF+1+PL
desafamamo-nos	desafamar+nós.AD.1.PL+PRS+1+PL
desafamamos-lhe	desafamar+V.ele.DAT.3.SG+PRF+1+PL
desafamamos-lhe	desafamar+V.ele.DAT.3.SG+PRS+1+PL
desafamamos-lhes	desafamar+V.ele.DAT.3.PL+PRF+1+PL
desafamamos-lhes	desafamar+V.ele.DAT.3.PL+PRS+1+PL
desafamamos-me	desafamar+V.eu.AD.1.SG+PRF+1+PL
desafamamos-me	desafamar+V.eu.AD.1.SG+PRS+1+PL
desafamamos-te	desafamar+V.tu.AD.2.SG+PRF+1+PL
desafamamos-te	desafamar+V.tu.AD.2.SG+PRS+1+PL
desafamamos-vos	desafamar+V.vós.AD.2.PL+PRF+1+PL
desafamamos-vos	desafamar+V.vós.AD.2.PL+PRS+1+PL
desafamam-se	desafamar+V.ele.REFL+PRS+3+PL
desafamam-te	desafamar+V.tu.AD.2.SG+PRS+3+PL
desafamam-vos	desafamar+V.vós.AD.2.PL+PRS+3+PL
desafamando-a	desafamar+V.ele.ACC.3.F.SG+GRD
desafamando-as	desafamar+V.ele.ACC.3.F.PL+GRD
desafamando-lhe	desafamar+V.ele.DAT.3.SG+GRD
desafamando-lhes	desafamar+V.ele.DAT.3.PL+GRD
desafamando-me	desafamar+V.eu.AD.1.SG+GRD
desafamando-nos	desafamar+nós.AD.1.PL+GRD
desafamando-o	desafamar+V.ele.ACC.3.M.SG+GRD
desafamando-os	desafamar+V.ele.ACC.3.M.PL+GRD
desafamando-se	desafamar+V.ele.REFL+GRD
desafamando-te	desafamar+V.tu.AD.2.SG+GRD
desafamando-vos	desafamar+V.vós.AD.2.PL+GRD
desafama-nos	desafamar+nós.AD.1.PL+PRS+2+SG
desafama-nos	desafamar+nós.AD.1.PL+PRS+3+SG
desafama-o	desafamar+V.ele.ACC.3.M.SG+PRS+3+SG
desafama-os	desafamar+V.ele.ACC.3.M.PL+PRS+3+SG
desafamara-a	desafamar+V.ele.ACC.3.F.SG+PQP+1+SG
