descompor-me-ia	descompor+V.eu.AD.1.SG+COND+1+SG
descompor-me-ia	descompor+V.eu.AD.1.SG+COND+3+SG
descompor-me-iam	descompor+V.eu.AD.1.SG+COND+3+PL
descompor-me-íamos	descompor+V.eu.AD.1.SG+COND+1+PL
descompor-me-ias	descompor+V.eu.AD.1.SG+COND+2+SG
descompor-me-íeis	descompor+V.eu.AD.1.SG+COND+2+PL
descompor-nos-á	descompor+nós.AD.1.PL+FUT+3+SG
descompor-nos-ão	descompor+nós.AD.1.PL+FUT+3+PL
descompor-nos-ás	descompor+nós.AD.1.PL+FUT+2+SG
descompor-nos	descompor+nós.AD.1.PL+INF
descompor-nos	descompor+nós.AD.1.PL+INF+1
descompor-nos	descompor+nós.AD.1.PL+INF+1+SG
descompor-nos	descompor+nós.AD.1.PL+INF+3
descompor-nos	descompor+nós.AD.1.PL+INF+3+SG
descompor-nos-ei	descompor+nós.AD.1.PL+FUT+1+SG
descompor-nos-eis	descompor+nós.AD.1.PL+FUT+2+PL
descompor-nos-emos	descompor+nós.AD.1.PL+FUT+1+PL
descompor-nos-ia	descompor+nós.AD.1.PL+COND+1+SG
descompor-nos-ia	descompor+nós.AD.1.PL+COND+3+SG
descompor-nos-iam	descompor+nós.AD.1.PL+COND+3+PL
descompor-nos-íamos	descompor+nós.AD.1.PL+COND+1+PL
descompor-nos-ias	descompor+nós.AD.1.PL+COND+2+SG
descompor-nos-íeis	descompor+nós.AD.1.PL+COND+2+PL
descompor-se-á	descompor+V.ele.REFL+FUT+3+SG
descompor-se-ão	descompor+V.ele.REFL+FUT+3+PL
descompor-se	descompor+V.ele.REFL+INF
descompor-se	descompor+V.ele.REFL+INF+3
descompor-se	descompor+V.ele.REFL+INF+3+SG
descompor-se-ia	descompor+V.ele.REFL+COND+3+SG
descompor-se-iam	descompor+V.ele.REFL+COND+3+PL
descompor-te-á	descompor+V.tu.AD.2.SG+FUT+3+SG
descompor-te-ão	descompor+V.tu.AD.2.SG+FUT+3+PL
descompor-te-ás	descompor+V.tu.AD.2.SG+FUT+2+SG
descompor-te	descompor+V.tu.AD.2.SG+INF
descompor-te	descompor+V.tu.AD.2.SG+INF+1
descompor-te	descompor+V.tu.AD.2.SG+INF+1+SG
descompor-te	descompor+V.tu.AD.2.SG+INF+3
descompor-te	descompor+V.tu.AD.2.SG+INF+3+SG
descompor-te-ei	descompor+V.tu.AD.2.SG+FUT+1+SG
descompor-te-eis	descompor+V.tu.AD.2.SG+FUT+2+PL
descompor-te-emos	descompor+V.tu.AD.2.SG+FUT+1+PL
descompor-te-ia	descompor+V.tu.AD.2.SG+COND+1+SG
descompor-te-ia	descompor+V.tu.AD.2.SG+COND+3+SG
descompor-te-iam	descompor+V.tu.AD.2.SG+COND+3+PL
descompor-te-íamos	descompor+V.tu.AD.2.SG+COND+1+PL
descompor-te-ias	descompor+V.tu.AD.2.SG+COND+2+SG
descompor-te-íeis	descompor+V.tu.AD.2.SG+COND+2+PL
descompor-vos-á	descompor+V.vós.AD.2.PL+FUT+3+SG
descompor-vos-ão	descompor+V.vós.AD.2.PL+FUT+3+PL
descompor-vos-ás	descompor+V.vós.AD.2.PL+FUT+2+SG
descompor-vos	descompor+V.vós.AD.2.PL+INF
descompor-vos	descompor+V.vós.AD.2.PL+INF+1
descompor-vos	descompor+V.vós.AD.2.PL+INF+1+SG
descompor-vos	descompor+V.vós.AD.2.PL+INF+3
descompor-vos	descompor+V.vós.AD.2.PL+INF+3+SG
descompor-vos-ei	descompor+V.vós.AD.2.PL+FUT+1+SG
descompor-vos-eis	descompor+V.vós.AD.2.PL+FUT+2+PL
descompor-vos-emos	descompor+V.vós.AD.2.PL+FUT+1+PL
descompor-vos-ia	descompor+V.vós.AD.2.PL+COND+1+SG
descompor-vos-ia	descompor+V.vós.AD.2.PL+COND+3+SG
descompor-vos-iam	descompor+V.vós.AD.2.PL+COND+3+PL
descompor-vos-íamos	descompor+V.vós.AD.2.PL+COND+1+PL
descompor-vos-ias	descompor+V.vós.AD.2.PL+COND+2+SG
descompor-vos-íeis	descompor+V.vós.AD.2.PL+COND+2+PL
descompôs-lhe	descompor+V.ele.DAT.3.SG+PRF+3+SG
descompôs-lhes	descompor+V.ele.DAT.3.PL+PRF+3+SG
descompôs-me	descompor+V.eu.AD.1.SG+PRF+3+SG
descompôs-nos	descompor+nós.AD.1.PL+PRF+3+SG
descompôs-se	descompor+V.ele.REFL+PRF+3+SG
descompôs-te	descompor+V.tu.AD.2.SG+PRF+3+SG
descompôs-vos	descompor+V.vós.AD.2.PL+PRF+3+SG
descompraé-la	descomprazer+V.ele.ACC.3.F.SG+PRS+3+SG
descompraé-las	descomprazer+V.ele.ACC.3.F.PL+PRS+3+SG
descompraé-lo	descomprazer+V.ele.ACC.3.M.SG+PRS+3+SG
descompraé-los	descomprazer+V.ele.ACC.3.M.PL+PRS+3+SG
descompraza-a	descomprazer+V.ele.ACC.3.F.SG+IMP+3+SG
descompraza-as	descomprazer+V.ele.ACC.3.F.PL+IMP+3+SG
descompraza-lhe	descomprazer+V.ele.DAT.3.SG+IMP+3+SG
descompraza-lhes	descomprazer+V.ele.DAT.3.PL+IMP+3+SG
descompraza-me	descomprazer+V.eu.AD.1.SG+IMP+3+SG
descomprazam-lhe	descomprazer+V.ele.DAT.3.SG+IMP+3+PL
descomprazam-lhes	descomprazer+V.ele.DAT.3.PL+IMP+3+PL
descomprazam-me	descomprazer+V.eu.AD.1.SG+IMP+3+PL
descomprazam-na	descomprazer+V.ele.ACC.3.F.SG+IMP+3+PL
descomprazam-nas	descomprazer+V.ele.ACC.3.F.PL+IMP+3+PL
descomprazam-no	descomprazer+V.ele.ACC.3.M.SG+IMP+3+PL
descomprazam-nos	descomprazer+V.ele.ACC.3.M.PL+IMP+3+PL
descomprazam-nos	descomprazer+V.nós.AD.1.PL+IMP+3+PL
descomprazamo-la	descomprazer+V.ele.ACC.3.F.SG+IMP+1+PL
descomprazamo-las	descomprazer+V.ele.ACC.3.F.PL+IMP+1+PL
descomprazamo-lo	descomprazer+V.ele.ACC.3.M.SG+IMP+1+PL
descomprazamo-los	descomprazer+V.ele.ACC.3.M.PL+IMP+1+PL
descomprazamo-nos	descomprazer+nós.AD.1.PL+IMP+1+PL
descomprazamos-lhe	descomprazer+V.ele.DAT.3.SG+IMP+1+PL
descomprazamos-lhes	descomprazer+V.ele.DAT.3.PL+IMP+1+PL
descomprazamos-me	descomprazer+V.eu.AD.1.SG+IMP+1+PL
descomprazamos-te	descomprazer+V.tu.AD.2.SG+IMP+1+PL
descomprazamos-vos	descomprazer+V.vós.AD.2.PL+IMP+1+PL
descomprazam-se	descomprazer+V.ele.REFL+IMP+3+PL
descomprazam-te	descomprazer+V.tu.AD.2.SG+IMP+3+PL
descomprazam-vos	descomprazer+V.vós.AD.2.PL+IMP+3+PL
descompraza-nos	descomprazer+nós.AD.1.PL+IMP+3+SG
descompraza-o	descomprazer+V.ele.ACC.3.M.SG+IMP+3+SG
descompraza-os	descomprazer+V.ele.ACC.3.M.PL+IMP+3+SG
descompraza-se	descomprazer+V.ele.REFL+IMP+3+SG
descompraza-te	descomprazer+V.tu.AD.2.SG+IMP+3+SG
descompraza-vos	descomprazer+V.vós.AD.2.PL+IMP+3+SG
descomprazei-la	descomprazer+V.ele.ACC.3.F.SG+PRS+2+PL
descomprazei-las	descomprazer+V.ele.ACC.3.F.PL+PRS+2+PL
descomprazei-lo	descomprazer+V.ele.ACC.3.M.SG+PRS+2+PL
descomprazei-los	descomprazer+V.ele.ACC.3.M.PL+PRS+2+PL
descomprazei-nos	descomprazer+nós.AD.1.PL+PRS+2+PL
descomprazeis-lhe	descomprazer+V.ele.DAT.3.SG+PRS+2+PL
descomprazeis-lhes	descomprazer+V.ele.DAT.3.PL+PRS+2+PL
descomprazeis-me	descomprazer+V.eu.AD.1.SG+PRS+2+PL
descomprazeis-te	descomprazer+V.tu.AD.2.SG+PRS+2+PL
descomprazeis-vos	descomprazer+V.vós.AD.2.PL+PRS+2+PL
descomprazê-la-á	descomprazer+V.ele.ACC.3.F.SG+FUT+3+SG
descomprazê-la-ão	descomprazer+V.ele.ACC.3.F.SG+FUT+3+PL
descomprazê-la-ás	descomprazer+V.ele.ACC.3.F.SG+FUT+2+SG
descomprazê-la	descomprazer+V.ele.ACC.3.F.SG+INF
descomprazê-la	descomprazer+V.ele.ACC.3.F.SG+INF+1+SG
descomprazê-la	descomprazer+V.ele.ACC.3.F.SG+INF+3+SG
descompraze-la	descomprazer+V.ele.ACC.3.F.SG+PRS+2+SG
descomprazê-la-ei	descomprazer+V.ele.ACC.3.F.SG+FUT+1+SG
descomprazê-la-eis	descomprazer+V.ele.ACC.3.F.SG+FUT+2+PL
descomprazê-la-emos	descomprazer+V.ele.ACC.3.F.SG+FUT+1+PL
descomprazê-la-ia	descomprazer+V.ele.ACC.3.F.SG+COND+1+SG
descomprazê-la-ia	descomprazer+V.ele.ACC.3.F.SG+COND+3+SG
descomprazê-la-iam	descomprazer+V.ele.ACC.3.F.SG+COND+3+PL
descomprazê-la-íamos	descomprazer+V.ele.ACC.3.F.SG+COND+1+PL
descomprazê-la-ias	descomprazer+V.ele.ACC.3.F.SG+COND+2+SG
descomprazê-la-íeis	descomprazer+V.ele.ACC.3.F.SG+COND+2+PL
descomprazê-las-á	descomprazer+V.ele.ACC.3.F.PL+FUT+3+SG
descomprazê-las-ão	descomprazer+V.ele.ACC.3.F.PL+FUT+3+PL
descomprazê-las-ás	descomprazer+V.ele.ACC.3.F.PL+FUT+2+SG
descomprazê-las	descomprazer+V.ele.ACC.3.F.PL+INF
descomprazê-las	descomprazer+V.ele.ACC.3.F.PL+INF+1+SG
descomprazê-las	descomprazer+V.ele.ACC.3.F.PL+INF+3+SG
descompraze-las	descomprazer+V.ele.ACC.3.F.PL+PRS+2+SG
descomprazê-las-ei	descomprazer+V.ele.ACC.3.F.PL+FUT+1+SG
descomprazê-las-eis	descomprazer+V.ele.ACC.3.F.PL+FUT+2+PL
descomprazê-las-emos	descomprazer+V.ele.ACC.3.F.PL+FUT+1+PL
descomprazê-las-ia	descomprazer+V.ele.ACC.3.F.PL+COND+1+SG
descomprazê-las-ia	descomprazer+V.ele.ACC.3.F.PL+COND+3+SG
descomprazê-las-iam	descomprazer+V.ele.ACC.3.F.PL+COND+3+PL
descomprazê-las-íamos	descomprazer+V.ele.ACC.3.F.PL+COND+1+PL
descomprazê-las-ias	descomprazer+V.ele.ACC.3.F.PL+COND+2+SG
descomprazê-las-íeis	descomprazer+V.ele.ACC.3.F.PL+COND+2+PL
descomprazê-lo-á	descomprazer+V.ele.ACC.3.M.SG+FUT+3+SG
descomprazê-lo-ão	descomprazer+V.ele.ACC.3.M.SG+FUT+3+PL
descomprazê-lo-ás	descomprazer+V.ele.ACC.3.M.SG+FUT+2+SG
descomprazê-lo	descomprazer+V.ele.ACC.3.M.SG+INF
descomprazê-lo	descomprazer+V.ele.ACC.3.M.SG+INF+1+SG
descomprazê-lo	descomprazer+V.ele.ACC.3.M.SG+INF+3+SG
descompraze-lo	descomprazer+V.ele.ACC.3.M.SG+PRS+2+SG
descomprazê-lo-ei	descomprazer+V.ele.ACC.3.M.SG+FUT+1+SG
descomprazê-lo-eis	descomprazer+V.ele.ACC.3.M.SG+FUT+2+PL
descomprazê-lo-emos	descomprazer+V.ele.ACC.3.M.SG+FUT+1+PL
descomprazê-lo-ia	descomprazer+V.ele.ACC.3.M.SG+COND+1+SG
descomprazê-lo-ia	descomprazer+V.ele.ACC.3.M.SG+COND+3+SG
descomprazê-lo-iam	descomprazer+V.ele.ACC.3.M.SG+COND+3+PL
descomprazê-lo-íamos	descomprazer+V.ele.ACC.3.M.SG+COND+1+PL
descomprazê-lo-ias	descomprazer+V.ele.ACC.3.M.SG+COND+2+SG
descomprazê-lo-íeis	descomprazer+V.ele.ACC.3.M.SG+COND+2+PL
descomprazê-los-á	descomprazer+V.ele.ACC.3.M.PL+FUT+3+SG
descomprazê-los-ão	descomprazer+V.ele.ACC.3.M.PL+FUT+3+PL
descomprazê-los-ás	descomprazer+V.ele.ACC.3.M.PL+FUT+2+SG
descomprazê-los	descomprazer+V.ele.ACC.3.M.PL+INF
descomprazê-los	descomprazer+V.ele.ACC.3.M.PL+INF+1+SG
descomprazê-los	descomprazer+V.ele.ACC.3.M.PL+INF+3+SG
descompraze-los	descomprazer+V.ele.ACC.3.M.PL+PRS+2+SG
descomprazê-los-ei	descomprazer+V.ele.ACC.3.M.PL+FUT+1+SG
descomprazê-los-eis	descomprazer+V.ele.ACC.3.M.PL+FUT+2+PL
descomprazê-los-emos	descomprazer+V.ele.ACC.3.M.PL+FUT+1+PL
descomprazê-los-ia	descomprazer+V.ele.ACC.3.M.PL+COND+1+SG
descomprazê-los-ia	descomprazer+V.ele.ACC.3.M.PL+COND+3+SG
descomprazê-los-iam	descomprazer+V.ele.ACC.3.M.PL+COND+3+PL
descomprazê-los-íamos	descomprazer+V.ele.ACC.3.M.PL+COND+1+PL
descomprazê-los-ias	descomprazer+V.ele.ACC.3.M.PL+COND+2+SG
descomprazê-los-íeis	descomprazer+V.ele.ACC.3.M.PL+COND+2+PL
descomprazem-lhe	descomprazer+V.ele.DAT.3.SG+PRS+3+PL
descomprazem-lhes	descomprazer+V.ele.DAT.3.PL+PRS+3+PL
descomprazem-me	descomprazer+V.eu.AD.1.SG+PRS+3+PL
descomprazem-na	descomprazer+V.ele.ACC.3.F.SG+PRS+3+PL
descomprazem-nas	descomprazer+V.ele.ACC.3.F.PL+PRS+3+PL
descomprazem-no	descomprazer+V.ele.ACC.3.M.SG+PRS+3+PL
descomprazem-nos	descomprazer+V.ele.ACC.3.M.PL+PRS+3+PL
descomprazem-nos	descomprazer+V.nós.AD.1.PL+PRS+3+PL
descomprazemo-la	descomprazer+V.ele.ACC.3.F.SG+PRS+1+PL
descomprazemo-las	descomprazer+V.ele.ACC.3.F.PL+PRS+1+PL
descomprazemo-lo	descomprazer+V.ele.ACC.3.M.SG+PRS+1+PL
descomprazemo-los	descomprazer+V.ele.ACC.3.M.PL+PRS+1+PL
descomprazemo-nos	descomprazer+nós.AD.1.PL+PRS+1+PL
descomprazemos-lhe	descomprazer+V.ele.DAT.3.SG+PRS+1+PL
descomprazemos-lhes	descomprazer+V.ele.DAT.3.PL+PRS+1+PL
descomprazemos-me	descomprazer+V.eu.AD.1.SG+PRS+1+PL
descomprazemos-te	descomprazer+V.tu.AD.2.SG+PRS+1+PL
descomprazemos-vos	descomprazer+V.vós.AD.2.PL+PRS+1+PL
descomprazem-se	descomprazer+V.ele.REFL+PRS+3+PL
descomprazem-te	descomprazer+V.tu.AD.2.SG+PRS+3+PL
descomprazem-vos	descomprazer+V.vós.AD.2.PL+PRS+3+PL
descomprazendo-a	descomprazer+V.ele.ACC.3.F.SG+GRD
descomprazendo-as	descomprazer+V.ele.ACC.3.F.PL+GRD
descomprazendo-lhe	descomprazer+V.ele.DAT.3.SG+GRD
descomprazendo-lhes	descomprazer+V.ele.DAT.3.PL+GRD
descomprazendo-me	descomprazer+V.eu.AD.1.SG+GRD
descomprazendo-nos	descomprazer+nós.AD.1.PL+GRD
descomprazendo-o	descomprazer+V.ele.ACC.3.M.SG+GRD
descomprazendo-os	descomprazer+V.ele.ACC.3.M.PL+GRD
descomprazendo-se	descomprazer+V.ele.REFL+GRD
descomprazendo-te	descomprazer+V.tu.AD.2.SG+GRD
descomprazendo-vos	descomprazer+V.vós.AD.2.PL+GRD
descompraze-nos	descomprazer+nós.AD.1.PL+PRS+2+SG
descomprazerde-la	descomprazer+V.ele.ACC.3.F.SG+INF+2+PL
descomprazerde-las	descomprazer+V.ele.ACC.3.F.PL+INF+2+PL
descomprazerde-lo	descomprazer+V.ele.ACC.3.M.SG+INF+2+PL
descomprazerde-los	descomprazer+V.ele.ACC.3.M.PL+INF+2+PL
descomprazerde-nos	descomprazer+nós.AD.1.PL+INF+2+PL
descomprazerdes-lhe	descomprazer+V.ele.DAT.3.SG+INF+2+PL
descomprazerdes-lhes	descomprazer+V.ele.DAT.3.PL+INF+2+PL
descomprazerdes-me	descomprazer+V.eu.AD.1.SG+INF+2+PL
descomprazerdes-te	descomprazer+V.tu.AD.2.SG+INF+2+PL
descomprazerdes-vos	descomprazer+V.vós.AD.2.PL+INF+2+PL
descomprazere-la	descomprazer+V.ele.ACC.3.F.SG+INF+2+SG
descomprazere-las	descomprazer+V.ele.ACC.3.F.PL+INF+2+SG
descomprazere-lo	descomprazer+V.ele.ACC.3.M.SG+INF+2+SG
descomprazere-los	descomprazer+V.ele.ACC.3.M.PL+INF+2+SG
descomprazerem-lhe	descomprazer+V.ele.DAT.3.SG+INF+3+PL
descomprazerem-lhes	descomprazer+V.ele.DAT.3.PL+INF+3+PL
descomprazerem-me	descomprazer+V.eu.AD.1.SG+INF+3+PL
descomprazerem-na	descomprazer+V.ele.ACC.3.F.SG+INF+3+PL
descomprazerem-nas	descomprazer+V.ele.ACC.3.F.PL+INF+3+PL
descomprazerem-no	descomprazer+V.ele.ACC.3.M.SG+INF+3+PL
descomprazerem-nos	descomprazer+V.ele.ACC.3.M.PL+INF+3+PL
descomprazerem-nos	descomprazer+V.nós.AD.1.PL+INF+3+PL
descomprazerem-se	descomprazer+V.ele.REFL+INF+3+PL
descomprazerem-te	descomprazer+V.tu.AD.2.SG+INF+3+PL
descomprazerem-vos	descomprazer+V.vós.AD.2.PL+INF+3+PL
descomprazere-nos	descomprazer+nós.AD.1.PL+INF+2+SG
descomprazeres-lhe	descomprazer+V.ele.DAT.3.SG+INF+2+SG
descomprazeres-lhes	descomprazer+V.ele.DAT.3.PL+INF+2+SG
descomprazeres-me	descomprazer+V.eu.AD.1.SG+INF+2+SG
descomprazeres-te	descomprazer+V.tu.AD.2.SG+INF+2+SG
descomprazeres-vos	descomprazer+V.vós.AD.2.PL+INF+2+SG
descomprazer-lhe-á	descomprazer+V.ele.DAT.3.SG+FUT+3+SG
descomprazer-lhe-ão	descomprazer+V.ele.DAT.3.SG+FUT+3+PL
descomprazer-lhe-ás	descomprazer+V.ele.DAT.3.SG+FUT+2+SG
descomprazer-lhe	descomprazer+V.ele.DAT.3.SG+INF
descomprazer-lhe	descomprazer+V.ele.DAT.3.SG+INF+1+SG
descomprazer-lhe	descomprazer+V.ele.DAT.3.SG+INF+3+SG
descomprazer-lhe-ei	descomprazer+V.ele.DAT.3.SG+FUT+1+SG
descomprazer-lhe-eis	descomprazer+V.ele.DAT.3.SG+FUT+2+PL
descomprazer-lhe-emos	descomprazer+V.ele.DAT.3.SG+FUT+1+PL
descomprazer-lhe-ia	descomprazer+V.ele.DAT.3.SG+COND+1+SG
descomprazer-lhe-ia	descomprazer+V.ele.DAT.3.SG+COND+3+SG
descomprazer-lhe-iam	descomprazer+V.ele.DAT.3.SG+COND+3+PL
descomprazer-lhe-íamos	descomprazer+V.ele.DAT.3.SG+COND+1+PL
descomprazer-lhe-ias	descomprazer+V.ele.DAT.3.SG+COND+2+SG
descomprazer-lhe-íeis	descomprazer+V.ele.DAT.3.SG+COND+2+PL
descomprazer-lhes-á	descomprazer+V.ele.DAT.3.PL+FUT+3+SG
descomprazer-lhes-ão	descomprazer+V.ele.DAT.3.PL+FUT+3+PL
descomprazer-lhes-ás	descomprazer+V.ele.DAT.3.PL+FUT+2+SG
descomprazer-lhes	descomprazer+V.ele.DAT.3.PL+INF
descomprazer-lhes	descomprazer+V.ele.DAT.3.PL+INF+1+SG
descomprazer-lhes	descomprazer+V.ele.DAT.3.PL+INF+3+SG
descomprazer-lhes-ei	descomprazer+V.ele.DAT.3.PL+FUT+1+SG
descomprazer-lhes-eis	descomprazer+V.ele.DAT.3.PL+FUT+2+PL
descomprazer-lhes-emos	descomprazer+V.ele.DAT.3.PL+FUT+1+PL
descomprazer-lhes-ia	descomprazer+V.ele.DAT.3.PL+COND+1+SG
descomprazer-lhes-ia	descomprazer+V.ele.DAT.3.PL+COND+3+SG
descomprazer-lhes-iam	descomprazer+V.ele.DAT.3.PL+COND+3+PL
descomprazer-lhes-íamos	descomprazer+V.ele.DAT.3.PL+COND+1+PL
descomprazer-lhes-ias	descomprazer+V.ele.DAT.3.PL+COND+2+SG
descomprazer-lhes-íeis	descomprazer+V.ele.DAT.3.PL+COND+2+PL
descomprazer-me-á	descomprazer+V.eu.AD.1.SG+FUT+3+SG
descomprazer-me-ão	descomprazer+V.eu.AD.1.SG+FUT+3+PL
descomprazer-me-ás	descomprazer+V.eu.AD.1.SG+FUT+2+SG
descomprazer-me	descomprazer+V.eu.AD.1.SG+INF
descomprazer-me	descomprazer+V.eu.AD.1.SG+INF+1+SG
descomprazer-me	descomprazer+V.eu.AD.1.SG+INF+3+SG
descomprazer-me-ei	descomprazer+V.eu.AD.1.SG+FUT+1+SG
descomprazer-me-eis	descomprazer+V.eu.AD.1.SG+FUT+2+PL
descomprazer-me-emos	descomprazer+V.eu.AD.1.SG+FUT+1+PL
descomprazer-me-ia	descomprazer+V.eu.AD.1.SG+COND+1+SG
descomprazer-me-ia	descomprazer+V.eu.AD.1.SG+COND+3+SG
descomprazer-me-iam	descomprazer+V.eu.AD.1.SG+COND+3+PL
descomprazer-me-íamos	descomprazer+V.eu.AD.1.SG+COND+1+PL
descomprazer-me-ias	descomprazer+V.eu.AD.1.SG+COND+2+SG
descomprazer-me-íeis	descomprazer+V.eu.AD.1.SG+COND+2+PL
descomprazermo-la	descomprazer+V.ele.ACC.3.F.SG+INF+1+PL
descomprazermo-las	descomprazer+V.ele.ACC.3.F.PL+INF+1+PL
descomprazermo-lo	descomprazer+V.ele.ACC.3.M.SG+INF+1+PL
descomprazermo-los	descomprazer+V.ele.ACC.3.M.PL+INF+1+PL
descomprazermo-nos	descomprazer+nós.AD.1.PL+INF+1+PL
descomprazermos-lhe	descomprazer+V.ele.DAT.3.SG+INF+1+PL
descomprazermos-lhes	descomprazer+V.ele.DAT.3.PL+INF+1+PL
descomprazermos-me	descomprazer+V.eu.AD.1.SG+INF+1+PL
descomprazermos-te	descomprazer+V.tu.AD.2.SG+INF+1+PL
descomprazermos-vos	descomprazer+V.vós.AD.2.PL+INF+1+PL
descomprazer-nos-á	descomprazer+nós.AD.1.PL+FUT+3+SG
descomprazer-nos-ão	descomprazer+nós.AD.1.PL+FUT+3+PL
descomprazer-nos-ás	descomprazer+nós.AD.1.PL+FUT+2+SG
descomprazer-nos	descomprazer+nós.AD.1.PL+INF
descomprazer-nos	descomprazer+nós.AD.1.PL+INF+1+SG
descomprazer-nos	descomprazer+nós.AD.1.PL+INF+3+SG
descomprazer-nos-ei	descomprazer+nós.AD.1.PL+FUT+1+SG
descomprazer-nos-eis	descomprazer+nós.AD.1.PL+FUT+2+PL
descomprazer-nos-emos	descomprazer+nós.AD.1.PL+FUT+1+PL
descomprazer-nos-ia	descomprazer+nós.AD.1.PL+COND+1+SG
descomprazer-nos-ia	descomprazer+nós.AD.1.PL+COND+3+SG
descomprazer-nos-iam	descomprazer+nós.AD.1.PL+COND+3+PL
descomprazer-nos-íamos	descomprazer+nós.AD.1.PL+COND+1+PL
descomprazer-nos-ias	descomprazer+nós.AD.1.PL+COND+2+SG
descomprazer-nos-íeis	descomprazer+nós.AD.1.PL+COND+2+PL
descomprazer-se-á	descomprazer+V.ele.REFL+FUT+3+SG
descomprazer-se-ão	descomprazer+V.ele.REFL+FUT+3+PL
descomprazer-se	descomprazer+V.ele.REFL+INF
descomprazer-se	descomprazer+V.ele.REFL+INF+3+SG
descomprazer-se-ia	descomprazer+V.ele.REFL+COND+3+SG
descomprazer-se-iam	descomprazer+V.ele.REFL+COND+3+PL
descomprazer-te-á	descomprazer+V.tu.AD.2.SG+FUT+3+SG
descomprazer-te-ão	descomprazer+V.tu.AD.2.SG+FUT+3+PL
descomprazer-te-ás	descomprazer+V.tu.AD.2.SG+FUT+2+SG
descomprazer-te	descomprazer+V.tu.AD.2.SG+INF
descomprazer-te	descomprazer+V.tu.AD.2.SG+INF+1+SG
descomprazer-te	descomprazer+V.tu.AD.2.SG+INF+3+SG
descomprazer-te-ei	descomprazer+V.tu.AD.2.SG+FUT+1+SG
descomprazer-te-eis	descomprazer+V.tu.AD.2.SG+FUT+2+PL
descomprazer-te-emos	descomprazer+V.tu.AD.2.SG+FUT+1+PL
descomprazer-te-ia	descomprazer+V.tu.AD.2.SG+COND+1+SG
descomprazer-te-ia	descomprazer+V.tu.AD.2.SG+COND+3+SG
descomprazer-te-iam	descomprazer+V.tu.AD.2.SG+COND+3+PL
descomprazer-te-íamos	descomprazer+V.tu.AD.2.SG+COND+1+PL
descomprazer-te-ias	descomprazer+V.tu.AD.2.SG+COND+2+SG
descomprazer-te-íeis	descomprazer+V.tu.AD.2.SG+COND+2+PL
descomprazer-vos-á	descomprazer+V.vós.AD.2.PL+FUT+3+SG
descomprazer-vos-ão	descomprazer+V.vós.AD.2.PL+FUT+3+PL
descomprazer-vos-ás	descomprazer+V.vós.AD.2.PL+FUT+2+SG
descomprazer-vos	descomprazer+V.vós.AD.2.PL+INF
descomprazer-vos	descomprazer+V.vós.AD.2.PL+INF+1+SG
descomprazer-vos	descomprazer+V.vós.AD.2.PL+INF+3+SG
descomprazer-vos-ei	descomprazer+V.vós.AD.2.PL+FUT+1+SG
descomprazer-vos-eis	descomprazer+V.vós.AD.2.PL+FUT+2+PL
descomprazer-vos-emos	descomprazer+V.vós.AD.2.PL+FUT+1+PL
descomprazer-vos-ia	descomprazer+V.vós.AD.2.PL+COND+1+SG
descomprazer-vos-ia	descomprazer+V.vós.AD.2.PL+COND+3+SG
descomprazer-vos-iam	descomprazer+V.vós.AD.2.PL+COND+3+PL
descomprazer-vos-íamos	descomprazer+V.vós.AD.2.PL+COND+1+PL
descomprazer-vos-ias	descomprazer+V.vós.AD.2.PL+COND+2+SG
descomprazer-vos-íeis	descomprazer+V.vós.AD.2.PL+COND+2+PL
descomprazes-lhe	descomprazer+V.ele.DAT.3.SG+PRS+2+SG
descomprazes-lhes	descomprazer+V.ele.DAT.3.PL+PRS+2+SG
descomprazes-me	descomprazer+V.eu.AD.1.SG+PRS+2+SG
descomprazes-te	descomprazer+V.tu.AD.2.SG+PRS+2+SG
descomprazes-vos	descomprazer+V.vós.AD.2.PL+PRS+2+SG
descomprazia-a	descomprazer+V.ele.ACC.3.F.SG+IMPF+1+SG
descomprazia-a	descomprazer+V.ele.ACC.3.F.SG+IMPF+3+SG
descomprazia-as	descomprazer+V.ele.ACC.3.F.PL+IMPF+1+SG
descomprazia-as	descomprazer+V.ele.ACC.3.F.PL+IMPF+3+SG
descomprazia-la	descomprazer+V.ele.ACC.3.F.SG+IMPF+2+SG
descomprazia-las	descomprazer+V.ele.ACC.3.F.PL+IMPF+2+SG
descomprazia-lhe	descomprazer+V.ele.DAT.3.SG+IMPF+1+SG
descomprazia-lhe	descomprazer+V.ele.DAT.3.SG+IMPF+3+SG
descomprazia-lhes	descomprazer+V.ele.DAT.3.PL+IMPF+1+SG
descomprazia-lhes	descomprazer+V.ele.DAT.3.PL+IMPF+3+SG
descomprazia-lo	descomprazer+V.ele.ACC.3.M.SG+IMPF+2+SG
descomprazia-los	descomprazer+V.ele.ACC.3.M.PL+IMPF+2+SG
descomprazia-me	descomprazer+V.eu.AD.1.SG+IMPF+1+SG
descomprazia-me	descomprazer+V.eu.AD.1.SG+IMPF+3+SG
descompraziam-lhe	descomprazer+V.ele.DAT.3.SG+IMPF+3+PL
descompraziam-lhes	descomprazer+V.ele.DAT.3.PL+IMPF+3+PL
descompraziam-me	descomprazer+V.eu.AD.1.SG+IMPF+3+PL
descompraziam-na	descomprazer+V.ele.ACC.3.F.SG+IMPF+3+PL
descompraziam-nas	descomprazer+V.ele.ACC.3.F.PL+IMPF+3+PL
descompraziam-no	descomprazer+V.ele.ACC.3.M.SG+IMPF+3+PL
descompraziam-nos	descomprazer+V.ele.ACC.3.M.PL+IMPF+3+PL
descompraziam-nos	descomprazer+V.nós.AD.1.PL+IMPF+3+PL
descomprazíamo-la	descomprazer+V.ele.ACC.3.F.SG+IMPF+1+PL
descomprazíamo-las	descomprazer+V.ele.ACC.3.F.PL+IMPF+1+PL
descomprazíamo-lo	descomprazer+V.ele.ACC.3.M.SG+IMPF+1+PL
descomprazíamo-los	descomprazer+V.ele.ACC.3.M.PL+IMPF+1+PL
descomprazíamo-nos	descomprazer+nós.AD.1.PL+IMPF+1+PL
descomprazíamos-lhe	descomprazer+V.ele.DAT.3.SG+IMPF+1+PL
descomprazíamos-lhes	descomprazer+V.ele.DAT.3.PL+IMPF+1+PL
descomprazíamos-me	descomprazer+V.eu.AD.1.SG+IMPF+1+PL
descomprazíamos-te	descomprazer+V.tu.AD.2.SG+IMPF+1+PL
descomprazíamos-vos	descomprazer+V.vós.AD.2.PL+IMPF+1+PL
descompraziam-se	descomprazer+V.ele.REFL+IMPF+3+PL
descompraziam-te	descomprazer+V.tu.AD.2.SG+IMPF+3+PL
descompraziam-vos	descomprazer+V.vós.AD.2.PL+IMPF+3+PL
descomprazia-nos	descomprazer+nós.AD.1.PL+IMPF+1+SG
descomprazia-nos	descomprazer+nós.AD.1.PL+IMPF+2+SG
descomprazia-nos	descomprazer+nós.AD.1.PL+IMPF+3+SG
descomprazia-o	descomprazer+V.ele.ACC.3.M.SG+IMPF+1+SG
descomprazia-o	descomprazer+V.ele.ACC.3.M.SG+IMPF+3+SG
descomprazia-os	descomprazer+V.ele.ACC.3.M.PL+IMPF+1+SG
descomprazia-os	descomprazer+V.ele.ACC.3.M.PL+IMPF+3+SG
descomprazia-se	descomprazer+V.ele.REFL+IMPF+3+SG
descomprazias-lhe	descomprazer+V.ele.DAT.3.SG+IMPF+2+SG
descomprazias-lhes	descomprazer+V.ele.DAT.3.PL+IMPF+2+SG
descomprazias-me	descomprazer+V.eu.AD.1.SG+IMPF+2+SG
descomprazias-te	descomprazer+V.tu.AD.2.SG+IMPF+2+SG
descomprazias-vos	descomprazer+V.vós.AD.2.PL+IMPF+2+SG
descomprazia-te	descomprazer+V.tu.AD.2.SG+IMPF+1+SG
descomprazia-te	descomprazer+V.tu.AD.2.SG+IMPF+3+SG
descomprazia-vos	descomprazer+V.vós.AD.2.PL+IMPF+1+SG
descomprazia-vos	descomprazer+V.vós.AD.2.PL+IMPF+3+SG
descomprazíei-la	descomprazer+V.ele.ACC.3.F.SG+IMPF+2+PL
descomprazíei-las	descomprazer+V.ele.ACC.3.F.PL+IMPF+2+PL
descomprazíei-lo	descomprazer+V.ele.ACC.3.M.SG+IMPF+2+PL
descomprazíei-los	descomprazer+V.ele.ACC.3.M.PL+IMPF+2+PL
descomprazíei-nos	descomprazer+nós.AD.1.PL+IMPF+2+PL
descomprazíeis-lhe	descomprazer+V.ele.DAT.3.SG+IMPF+2+PL
descomprazíeis-lhes	descomprazer+V.ele.DAT.3.PL+IMPF+2+PL
descomprazíeis-me	descomprazer+V.eu.AD.1.SG+IMPF+2+PL
descomprazíeis-te	descomprazer+V.tu.AD.2.SG+IMPF+2+PL
descomprazíeis-vos	descomprazer+V.vós.AD.2.PL+IMPF+2+PL
descompraz-lhe	descomprazer+V.ele.DAT.3.SG+PRS+3+SG
descompraz-lhes	descomprazer+V.ele.DAT.3.PL+PRS+3+SG
descompraz-me	descomprazer+V.eu.AD.1.SG+PRS+3+SG
descompraz-nos	descomprazer+nós.AD.1.PL+PRS+3+SG
descomprazo-a	descomprazer+V.ele.ACC.3.F.SG+PRS+1+SG
descomprazo-as	descomprazer+V.ele.ACC.3.F.PL+PRS+1+SG
descomprazo-lhe	descomprazer+V.ele.DAT.3.SG+PRS+1+SG
descomprazo-lhes	descomprazer+V.ele.DAT.3.PL+PRS+1+SG
descomprazo-me	descomprazer+V.eu.AD.1.SG+PRS+1+SG
descomprazo-nos	descomprazer+nós.AD.1.PL+PRS+1+SG
descomprazo-o	descomprazer+V.ele.ACC.3.M.SG+PRS+1+SG
descomprazo-os	descomprazer+V.ele.ACC.3.M.PL+PRS+1+SG
descomprazo-te	descomprazer+V.tu.AD.2.SG+PRS+1+SG
descomprazo-vos	descomprazer+V.vós.AD.2.PL+PRS+1+SG
descompraz-se	descomprazer+V.ele.REFL+PRS+3+SG
descompraz-te	descomprazer+V.tu.AD.2.SG+PRS+3+SG
descompraz-vos	descomprazer+V.vós.AD.2.PL+PRS+3+SG
descompreenda-a	descompreender+V.ele.ACC.3.F.SG+IMP+3+SG
descompreenda-as	descompreender+V.ele.ACC.3.F.PL+IMP+3+SG
descompreenda-lhe	descompreender+V.ele.DAT.3.SG+IMP+3+SG
descompreenda-lhes	descompreender+V.ele.DAT.3.PL+IMP+3+SG
descompreenda-me	descompreender+V.eu.AD.1.SG+IMP+3+SG
descompreendam-lhe	descompreender+V.ele.DAT.3.SG+IMP+3+PL
descompreendam-lhes	descompreender+V.ele.DAT.3.PL+IMP+3+PL
descompreendam-me	descompreender+V.eu.AD.1.SG+IMP+3+PL
descompreendam-na	descompreender+V.ele.ACC.3.F.SG+IMP+3+PL
descompreendam-nas	descompreender+V.ele.ACC.3.F.PL+IMP+3+PL
descompreendam-no	descompreender+V.ele.ACC.3.M.SG+IMP+3+PL
descompreendam-nos	descompreender+V.ele.ACC.3.M.PL+IMP+3+PL
descompreendam-nos	descompreender+V.nós.AD.1.PL+IMP+3+PL
descompreendamo-la	descompreender+V.ele.ACC.3.F.SG+IMP+1+PL
descompreendamo-las	descompreender+V.ele.ACC.3.F.PL+IMP+1+PL
descompreendamo-lo	descompreender+V.ele.ACC.3.M.SG+IMP+1+PL
descompreendamo-los	descompreender+V.ele.ACC.3.M.PL+IMP+1+PL
descompreendamo-nos	descompreender+nós.AD.1.PL+IMP+1+PL
descompreendamos-lhe	descompreender+V.ele.DAT.3.SG+IMP+1+PL
descompreendamos-lhes	descompreender+V.ele.DAT.3.PL+IMP+1+PL
descompreendamos-me	descompreender+V.eu.AD.1.SG+IMP+1+PL
descompreendamos-te	descompreender+V.tu.AD.2.SG+IMP+1+PL
descompreendamos-vos	descompreender+V.vós.AD.2.PL+IMP+1+PL
descompreendam-se	descompreender+V.ele.REFL+IMP+3+PL
descompreendam-te	descompreender+V.tu.AD.2.SG+IMP+3+PL
descompreendam-vos	descompreender+V.vós.AD.2.PL+IMP+3+PL
descompreenda-nos	descompreender+nós.AD.1.PL+IMP+3+SG
descompreenda-o	descompreender+V.ele.ACC.3.M.SG+IMP+3+SG
descompreenda-os	descompreender+V.ele.ACC.3.M.PL+IMP+3+SG
descompreenda-se	descompreender+V.ele.REFL+IMP+3+SG
descompreenda-te	descompreender+V.tu.AD.2.SG+IMP+3+SG
descompreenda-vos	descompreender+V.vós.AD.2.PL+IMP+3+SG
descompreende-a	descompreender+V.ele.ACC.3.F.SG+PRS+3+SG
descompreende-as	descompreender+V.ele.ACC.3.F.PL+PRS+3+SG
descompreendei-la	descompreender+V.ele.ACC.3.F.SG+PRS+2+PL
descompreendei-las	descompreender+V.ele.ACC.3.F.PL+PRS+2+PL
descompreendei-lo	descompreender+V.ele.ACC.3.M.SG+PRS+2+PL
descompreendei-los	descompreender+V.ele.ACC.3.M.PL+PRS+2+PL
descompreendei-nos	descompreender+nós.AD.1.PL+PRS+2+PL
descompreendeis-lhe	descompreender+V.ele.DAT.3.SG+PRS+2+PL
descompreendeis-lhes	descompreender+V.ele.DAT.3.PL+PRS+2+PL
descompreendeis-me	descompreender+V.eu.AD.1.SG+PRS+2+PL
descompreendeis-te	descompreender+V.tu.AD.2.SG+PRS+2+PL
descompreendeis-vos	descompreender+V.vós.AD.2.PL+PRS+2+PL
descompreendê-la-á	descompreender+V.ele.ACC.3.F.SG+FUT+3+SG
descompreendê-la-ão	descompreender+V.ele.ACC.3.F.SG+FUT+3+PL
descompreendê-la-ás	descompreender+V.ele.ACC.3.F.SG+FUT+2+SG
descompreendê-la	descompreender+V.ele.ACC.3.F.SG+INF
descompreendê-la	descompreender+V.ele.ACC.3.F.SG+INF+1+SG
descompreendê-la	descompreender+V.ele.ACC.3.F.SG+INF+3+SG
descompreende-la	descompreender+V.ele.ACC.3.F.SG+PRS+2+SG
descompreendê-la	descompreender+V.ele.ACC.3.F.SG+SBJF+1+SG
descompreendê-la	descompreender+V.ele.ACC.3.F.SG+SBJF+3+SG
descompreendê-la-ei	descompreender+V.ele.ACC.3.F.SG+FUT+1+SG
descompreendê-la-eis	descompreender+V.ele.ACC.3.F.SG+FUT+2+PL
descompreendê-la-emos	descompreender+V.ele.ACC.3.F.SG+FUT+1+PL
descompreendê-la-ia	descompreender+V.ele.ACC.3.F.SG+COND+1+SG
descompreendê-la-ia	descompreender+V.ele.ACC.3.F.SG+COND+3+SG
descompreendê-la-iam	descompreender+V.ele.ACC.3.F.SG+COND+3+PL
descompreendê-la-íamos	descompreender+V.ele.ACC.3.F.SG+COND+1+PL
descompreendê-la-ias	descompreender+V.ele.ACC.3.F.SG+COND+2+SG
descompreendê-la-íeis	descompreender+V.ele.ACC.3.F.SG+COND+2+PL
descompreendê-las-á	descompreender+V.ele.ACC.3.F.PL+FUT+3+SG
descompreendê-las-ão	descompreender+V.ele.ACC.3.F.PL+FUT+3+PL
descompreendê-las-ás	descompreender+V.ele.ACC.3.F.PL+FUT+2+SG
descompreendê-las	descompreender+V.ele.ACC.3.F.PL+INF
descompreendê-las	descompreender+V.ele.ACC.3.F.PL+INF+1+SG
descompreendê-las	descompreender+V.ele.ACC.3.F.PL+INF+3+SG
descompreende-las	descompreender+V.ele.ACC.3.F.PL+PRS+2+SG
descompreendê-las	descompreender+V.ele.ACC.3.F.PL+SBJF+1+SG
descompreendê-las	descompreender+V.ele.ACC.3.F.PL+SBJF+3+SG
descompreendê-las-ei	descompreender+V.ele.ACC.3.F.PL+FUT+1+SG
descompreendê-las-eis	descompreender+V.ele.ACC.3.F.PL+FUT+2+PL
descompreendê-las-emos	descompreender+V.ele.ACC.3.F.PL+FUT+1+PL
descompreendê-las-ia	descompreender+V.ele.ACC.3.F.PL+COND+1+SG
descompreendê-las-ia	descompreender+V.ele.ACC.3.F.PL+COND+3+SG
descompreendê-las-iam	descompreender+V.ele.ACC.3.F.PL+COND+3+PL
descompreendê-las-íamos	descompreender+V.ele.ACC.3.F.PL+COND+1+PL
descompreendê-las-ias	descompreender+V.ele.ACC.3.F.PL+COND+2+SG
descompreendê-las-íeis	descompreender+V.ele.ACC.3.F.PL+COND+2+PL
descompreende-lhe	descompreender+V.ele.DAT.3.SG+PRS+3+SG
descompreende-lhes	descompreender+V.ele.DAT.3.PL+PRS+3+SG
descompreendê-lo-á	descompreender+V.ele.ACC.3.M.SG+FUT+3+SG
descompreendê-lo-ão	descompreender+V.ele.ACC.3.M.SG+FUT+3+PL
descompreendê-lo-ás	descompreender+V.ele.ACC.3.M.SG+FUT+2+SG
descompreendê-lo	descompreender+V.ele.ACC.3.M.SG+INF
descompreendê-lo	descompreender+V.ele.ACC.3.M.SG+INF+1+SG
descompreendê-lo	descompreender+V.ele.ACC.3.M.SG+INF+3+SG
descompreende-lo	descompreender+V.ele.ACC.3.M.SG+PRS+2+SG
descompreendê-lo	descompreender+V.ele.ACC.3.M.SG+SBJF+1+SG
descompreendê-lo	descompreender+V.ele.ACC.3.M.SG+SBJF+3+SG
descompreendê-lo-ei	descompreender+V.ele.ACC.3.M.SG+FUT+1+SG
descompreendê-lo-eis	descompreender+V.ele.ACC.3.M.SG+FUT+2+PL
descompreendê-lo-emos	descompreender+V.ele.ACC.3.M.SG+FUT+1+PL
descompreendê-lo-ia	descompreender+V.ele.ACC.3.M.SG+COND+1+SG
descompreendê-lo-ia	descompreender+V.ele.ACC.3.M.SG+COND+3+SG
descompreendê-lo-iam	descompreender+V.ele.ACC.3.M.SG+COND+3+PL
descompreendê-lo-íamos	descompreender+V.ele.ACC.3.M.SG+COND+1+PL
descompreendê-lo-ias	descompreender+V.ele.ACC.3.M.SG+COND+2+SG
descompreendê-lo-íeis	descompreender+V.ele.ACC.3.M.SG+COND+2+PL
descompreendê-los-á	descompreender+V.ele.ACC.3.M.PL+FUT+3+SG
descompreendê-los-ão	descompreender+V.ele.ACC.3.M.PL+FUT+3+PL
descompreendê-los-ás	descompreender+V.ele.ACC.3.M.PL+FUT+2+SG
descompreendê-los	descompreender+V.ele.ACC.3.M.PL+INF
descompreendê-los	descompreender+V.ele.ACC.3.M.PL+INF+1+SG
descompreendê-los	descompreender+V.ele.ACC.3.M.PL+INF+3+SG
descompreende-los	descompreender+V.ele.ACC.3.M.PL+PRS+2+SG
descompreendê-los	descompreender+V.ele.ACC.3.M.PL+SBJF+1+SG
descompreendê-los	descompreender+V.ele.ACC.3.M.PL+SBJF+3+SG
descompreendê-los-ei	descompreender+V.ele.ACC.3.M.PL+FUT+1+SG
descompreendê-los-eis	descompreender+V.ele.ACC.3.M.PL+FUT+2+PL
descompreendê-los-emos	descompreender+V.ele.ACC.3.M.PL+FUT+1+PL
descompreendê-los-ia	descompreender+V.ele.ACC.3.M.PL+COND+1+SG
descompreendê-los-ia	descompreender+V.ele.ACC.3.M.PL+COND+3+SG
descompreendê-los-iam	descompreender+V.ele.ACC.3.M.PL+COND+3+PL
descompreendê-los-íamos	descompreender+V.ele.ACC.3.M.PL+COND+1+PL
descompreendê-los-ias	descompreender+V.ele.ACC.3.M.PL+COND+2+SG
descompreendê-los-íeis	descompreender+V.ele.ACC.3.M.PL+COND+2+PL
descompreende-me	descompreender+V.eu.AD.1.SG+PRS+3+SG
descompreendem-lhe	descompreender+V.ele.DAT.3.SG+PRS+3+PL
descompreendem-lhes	descompreender+V.ele.DAT.3.PL+PRS+3+PL
descompreendem-me	descompreender+V.eu.AD.1.SG+PRS+3+PL
descompreendem-na	descompreender+V.ele.ACC.3.F.SG+PRS+3+PL
descompreendem-nas	descompreender+V.ele.ACC.3.F.PL+PRS+3+PL
descompreendem-no	descompreender+V.ele.ACC.3.M.SG+PRS+3+PL
descompreendem-nos	descompreender+V.ele.ACC.3.M.PL+PRS+3+PL
descompreendem-nos	descompreender+V.nós.AD.1.PL+PRS+3+PL
descompreendemo-la	descompreender+V.ele.ACC.3.F.SG+PRF+1+PL
descompreendemo-la	descompreender+V.ele.ACC.3.F.SG+PRS+1+PL
descompreendemo-las	descompreender+V.ele.ACC.3.F.PL+PRF+1+PL
descompreendemo-las	descompreender+V.ele.ACC.3.F.PL+PRS+1+PL
descompreendemo-lo	descompreender+V.ele.ACC.3.M.SG+PRF+1+PL
descompreendemo-lo	descompreender+V.ele.ACC.3.M.SG+PRS+1+PL
descompreendemo-los	descompreender+V.ele.ACC.3.M.PL+PRF+1+PL
descompreendemo-los	descompreender+V.ele.ACC.3.M.PL+PRS+1+PL
descompreendemo-nos	descompreender+nós.AD.1.PL+PRF+1+PL
descompreendemo-nos	descompreender+nós.AD.1.PL+PRS+1+PL
descompreendemos-lhe	descompreender+V.ele.DAT.3.SG+PRF+1+PL
descompreendemos-lhe	descompreender+V.ele.DAT.3.SG+PRS+1+PL
descompreendemos-lhes	descompreender+V.ele.DAT.3.PL+PRF+1+PL
descompreendemos-lhes	descompreender+V.ele.DAT.3.PL+PRS+1+PL
descompreendemos-me	descompreender+V.eu.AD.1.SG+PRF+1+PL
descompreendemos-me	descompreender+V.eu.AD.1.SG+PRS+1+PL
descompreendemos-te	descompreender+V.tu.AD.2.SG+PRF+1+PL
descompreendemos-te	descompreender+V.tu.AD.2.SG+PRS+1+PL
descompreendemos-vos	descompreender+V.vós.AD.2.PL+PRF+1+PL
descompreendemos-vos	descompreender+V.vós.AD.2.PL+PRS+1+PL
descompreendem-se	descompreender+V.ele.REFL+PRS+3+PL
descompreendem-te	descompreender+V.tu.AD.2.SG+PRS+3+PL
descompreendem-vos	descompreender+V.vós.AD.2.PL+PRS+3+PL
descompreendendo-a	descompreender+V.ele.ACC.3.F.SG+GRD
descompreendendo-as	descompreender+V.ele.ACC.3.F.PL+GRD
descompreendendo-lhe	descompreender+V.ele.DAT.3.SG+GRD
descompreendendo-lhes	descompreender+V.ele.DAT.3.PL+GRD
descompreendendo-me	descompreender+V.eu.AD.1.SG+GRD
descompreendendo-nos	descompreender+nós.AD.1.PL+GRD
descompreendendo-o	descompreender+V.ele.ACC.3.M.SG+GRD
descompreendendo-os	descompreender+V.ele.ACC.3.M.PL+GRD
descompreendendo-se	descompreender+V.ele.REFL+GRD
descompreendendo-te	descompreender+V.tu.AD.2.SG+GRD
descompreendendo-vos	descompreender+V.vós.AD.2.PL+GRD
descompreende-nos	descompreender+nós.AD.1.PL+PRS+2+SG
descompreende-nos	descompreender+nós.AD.1.PL+PRS+3+SG
descompreende-o	descompreender+V.ele.ACC.3.M.SG+PRS+3+SG
descompreende-os	descompreender+V.ele.ACC.3.M.PL+PRS+3+SG
descompreendera-a	descompreender+V.ele.ACC.3.F.SG+PQP+1+SG
descompreendera-a	descompreender+V.ele.ACC.3.F.SG+PQP+3+SG
descompreendera-as	descompreender+V.ele.ACC.3.F.PL+PQP+1+SG
descompreendera-as	descompreender+V.ele.ACC.3.F.PL+PQP+3+SG
descompreendera-la	descompreender+V.ele.ACC.3.F.SG+PQP+2+SG
descompreendera-las	descompreender+V.ele.ACC.3.F.PL+PQP+2+SG
descompreendera-lhe	descompreender+V.ele.DAT.3.SG+PQP+1+SG
descompreendera-lhe	descompreender+V.ele.DAT.3.SG+PQP+3+SG
descompreendera-lhes	descompreender+V.ele.DAT.3.PL+PQP+1+SG
descompreendera-lhes	descompreender+V.ele.DAT.3.PL+PQP+3+SG
descompreendera-lo	descompreender+V.ele.ACC.3.M.SG+PQP+2+SG
descompreendera-los	descompreender+V.ele.ACC.3.M.PL+PQP+2+SG
descompreendera-me	descompreender+V.eu.AD.1.SG+PQP+1+SG
descompreendera-me	descompreender+V.eu.AD.1.SG+PQP+3+SG
descompreenderam-lhe	descompreender+V.ele.DAT.3.SG+PQP+3+PL
descompreenderam-lhe	descompreender+V.ele.DAT.3.SG+PRF+3+PL
descompreenderam-lhes	descompreender+V.ele.DAT.3.PL+PQP+3+PL
descompreenderam-lhes	descompreender+V.ele.DAT.3.PL+PRF+3+PL
descompreenderam-me	descompreender+V.eu.AD.1.SG+PQP+3+PL
descompreenderam-me	descompreender+V.eu.AD.1.SG+PRF+3+PL
descompreenderam-na	descompreender+V.ele.ACC.3.F.SG+PQP+3+PL
descompreenderam-na	descompreender+V.ele.ACC.3.F.SG+PRF+3+PL
descompreenderam-nas	descompreender+V.ele.ACC.3.F.PL+PQP+3+PL
descompreenderam-nas	descompreender+V.ele.ACC.3.F.PL+PRF+3+PL
descompreenderam-no	descompreender+V.ele.ACC.3.M.SG+PQP+3+PL
descompreenderam-no	descompreender+V.ele.ACC.3.M.SG+PRF+3+PL
descompreenderam-nos	descompreender+V.ele.ACC.3.M.PL+PQP+3+PL
descompreenderam-nos	descompreender+V.ele.ACC.3.M.PL+PRF+3+PL
descompreenderam-nos	descompreender+V.nós.AD.1.PL+PQP+3+PL
descompreenderam-nos	descompreender+V.nós.AD.1.PL+PRF+3+PL
descompreendêramo-la	descompreender+V.ele.ACC.3.F.SG+PQP+1+PL
descompreendêramo-las	descompreender+V.ele.ACC.3.F.PL+PQP+1+PL
descompreendêramo-lo	descompreender+V.ele.ACC.3.M.SG+PQP+1+PL
descompreendêramo-los	descompreender+V.ele.ACC.3.M.PL+PQP+1+PL
descompreendêramo-nos	descompreender+nós.AD.1.PL+PQP+1+PL
descompreendêramos-lhe	descompreender+V.ele.DAT.3.SG+PQP+1+PL
descompreendêramos-lhes	descompreender+V.ele.DAT.3.PL+PQP+1+PL
descompreendêramos-me	descompreender+V.eu.AD.1.SG+PQP+1+PL
descompreendêramos-te	descompreender+V.tu.AD.2.SG+PQP+1+PL
descompreendêramos-vos	descompreender+V.vós.AD.2.PL+PQP+1+PL
descompreenderam-se	descompreender+V.ele.REFL+PQP+3+PL
descompreenderam-se	descompreender+V.ele.REFL+PRF+3+PL
descompreenderam-te	descompreender+V.tu.AD.2.SG+PQP+3+PL
descompreenderam-te	descompreender+V.tu.AD.2.SG+PRF+3+PL
descompreenderam-vos	descompreender+V.vós.AD.2.PL+PQP+3+PL
descompreenderam-vos	descompreender+V.vós.AD.2.PL+PRF+3+PL
descompreendera-nos	descompreender+nós.AD.1.PL+PQP+1+SG
descompreendera-nos	descompreender+nós.AD.1.PL+PQP+2+SG
descompreendera-nos	descompreender+nós.AD.1.PL+PQP+3+SG
descompreendera-o	descompreender+V.ele.ACC.3.M.SG+PQP+1+SG
descompreendera-o	descompreender+V.ele.ACC.3.M.SG+PQP+3+SG
descompreendera-os	descompreender+V.ele.ACC.3.M.PL+PQP+1+SG
descompreendera-os	descompreender+V.ele.ACC.3.M.PL+PQP+3+SG
descompreendera-se	descompreender+V.ele.REFL+PQP+3+SG
descompreenderas-lhe	descompreender+V.ele.DAT.3.SG+PQP+2+SG
descompreenderas-lhes	descompreender+V.ele.DAT.3.PL+PQP+2+SG
descompreenderas-me	descompreender+V.eu.AD.1.SG+PQP+2+SG
descompreenderas-te	descompreender+V.tu.AD.2.SG+PQP+2+SG
descompreenderas-vos	descompreender+V.vós.AD.2.PL+PQP+2+SG
descompreendera-te	descompreender+V.tu.AD.2.SG+PQP+1+SG
descompreendera-te	descompreender+V.tu.AD.2.SG+PQP+3+SG
descompreendera-vos	descompreender+V.vós.AD.2.PL+PQP+1+SG
descompreendera-vos	descompreender+V.vós.AD.2.PL+PQP+3+SG
descompreenderde-la	descompreender+V.ele.ACC.3.F.SG+INF+2+PL
descompreenderde-la	descompreender+V.ele.ACC.3.F.SG+SBJF+2+PL
descompreenderde-las	descompreender+V.ele.ACC.3.F.PL+INF+2+PL
descompreenderde-las	descompreender+V.ele.ACC.3.F.PL+SBJF+2+PL
descompreenderde-lo	descompreender+V.ele.ACC.3.M.SG+INF+2+PL
descompreenderde-lo	descompreender+V.ele.ACC.3.M.SG+SBJF+2+PL
descompreenderde-los	descompreender+V.ele.ACC.3.M.PL+INF+2+PL
descompreenderde-los	descompreender+V.ele.ACC.3.M.PL+SBJF+2+PL
descompreenderde-nos	descompreender+nós.AD.1.PL+INF+2+PL
descompreenderde-nos	descompreender+nós.AD.1.PL+SBJF+2+PL
descompreenderdes-lhe	descompreender+V.ele.DAT.3.SG+INF+2+PL
descompreenderdes-lhe	descompreender+V.ele.DAT.3.SG+SBJF+2+PL
descompreenderdes-lhes	descompreender+V.ele.DAT.3.PL+INF+2+PL
descompreenderdes-lhes	descompreender+V.ele.DAT.3.PL+SBJF+2+PL
descompreenderdes-me	descompreender+V.eu.AD.1.SG+INF+2+PL
descompreenderdes-me	descompreender+V.eu.AD.1.SG+SBJF+2+PL
descompreenderdes-te	descompreender+V.tu.AD.2.SG+INF+2+PL
descompreenderdes-te	descompreender+V.tu.AD.2.SG+SBJF+2+PL
descompreenderdes-vos	descompreender+V.vós.AD.2.PL+INF+2+PL
descompreenderdes-vos	descompreender+V.vós.AD.2.PL+SBJF+2+PL
descompreendêrei-la	descompreender+V.ele.ACC.3.F.SG+PQP+2+PL
descompreendêrei-las	descompreender+V.ele.ACC.3.F.PL+PQP+2+PL
descompreendêrei-lo	descompreender+V.ele.ACC.3.M.SG+PQP+2+PL
descompreendêrei-los	descompreender+V.ele.ACC.3.M.PL+PQP+2+PL
descompreendêrei-nos	descompreender+nós.AD.1.PL+PQP+2+PL
descompreendêreis-lhe	descompreender+V.ele.DAT.3.SG+PQP+2+PL
descompreendêreis-lhes	descompreender+V.ele.DAT.3.PL+PQP+2+PL
descompreendêreis-me	descompreender+V.eu.AD.1.SG+PQP+2+PL
descompreendêreis-te	descompreender+V.tu.AD.2.SG+PQP+2+PL
descompreendêreis-vos	descompreender+V.vós.AD.2.PL+PQP+2+PL
descompreendere-la	descompreender+V.ele.ACC.3.F.SG+INF+2+SG
descompreendere-la	descompreender+V.ele.ACC.3.F.SG+SBJF+2+SG
descompreendere-las	descompreender+V.ele.ACC.3.F.PL+INF+2+SG
descompreendere-las	descompreender+V.ele.ACC.3.F.PL+SBJF+2+SG
descompreendere-lo	descompreender+V.ele.ACC.3.M.SG+INF+2+SG
descompreendere-lo	descompreender+V.ele.ACC.3.M.SG+SBJF+2+SG
descompreendere-los	descompreender+V.ele.ACC.3.M.PL+INF+2+SG
descompreendere-los	descompreender+V.ele.ACC.3.M.PL+SBJF+2+SG
descompreenderem-lhe	descompreender+V.ele.DAT.3.SG+INF+3+PL
descompreenderem-lhe	descompreender+V.ele.DAT.3.SG+SBJF+3+PL
descompreenderem-lhes	descompreender+V.ele.DAT.3.PL+INF+3+PL
descompreenderem-lhes	descompreender+V.ele.DAT.3.PL+SBJF+3+PL
descompreenderem-me	descompreender+V.eu.AD.1.SG+INF+3+PL
descompreenderem-me	descompreender+V.eu.AD.1.SG+SBJF+3+PL
descompreenderem-na	descompreender+V.ele.ACC.3.F.SG+INF+3+PL
descompreenderem-na	descompreender+V.ele.ACC.3.F.SG+SBJF+3+PL
descompreenderem-nas	descompreender+V.ele.ACC.3.F.PL+INF+3+PL
descompreenderem-nas	descompreender+V.ele.ACC.3.F.PL+SBJF+3+PL
descompreenderem-no	descompreender+V.ele.ACC.3.M.SG+INF+3+PL
descompreenderem-no	descompreender+V.ele.ACC.3.M.SG+SBJF+3+PL
descompreenderem-nos	descompreender+V.ele.ACC.3.M.PL+INF+3+PL
descompreenderem-nos	descompreender+V.ele.ACC.3.M.PL+SBJF+3+PL
descompreenderem-nos	descompreender+V.nós.AD.1.PL+INF+3+PL
descompreenderem-nos	descompreender+V.nós.AD.1.PL+SBJF+3+PL
descompreenderem-se	descompreender+V.ele.REFL+INF+3+PL
descompreenderem-se	descompreender+V.ele.REFL+SBJF+3+PL
descompreenderem-te	descompreender+V.tu.AD.2.SG+INF+3+PL
descompreenderem-te	descompreender+V.tu.AD.2.SG+SBJF+3+PL
descompreenderem-vos	descompreender+V.vós.AD.2.PL+INF+3+PL
descompreenderem-vos	descompreender+V.vós.AD.2.PL+SBJF+3+PL
descompreendere-nos	descompreender+nós.AD.1.PL+INF+2+SG
descompreendere-nos	descompreender+nós.AD.1.PL+SBJF+2+SG
descompreenderes-lhe	descompreender+V.ele.DAT.3.SG+INF+2+SG
descompreenderes-lhe	descompreender+V.ele.DAT.3.SG+SBJF+2+SG
descompreenderes-lhes	descompreender+V.ele.DAT.3.PL+INF+2+SG
descompreenderes-lhes	descompreender+V.ele.DAT.3.PL+SBJF+2+SG
descompreenderes-me	descompreender+V.eu.AD.1.SG+INF+2+SG
descompreenderes-me	descompreender+V.eu.AD.1.SG+SBJF+2+SG
descompreenderes-te	descompreender+V.tu.AD.2.SG+INF+2+SG
descompreenderes-te	descompreender+V.tu.AD.2.SG+SBJF+2+SG
descompreenderes-vos	descompreender+V.vós.AD.2.PL+INF+2+SG
descompreenderes-vos	descompreender+V.vós.AD.2.PL+SBJF+2+SG
descompreender-lhe-á	descompreender+V.ele.DAT.3.SG+FUT+3+SG
descompreender-lhe-ão	descompreender+V.ele.DAT.3.SG+FUT+3+PL
descompreender-lhe-ás	descompreender+V.ele.DAT.3.SG+FUT+2+SG
descompreender-lhe	descompreender+V.ele.DAT.3.SG+INF
descompreender-lhe	descompreender+V.ele.DAT.3.SG+INF+1+SG
descompreender-lhe	descompreender+V.ele.DAT.3.SG+INF+3+SG
descompreender-lhe	descompreender+V.ele.DAT.3.SG+SBJF+1+SG
descompreender-lhe	descompreender+V.ele.DAT.3.SG+SBJF+3+SG
descompreender-lhe-ei	descompreender+V.ele.DAT.3.SG+FUT+1+SG
descompreender-lhe-eis	descompreender+V.ele.DAT.3.SG+FUT+2+PL
descompreender-lhe-emos	descompreender+V.ele.DAT.3.SG+FUT+1+PL
descompreender-lhe-ia	descompreender+V.ele.DAT.3.SG+COND+1+SG
descompreender-lhe-ia	descompreender+V.ele.DAT.3.SG+COND+3+SG
descompreender-lhe-iam	descompreender+V.ele.DAT.3.SG+COND+3+PL
descompreender-lhe-íamos	descompreender+V.ele.DAT.3.SG+COND+1+PL
descompreender-lhe-ias	descompreender+V.ele.DAT.3.SG+COND+2+SG
descompreender-lhe-íeis	descompreender+V.ele.DAT.3.SG+COND+2+PL
descompreender-lhes-á	descompreender+V.ele.DAT.3.PL+FUT+3+SG
descompreender-lhes-ão	descompreender+V.ele.DAT.3.PL+FUT+3+PL
descompreender-lhes-ás	descompreender+V.ele.DAT.3.PL+FUT+2+SG
descompreender-lhes	descompreender+V.ele.DAT.3.PL+INF
descompreender-lhes	descompreender+V.ele.DAT.3.PL+INF+1+SG
descompreender-lhes	descompreender+V.ele.DAT.3.PL+INF+3+SG
descompreender-lhes	descompreender+V.ele.DAT.3.PL+SBJF+1+SG
descompreender-lhes	descompreender+V.ele.DAT.3.PL+SBJF+3+SG
descompreender-lhes-ei	descompreender+V.ele.DAT.3.PL+FUT+1+SG
descompreender-lhes-eis	descompreender+V.ele.DAT.3.PL+FUT+2+PL
descompreender-lhes-emos	descompreender+V.ele.DAT.3.PL+FUT+1+PL
descompreender-lhes-ia	descompreender+V.ele.DAT.3.PL+COND+1+SG
descompreender-lhes-ia	descompreender+V.ele.DAT.3.PL+COND+3+SG
descompreender-lhes-iam	descompreender+V.ele.DAT.3.PL+COND+3+PL
descompreender-lhes-íamos	descompreender+V.ele.DAT.3.PL+COND+1+PL
descompreender-lhes-ias	descompreender+V.ele.DAT.3.PL+COND+2+SG
descompreender-lhes-íeis	descompreender+V.ele.DAT.3.PL+COND+2+PL
descompreender-me-á	descompreender+V.eu.AD.1.SG+FUT+3+SG
descompreender-me-ão	descompreender+V.eu.AD.1.SG+FUT+3+PL
descompreender-me-ás	descompreender+V.eu.AD.1.SG+FUT+2+SG
descompreender-me	descompreender+V.eu.AD.1.SG+INF
descompreender-me	descompreender+V.eu.AD.1.SG+INF+1+SG
descompreender-me	descompreender+V.eu.AD.1.SG+INF+3+SG
descompreender-me	descompreender+V.eu.AD.1.SG+SBJF+1+SG
descompreender-me	descompreender+V.eu.AD.1.SG+SBJF+3+SG
descompreender-me-ei	descompreender+V.eu.AD.1.SG+FUT+1+SG
descompreender-me-eis	descompreender+V.eu.AD.1.SG+FUT+2+PL
descompreender-me-emos	descompreender+V.eu.AD.1.SG+FUT+1+PL
descompreender-me-ia	descompreender+V.eu.AD.1.SG+COND+1+SG
descompreender-me-ia	descompreender+V.eu.AD.1.SG+COND+3+SG
descompreender-me-iam	descompreender+V.eu.AD.1.SG+COND+3+PL
descompreender-me-íamos	descompreender+V.eu.AD.1.SG+COND+1+PL
descompreender-me-ias	descompreender+V.eu.AD.1.SG+COND+2+SG
descompreender-me-íeis	descompreender+V.eu.AD.1.SG+COND+2+PL
descompreendermo-la	descompreender+V.ele.ACC.3.F.SG+INF+1+PL
descompreendermo-la	descompreender+V.ele.ACC.3.F.SG+SBJF+1+PL
descompreendermo-las	descompreender+V.ele.ACC.3.F.PL+INF+1+PL
descompreendermo-las	descompreender+V.ele.ACC.3.F.PL+SBJF+1+PL
descompreendermo-lo	descompreender+V.ele.ACC.3.M.SG+INF+1+PL
descompreendermo-lo	descompreender+V.ele.ACC.3.M.SG+SBJF+1+PL
descompreendermo-los	descompreender+V.ele.ACC.3.M.PL+INF+1+PL
descompreendermo-los	descompreender+V.ele.ACC.3.M.PL+SBJF+1+PL
descompreendermo-nos	descompreender+nós.AD.1.PL+INF+1+PL
descompreendermo-nos	descompreender+nós.AD.1.PL+SBJF+1+PL
descompreendermos-lhe	descompreender+V.ele.DAT.3.SG+INF+1+PL
descompreendermos-lhe	descompreender+V.ele.DAT.3.SG+SBJF+1+PL
descompreendermos-lhes	descompreender+V.ele.DAT.3.PL+INF+1+PL
descompreendermos-lhes	descompreender+V.ele.DAT.3.PL+SBJF+1+PL
descompreendermos-me	descompreender+V.eu.AD.1.SG+INF+1+PL
descompreendermos-me	descompreender+V.eu.AD.1.SG+SBJF+1+PL
descompreendermos-te	descompreender+V.tu.AD.2.SG+INF+1+PL
descompreendermos-te	descompreender+V.tu.AD.2.SG+SBJF+1+PL
descompreendermos-vos	descompreender+V.vós.AD.2.PL+INF+1+PL
descompreendermos-vos	descompreender+V.vós.AD.2.PL+SBJF+1+PL
descompreender-nos-á	descompreender+nós.AD.1.PL+FUT+3+SG
descompreender-nos-ão	descompreender+nós.AD.1.PL+FUT+3+PL
descompreender-nos-ás	descompreender+nós.AD.1.PL+FUT+2+SG
descompreender-nos	descompreender+nós.AD.1.PL+INF
descompreender-nos	descompreender+nós.AD.1.PL+INF+1+SG
descompreender-nos	descompreender+nós.AD.1.PL+INF+3+SG
descompreender-nos	descompreender+nós.AD.1.PL+SBJF+1+SG
descompreender-nos	descompreender+nós.AD.1.PL+SBJF+3+SG
descompreender-nos-ei	descompreender+nós.AD.1.PL+FUT+1+SG
descompreender-nos-eis	descompreender+nós.AD.1.PL+FUT+2+PL
descompreender-nos-emos	descompreender+nós.AD.1.PL+FUT+1+PL
descompreender-nos-ia	descompreender+nós.AD.1.PL+COND+1+SG
descompreender-nos-ia	descompreender+nós.AD.1.PL+COND+3+SG
descompreender-nos-iam	descompreender+nós.AD.1.PL+COND+3+PL
descompreender-nos-íamos	descompreender+nós.AD.1.PL+COND+1+PL
descompreender-nos-ias	descompreender+nós.AD.1.PL+COND+2+SG
descompreender-nos-íeis	descompreender+nós.AD.1.PL+COND+2+PL
descompreender-se-á	descompreender+V.ele.REFL+FUT+3+SG
descompreender-se-ão	descompreender+V.ele.REFL+FUT+3+PL
descompreender-se	descompreender+V.ele.REFL+INF
descompreender-se	descompreender+V.ele.REFL+INF+3+SG
descompreender-se	descompreender+V.ele.REFL+SBJF+3+SG
descompreender-se-ia	descompreender+V.ele.REFL+COND+3+SG
descompreender-se-iam	descompreender+V.ele.REFL+COND+3+PL
descompreender-te-á	descompreender+V.tu.AD.2.SG+FUT+3+SG
descompreender-te-ão	descompreender+V.tu.AD.2.SG+FUT+3+PL
descompreender-te-ás	descompreender+V.tu.AD.2.SG+FUT+2+SG
descompreender-te	descompreender+V.tu.AD.2.SG+INF
descompreender-te	descompreender+V.tu.AD.2.SG+INF+1+SG
descompreender-te	descompreender+V.tu.AD.2.SG+INF+3+SG
descompreender-te	descompreender+V.tu.AD.2.SG+SBJF+1+SG
descompreender-te	descompreender+V.tu.AD.2.SG+SBJF+3+SG
descompreender-te-ei	descompreender+V.tu.AD.2.SG+FUT+1+SG
descompreender-te-eis	descompreender+V.tu.AD.2.SG+FUT+2+PL
descompreender-te-emos	descompreender+V.tu.AD.2.SG+FUT+1+PL
descompreender-te-ia	descompreender+V.tu.AD.2.SG+COND+1+SG
descompreender-te-ia	descompreender+V.tu.AD.2.SG+COND+3+SG
descompreender-te-iam	descompreender+V.tu.AD.2.SG+COND+3+PL
descompreender-te-íamos	descompreender+V.tu.AD.2.SG+COND+1+PL
descompreender-te-ias	descompreender+V.tu.AD.2.SG+COND+2+SG
descompreender-te-íeis	descompreender+V.tu.AD.2.SG+COND+2+PL
descompreender-vos-á	descompreender+V.vós.AD.2.PL+FUT+3+SG
descompreender-vos-ão	descompreender+V.vós.AD.2.PL+FUT+3+PL
descompreender-vos-ás	descompreender+V.vós.AD.2.PL+FUT+2+SG
descompreender-vos	descompreender+V.vós.AD.2.PL+INF
descompreender-vos	descompreender+V.vós.AD.2.PL+INF+1+SG
descompreender-vos	descompreender+V.vós.AD.2.PL+INF+3+SG
descompreender-vos	descompreender+V.vós.AD.2.PL+SBJF+1+SG
descompreender-vos	descompreender+V.vós.AD.2.PL+SBJF+3+SG
descompreender-vos-ei	descompreender+V.vós.AD.2.PL+FUT+1+SG
descompreender-vos-eis	descompreender+V.vós.AD.2.PL+FUT+2+PL
descompreender-vos-emos	descompreender+V.vós.AD.2.PL+FUT+1+PL
descompreender-vos-ia	descompreender+V.vós.AD.2.PL+COND+1+SG
descompreender-vos-ia	descompreender+V.vós.AD.2.PL+COND+3+SG
descompreender-vos-iam	descompreender+V.vós.AD.2.PL+COND+3+PL
descompreender-vos-íamos	descompreender+V.vós.AD.2.PL+COND+1+PL
descompreender-vos-ias	descompreender+V.vós.AD.2.PL+COND+2+SG
descompreender-vos-íeis	descompreender+V.vós.AD.2.PL+COND+2+PL
descompreende-se	descompreender+V.ele.REFL+PRS+3+SG
descompreendes-lhe	descompreender+V.ele.DAT.3.SG+PRS+2+SG
descompreendes-lhes	descompreender+V.ele.DAT.3.PL+PRS+2+SG
descompreendes-me	descompreender+V.eu.AD.1.SG+PRS+2+SG
descompreendeste-a	descompreender+V.ele.ACC.3.F.SG+PRF+2+SG
descompreendeste-as	descompreender+V.ele.ACC.3.F.PL+PRF+2+SG
descompreendes-te	descompreender+V.tu.AD.2.SG+PRS+2+SG
descompreendeste-la	descompreender+V.ele.ACC.3.F.SG+PRF+2+PL
descompreendeste-las	descompreender+V.ele.ACC.3.F.PL+PRF+2+PL
descompreendeste-lhe	descompreender+V.ele.DAT.3.SG+PRF+2+SG
descompreendeste-lhes	descompreender+V.ele.DAT.3.PL+PRF+2+SG
descompreendeste-lo	descompreender+V.ele.ACC.3.M.SG+PRF+2+PL
descompreendeste-los	descompreender+V.ele.ACC.3.M.PL+PRF+2+PL
descompreendeste-me	descompreender+V.eu.AD.1.SG+PRF+2+SG
descompreendeste-nos	descompreender+nós.AD.1.PL+PRF+2+PL
descompreendeste-nos	descompreender+nós.AD.1.PL+PRF+2+SG
descompreendeste-o	descompreender+V.ele.ACC.3.M.SG+PRF+2+SG
descompreendeste-os	descompreender+V.ele.ACC.3.M.PL+PRF+2+SG
descompreendestes-lhe	descompreender+V.ele.DAT.3.SG+PRF+2+PL
descompreendestes-lhes	descompreender+V.ele.DAT.3.PL+PRF+2+PL
descompreendestes-me	descompreender+V.eu.AD.1.SG+PRF+2+PL
descompreendestes-te	descompreender+V.tu.AD.2.SG+PRF+2+PL
descompreendestes-vos	descompreender+V.vós.AD.2.PL+PRF+2+PL
descompreendeste-te	descompreender+V.tu.AD.2.SG+PRF+2+SG
descompreendeste-vos	descompreender+V.vós.AD.2.PL+PRF+2+SG
descompreendes-vos	descompreender+V.vós.AD.2.PL+PRS+2+SG
descompreende-te	descompreender+V.tu.AD.2.SG+PRS+3+SG
descompreendeu-a	descompreender+V.ele.ACC.3.F.SG+PRF+3+SG
descompreendeu-as	descompreender+V.ele.ACC.3.F.PL+PRF+3+SG
descompreendeu-lhe	descompreender+V.ele.DAT.3.SG+PRF+3+SG
descompreendeu-lhes	descompreender+V.ele.DAT.3.PL+PRF+3+SG
descompreendeu-me	descompreender+V.eu.AD.1.SG+PRF+3+SG
descompreendeu-nos	descompreender+nós.AD.1.PL+PRF+3+SG
descompreendeu-o	descompreender+V.ele.ACC.3.M.SG+PRF+3+SG
descompreendeu-os	descompreender+V.ele.ACC.3.M.PL+PRF+3+SG
descompreendeu-se	descompreender+V.ele.REFL+PRF+3+SG
descompreendeu-te	descompreender+V.tu.AD.2.SG+PRF+3+SG
descompreendeu-vos	descompreender+V.vós.AD.2.PL+PRF+3+SG
descompreende-vos	descompreender+V.vós.AD.2.PL+PRS+3+SG
descompreendia-a	descompreender+V.ele.ACC.3.F.SG+IMPF+1+SG
descompreendia-a	descompreender+V.ele.ACC.3.F.SG+IMPF+3+SG
descompreendia-as	descompreender+V.ele.ACC.3.F.PL+IMPF+1+SG
descompreendia-as	descompreender+V.ele.ACC.3.F.PL+IMPF+3+SG
descompreendi-a	descompreender+V.ele.ACC.3.F.SG+PRF+1+SG
descompreendia-la	descompreender+V.ele.ACC.3.F.SG+IMPF+2+SG
descompreendia-las	descompreender+V.ele.ACC.3.F.PL+IMPF+2+SG
descompreendia-lhe	descompreender+V.ele.DAT.3.SG+IMPF+1+SG
descompreendia-lhe	descompreender+V.ele.DAT.3.SG+IMPF+3+SG
descompreendia-lhes	descompreender+V.ele.DAT.3.PL+IMPF+1+SG
descompreendia-lhes	descompreender+V.ele.DAT.3.PL+IMPF+3+SG
descompreendia-lo	descompreender+V.ele.ACC.3.M.SG+IMPF+2+SG
descompreendia-los	descompreender+V.ele.ACC.3.M.PL+IMPF+2+SG
descompreendia-me	descompreender+V.eu.AD.1.SG+IMPF+1+SG
descompreendia-me	descompreender+V.eu.AD.1.SG+IMPF+3+SG
descompreendiam-lhe	descompreender+V.ele.DAT.3.SG+IMPF+3+PL
descompreendiam-lhes	descompreender+V.ele.DAT.3.PL+IMPF+3+PL
descompreendiam-me	descompreender+V.eu.AD.1.SG+IMPF+3+PL
descompreendiam-na	descompreender+V.ele.ACC.3.F.SG+IMPF+3+PL
descompreendiam-nas	descompreender+V.ele.ACC.3.F.PL+IMPF+3+PL
descompreendiam-no	descompreender+V.ele.ACC.3.M.SG+IMPF+3+PL
descompreendiam-nos	descompreender+V.ele.ACC.3.M.PL+IMPF+3+PL
descompreendiam-nos	descompreender+V.nós.AD.1.PL+IMPF+3+PL
descompreendíamo-la	descompreender+V.ele.ACC.3.F.SG+IMPF+1+PL
descompreendíamo-las	descompreender+V.ele.ACC.3.F.PL+IMPF+1+PL
descompreendíamo-lo	descompreender+V.ele.ACC.3.M.SG+IMPF+1+PL
descompreendíamo-los	descompreender+V.ele.ACC.3.M.PL+IMPF+1+PL
descompreendíamo-nos	descompreender+nós.AD.1.PL+IMPF+1+PL
descompreendíamos-lhe	descompreender+V.ele.DAT.3.SG+IMPF+1+PL
descompreendíamos-lhes	descompreender+V.ele.DAT.3.PL+IMPF+1+PL
descompreendíamos-me	descompreender+V.eu.AD.1.SG+IMPF+1+PL
descompreendíamos-te	descompreender+V.tu.AD.2.SG+IMPF+1+PL
descompreendíamos-vos	descompreender+V.vós.AD.2.PL+IMPF+1+PL
descompreendiam-se	descompreender+V.ele.REFL+IMPF+3+PL
descompreendiam-te	descompreender+V.tu.AD.2.SG+IMPF+3+PL
descompreendiam-vos	descompreender+V.vós.AD.2.PL+IMPF+3+PL
descompreendia-nos	descompreender+nós.AD.1.PL+IMPF+1+SG
descompreendia-nos	descompreender+nós.AD.1.PL+IMPF+2+SG
descompreendia-nos	descompreender+nós.AD.1.PL+IMPF+3+SG
descompreendia-o	descompreender+V.ele.ACC.3.M.SG+IMPF+1+SG
descompreendia-o	descompreender+V.ele.ACC.3.M.SG+IMPF+3+SG
descompreendia-os	descompreender+V.ele.ACC.3.M.PL+IMPF+1+SG
descompreendia-os	descompreender+V.ele.ACC.3.M.PL+IMPF+3+SG
descompreendi-as	descompreender+V.ele.ACC.3.F.PL+PRF+1+SG
descompreendia-se	descompreender+V.ele.REFL+IMPF+3+SG
descompreendias-lhe	descompreender+V.ele.DAT.3.SG+IMPF+2+SG
descompreendias-lhes	descompreender+V.ele.DAT.3.PL+IMPF+2+SG
descompreendias-me	descompreender+V.eu.AD.1.SG+IMPF+2+SG
descompreendias-te	descompreender+V.tu.AD.2.SG+IMPF+2+SG
descompreendias-vos	descompreender+V.vós.AD.2.PL+IMPF+2+SG
descompreendia-te	descompreender+V.tu.AD.2.SG+IMPF+1+SG
descompreendia-te	descompreender+V.tu.AD.2.SG+IMPF+3+SG
descompreendia-vos	descompreender+V.vós.AD.2.PL+IMPF+1+SG
descompreendia-vos	descompreender+V.vós.AD.2.PL+IMPF+3+SG
descompreendíei-la	descompreender+V.ele.ACC.3.F.SG+IMPF+2+PL
descompreendíei-las	descompreender+V.ele.ACC.3.F.PL+IMPF+2+PL
descompreendíei-lo	descompreender+V.ele.ACC.3.M.SG+IMPF+2+PL
descompreendíei-los	descompreender+V.ele.ACC.3.M.PL+IMPF+2+PL
descompreendíei-nos	descompreender+nós.AD.1.PL+IMPF+2+PL
descompreendíeis-lhe	descompreender+V.ele.DAT.3.SG+IMPF+2+PL
descompreendíeis-lhes	descompreender+V.ele.DAT.3.PL+IMPF+2+PL
descompreendíeis-me	descompreender+V.eu.AD.1.SG+IMPF+2+PL
descompreendíeis-te	descompreender+V.tu.AD.2.SG+IMPF+2+PL
descompreendíeis-vos	descompreender+V.vós.AD.2.PL+IMPF+2+PL
descompreendi-lhe	descompreender+V.ele.DAT.3.SG+PRF+1+SG
descompreendi-lhes	descompreender+V.ele.DAT.3.PL+PRF+1+SG
descompreendi-me	descompreender+V.eu.AD.1.SG+PRF+1+SG
descompreendi-nos	descompreender+nós.AD.1.PL+PRF+1+SG
descompreendi-o	descompreender+V.ele.ACC.3.M.SG+PRF+1+SG
descompreendi-os	descompreender+V.ele.ACC.3.M.PL+PRF+1+SG
descompreendi-te	descompreender+V.tu.AD.2.SG+PRF+1+SG
descompreendi-vos	descompreender+V.vós.AD.2.PL+PRF+1+SG
descompreendo-a	descompreender+V.ele.ACC.3.F.SG+PRS+1+SG
descompreendo-as	descompreender+V.ele.ACC.3.F.PL+PRS+1+SG
descompreendo-lhe	descompreender+V.ele.DAT.3.SG+PRS+1+SG
descompreendo-lhes	descompreender+V.ele.DAT.3.PL+PRS+1+SG
descompreendo-me	descompreender+V.eu.AD.1.SG+PRS+1+SG
descompreendo-nos	descompreender+nós.AD.1.PL+PRS+1+SG
descompreendo-o	descompreender+V.ele.ACC.3.M.SG+PRS+1+SG
descompreendo-os	descompreender+V.ele.ACC.3.M.PL+PRS+1+SG
descompreendo-te	descompreender+V.tu.AD.2.SG+PRS+1+SG
descompreendo-vos	descompreender+V.vós.AD.2.PL+PRS+1+SG
descomprima-a	descomprimir+V.ele.ACC.3.F.SG+IMP+3+SG
descomprima-as	descomprimir+V.ele.ACC.3.F.PL+IMP+3+SG
descomprima-lhe	descomprimir+V.ele.DAT.3.SG+IMP+3+SG
descomprima-lhes	descomprimir+V.ele.DAT.3.PL+IMP+3+SG
descomprima-me	descomprimir+V.eu.AD.1.SG+IMP+3+SG
descomprimam-lhe	descomprimir+V.ele.DAT.3.SG+IMP+3+PL
descomprimam-lhes	descomprimir+V.ele.DAT.3.PL+IMP+3+PL
descomprimam-me	descomprimir+V.eu.AD.1.SG+IMP+3+PL
descomprimam-na	descomprimir+V.ele.ACC.3.F.SG+IMP+3+PL
descomprimam-nas	descomprimir+V.ele.ACC.3.F.PL+IMP+3+PL
descomprimam-no	descomprimir+V.ele.ACC.3.M.SG+IMP+3+PL
descomprimam-nos	descomprimir+V.ele.ACC.3.M.PL+IMP+3+PL
descomprimam-nos	descomprimir+V.nós.AD.1.PL+IMP+3+PL
descomprimamo-la	descomprimir+V.ele.ACC.3.F.SG+IMP+1+PL
descomprimamo-las	descomprimir+V.ele.ACC.3.F.PL+IMP+1+PL
