desconsertar-lhe-emos	desconsertar+V.ele.DAT.3.SG+FUT+1+PL
desconsertar-lhe-ia	desconsertar+V.ele.DAT.3.SG+COND+1+SG
desconsertar-lhe-ia	desconsertar+V.ele.DAT.3.SG+COND+3+SG
desconsertar-lhe-iam	desconsertar+V.ele.DAT.3.SG+COND+3+PL
desconsertar-lhe-íamos	desconsertar+V.ele.DAT.3.SG+COND+1+PL
desconsertar-lhe-ias	desconsertar+V.ele.DAT.3.SG+COND+2+SG
desconsertar-lhe-íeis	desconsertar+V.ele.DAT.3.SG+COND+2+PL
desconsertar-lhes-á	desconsertar+V.ele.DAT.3.PL+FUT+3+SG
desconsertar-lhes-ão	desconsertar+V.ele.DAT.3.PL+FUT+3+PL
desconsertar-lhes-ás	desconsertar+V.ele.DAT.3.PL+FUT+2+SG
desconsertar-lhes	desconsertar+V.ele.DAT.3.PL+INF
desconsertar-lhes	desconsertar+V.ele.DAT.3.PL+INF+1+SG
desconsertar-lhes	desconsertar+V.ele.DAT.3.PL+INF+3+SG
desconsertar-lhes	desconsertar+V.ele.DAT.3.PL+SBJF+1+SG
desconsertar-lhes	desconsertar+V.ele.DAT.3.PL+SBJF+3+SG
desconsertar-lhes-ei	desconsertar+V.ele.DAT.3.PL+FUT+1+SG
desconsertar-lhes-eis	desconsertar+V.ele.DAT.3.PL+FUT+2+PL
desconsertar-lhes-emos	desconsertar+V.ele.DAT.3.PL+FUT+1+PL
desconsertar-lhes-ia	desconsertar+V.ele.DAT.3.PL+COND+1+SG
desconsertar-lhes-ia	desconsertar+V.ele.DAT.3.PL+COND+3+SG
desconsertar-lhes-iam	desconsertar+V.ele.DAT.3.PL+COND+3+PL
desconsertar-lhes-íamos	desconsertar+V.ele.DAT.3.PL+COND+1+PL
desconsertar-lhes-ias	desconsertar+V.ele.DAT.3.PL+COND+2+SG
desconsertar-lhes-íeis	desconsertar+V.ele.DAT.3.PL+COND+2+PL
desconsertar-me-á	desconsertar+V.eu.AD.1.SG+FUT+3+SG
desconsertar-me-ão	desconsertar+V.eu.AD.1.SG+FUT+3+PL
desconsertar-me-ás	desconsertar+V.eu.AD.1.SG+FUT+2+SG
desconsertar-me	desconsertar+V.eu.AD.1.SG+INF
desconsertar-me	desconsertar+V.eu.AD.1.SG+INF+1+SG
desconsertar-me	desconsertar+V.eu.AD.1.SG+INF+3+SG
desconsertar-me	desconsertar+V.eu.AD.1.SG+SBJF+1+SG
desconsertar-me	desconsertar+V.eu.AD.1.SG+SBJF+3+SG
desconsertar-me-ei	desconsertar+V.eu.AD.1.SG+FUT+1+SG
desconsertar-me-eis	desconsertar+V.eu.AD.1.SG+FUT+2+PL
desconsertar-me-emos	desconsertar+V.eu.AD.1.SG+FUT+1+PL
desconsertar-me-ia	desconsertar+V.eu.AD.1.SG+COND+1+SG
desconsertar-me-ia	desconsertar+V.eu.AD.1.SG+COND+3+SG
desconsertar-me-iam	desconsertar+V.eu.AD.1.SG+COND+3+PL
desconsertar-me-íamos	desconsertar+V.eu.AD.1.SG+COND+1+PL
desconsertar-me-ias	desconsertar+V.eu.AD.1.SG+COND+2+SG
desconsertar-me-íeis	desconsertar+V.eu.AD.1.SG+COND+2+PL
desconsertarmo-la	desconsertar+V.ele.ACC.3.F.SG+INF+1+PL
desconsertarmo-la	desconsertar+V.ele.ACC.3.F.SG+SBJF+1+PL
desconsertarmo-las	desconsertar+V.ele.ACC.3.F.PL+INF+1+PL
desconsertarmo-las	desconsertar+V.ele.ACC.3.F.PL+SBJF+1+PL
desconsertarmo-lo	desconsertar+V.ele.ACC.3.M.SG+INF+1+PL
desconsertarmo-lo	desconsertar+V.ele.ACC.3.M.SG+SBJF+1+PL
desconsertarmo-los	desconsertar+V.ele.ACC.3.M.PL+INF+1+PL
desconsertarmo-los	desconsertar+V.ele.ACC.3.M.PL+SBJF+1+PL
desconsertarmo-nos	desconsertar+nós.AD.1.PL+INF+1+PL
desconsertarmo-nos	desconsertar+nós.AD.1.PL+SBJF+1+PL
desconsertarmos-lhe	desconsertar+V.ele.DAT.3.SG+INF+1+PL
desconsertarmos-lhe	desconsertar+V.ele.DAT.3.SG+SBJF+1+PL
desconsertarmos-lhes	desconsertar+V.ele.DAT.3.PL+INF+1+PL
desconsertarmos-lhes	desconsertar+V.ele.DAT.3.PL+SBJF+1+PL
desconsertarmos-me	desconsertar+V.eu.AD.1.SG+INF+1+PL
desconsertarmos-me	desconsertar+V.eu.AD.1.SG+SBJF+1+PL
desconsertarmos-te	desconsertar+V.tu.AD.2.SG+INF+1+PL
desconsertarmos-te	desconsertar+V.tu.AD.2.SG+SBJF+1+PL
desconsertarmos-vos	desconsertar+V.vós.AD.2.PL+INF+1+PL
desconsertarmos-vos	desconsertar+V.vós.AD.2.PL+SBJF+1+PL
desconsertar-nos-á	desconsertar+nós.AD.1.PL+FUT+3+SG
desconsertar-nos-ão	desconsertar+nós.AD.1.PL+FUT+3+PL
desconsertar-nos-ás	desconsertar+nós.AD.1.PL+FUT+2+SG
desconsertar-nos	desconsertar+nós.AD.1.PL+INF
desconsertar-nos	desconsertar+nós.AD.1.PL+INF+1+SG
desconsertar-nos	desconsertar+nós.AD.1.PL+INF+3+SG
desconsertar-nos	desconsertar+nós.AD.1.PL+SBJF+1+SG
desconsertar-nos	desconsertar+nós.AD.1.PL+SBJF+3+SG
desconsertar-nos-ei	desconsertar+nós.AD.1.PL+FUT+1+SG
desconsertar-nos-eis	desconsertar+nós.AD.1.PL+FUT+2+PL
desconsertar-nos-emos	desconsertar+nós.AD.1.PL+FUT+1+PL
desconsertar-nos-ia	desconsertar+nós.AD.1.PL+COND+1+SG
desconsertar-nos-ia	desconsertar+nós.AD.1.PL+COND+3+SG
desconsertar-nos-iam	desconsertar+nós.AD.1.PL+COND+3+PL
desconsertar-nos-íamos	desconsertar+nós.AD.1.PL+COND+1+PL
desconsertar-nos-ias	desconsertar+nós.AD.1.PL+COND+2+SG
desconsertar-nos-íeis	desconsertar+nós.AD.1.PL+COND+2+PL
desconsertar-se-á	desconsertar+V.ele.REFL+FUT+3+SG
desconsertar-se-ão	desconsertar+V.ele.REFL+FUT+3+PL
desconsertar-se	desconsertar+V.ele.REFL+INF
desconsertar-se	desconsertar+V.ele.REFL+INF+3+SG
desconsertar-se	desconsertar+V.ele.REFL+SBJF+3+SG
desconsertar-se-ia	desconsertar+V.ele.REFL+COND+3+SG
desconsertar-se-iam	desconsertar+V.ele.REFL+COND+3+PL
desconsertar-te-á	desconsertar+V.tu.AD.2.SG+FUT+3+SG
desconsertar-te-ão	desconsertar+V.tu.AD.2.SG+FUT+3+PL
desconsertar-te-ás	desconsertar+V.tu.AD.2.SG+FUT+2+SG
desconsertar-te	desconsertar+V.tu.AD.2.SG+INF
desconsertar-te	desconsertar+V.tu.AD.2.SG+INF+1+SG
desconsertar-te	desconsertar+V.tu.AD.2.SG+INF+3+SG
desconsertar-te	desconsertar+V.tu.AD.2.SG+SBJF+1+SG
desconsertar-te	desconsertar+V.tu.AD.2.SG+SBJF+3+SG
desconsertar-te-ei	desconsertar+V.tu.AD.2.SG+FUT+1+SG
desconsertar-te-eis	desconsertar+V.tu.AD.2.SG+FUT+2+PL
desconsertar-te-emos	desconsertar+V.tu.AD.2.SG+FUT+1+PL
desconsertar-te-ia	desconsertar+V.tu.AD.2.SG+COND+1+SG
desconsertar-te-ia	desconsertar+V.tu.AD.2.SG+COND+3+SG
desconsertar-te-iam	desconsertar+V.tu.AD.2.SG+COND+3+PL
desconsertar-te-íamos	desconsertar+V.tu.AD.2.SG+COND+1+PL
desconsertar-te-ias	desconsertar+V.tu.AD.2.SG+COND+2+SG
desconsertar-te-íeis	desconsertar+V.tu.AD.2.SG+COND+2+PL
desconsertar-vos-á	desconsertar+V.vós.AD.2.PL+FUT+3+SG
desconsertar-vos-ão	desconsertar+V.vós.AD.2.PL+FUT+3+PL
desconsertar-vos-ás	desconsertar+V.vós.AD.2.PL+FUT+2+SG
desconsertar-vos	desconsertar+V.vós.AD.2.PL+INF
desconsertar-vos	desconsertar+V.vós.AD.2.PL+INF+1+SG
desconsertar-vos	desconsertar+V.vós.AD.2.PL+INF+3+SG
desconsertar-vos	desconsertar+V.vós.AD.2.PL+SBJF+1+SG
desconsertar-vos	desconsertar+V.vós.AD.2.PL+SBJF+3+SG
desconsertar-vos-ei	desconsertar+V.vós.AD.2.PL+FUT+1+SG
desconsertar-vos-eis	desconsertar+V.vós.AD.2.PL+FUT+2+PL
desconsertar-vos-emos	desconsertar+V.vós.AD.2.PL+FUT+1+PL
desconsertar-vos-ia	desconsertar+V.vós.AD.2.PL+COND+1+SG
desconsertar-vos-ia	desconsertar+V.vós.AD.2.PL+COND+3+SG
desconsertar-vos-iam	desconsertar+V.vós.AD.2.PL+COND+3+PL
desconsertar-vos-íamos	desconsertar+V.vós.AD.2.PL+COND+1+PL
desconsertar-vos-ias	desconsertar+V.vós.AD.2.PL+COND+2+SG
desconsertar-vos-íeis	desconsertar+V.vós.AD.2.PL+COND+2+PL
desconserta-se	desconsertar+V.ele.REFL+PRS+3+SG
desconsertas-lhe	desconsertar+V.ele.DAT.3.SG+PRS+2+SG
desconsertas-lhes	desconsertar+V.ele.DAT.3.PL+PRS+2+SG
desconsertas-me	desconsertar+V.eu.AD.1.SG+PRS+2+SG
desconsertaste-a	desconsertar+V.ele.ACC.3.F.SG+PRF+2+SG
desconsertaste-as	desconsertar+V.ele.ACC.3.F.PL+PRF+2+SG
desconsertas-te	desconsertar+V.tu.AD.2.SG+PRS+2+SG
desconsertaste-la	desconsertar+V.ele.ACC.3.F.SG+PRF+2+PL
desconsertaste-las	desconsertar+V.ele.ACC.3.F.PL+PRF+2+PL
desconsertaste-lhe	desconsertar+V.ele.DAT.3.SG+PRF+2+SG
desconsertaste-lhes	desconsertar+V.ele.DAT.3.PL+PRF+2+SG
desconsertaste-lo	desconsertar+V.ele.ACC.3.M.SG+PRF+2+PL
desconsertaste-los	desconsertar+V.ele.ACC.3.M.PL+PRF+2+PL
desconsertaste-me	desconsertar+V.eu.AD.1.SG+PRF+2+SG
desconsertaste-nos	desconsertar+nós.AD.1.PL+PRF+2+PL
desconsertaste-nos	desconsertar+nós.AD.1.PL+PRF+2+SG
desconsertaste-o	desconsertar+V.ele.ACC.3.M.SG+PRF+2+SG
desconsertaste-os	desconsertar+V.ele.ACC.3.M.PL+PRF+2+SG
desconsertastes-lhe	desconsertar+V.ele.DAT.3.SG+PRF+2+PL
desconsertastes-lhes	desconsertar+V.ele.DAT.3.PL+PRF+2+PL
desconsertastes-me	desconsertar+V.eu.AD.1.SG+PRF+2+PL
desconsertastes-te	desconsertar+V.tu.AD.2.SG+PRF+2+PL
desconsertastes-vos	desconsertar+V.vós.AD.2.PL+PRF+2+PL
desconsertaste-te	desconsertar+V.tu.AD.2.SG+PRF+2+SG
desconsertaste-vos	desconsertar+V.vós.AD.2.PL+PRF+2+SG
desconsertas-vos	desconsertar+V.vós.AD.2.PL+PRS+2+SG
desconserta-te	desconsertar+V.tu.AD.2.SG+PRS+3+SG
desconsertava-a	desconsertar+V.ele.ACC.3.F.SG+IMPF+1+SG
desconsertava-a	desconsertar+V.ele.ACC.3.F.SG+IMPF+3+SG
desconsertava-as	desconsertar+V.ele.ACC.3.F.PL+IMPF+1+SG
desconsertava-as	desconsertar+V.ele.ACC.3.F.PL+IMPF+3+SG
desconsertava-la	desconsertar+V.ele.ACC.3.F.SG+IMPF+2+SG
desconsertava-las	desconsertar+V.ele.ACC.3.F.PL+IMPF+2+SG
desconsertava-lhe	desconsertar+V.ele.DAT.3.SG+IMPF+1+SG
desconsertava-lhe	desconsertar+V.ele.DAT.3.SG+IMPF+3+SG
desconsertava-lhes	desconsertar+V.ele.DAT.3.PL+IMPF+1+SG
desconsertava-lhes	desconsertar+V.ele.DAT.3.PL+IMPF+3+SG
desconsertava-lo	desconsertar+V.ele.ACC.3.M.SG+IMPF+2+SG
desconsertava-los	desconsertar+V.ele.ACC.3.M.PL+IMPF+2+SG
desconsertava-me	desconsertar+V.eu.AD.1.SG+IMPF+1+SG
desconsertava-me	desconsertar+V.eu.AD.1.SG+IMPF+3+SG
desconsertavam-lhe	desconsertar+V.ele.DAT.3.SG+IMPF+3+PL
desconsertavam-lhes	desconsertar+V.ele.DAT.3.PL+IMPF+3+PL
desconsertavam-me	desconsertar+V.eu.AD.1.SG+IMPF+3+PL
desconsertavam-na	desconsertar+V.ele.ACC.3.F.SG+IMPF+3+PL
desconsertavam-nas	desconsertar+V.ele.ACC.3.F.PL+IMPF+3+PL
desconsertavam-no	desconsertar+V.ele.ACC.3.M.SG+IMPF+3+PL
desconsertavam-nos	desconsertar+V.ele.ACC.3.M.PL+IMPF+3+PL
desconsertavam-nos	desconsertar+V.nós.AD.1.PL+IMPF+3+PL
desconsertávamo-la	desconsertar+V.ele.ACC.3.F.SG+IMPF+1+PL
desconsertávamo-las	desconsertar+V.ele.ACC.3.F.PL+IMPF+1+PL
desconsertávamo-lo	desconsertar+V.ele.ACC.3.M.SG+IMPF+1+PL
desconsertávamo-los	desconsertar+V.ele.ACC.3.M.PL+IMPF+1+PL
desconsertávamo-nos	desconsertar+nós.AD.1.PL+IMPF+1+PL
desconsertávamos-lhe	desconsertar+V.ele.DAT.3.SG+IMPF+1+PL
desconsertávamos-lhes	desconsertar+V.ele.DAT.3.PL+IMPF+1+PL
desconsertávamos-me	desconsertar+V.eu.AD.1.SG+IMPF+1+PL
desconsertávamos-te	desconsertar+V.tu.AD.2.SG+IMPF+1+PL
desconsertávamos-vos	desconsertar+V.vós.AD.2.PL+IMPF+1+PL
desconsertavam-se	desconsertar+V.ele.REFL+IMPF+3+PL
desconsertavam-te	desconsertar+V.tu.AD.2.SG+IMPF+3+PL
desconsertavam-vos	desconsertar+V.vós.AD.2.PL+IMPF+3+PL
desconsertava-nos	desconsertar+nós.AD.1.PL+IMPF+1+SG
desconsertava-nos	desconsertar+nós.AD.1.PL+IMPF+2+SG
desconsertava-nos	desconsertar+nós.AD.1.PL+IMPF+3+SG
desconsertava-o	desconsertar+V.ele.ACC.3.M.SG+IMPF+1+SG
desconsertava-o	desconsertar+V.ele.ACC.3.M.SG+IMPF+3+SG
desconsertava-os	desconsertar+V.ele.ACC.3.M.PL+IMPF+1+SG
desconsertava-os	desconsertar+V.ele.ACC.3.M.PL+IMPF+3+SG
desconsertava-se	desconsertar+V.ele.REFL+IMPF+1+SG
desconsertava-se	desconsertar+V.ele.REFL+IMPF+3+SG
desconsertavas-lhe	desconsertar+V.ele.DAT.3.SG+IMPF+2+SG
desconsertavas-lhes	desconsertar+V.ele.DAT.3.PL+IMPF+2+SG
desconsertavas-me	desconsertar+V.eu.AD.1.SG+IMPF+2+SG
desconsertavas-te	desconsertar+V.tu.AD.2.SG+IMPF+2+SG
desconsertavas-vos	desconsertar+V.vós.AD.2.PL+IMPF+2+SG
desconsertava-te	desconsertar+V.tu.AD.2.SG+IMPF+1+SG
desconsertava-te	desconsertar+V.tu.AD.2.SG+IMPF+3+SG
desconsertava-vos	desconsertar+V.vós.AD.2.PL+IMPF+1+SG
desconsertava-vos	desconsertar+V.vós.AD.2.PL+IMPF+3+SG
desconsertávei-la	desconsertar+V.ele.ACC.3.F.SG+IMPF+2+PL
desconsertávei-las	desconsertar+V.ele.ACC.3.F.PL+IMPF+2+PL
desconsertávei-lo	desconsertar+V.ele.ACC.3.M.SG+IMPF+2+PL
desconsertávei-los	desconsertar+V.ele.ACC.3.M.PL+IMPF+2+PL
desconsertávei-nos	desconsertar+nós.AD.1.PL+IMPF+2+PL
desconsertáveis-lhe	desconsertar+V.ele.DAT.3.SG+IMPF+2+PL
desconsertáveis-lhes	desconsertar+V.ele.DAT.3.PL+IMPF+2+PL
desconsertáveis-me	desconsertar+V.eu.AD.1.SG+IMPF+2+PL
desconsertáveis-te	desconsertar+V.tu.AD.2.SG+IMPF+2+PL
desconsertáveis-vos	desconsertar+V.vós.AD.2.PL+IMPF+2+PL
desconserta-vos	desconsertar+V.vós.AD.2.PL+PRS+3+SG
desconserte-a	desconsertar+V.ele.ACC.3.F.SG+IMP+3+SG
desconserte-as	desconsertar+V.ele.ACC.3.F.PL+IMP+3+SG
desconsertei-a	desconsertar+V.ele.ACC.3.F.SG+PRF+1+SG
desconsertei-as	desconsertar+V.ele.ACC.3.F.PL+PRF+1+SG
desconsertei-lhe	desconsertar+V.ele.DAT.3.SG+PRF+1+SG
desconsertei-lhes	desconsertar+V.ele.DAT.3.PL+PRF+1+SG
desconsertei-me	desconsertar+V.eu.AD.1.SG+PRF+1+SG
desconsertei-nos	desconsertar+nós.AD.1.PL+PRF+1+SG
desconsertei-o	desconsertar+V.ele.ACC.3.M.SG+PRF+1+SG
desconsertei-os	desconsertar+V.ele.ACC.3.M.PL+PRF+1+SG
desconsertei-te	desconsertar+V.tu.AD.2.SG+PRF+1+SG
desconsertei-vos	desconsertar+V.vós.AD.2.PL+PRF+1+SG
desconserte-lhe	desconsertar+V.ele.DAT.3.SG+IMP+3+SG
desconserte-lhes	desconsertar+V.ele.DAT.3.PL+IMP+3+SG
desconserte-me	desconsertar+V.eu.AD.1.SG+IMP+3+SG
desconsertem-lhe	desconsertar+V.ele.DAT.3.SG+IMP+3+PL
desconsertem-lhes	desconsertar+V.ele.DAT.3.PL+IMP+3+PL
desconsertem-me	desconsertar+V.eu.AD.1.SG+IMP+3+PL
desconsertem-na	desconsertar+V.ele.ACC.3.F.SG+IMP+3+PL
desconsertem-nas	desconsertar+V.ele.ACC.3.F.PL+IMP+3+PL
desconsertem-no	desconsertar+V.ele.ACC.3.M.SG+IMP+3+PL
desconsertem-nos	desconsertar+V.ele.ACC.3.M.PL+IMP+3+PL
desconsertem-nos	desconsertar+V.nós.AD.1.PL+IMP+3+PL
desconsertemo-la	desconsertar+V.ele.ACC.3.F.SG+IMP+1+PL
desconsertemo-las	desconsertar+V.ele.ACC.3.F.PL+IMP+1+PL
desconsertemo-lo	desconsertar+V.ele.ACC.3.M.SG+IMP+1+PL
desconsertemo-los	desconsertar+V.ele.ACC.3.M.PL+IMP+1+PL
desconsertemo-nos	desconsertar+nós.AD.1.PL+IMP+1+PL
desconsertemos-lhe	desconsertar+V.ele.DAT.3.SG+IMP+1+PL
desconsertemos-lhes	desconsertar+V.ele.DAT.3.PL+IMP+1+PL
desconsertemos-me	desconsertar+V.eu.AD.1.SG+IMP+1+PL
desconsertemos-te	desconsertar+V.tu.AD.2.SG+IMP+1+PL
desconsertemos-vos	desconsertar+V.vós.AD.2.PL+IMP+1+PL
desconsertem-se	desconsertar+V.ele.REFL+IMP+3+PL
desconsertem-te	desconsertar+V.tu.AD.2.SG+IMP+3+PL
desconsertem-vos	desconsertar+V.vós.AD.2.PL+IMP+3+PL
desconserte-nos	desconsertar+nós.AD.1.PL+IMP+3+SG
desconserte-o	desconsertar+V.ele.ACC.3.M.SG+IMP+3+SG
desconserte-os	desconsertar+V.ele.ACC.3.M.PL+IMP+3+SG
desconserte-se	desconsertar+V.ele.REFL+IMP+3+SG
desconserte-te	desconsertar+V.tu.AD.2.SG+IMP+3+SG
desconserte-vos	desconsertar+V.vós.AD.2.PL+IMP+3+SG
desconserto-a	desconsertar+V.ele.ACC.3.F.SG+PRS+1+SG
desconserto-as	desconsertar+V.ele.ACC.3.F.PL+PRS+1+SG
desconserto-lhe	desconsertar+V.ele.DAT.3.SG+PRS+1+SG
desconserto-lhes	desconsertar+V.ele.DAT.3.PL+PRS+1+SG
desconserto-me	desconsertar+V.eu.AD.1.SG+PRS+1+SG
desconserto-nos	desconsertar+nós.AD.1.PL+PRS+1+SG
desconserto-o	desconsertar+V.ele.ACC.3.M.SG+PRS+1+SG
desconserto-os	desconsertar+V.ele.ACC.3.M.PL+PRS+1+SG
desconserto-te	desconsertar+V.tu.AD.2.SG+PRS+1+SG
desconsertou-a	desconsertar+V.ele.ACC.3.F.SG+PRF+3+SG
desconsertou-as	desconsertar+V.ele.ACC.3.F.PL+PRF+3+SG
desconsertou-lhe	desconsertar+V.ele.DAT.3.SG+PRF+3+SG
desconsertou-lhes	desconsertar+V.ele.DAT.3.PL+PRF+3+SG
desconsertou-me	desconsertar+V.eu.AD.1.SG+PRF+3+SG
desconsertou-nos	desconsertar+nós.AD.1.PL+PRF+3+SG
desconsertou-o	desconsertar+V.ele.ACC.3.M.SG+PRF+3+SG
desconsertou-os	desconsertar+V.ele.ACC.3.M.PL+PRF+3+SG
desconsertou-se	desconsertar+V.ele.REFL+PRF+3+SG
desconsertou-te	desconsertar+V.tu.AD.2.SG+PRF+3+SG
desconsertou-vos	desconsertar+V.vós.AD.2.PL+PRF+3+SG
desconserto-vos	desconsertar+V.vós.AD.2.PL+PRS+1+SG
desconsidera-a	desconsiderar+V.ele.ACC.3.F.SG+PRS+3+SG
desconsidera-as	desconsiderar+V.ele.ACC.3.F.PL+PRS+3+SG
desconsiderai-la	desconsiderar+V.ele.ACC.3.F.SG+PRS+2+PL
desconsiderai-las	desconsiderar+V.ele.ACC.3.F.PL+PRS+2+PL
desconsiderai-lo	desconsiderar+V.ele.ACC.3.M.SG+PRS+2+PL
desconsiderai-los	desconsiderar+V.ele.ACC.3.M.PL+PRS+2+PL
desconsiderai-nos	desconsiderar+nós.AD.1.PL+PRS+2+PL
desconsiderais-lhe	desconsiderar+V.ele.DAT.3.SG+PRS+2+PL
desconsiderais-lhes	desconsiderar+V.ele.DAT.3.PL+PRS+2+PL
desconsiderais-me	desconsiderar+V.eu.AD.1.SG+PRS+2+PL
desconsiderais-te	desconsiderar+V.tu.AD.2.SG+PRS+2+PL
desconsiderais-vos	desconsiderar+V.vós.AD.2.PL+PRS+2+PL
desconsiderá-la-á	desconsiderar+V.ele.ACC.3.F.SG+FUT+3+SG
desconsiderá-la-ão	desconsiderar+V.ele.ACC.3.F.SG+FUT+3+PL
desconsiderá-la-ás	desconsiderar+V.ele.ACC.3.F.SG+FUT+2+SG
desconsiderá-la	desconsiderar+V.ele.ACC.3.F.SG+INF+1+SG
desconsiderá-la	desconsiderar+V.ele.ACC.3.F.SG+INF+3+SG
desconsidera-la	desconsiderar+V.ele.ACC.3.F.SG+PRS+2+SG
desconsiderá-la	desconsiderar+V.ele.ACC.3.F.SG+SBJF+1+SG
desconsiderá-la	desconsiderar+V.ele.ACC.3.F.SG+SBJF+3+SG
desconsiderá-la-ei	desconsiderar+V.ele.ACC.3.F.SG+FUT+1+SG
desconsiderá-la-eis	desconsiderar+V.ele.ACC.3.F.SG+FUT+2+PL
desconsiderá-la-emos	desconsiderar+V.ele.ACC.3.F.SG+FUT+1+PL
desconsiderá-la-ia	desconsiderar+V.ele.ACC.3.F.SG+COND+1+SG
desconsiderá-la-ia	desconsiderar+V.ele.ACC.3.F.SG+COND+3+SG
desconsiderá-la-iam	desconsiderar+V.ele.ACC.3.F.SG+COND+3+PL
desconsiderá-la-íamos	desconsiderar+V.ele.ACC.3.F.SG+COND+1+PL
desconsiderá-la-ias	desconsiderar+V.ele.ACC.3.F.SG+COND+2+SG
desconsiderá-la-íeis	desconsiderar+V.ele.ACC.3.F.SG+COND+2+PL
desconsiderá-las-á	desconsiderar+V.ele.ACC.3.F.PL+FUT+3+SG
desconsiderá-las-ão	desconsiderar+V.ele.ACC.3.F.PL+FUT+3+PL
desconsiderá-las-ás	desconsiderar+V.ele.ACC.3.F.PL+FUT+2+SG
desconsiderá-las	desconsiderar+V.ele.ACC.3.F.PL+INF+1+SG
desconsiderá-las	desconsiderar+V.ele.ACC.3.F.PL+INF+3+SG
desconsidera-las	desconsiderar+V.ele.ACC.3.F.PL+PRS+2+SG
desconsiderá-las	desconsiderar+V.ele.ACC.3.F.PL+SBJF+1+SG
desconsiderá-las	desconsiderar+V.ele.ACC.3.F.PL+SBJF+3+SG
desconsiderá-las-ei	desconsiderar+V.ele.ACC.3.F.PL+FUT+1+SG
desconsiderá-las-eis	desconsiderar+V.ele.ACC.3.F.PL+FUT+2+PL
desconsiderá-las-emos	desconsiderar+V.ele.ACC.3.F.PL+FUT+1+PL
desconsiderá-las-ia	desconsiderar+V.ele.ACC.3.F.PL+COND+1+SG
desconsiderá-las-ia	desconsiderar+V.ele.ACC.3.F.PL+COND+3+SG
desconsiderá-las-iam	desconsiderar+V.ele.ACC.3.F.PL+COND+3+PL
desconsiderá-las-íamos	desconsiderar+V.ele.ACC.3.F.PL+COND+1+PL
desconsiderá-las-ias	desconsiderar+V.ele.ACC.3.F.PL+COND+2+SG
desconsiderá-las-íeis	desconsiderar+V.ele.ACC.3.F.PL+COND+2+PL
desconsidera-lhe	desconsiderar+V.ele.DAT.3.SG+PRS+3+SG
desconsidera-lhes	desconsiderar+V.ele.DAT.3.PL+PRS+3+SG
desconsiderá-lo-á	desconsiderar+V.ele.ACC.3.M.SG+FUT+3+SG
desconsiderá-lo-ão	desconsiderar+V.ele.ACC.3.M.SG+FUT+3+PL
desconsiderá-lo-ás	desconsiderar+V.ele.ACC.3.M.SG+FUT+2+SG
desconsiderá-lo	desconsiderar+V.ele.ACC.3.M.SG+INF+1+SG
desconsiderá-lo	desconsiderar+V.ele.ACC.3.M.SG+INF+3+SG
desconsidera-lo	desconsiderar+V.ele.ACC.3.M.SG+PRS+2+SG
desconsiderá-lo	desconsiderar+V.ele.ACC.3.M.SG+SBJF+1+SG
desconsiderá-lo	desconsiderar+V.ele.ACC.3.M.SG+SBJF+3+SG
desconsiderá-lo-ei	desconsiderar+V.ele.ACC.3.M.SG+FUT+1+SG
desconsiderá-lo-eis	desconsiderar+V.ele.ACC.3.M.SG+FUT+2+PL
desconsiderá-lo-emos	desconsiderar+V.ele.ACC.3.M.SG+FUT+1+PL
desconsiderá-lo-ia	desconsiderar+V.ele.ACC.3.M.SG+COND+1+SG
desconsiderá-lo-ia	desconsiderar+V.ele.ACC.3.M.SG+COND+3+SG
desconsiderá-lo-iam	desconsiderar+V.ele.ACC.3.M.SG+COND+3+PL
desconsiderá-lo-íamos	desconsiderar+V.ele.ACC.3.M.SG+COND+1+PL
desconsiderá-lo-ias	desconsiderar+V.ele.ACC.3.M.SG+COND+2+SG
desconsiderá-lo-íeis	desconsiderar+V.ele.ACC.3.M.SG+COND+2+PL
desconsiderá-los-á	desconsiderar+V.ele.ACC.3.M.PL+FUT+3+SG
desconsiderá-los-ão	desconsiderar+V.ele.ACC.3.M.PL+FUT+3+PL
desconsiderá-los-ás	desconsiderar+V.ele.ACC.3.M.PL+FUT+2+SG
desconsiderá-los	desconsiderar+V.ele.ACC.3.M.PL+INF+1+SG
desconsiderá-los	desconsiderar+V.ele.ACC.3.M.PL+INF+3+SG
desconsidera-los	desconsiderar+V.ele.ACC.3.M.PL+PRS+2+SG
desconsiderá-los	desconsiderar+V.ele.ACC.3.M.PL+SBJF+1+SG
desconsiderá-los	desconsiderar+V.ele.ACC.3.M.PL+SBJF+3+SG
desconsiderá-los-ei	desconsiderar+V.ele.ACC.3.M.PL+FUT+1+SG
desconsiderá-los-eis	desconsiderar+V.ele.ACC.3.M.PL+FUT+2+PL
desconsiderá-los-emos	desconsiderar+V.ele.ACC.3.M.PL+FUT+1+PL
desconsiderá-los-ia	desconsiderar+V.ele.ACC.3.M.PL+COND+1+SG
desconsiderá-los-ia	desconsiderar+V.ele.ACC.3.M.PL+COND+3+SG
desconsiderá-los-iam	desconsiderar+V.ele.ACC.3.M.PL+COND+3+PL
desconsiderá-los-íamos	desconsiderar+V.ele.ACC.3.M.PL+COND+1+PL
desconsiderá-los-ias	desconsiderar+V.ele.ACC.3.M.PL+COND+2+SG
desconsiderá-los-íeis	desconsiderar+V.ele.ACC.3.M.PL+COND+2+PL
desconsidera-me	desconsiderar+V.eu.AD.1.SG+PRS+3+SG
desconsideram-lhe	desconsiderar+V.ele.DAT.3.SG+PRS+3+PL
desconsideram-lhes	desconsiderar+V.ele.DAT.3.PL+PRS+3+PL
desconsideram-me	desconsiderar+V.eu.AD.1.SG+PRS+3+PL
desconsideram-na	desconsiderar+V.ele.ACC.3.F.SG+PRS+3+PL
desconsideram-nas	desconsiderar+V.ele.ACC.3.F.PL+PRS+3+PL
desconsideram-no	desconsiderar+V.ele.ACC.3.M.SG+PRS+3+PL
desconsideram-nos	desconsiderar+V.ele.ACC.3.M.PL+PRS+3+PL
desconsideram-nos	desconsiderar+V.nós.AD.1.PL+PRS+3+PL
desconsideramo-la	desconsiderar+V.ele.ACC.3.F.SG+PRF+1+PL
desconsideramo-la	desconsiderar+V.ele.ACC.3.F.SG+PRS+1+PL
desconsideramo-las	desconsiderar+V.ele.ACC.3.F.PL+PRF+1+PL
desconsideramo-las	desconsiderar+V.ele.ACC.3.F.PL+PRS+1+PL
desconsideramo-lo	desconsiderar+V.ele.ACC.3.M.SG+PRF+1+PL
desconsideramo-lo	desconsiderar+V.ele.ACC.3.M.SG+PRS+1+PL
desconsideramo-los	desconsiderar+V.ele.ACC.3.M.PL+PRF+1+PL
desconsideramo-los	desconsiderar+V.ele.ACC.3.M.PL+PRS+1+PL
desconsideramo-nos	desconsiderar+nós.AD.1.PL+PRF+1+PL
desconsideramo-nos	desconsiderar+nós.AD.1.PL+PRS+1+PL
desconsideramos-lhe	desconsiderar+V.ele.DAT.3.SG+PRF+1+PL
desconsideramos-lhe	desconsiderar+V.ele.DAT.3.SG+PRS+1+PL
desconsideramos-lhes	desconsiderar+V.ele.DAT.3.PL+PRF+1+PL
desconsideramos-lhes	desconsiderar+V.ele.DAT.3.PL+PRS+1+PL
desconsideramos-me	desconsiderar+V.eu.AD.1.SG+PRF+1+PL
desconsideramos-me	desconsiderar+V.eu.AD.1.SG+PRS+1+PL
desconsideramos-te	desconsiderar+V.tu.AD.2.SG+PRF+1+PL
desconsideramos-te	desconsiderar+V.tu.AD.2.SG+PRS+1+PL
desconsideramos-vos	desconsiderar+V.vós.AD.2.PL+PRF+1+PL
desconsideramos-vos	desconsiderar+V.vós.AD.2.PL+PRS+1+PL
desconsideram-se	desconsiderar+V.ele.REFL+PRS+3+PL
desconsideram-te	desconsiderar+V.tu.AD.2.SG+PRS+3+PL
desconsideram-vos	desconsiderar+V.vós.AD.2.PL+PRS+3+PL
desconsiderando-a	desconsiderar+V.ele.ACC.3.F.SG+GRD
desconsiderando-as	desconsiderar+V.ele.ACC.3.F.PL+GRD
desconsiderando-lhe	desconsiderar+V.ele.DAT.3.SG+GRD
desconsiderando-lhes	desconsiderar+V.ele.DAT.3.PL+GRD
desconsiderando-me	desconsiderar+V.eu.AD.1.SG+GRD
desconsiderando-nos	desconsiderar+nós.AD.1.PL+GRD
desconsiderando-o	desconsiderar+V.ele.ACC.3.M.SG+GRD
desconsiderando-os	desconsiderar+V.ele.ACC.3.M.PL+GRD
desconsiderando-se	desconsiderar+V.ele.REFL+GRD
desconsiderando-te	desconsiderar+V.tu.AD.2.SG+GRD
desconsiderando-vos	desconsiderar+V.vós.AD.2.PL+GRD
desconsidera-nos	desconsiderar+nós.AD.1.PL+PRS+2+SG
desconsidera-nos	desconsiderar+nós.AD.1.PL+PRS+3+SG
desconsidera-o	desconsiderar+V.ele.ACC.3.M.SG+PRS+3+SG
desconsidera-os	desconsiderar+V.ele.ACC.3.M.PL+PRS+3+SG
desconsiderara-a	desconsiderar+V.ele.ACC.3.F.SG+PQP+1+SG
desconsiderara-a	desconsiderar+V.ele.ACC.3.F.SG+PQP+3+SG
desconsiderara-as	desconsiderar+V.ele.ACC.3.F.PL+PQP+1+SG
desconsiderara-as	desconsiderar+V.ele.ACC.3.F.PL+PQP+3+SG
desconsiderara-la	desconsiderar+V.ele.ACC.3.F.SG+PQP+2+SG
desconsiderara-las	desconsiderar+V.ele.ACC.3.F.PL+PQP+2+SG
desconsiderara-lhe	desconsiderar+V.ele.DAT.3.SG+PQP+1+SG
desconsiderara-lhe	desconsiderar+V.ele.DAT.3.SG+PQP+3+SG
desconsiderara-lhes	desconsiderar+V.ele.DAT.3.PL+PQP+1+SG
desconsiderara-lhes	desconsiderar+V.ele.DAT.3.PL+PQP+3+SG
desconsiderara-lo	desconsiderar+V.ele.ACC.3.M.SG+PQP+2+SG
desconsiderara-los	desconsiderar+V.ele.ACC.3.M.PL+PQP+2+SG
desconsiderara-me	desconsiderar+V.eu.AD.1.SG+PQP+1+SG
desconsiderara-me	desconsiderar+V.eu.AD.1.SG+PQP+3+SG
desconsideraram-lhe	desconsiderar+V.ele.DAT.3.SG+PQP+3+PL
desconsideraram-lhe	desconsiderar+V.ele.DAT.3.SG+PRF+3+PL
desconsideraram-lhes	desconsiderar+V.ele.DAT.3.PL+PQP+3+PL
desconsideraram-lhes	desconsiderar+V.ele.DAT.3.PL+PRF+3+PL
desconsideraram-me	desconsiderar+V.eu.AD.1.SG+PQP+3+PL
desconsideraram-me	desconsiderar+V.eu.AD.1.SG+PRF+3+PL
desconsideraram-na	desconsiderar+V.ele.ACC.3.F.SG+PQP+3+PL
desconsideraram-na	desconsiderar+V.ele.ACC.3.F.SG+PRF+3+PL
desconsideraram-nas	desconsiderar+V.ele.ACC.3.F.PL+PQP+3+PL
desconsideraram-nas	desconsiderar+V.ele.ACC.3.F.PL+PRF+3+PL
desconsideraram-no	desconsiderar+V.ele.ACC.3.M.SG+PQP+3+PL
desconsideraram-no	desconsiderar+V.ele.ACC.3.M.SG+PRF+3+PL
desconsideraram-nos	desconsiderar+V.ele.ACC.3.M.PL+PQP+3+PL
desconsideraram-nos	desconsiderar+V.ele.ACC.3.M.PL+PRF+3+PL
desconsideraram-nos	desconsiderar+V.nós.AD.1.PL+PQP+3+PL
desconsideraram-nos	desconsiderar+V.nós.AD.1.PL+PRF+3+PL
desconsideráramo-la	desconsiderar+V.ele.ACC.3.F.SG+PQP+1+PL
desconsideráramo-las	desconsiderar+V.ele.ACC.3.F.PL+PQP+1+PL
desconsideráramo-lo	desconsiderar+V.ele.ACC.3.M.SG+PQP+1+PL
desconsideráramo-los	desconsiderar+V.ele.ACC.3.M.PL+PQP+1+PL
desconsideráramo-nos	desconsiderar+nós.AD.1.PL+PQP+1+PL
desconsideráramos-lhe	desconsiderar+V.ele.DAT.3.SG+PQP+1+PL
desconsideráramos-lhes	desconsiderar+V.ele.DAT.3.PL+PQP+1+PL
desconsideráramos-me	desconsiderar+V.eu.AD.1.SG+PQP+1+PL
desconsideráramos-te	desconsiderar+V.tu.AD.2.SG+PQP+1+PL
desconsideráramos-vos	desconsiderar+V.vós.AD.2.PL+PQP+1+PL
desconsideraram-se	desconsiderar+V.ele.REFL+PQP+3+PL
desconsideraram-se	desconsiderar+V.ele.REFL+PRF+3+PL
desconsideraram-te	desconsiderar+V.tu.AD.2.SG+PQP+3+PL
desconsideraram-te	desconsiderar+V.tu.AD.2.SG+PRF+3+PL
desconsideraram-vos	desconsiderar+V.vós.AD.2.PL+PQP+3+PL
desconsideraram-vos	desconsiderar+V.vós.AD.2.PL+PRF+3+PL
desconsiderara-nos	desconsiderar+nós.AD.1.PL+PQP+1+SG
desconsiderara-nos	desconsiderar+nós.AD.1.PL+PQP+2+SG
desconsiderara-nos	desconsiderar+nós.AD.1.PL+PQP+3+SG
desconsiderara-o	desconsiderar+V.ele.ACC.3.M.SG+PQP+1+SG
desconsiderara-o	desconsiderar+V.ele.ACC.3.M.SG+PQP+3+SG
desconsiderara-os	desconsiderar+V.ele.ACC.3.M.PL+PQP+1+SG
desconsiderara-os	desconsiderar+V.ele.ACC.3.M.PL+PQP+3+SG
desconsiderara-se	desconsiderar+V.ele.REFL+PQP+1+SG
desconsiderara-se	desconsiderar+V.ele.REFL+PQP+3+SG
desconsideraras-lhe	desconsiderar+V.ele.DAT.3.SG+PQP+2+SG
desconsideraras-lhes	desconsiderar+V.ele.DAT.3.PL+PQP+2+SG
desconsideraras-me	desconsiderar+V.eu.AD.1.SG+PQP+2+SG
desconsideraras-te	desconsiderar+V.tu.AD.2.SG+PQP+2+SG
desconsideraras-vos	desconsiderar+V.vós.AD.2.PL+PQP+2+SG
desconsiderara-te	desconsiderar+V.tu.AD.2.SG+PQP+1+SG
desconsiderara-te	desconsiderar+V.tu.AD.2.SG+PQP+3+SG
desconsiderara-vos	desconsiderar+V.vós.AD.2.PL+PQP+1+SG
desconsiderara-vos	desconsiderar+V.vós.AD.2.PL+PQP+3+SG
desconsiderarde-la	desconsiderar+V.ele.ACC.3.F.SG+INF+2+PL
desconsiderarde-la	desconsiderar+V.ele.ACC.3.F.SG+SBJF+2+PL
desconsiderarde-las	desconsiderar+V.ele.ACC.3.F.PL+INF+2+PL
desconsiderarde-las	desconsiderar+V.ele.ACC.3.F.PL+SBJF+2+PL
desconsiderarde-lo	desconsiderar+V.ele.ACC.3.M.SG+INF+2+PL
desconsiderarde-lo	desconsiderar+V.ele.ACC.3.M.SG+SBJF+2+PL
desconsiderarde-los	desconsiderar+V.ele.ACC.3.M.PL+INF+2+PL
desconsiderarde-los	desconsiderar+V.ele.ACC.3.M.PL+SBJF+2+PL
desconsiderarde-nos	desconsiderar+nós.AD.1.PL+INF+2+PL
desconsiderarde-nos	desconsiderar+nós.AD.1.PL+SBJF+2+PL
desconsiderardes-lhe	desconsiderar+V.ele.DAT.3.SG+INF+2+PL
desconsiderardes-lhe	desconsiderar+V.ele.DAT.3.SG+SBJF+2+PL
desconsiderardes-lhes	desconsiderar+V.ele.DAT.3.PL+INF+2+PL
desconsiderardes-lhes	desconsiderar+V.ele.DAT.3.PL+SBJF+2+PL
desconsiderardes-me	desconsiderar+V.eu.AD.1.SG+INF+2+PL
desconsiderardes-me	desconsiderar+V.eu.AD.1.SG+SBJF+2+PL
desconsiderardes-te	desconsiderar+V.tu.AD.2.SG+INF+2+PL
desconsiderardes-te	desconsiderar+V.tu.AD.2.SG+SBJF+2+PL
desconsiderardes-vos	desconsiderar+V.vós.AD.2.PL+INF+2+PL
desconsiderardes-vos	desconsiderar+V.vós.AD.2.PL+SBJF+2+PL
desconsiderárei-la	desconsiderar+V.ele.ACC.3.F.SG+PQP+2+PL
desconsiderárei-las	desconsiderar+V.ele.ACC.3.F.PL+PQP+2+PL
desconsiderárei-lo	desconsiderar+V.ele.ACC.3.M.SG+PQP+2+PL
desconsiderárei-los	desconsiderar+V.ele.ACC.3.M.PL+PQP+2+PL
desconsiderárei-nos	desconsiderar+nós.AD.1.PL+PQP+2+PL
desconsideráreis-lhe	desconsiderar+V.ele.DAT.3.SG+PQP+2+PL
desconsideráreis-lhes	desconsiderar+V.ele.DAT.3.PL+PQP+2+PL
desconsideráreis-me	desconsiderar+V.eu.AD.1.SG+PQP+2+PL
desconsideráreis-te	desconsiderar+V.tu.AD.2.SG+PQP+2+PL
desconsideráreis-vos	desconsiderar+V.vós.AD.2.PL+PQP+2+PL
desconsiderare-la	desconsiderar+V.ele.ACC.3.F.SG+INF+2+SG
desconsiderare-la	desconsiderar+V.ele.ACC.3.F.SG+SBJF+2+SG
desconsiderare-las	desconsiderar+V.ele.ACC.3.F.PL+INF+2+SG
desconsiderare-las	desconsiderar+V.ele.ACC.3.F.PL+SBJF+2+SG
desconsiderare-lo	desconsiderar+V.ele.ACC.3.M.SG+INF+2+SG
desconsiderare-lo	desconsiderar+V.ele.ACC.3.M.SG+SBJF+2+SG
desconsiderare-los	desconsiderar+V.ele.ACC.3.M.PL+INF+2+SG
desconsiderare-los	desconsiderar+V.ele.ACC.3.M.PL+SBJF+2+SG
desconsiderarem-lhe	desconsiderar+V.ele.DAT.3.SG+INF+3+PL
desconsiderarem-lhe	desconsiderar+V.ele.DAT.3.SG+SBJF+3+PL
desconsiderarem-lhes	desconsiderar+V.ele.DAT.3.PL+INF+3+PL
desconsiderarem-lhes	desconsiderar+V.ele.DAT.3.PL+SBJF+3+PL
desconsiderarem-me	desconsiderar+V.eu.AD.1.SG+INF+3+PL
desconsiderarem-me	desconsiderar+V.eu.AD.1.SG+SBJF+3+PL
desconsiderarem-na	desconsiderar+V.ele.ACC.3.F.SG+INF+3+PL
desconsiderarem-na	desconsiderar+V.ele.ACC.3.F.SG+SBJF+3+PL
desconsiderarem-nas	desconsiderar+V.ele.ACC.3.F.PL+INF+3+PL
desconsiderarem-nas	desconsiderar+V.ele.ACC.3.F.PL+SBJF+3+PL
desconsiderarem-no	desconsiderar+V.ele.ACC.3.M.SG+INF+3+PL
desconsiderarem-no	desconsiderar+V.ele.ACC.3.M.SG+SBJF+3+PL
desconsiderarem-nos	desconsiderar+V.ele.ACC.3.M.PL+INF+3+PL
desconsiderarem-nos	desconsiderar+V.ele.ACC.3.M.PL+SBJF+3+PL
desconsiderarem-nos	desconsiderar+V.nós.AD.1.PL+INF+3+PL
desconsiderarem-nos	desconsiderar+V.nós.AD.1.PL+SBJF+3+PL
desconsiderarem-se	desconsiderar+V.ele.REFL+INF+3+PL
desconsiderarem-se	desconsiderar+V.ele.REFL+SBJF+3+PL
desconsiderarem-te	desconsiderar+V.tu.AD.2.SG+INF+3+PL
desconsiderarem-te	desconsiderar+V.tu.AD.2.SG+SBJF+3+PL
desconsiderarem-vos	desconsiderar+V.vós.AD.2.PL+INF+3+PL
desconsiderarem-vos	desconsiderar+V.vós.AD.2.PL+SBJF+3+PL
desconsiderare-nos	desconsiderar+nós.AD.1.PL+INF+2+SG
desconsiderare-nos	desconsiderar+nós.AD.1.PL+SBJF+2+SG
desconsiderares-lhe	desconsiderar+V.ele.DAT.3.SG+INF+2+SG
desconsiderares-lhe	desconsiderar+V.ele.DAT.3.SG+SBJF+2+SG
desconsiderares-lhes	desconsiderar+V.ele.DAT.3.PL+INF+2+SG
desconsiderares-lhes	desconsiderar+V.ele.DAT.3.PL+SBJF+2+SG
desconsiderares-me	desconsiderar+V.eu.AD.1.SG+INF+2+SG
desconsiderares-me	desconsiderar+V.eu.AD.1.SG+SBJF+2+SG
desconsiderares-te	desconsiderar+V.tu.AD.2.SG+INF+2+SG
desconsiderares-te	desconsiderar+V.tu.AD.2.SG+SBJF+2+SG
desconsiderares-vos	desconsiderar+V.vós.AD.2.PL+INF+2+SG
desconsiderares-vos	desconsiderar+V.vós.AD.2.PL+SBJF+2+SG
desconsiderar-lhe-á	desconsiderar+V.ele.DAT.3.SG+FUT+3+SG
desconsiderar-lhe-ão	desconsiderar+V.ele.DAT.3.SG+FUT+3+PL
desconsiderar-lhe-ás	desconsiderar+V.ele.DAT.3.SG+FUT+2+SG
desconsiderar-lhe	desconsiderar+V.ele.DAT.3.SG+INF
desconsiderar-lhe	desconsiderar+V.ele.DAT.3.SG+INF+1+SG
desconsiderar-lhe	desconsiderar+V.ele.DAT.3.SG+INF+3+SG
desconsiderar-lhe	desconsiderar+V.ele.DAT.3.SG+SBJF+1+SG
desconsiderar-lhe	desconsiderar+V.ele.DAT.3.SG+SBJF+3+SG
desconsiderar-lhe-ei	desconsiderar+V.ele.DAT.3.SG+FUT+1+SG
desconsiderar-lhe-eis	desconsiderar+V.ele.DAT.3.SG+FUT+2+PL
desconsiderar-lhe-emos	desconsiderar+V.ele.DAT.3.SG+FUT+1+PL
desconsiderar-lhe-ia	desconsiderar+V.ele.DAT.3.SG+COND+1+SG
desconsiderar-lhe-ia	desconsiderar+V.ele.DAT.3.SG+COND+3+SG
desconsiderar-lhe-iam	desconsiderar+V.ele.DAT.3.SG+COND+3+PL
desconsiderar-lhe-íamos	desconsiderar+V.ele.DAT.3.SG+COND+1+PL
desconsiderar-lhe-ias	desconsiderar+V.ele.DAT.3.SG+COND+2+SG
desconsiderar-lhe-íeis	desconsiderar+V.ele.DAT.3.SG+COND+2+PL
desconsiderar-lhes-á	desconsiderar+V.ele.DAT.3.PL+FUT+3+SG
desconsiderar-lhes-ão	desconsiderar+V.ele.DAT.3.PL+FUT+3+PL
desconsiderar-lhes-ás	desconsiderar+V.ele.DAT.3.PL+FUT+2+SG
desconsiderar-lhes	desconsiderar+V.ele.DAT.3.PL+INF
desconsiderar-lhes	desconsiderar+V.ele.DAT.3.PL+INF+1+SG
desconsiderar-lhes	desconsiderar+V.ele.DAT.3.PL+INF+3+SG
desconsiderar-lhes	desconsiderar+V.ele.DAT.3.PL+SBJF+1+SG
desconsiderar-lhes	desconsiderar+V.ele.DAT.3.PL+SBJF+3+SG
desconsiderar-lhes-ei	desconsiderar+V.ele.DAT.3.PL+FUT+1+SG
desconsiderar-lhes-eis	desconsiderar+V.ele.DAT.3.PL+FUT+2+PL
desconsiderar-lhes-emos	desconsiderar+V.ele.DAT.3.PL+FUT+1+PL
desconsiderar-lhes-ia	desconsiderar+V.ele.DAT.3.PL+COND+1+SG
desconsiderar-lhes-ia	desconsiderar+V.ele.DAT.3.PL+COND+3+SG
desconsiderar-lhes-iam	desconsiderar+V.ele.DAT.3.PL+COND+3+PL
desconsiderar-lhes-íamos	desconsiderar+V.ele.DAT.3.PL+COND+1+PL
desconsiderar-lhes-ias	desconsiderar+V.ele.DAT.3.PL+COND+2+SG
desconsiderar-lhes-íeis	desconsiderar+V.ele.DAT.3.PL+COND+2+PL
desconsiderar-me-á	desconsiderar+V.eu.AD.1.SG+FUT+3+SG
desconsiderar-me-ão	desconsiderar+V.eu.AD.1.SG+FUT+3+PL
desconsiderar-me-ás	desconsiderar+V.eu.AD.1.SG+FUT+2+SG
desconsiderar-me	desconsiderar+V.eu.AD.1.SG+INF
desconsiderar-me	desconsiderar+V.eu.AD.1.SG+INF+1+SG
desconsiderar-me	desconsiderar+V.eu.AD.1.SG+INF+3+SG
desconsiderar-me	desconsiderar+V.eu.AD.1.SG+SBJF+1+SG
desconsiderar-me	desconsiderar+V.eu.AD.1.SG+SBJF+3+SG
desconsiderar-me-ei	desconsiderar+V.eu.AD.1.SG+FUT+1+SG
desconsiderar-me-eis	desconsiderar+V.eu.AD.1.SG+FUT+2+PL
desconsiderar-me-emos	desconsiderar+V.eu.AD.1.SG+FUT+1+PL
desconsiderar-me-ia	desconsiderar+V.eu.AD.1.SG+COND+1+SG
desconsiderar-me-ia	desconsiderar+V.eu.AD.1.SG+COND+3+SG
desconsiderar-me-iam	desconsiderar+V.eu.AD.1.SG+COND+3+PL
desconsiderar-me-íamos	desconsiderar+V.eu.AD.1.SG+COND+1+PL
desconsiderar-me-ias	desconsiderar+V.eu.AD.1.SG+COND+2+SG
desconsiderar-me-íeis	desconsiderar+V.eu.AD.1.SG+COND+2+PL
desconsiderarmo-la	desconsiderar+V.ele.ACC.3.F.SG+INF+1+PL
desconsiderarmo-la	desconsiderar+V.ele.ACC.3.F.SG+SBJF+1+PL
desconsiderarmo-las	desconsiderar+V.ele.ACC.3.F.PL+INF+1+PL
desconsiderarmo-las	desconsiderar+V.ele.ACC.3.F.PL+SBJF+1+PL
desconsiderarmo-lo	desconsiderar+V.ele.ACC.3.M.SG+INF+1+PL
desconsiderarmo-lo	desconsiderar+V.ele.ACC.3.M.SG+SBJF+1+PL
desconsiderarmo-los	desconsiderar+V.ele.ACC.3.M.PL+INF+1+PL
desconsiderarmo-los	desconsiderar+V.ele.ACC.3.M.PL+SBJF+1+PL
desconsiderarmo-nos	desconsiderar+nós.AD.1.PL+INF+1+PL
desconsiderarmo-nos	desconsiderar+nós.AD.1.PL+SBJF+1+PL
desconsiderarmos-lhe	desconsiderar+V.ele.DAT.3.SG+INF+1+PL
desconsiderarmos-lhe	desconsiderar+V.ele.DAT.3.SG+SBJF+1+PL
desconsiderarmos-lhes	desconsiderar+V.ele.DAT.3.PL+INF+1+PL
desconsiderarmos-lhes	desconsiderar+V.ele.DAT.3.PL+SBJF+1+PL
desconsiderarmos-me	desconsiderar+V.eu.AD.1.SG+INF+1+PL
desconsiderarmos-me	desconsiderar+V.eu.AD.1.SG+SBJF+1+PL
desconsiderarmos-te	desconsiderar+V.tu.AD.2.SG+INF+1+PL
desconsiderarmos-te	desconsiderar+V.tu.AD.2.SG+SBJF+1+PL
desconsiderarmos-vos	desconsiderar+V.vós.AD.2.PL+INF+1+PL
desconsiderarmos-vos	desconsiderar+V.vós.AD.2.PL+SBJF+1+PL
desconsiderar-nos-á	desconsiderar+nós.AD.1.PL+FUT+3+SG
desconsiderar-nos-ão	desconsiderar+nós.AD.1.PL+FUT+3+PL
desconsiderar-nos-ás	desconsiderar+nós.AD.1.PL+FUT+2+SG
desconsiderar-nos	desconsiderar+nós.AD.1.PL+INF
desconsiderar-nos	desconsiderar+nós.AD.1.PL+INF+1+SG
desconsiderar-nos	desconsiderar+nós.AD.1.PL+INF+3+SG
desconsiderar-nos	desconsiderar+nós.AD.1.PL+SBJF+1+SG
desconsiderar-nos	desconsiderar+nós.AD.1.PL+SBJF+3+SG
desconsiderar-nos-ei	desconsiderar+nós.AD.1.PL+FUT+1+SG
desconsiderar-nos-eis	desconsiderar+nós.AD.1.PL+FUT+2+PL
desconsiderar-nos-emos	desconsiderar+nós.AD.1.PL+FUT+1+PL
desconsiderar-nos-ia	desconsiderar+nós.AD.1.PL+COND+1+SG
desconsiderar-nos-ia	desconsiderar+nós.AD.1.PL+COND+3+SG
desconsiderar-nos-iam	desconsiderar+nós.AD.1.PL+COND+3+PL
desconsiderar-nos-íamos	desconsiderar+nós.AD.1.PL+COND+1+PL
desconsiderar-nos-ias	desconsiderar+nós.AD.1.PL+COND+2+SG
desconsiderar-nos-íeis	desconsiderar+nós.AD.1.PL+COND+2+PL
desconsiderar-se-á	desconsiderar+V.ele.REFL+FUT+3+SG
desconsiderar-se-ão	desconsiderar+V.ele.REFL+FUT+3+PL
desconsiderar-se	desconsiderar+V.ele.REFL+INF
desconsiderar-se	desconsiderar+V.ele.REFL+INF+3+SG
desconsiderar-se	desconsiderar+V.ele.REFL+SBJF+3+SG
desconsiderar-se-ia	desconsiderar+V.ele.REFL+COND+3+SG
desconsiderar-se-iam	desconsiderar+V.ele.REFL+COND+3+PL
desconsiderar-te-á	desconsiderar+V.tu.AD.2.SG+FUT+3+SG
desconsiderar-te-ão	desconsiderar+V.tu.AD.2.SG+FUT+3+PL
desconsiderar-te-ás	desconsiderar+V.tu.AD.2.SG+FUT+2+SG
desconsiderar-te	desconsiderar+V.tu.AD.2.SG+INF
desconsiderar-te	desconsiderar+V.tu.AD.2.SG+INF+1+SG
desconsiderar-te	desconsiderar+V.tu.AD.2.SG+INF+3+SG
desconsiderar-te	desconsiderar+V.tu.AD.2.SG+SBJF+1+SG
desconsiderar-te	desconsiderar+V.tu.AD.2.SG+SBJF+3+SG
desconsiderar-te-ei	desconsiderar+V.tu.AD.2.SG+FUT+1+SG
desconsiderar-te-eis	desconsiderar+V.tu.AD.2.SG+FUT+2+PL
desconsiderar-te-emos	desconsiderar+V.tu.AD.2.SG+FUT+1+PL
desconsiderar-te-ia	desconsiderar+V.tu.AD.2.SG+COND+1+SG
desconsiderar-te-ia	desconsiderar+V.tu.AD.2.SG+COND+3+SG
desconsiderar-te-iam	desconsiderar+V.tu.AD.2.SG+COND+3+PL
desconsiderar-te-íamos	desconsiderar+V.tu.AD.2.SG+COND+1+PL
desconsiderar-te-ias	desconsiderar+V.tu.AD.2.SG+COND+2+SG
desconsiderar-te-íeis	desconsiderar+V.tu.AD.2.SG+COND+2+PL
desconsiderar-vos-á	desconsiderar+V.vós.AD.2.PL+FUT+3+SG
desconsiderar-vos-ão	desconsiderar+V.vós.AD.2.PL+FUT+3+PL
desconsiderar-vos-ás	desconsiderar+V.vós.AD.2.PL+FUT+2+SG
desconsiderar-vos	desconsiderar+V.vós.AD.2.PL+INF
desconsiderar-vos	desconsiderar+V.vós.AD.2.PL+INF+1+SG
desconsiderar-vos	desconsiderar+V.vós.AD.2.PL+INF+3+SG
desconsiderar-vos	desconsiderar+V.vós.AD.2.PL+SBJF+1+SG
desconsiderar-vos	desconsiderar+V.vós.AD.2.PL+SBJF+3+SG
desconsiderar-vos-ei	desconsiderar+V.vós.AD.2.PL+FUT+1+SG
desconsiderar-vos-eis	desconsiderar+V.vós.AD.2.PL+FUT+2+PL
desconsiderar-vos-emos	desconsiderar+V.vós.AD.2.PL+FUT+1+PL
desconsiderar-vos-ia	desconsiderar+V.vós.AD.2.PL+COND+1+SG
desconsiderar-vos-ia	desconsiderar+V.vós.AD.2.PL+COND+3+SG
desconsiderar-vos-iam	desconsiderar+V.vós.AD.2.PL+COND+3+PL
desconsiderar-vos-íamos	desconsiderar+V.vós.AD.2.PL+COND+1+PL
desconsiderar-vos-ias	desconsiderar+V.vós.AD.2.PL+COND+2+SG
desconsiderar-vos-íeis	desconsiderar+V.vós.AD.2.PL+COND+2+PL
desconsidera-se	desconsiderar+V.ele.REFL+PRS+3+SG
desconsideras-lhe	desconsiderar+V.ele.DAT.3.SG+PRS+2+SG
desconsideras-lhes	desconsiderar+V.ele.DAT.3.PL+PRS+2+SG
desconsideras-me	desconsiderar+V.eu.AD.1.SG+PRS+2+SG
desconsideraste-a	desconsiderar+V.ele.ACC.3.F.SG+PRF+2+SG
desconsideraste-as	desconsiderar+V.ele.ACC.3.F.PL+PRF+2+SG
desconsideras-te	desconsiderar+V.tu.AD.2.SG+PRS+2+SG
desconsideraste-la	desconsiderar+V.ele.ACC.3.F.SG+PRF+2+PL
desconsideraste-las	desconsiderar+V.ele.ACC.3.F.PL+PRF+2+PL
desconsideraste-lhe	desconsiderar+V.ele.DAT.3.SG+PRF+2+SG
desconsideraste-lhes	desconsiderar+V.ele.DAT.3.PL+PRF+2+SG
desconsideraste-lo	desconsiderar+V.ele.ACC.3.M.SG+PRF+2+PL
desconsideraste-los	desconsiderar+V.ele.ACC.3.M.PL+PRF+2+PL
desconsideraste-me	desconsiderar+V.eu.AD.1.SG+PRF+2+SG
desconsideraste-nos	desconsiderar+nós.AD.1.PL+PRF+2+PL
desconsideraste-nos	desconsiderar+nós.AD.1.PL+PRF+2+SG
desconsideraste-o	desconsiderar+V.ele.ACC.3.M.SG+PRF+2+SG
desconsideraste-os	desconsiderar+V.ele.ACC.3.M.PL+PRF+2+SG
desconsiderastes-lhe	desconsiderar+V.ele.DAT.3.SG+PRF+2+PL
desconsiderastes-lhes	desconsiderar+V.ele.DAT.3.PL+PRF+2+PL
desconsiderastes-me	desconsiderar+V.eu.AD.1.SG+PRF+2+PL
desconsiderastes-te	desconsiderar+V.tu.AD.2.SG+PRF+2+PL
desconsiderastes-vos	desconsiderar+V.vós.AD.2.PL+PRF+2+PL
desconsideraste-te	desconsiderar+V.tu.AD.2.SG+PRF+2+SG
desconsideraste-vos	desconsiderar+V.vós.AD.2.PL+PRF+2+SG
desconsideras-vos	desconsiderar+V.vós.AD.2.PL+PRS+2+SG
desconsidera-te	desconsiderar+V.tu.AD.2.SG+PRS+3+SG
desconsiderava-a	desconsiderar+V.ele.ACC.3.F.SG+IMPF+1+SG
desconsiderava-a	desconsiderar+V.ele.ACC.3.F.SG+IMPF+3+SG
desconsiderava-as	desconsiderar+V.ele.ACC.3.F.PL+IMPF+1+SG
desconsiderava-as	desconsiderar+V.ele.ACC.3.F.PL+IMPF+3+SG
desconsiderava-la	desconsiderar+V.ele.ACC.3.F.SG+IMPF+2+SG
desconsiderava-las	desconsiderar+V.ele.ACC.3.F.PL+IMPF+2+SG
desconsiderava-lhe	desconsiderar+V.ele.DAT.3.SG+IMPF+1+SG
desconsiderava-lhe	desconsiderar+V.ele.DAT.3.SG+IMPF+3+SG
desconsiderava-lhes	desconsiderar+V.ele.DAT.3.PL+IMPF+1+SG
desconsiderava-lhes	desconsiderar+V.ele.DAT.3.PL+IMPF+3+SG
desconsiderava-lo	desconsiderar+V.ele.ACC.3.M.SG+IMPF+2+SG
desconsiderava-los	desconsiderar+V.ele.ACC.3.M.PL+IMPF+2+SG
desconsiderava-me	desconsiderar+V.eu.AD.1.SG+IMPF+1+SG
desconsiderava-me	desconsiderar+V.eu.AD.1.SG+IMPF+3+SG
desconsideravam-lhe	desconsiderar+V.ele.DAT.3.SG+IMPF+3+PL
desconsideravam-lhes	desconsiderar+V.ele.DAT.3.PL+IMPF+3+PL
desconsideravam-me	desconsiderar+V.eu.AD.1.SG+IMPF+3+PL
desconsideravam-na	desconsiderar+V.ele.ACC.3.F.SG+IMPF+3+PL
desconsideravam-nas	desconsiderar+V.ele.ACC.3.F.PL+IMPF+3+PL
desconsideravam-no	desconsiderar+V.ele.ACC.3.M.SG+IMPF+3+PL
desconsideravam-nos	desconsiderar+V.ele.ACC.3.M.PL+IMPF+3+PL
desconsideravam-nos	desconsiderar+V.nós.AD.1.PL+IMPF+3+PL
desconsiderávamo-la	desconsiderar+V.ele.ACC.3.F.SG+IMPF+1+PL
desconsiderávamo-las	desconsiderar+V.ele.ACC.3.F.PL+IMPF+1+PL
desconsiderávamo-lo	desconsiderar+V.ele.ACC.3.M.SG+IMPF+1+PL
desconsiderávamo-los	desconsiderar+V.ele.ACC.3.M.PL+IMPF+1+PL
desconsiderávamo-nos	desconsiderar+nós.AD.1.PL+IMPF+1+PL
desconsiderávamos-lhe	desconsiderar+V.ele.DAT.3.SG+IMPF+1+PL
desconsiderávamos-lhes	desconsiderar+V.ele.DAT.3.PL+IMPF+1+PL
desconsiderávamos-me	desconsiderar+V.eu.AD.1.SG+IMPF+1+PL
desconsiderávamos-te	desconsiderar+V.tu.AD.2.SG+IMPF+1+PL
desconsiderávamos-vos	desconsiderar+V.vós.AD.2.PL+IMPF+1+PL
desconsideravam-se	desconsiderar+V.ele.REFL+IMPF+3+PL
desconsideravam-te	desconsiderar+V.tu.AD.2.SG+IMPF+3+PL
desconsideravam-vos	desconsiderar+V.vós.AD.2.PL+IMPF+3+PL
desconsiderava-nos	desconsiderar+nós.AD.1.PL+IMPF+1+SG
desconsiderava-nos	desconsiderar+nós.AD.1.PL+IMPF+2+SG
desconsiderava-nos	desconsiderar+nós.AD.1.PL+IMPF+3+SG
desconsiderava-o	desconsiderar+V.ele.ACC.3.M.SG+IMPF+1+SG
desconsiderava-o	desconsiderar+V.ele.ACC.3.M.SG+IMPF+3+SG
desconsiderava-os	desconsiderar+V.ele.ACC.3.M.PL+IMPF+1+SG
desconsiderava-os	desconsiderar+V.ele.ACC.3.M.PL+IMPF+3+SG
desconsiderava-se	desconsiderar+V.ele.REFL+IMPF+1+SG
desconsiderava-se	desconsiderar+V.ele.REFL+IMPF+3+SG
desconsideravas-lhe	desconsiderar+V.ele.DAT.3.SG+IMPF+2+SG
desconsideravas-lhes	desconsiderar+V.ele.DAT.3.PL+IMPF+2+SG
desconsideravas-me	desconsiderar+V.eu.AD.1.SG+IMPF+2+SG
desconsideravas-te	desconsiderar+V.tu.AD.2.SG+IMPF+2+SG
desconsideravas-vos	desconsiderar+V.vós.AD.2.PL+IMPF+2+SG
desconsiderava-te	desconsiderar+V.tu.AD.2.SG+IMPF+1+SG
desconsiderava-te	desconsiderar+V.tu.AD.2.SG+IMPF+3+SG
desconsiderava-vos	desconsiderar+V.vós.AD.2.PL+IMPF+1+SG
desconsiderava-vos	desconsiderar+V.vós.AD.2.PL+IMPF+3+SG
desconsiderávei-la	desconsiderar+V.ele.ACC.3.F.SG+IMPF+2+PL
desconsiderávei-las	desconsiderar+V.ele.ACC.3.F.PL+IMPF+2+PL
desconsiderávei-lo	desconsiderar+V.ele.ACC.3.M.SG+IMPF+2+PL
desconsiderávei-los	desconsiderar+V.ele.ACC.3.M.PL+IMPF+2+PL
desconsiderávei-nos	desconsiderar+nós.AD.1.PL+IMPF+2+PL
desconsideráveis-lhe	desconsiderar+V.ele.DAT.3.SG+IMPF+2+PL
desconsideráveis-lhes	desconsiderar+V.ele.DAT.3.PL+IMPF+2+PL
desconsideráveis-me	desconsiderar+V.eu.AD.1.SG+IMPF+2+PL
desconsideráveis-te	desconsiderar+V.tu.AD.2.SG+IMPF+2+PL
desconsideráveis-vos	desconsiderar+V.vós.AD.2.PL+IMPF+2+PL
desconsidera-vos	desconsiderar+V.vós.AD.2.PL+PRS+3+SG
desconsidere-a	desconsiderar+V.ele.ACC.3.F.SG+IMP+3+SG
desconsidere-as	desconsiderar+V.ele.ACC.3.F.PL+IMP+3+SG
desconsiderei-a	desconsiderar+V.ele.ACC.3.F.SG+PRF+1+SG
desconsiderei-as	desconsiderar+V.ele.ACC.3.F.PL+PRF+1+SG
desconsiderei-lhe	desconsiderar+V.ele.DAT.3.SG+PRF+1+SG
desconsiderei-lhes	desconsiderar+V.ele.DAT.3.PL+PRF+1+SG
desconsiderei-me	desconsiderar+V.eu.AD.1.SG+PRF+1+SG
desconsiderei-nos	desconsiderar+nós.AD.1.PL+PRF+1+SG
desconsiderei-o	desconsiderar+V.ele.ACC.3.M.SG+PRF+1+SG
desconsiderei-os	desconsiderar+V.ele.ACC.3.M.PL+PRF+1+SG
desconsiderei-te	desconsiderar+V.tu.AD.2.SG+PRF+1+SG
desconsiderei-vos	desconsiderar+V.vós.AD.2.PL+PRF+1+SG
desconsidere-lhe	desconsiderar+V.ele.DAT.3.SG+IMP+3+SG
desconsidere-lhes	desconsiderar+V.ele.DAT.3.PL+IMP+3+SG
desconsidere-me	desconsiderar+V.eu.AD.1.SG+IMP+3+SG
desconsiderem-lhe	desconsiderar+V.ele.DAT.3.SG+IMP+3+PL
desconsiderem-lhes	desconsiderar+V.ele.DAT.3.PL+IMP+3+PL
desconsiderem-me	desconsiderar+V.eu.AD.1.SG+IMP+3+PL
desconsiderem-na	desconsiderar+V.ele.ACC.3.F.SG+IMP+3+PL
desconsiderem-nas	desconsiderar+V.ele.ACC.3.F.PL+IMP+3+PL
desconsiderem-no	desconsiderar+V.ele.ACC.3.M.SG+IMP+3+PL
desconsiderem-nos	desconsiderar+V.ele.ACC.3.M.PL+IMP+3+PL
desconsiderem-nos	desconsiderar+V.nós.AD.1.PL+IMP+3+PL
desconsideremo-la	desconsiderar+V.ele.ACC.3.F.SG+IMP+1+PL
desconsideremo-las	desconsiderar+V.ele.ACC.3.F.PL+IMP+1+PL
desconsideremo-lo	desconsiderar+V.ele.ACC.3.M.SG+IMP+1+PL
desconsideremo-los	desconsiderar+V.ele.ACC.3.M.PL+IMP+1+PL
desconsideremo-nos	desconsiderar+nós.AD.1.PL+IMP+1+PL
desconsideremos-lhe	desconsiderar+V.ele.DAT.3.SG+IMP+1+PL
desconsideremos-lhes	desconsiderar+V.ele.DAT.3.PL+IMP+1+PL
desconsideremos-me	desconsiderar+V.eu.AD.1.SG+IMP+1+PL
desconsideremos-te	desconsiderar+V.tu.AD.2.SG+IMP+1+PL
desconsideremos-vos	desconsiderar+V.vós.AD.2.PL+IMP+1+PL
desconsiderem-se	desconsiderar+V.ele.REFL+IMP+3+PL
desconsiderem-te	desconsiderar+V.tu.AD.2.SG+IMP+3+PL
desconsiderem-vos	desconsiderar+V.vós.AD.2.PL+IMP+3+PL
desconsidere-nos	desconsiderar+nós.AD.1.PL+IMP+3+SG
desconsidere-o	desconsiderar+V.ele.ACC.3.M.SG+IMP+3+SG
desconsidere-os	desconsiderar+V.ele.ACC.3.M.PL+IMP+3+SG
desconsidere-se	desconsiderar+V.ele.REFL+IMP+3+SG
desconsidere-te	desconsiderar+V.tu.AD.2.SG+IMP+3+SG
desconsidere-vos	desconsiderar+V.vós.AD.2.PL+IMP+3+SG
desconsidero-a	desconsiderar+V.ele.ACC.3.F.SG+PRS+1+SG
desconsidero-as	desconsiderar+V.ele.ACC.3.F.PL+PRS+1+SG
desconsidero-lhe	desconsiderar+V.ele.DAT.3.SG+PRS+1+SG
desconsidero-lhes	desconsiderar+V.ele.DAT.3.PL+PRS+1+SG
desconsidero-me	desconsiderar+V.eu.AD.1.SG+PRS+1+SG
desconsidero-nos	desconsiderar+nós.AD.1.PL+PRS+1+SG
desconsidero-o	desconsiderar+V.ele.ACC.3.M.SG+PRS+1+SG
desconsidero-os	desconsiderar+V.ele.ACC.3.M.PL+PRS+1+SG
desconsidero-te	desconsiderar+V.tu.AD.2.SG+PRS+1+SG
desconsiderou-a	desconsiderar+V.ele.ACC.3.F.SG+PRF+3+SG
desconsiderou-as	desconsiderar+V.ele.ACC.3.F.PL+PRF+3+SG
desconsiderou-lhe	desconsiderar+V.ele.DAT.3.SG+PRF+3+SG
desconsiderou-lhes	desconsiderar+V.ele.DAT.3.PL+PRF+3+SG
desconsiderou-me	desconsiderar+V.eu.AD.1.SG+PRF+3+SG
desconsiderou-nos	desconsiderar+nós.AD.1.PL+PRF+3+SG
desconsiderou-o	desconsiderar+V.ele.ACC.3.M.SG+PRF+3+SG
desconsiderou-os	desconsiderar+V.ele.ACC.3.M.PL+PRF+3+SG
desconsiderou-se	desconsiderar+V.ele.REFL+PRF+3+SG
desconsiderou-te	desconsiderar+V.tu.AD.2.SG+PRF+3+SG
desconsiderou-vos	desconsiderar+V.vós.AD.2.PL+PRF+3+SG
desconsidero-vos	desconsiderar+V.vós.AD.2.PL+PRS+1+SG
desconsinta-a	desconsentir+V.ele.ACC.3.F.SG+IMP+3+SG
desconsinta-as	desconsentir+V.ele.ACC.3.F.PL+IMP+3+SG
desconsinta-lhe	desconsentir+V.ele.DAT.3.SG+IMP+3+SG
desconsinta-lhes	desconsentir+V.ele.DAT.3.PL+IMP+3+SG
desconsinta-me	desconsentir+V.eu.AD.1.SG+IMP+3+SG
desconsintam-lhe	desconsentir+V.ele.DAT.3.SG+IMP+3+PL
desconsintam-lhes	desconsentir+V.ele.DAT.3.PL+IMP+3+PL
desconsintam-me	desconsentir+V.eu.AD.1.SG+IMP+3+PL
desconsintam-na	desconsentir+V.ele.ACC.3.F.SG+IMP+3+PL
desconsintam-nas	desconsentir+V.ele.ACC.3.F.PL+IMP+3+PL
desconsintam-no	desconsentir+V.ele.ACC.3.M.SG+IMP+3+PL
desconsintam-nos	desconsentir+V.ele.ACC.3.M.PL+IMP+3+PL
desconsintam-nos	desconsentir+V.nós.AD.1.PL+IMP+3+PL
desconsintamo-la	desconsentir+V.ele.ACC.3.F.SG+IMP+1+PL
desconsintamo-las	desconsentir+V.ele.ACC.3.F.PL+IMP+1+PL
desconsintamo-lo	desconsentir+V.ele.ACC.3.M.SG+IMP+1+PL
desconsintamo-los	desconsentir+V.ele.ACC.3.M.PL+IMP+1+PL
desconsintamo-nos	desconsentir+nós.AD.1.PL+IMP+1+PL
desconsintamos-lhe	desconsentir+V.ele.DAT.3.SG+IMP+1+PL
desconsintamos-lhes	desconsentir+V.ele.DAT.3.PL+IMP+1+PL
desconsintamos-me	desconsentir+V.eu.AD.1.SG+IMP+1+PL
desconsintamos-te	desconsentir+V.tu.AD.2.SG+IMP+1+PL
desconsintamos-vos	desconsentir+V.vós.AD.2.PL+IMP+1+PL
desconsintam-se	desconsentir+V.ele.REFL+IMP+3+PL
desconsintam-te	desconsentir+V.tu.AD.2.SG+IMP+3+PL
desconsintam-vos	desconsentir+V.vós.AD.2.PL+IMP+3+PL
desconsinta-nos	desconsentir+nós.AD.1.PL+IMP+3+SG
desconsinta-o	desconsentir+V.ele.ACC.3.M.SG+IMP+3+SG
desconsinta-os	desconsentir+V.ele.ACC.3.M.PL+IMP+3+SG
desconsinta-se	desconsentir+V.ele.REFL+IMP+3+SG
desconsinta-te	desconsentir+V.tu.AD.2.SG+IMP+3+SG
desconsinta-vos	desconsentir+V.vós.AD.2.PL+IMP+3+SG
desconsinto-a	desconsentir+V.ele.ACC.3.F.SG+PRS+1+SG
desconsinto-as	desconsentir+V.ele.ACC.3.F.PL+PRS+1+SG
desconsinto-lhe	desconsentir+V.ele.DAT.3.SG+PRS+1+SG
desconsinto-lhes	desconsentir+V.ele.DAT.3.PL+PRS+1+SG
desconsinto-me	desconsentir+V.eu.AD.1.SG+PRS+1+SG
desconsinto-nos	desconsentir+nós.AD.1.PL+PRS+1+SG
desconsinto-o	desconsentir+V.ele.ACC.3.M.SG+PRS+1+SG
desconsinto-os	desconsentir+V.ele.ACC.3.M.PL+PRS+1+SG
desconsinto-te	desconsentir+V.tu.AD.2.SG+PRS+1+SG
desconsinto-vos	desconsentir+V.vós.AD.2.PL+PRS+1+SG
desconsola-a	desconsolar+V.ele.ACC.3.F.SG+PRS+3+SG
desconsola-as	desconsolar+V.ele.ACC.3.F.PL+PRS+3+SG
desconsolai-la	desconsolar+V.ele.ACC.3.F.SG+PRS+2+PL
desconsolai-las	desconsolar+V.ele.ACC.3.F.PL+PRS+2+PL
desconsolai-lo	desconsolar+V.ele.ACC.3.M.SG+PRS+2+PL
desconsolai-los	desconsolar+V.ele.ACC.3.M.PL+PRS+2+PL
desconsolai-nos	desconsolar+nós.AD.1.PL+PRS+2+PL
desconsolais-lhe	desconsolar+V.ele.DAT.3.SG+PRS+2+PL
desconsolais-lhes	desconsolar+V.ele.DAT.3.PL+PRS+2+PL
desconsolais-me	desconsolar+V.eu.AD.1.SG+PRS+2+PL
desconsolais-te	desconsolar+V.tu.AD.2.SG+PRS+2+PL
desconsolais-vos	desconsolar+V.vós.AD.2.PL+PRS+2+PL
desconsolá-la-á	desconsolar+V.ele.ACC.3.F.SG+FUT+3+SG
desconsolá-la-ão	desconsolar+V.ele.ACC.3.F.SG+FUT+3+PL
desconsolá-la-ás	desconsolar+V.ele.ACC.3.F.SG+FUT+2+SG
desconsolá-la	desconsolar+V.ele.ACC.3.F.SG+INF+1+SG
desconsolá-la	desconsolar+V.ele.ACC.3.F.SG+INF+3+SG
desconsola-la	desconsolar+V.ele.ACC.3.F.SG+PRS+2+SG
desconsolá-la	desconsolar+V.ele.ACC.3.F.SG+SBJF+1+SG
desconsolá-la	desconsolar+V.ele.ACC.3.F.SG+SBJF+3+SG
desconsolá-la-ei	desconsolar+V.ele.ACC.3.F.SG+FUT+1+SG
desconsolá-la-eis	desconsolar+V.ele.ACC.3.F.SG+FUT+2+PL
desconsolá-la-emos	desconsolar+V.ele.ACC.3.F.SG+FUT+1+PL
desconsolá-la-ia	desconsolar+V.ele.ACC.3.F.SG+COND+1+SG
desconsolá-la-ia	desconsolar+V.ele.ACC.3.F.SG+COND+3+SG
desconsolá-la-iam	desconsolar+V.ele.ACC.3.F.SG+COND+3+PL
desconsolá-la-íamos	desconsolar+V.ele.ACC.3.F.SG+COND+1+PL
desconsolá-la-ias	desconsolar+V.ele.ACC.3.F.SG+COND+2+SG
desconsolá-la-íeis	desconsolar+V.ele.ACC.3.F.SG+COND+2+PL
desconsolá-las-á	desconsolar+V.ele.ACC.3.F.PL+FUT+3+SG
desconsolá-las-ão	desconsolar+V.ele.ACC.3.F.PL+FUT+3+PL
desconsolá-las-ás	desconsolar+V.ele.ACC.3.F.PL+FUT+2+SG
desconsolá-las	desconsolar+V.ele.ACC.3.F.PL+INF+1+SG
desconsolá-las	desconsolar+V.ele.ACC.3.F.PL+INF+3+SG
desconsola-las	desconsolar+V.ele.ACC.3.F.PL+PRS+2+SG
desconsolá-las	desconsolar+V.ele.ACC.3.F.PL+SBJF+1+SG
desconsolá-las	desconsolar+V.ele.ACC.3.F.PL+SBJF+3+SG
desconsolá-las-ei	desconsolar+V.ele.ACC.3.F.PL+FUT+1+SG
desconsolá-las-eis	desconsolar+V.ele.ACC.3.F.PL+FUT+2+PL
desconsolá-las-emos	desconsolar+V.ele.ACC.3.F.PL+FUT+1+PL
desconsolá-las-ia	desconsolar+V.ele.ACC.3.F.PL+COND+1+SG
desconsolá-las-ia	desconsolar+V.ele.ACC.3.F.PL+COND+3+SG
desconsolá-las-iam	desconsolar+V.ele.ACC.3.F.PL+COND+3+PL
desconsolá-las-íamos	desconsolar+V.ele.ACC.3.F.PL+COND+1+PL
desconsolá-las-ias	desconsolar+V.ele.ACC.3.F.PL+COND+2+SG
desconsolá-las-íeis	desconsolar+V.ele.ACC.3.F.PL+COND+2+PL
desconsola-lhe	desconsolar+V.ele.DAT.3.SG+PRS+3+SG
desconsola-lhes	desconsolar+V.ele.DAT.3.PL+PRS+3+SG
desconsolá-lo-á	desconsolar+V.ele.ACC.3.M.SG+FUT+3+SG
desconsolá-lo-ão	desconsolar+V.ele.ACC.3.M.SG+FUT+3+PL
desconsolá-lo-ás	desconsolar+V.ele.ACC.3.M.SG+FUT+2+SG
desconsolá-lo	desconsolar+V.ele.ACC.3.M.SG+INF+1+SG
desconsolá-lo	desconsolar+V.ele.ACC.3.M.SG+INF+3+SG
desconsola-lo	desconsolar+V.ele.ACC.3.M.SG+PRS+2+SG
desconsolá-lo	desconsolar+V.ele.ACC.3.M.SG+SBJF+1+SG
desconsolá-lo	desconsolar+V.ele.ACC.3.M.SG+SBJF+3+SG
desconsolá-lo-ei	desconsolar+V.ele.ACC.3.M.SG+FUT+1+SG
desconsolá-lo-eis	desconsolar+V.ele.ACC.3.M.SG+FUT+2+PL
desconsolá-lo-emos	desconsolar+V.ele.ACC.3.M.SG+FUT+1+PL
desconsolá-lo-ia	desconsolar+V.ele.ACC.3.M.SG+COND+1+SG
desconsolá-lo-ia	desconsolar+V.ele.ACC.3.M.SG+COND+3+SG
desconsolá-lo-iam	desconsolar+V.ele.ACC.3.M.SG+COND+3+PL
desconsolá-lo-íamos	desconsolar+V.ele.ACC.3.M.SG+COND+1+PL
desconsolá-lo-ias	desconsolar+V.ele.ACC.3.M.SG+COND+2+SG
desconsolá-lo-íeis	desconsolar+V.ele.ACC.3.M.SG+COND+2+PL
desconsolá-los-á	desconsolar+V.ele.ACC.3.M.PL+FUT+3+SG
desconsolá-los-ão	desconsolar+V.ele.ACC.3.M.PL+FUT+3+PL
desconsolá-los-ás	desconsolar+V.ele.ACC.3.M.PL+FUT+2+SG
desconsolá-los	desconsolar+V.ele.ACC.3.M.PL+INF+1+SG
desconsolá-los	desconsolar+V.ele.ACC.3.M.PL+INF+3+SG
desconsola-los	desconsolar+V.ele.ACC.3.M.PL+PRS+2+SG
desconsolá-los	desconsolar+V.ele.ACC.3.M.PL+SBJF+1+SG
desconsolá-los	desconsolar+V.ele.ACC.3.M.PL+SBJF+3+SG
desconsolá-los-ei	desconsolar+V.ele.ACC.3.M.PL+FUT+1+SG
desconsolá-los-eis	desconsolar+V.ele.ACC.3.M.PL+FUT+2+PL
desconsolá-los-emos	desconsolar+V.ele.ACC.3.M.PL+FUT+1+PL
desconsolá-los-ia	desconsolar+V.ele.ACC.3.M.PL+COND+1+SG
desconsolá-los-ia	desconsolar+V.ele.ACC.3.M.PL+COND+3+SG
desconsolá-los-iam	desconsolar+V.ele.ACC.3.M.PL+COND+3+PL
desconsolá-los-íamos	desconsolar+V.ele.ACC.3.M.PL+COND+1+PL
desconsolá-los-ias	desconsolar+V.ele.ACC.3.M.PL+COND+2+SG
desconsolá-los-íeis	desconsolar+V.ele.ACC.3.M.PL+COND+2+PL
desconsola-me	desconsolar+V.eu.AD.1.SG+PRS+3+SG
desconsolam-lhe	desconsolar+V.ele.DAT.3.SG+PRS+3+PL
desconsolam-lhes	desconsolar+V.ele.DAT.3.PL+PRS+3+PL
desconsolam-me	desconsolar+V.eu.AD.1.SG+PRS+3+PL
desconsolam-na	desconsolar+V.ele.ACC.3.F.SG+PRS+3+PL
desconsolam-nas	desconsolar+V.ele.ACC.3.F.PL+PRS+3+PL
desconsolam-no	desconsolar+V.ele.ACC.3.M.SG+PRS+3+PL
desconsolam-nos	desconsolar+V.ele.ACC.3.M.PL+PRS+3+PL
desconsolam-nos	desconsolar+V.nós.AD.1.PL+PRS+3+PL
desconsolamo-la	desconsolar+V.ele.ACC.3.F.SG+PRF+1+PL
desconsolamo-la	desconsolar+V.ele.ACC.3.F.SG+PRS+1+PL
desconsolamo-las	desconsolar+V.ele.ACC.3.F.PL+PRF+1+PL
desconsolamo-las	desconsolar+V.ele.ACC.3.F.PL+PRS+1+PL
desconsolamo-lo	desconsolar+V.ele.ACC.3.M.SG+PRF+1+PL
desconsolamo-lo	desconsolar+V.ele.ACC.3.M.SG+PRS+1+PL
desconsolamo-los	desconsolar+V.ele.ACC.3.M.PL+PRF+1+PL
desconsolamo-los	desconsolar+V.ele.ACC.3.M.PL+PRS+1+PL
desconsolamo-nos	desconsolar+nós.AD.1.PL+PRF+1+PL
desconsolamo-nos	desconsolar+nós.AD.1.PL+PRS+1+PL
desconsolamos-lhe	desconsolar+V.ele.DAT.3.SG+PRF+1+PL
desconsolamos-lhe	desconsolar+V.ele.DAT.3.SG+PRS+1+PL
desconsolamos-lhes	desconsolar+V.ele.DAT.3.PL+PRF+1+PL
desconsolamos-lhes	desconsolar+V.ele.DAT.3.PL+PRS+1+PL
desconsolamos-me	desconsolar+V.eu.AD.1.SG+PRF+1+PL
desconsolamos-me	desconsolar+V.eu.AD.1.SG+PRS+1+PL
desconsolamos-te	desconsolar+V.tu.AD.2.SG+PRF+1+PL
desconsolamos-te	desconsolar+V.tu.AD.2.SG+PRS+1+PL
desconsolamos-vos	desconsolar+V.vós.AD.2.PL+PRF+1+PL
desconsolamos-vos	desconsolar+V.vós.AD.2.PL+PRS+1+PL
desconsolam-se	desconsolar+V.ele.REFL+PRS+3+PL
desconsolam-te	desconsolar+V.tu.AD.2.SG+PRS+3+PL
desconsolam-vos	desconsolar+V.vós.AD.2.PL+PRS+3+PL
desconsolando-a	desconsolar+V.ele.ACC.3.F.SG+GRD
desconsolando-as	desconsolar+V.ele.ACC.3.F.PL+GRD
desconsolando-lhe	desconsolar+V.ele.DAT.3.SG+GRD
desconsolando-lhes	desconsolar+V.ele.DAT.3.PL+GRD
desconsolando-me	desconsolar+V.eu.AD.1.SG+GRD
desconsolando-nos	desconsolar+nós.AD.1.PL+GRD
desconsolando-o	desconsolar+V.ele.ACC.3.M.SG+GRD
desconsolando-os	desconsolar+V.ele.ACC.3.M.PL+GRD
desconsolando-se	desconsolar+V.ele.REFL+GRD
desconsolando-te	desconsolar+V.tu.AD.2.SG+GRD
desconsolando-vos	desconsolar+V.vós.AD.2.PL+GRD
desconsola-nos	desconsolar+nós.AD.1.PL+PRS+2+SG
desconsola-nos	desconsolar+nós.AD.1.PL+PRS+3+SG
desconsola-o	desconsolar+V.ele.ACC.3.M.SG+PRS+3+SG
desconsola-os	desconsolar+V.ele.ACC.3.M.PL+PRS+3+SG
desconsolara-a	desconsolar+V.ele.ACC.3.F.SG+PQP+1+SG
desconsolara-a	desconsolar+V.ele.ACC.3.F.SG+PQP+3+SG
desconsolara-as	desconsolar+V.ele.ACC.3.F.PL+PQP+1+SG
desconsolara-as	desconsolar+V.ele.ACC.3.F.PL+PQP+3+SG
desconsolara-la	desconsolar+V.ele.ACC.3.F.SG+PQP+2+SG
desconsolara-las	desconsolar+V.ele.ACC.3.F.PL+PQP+2+SG
desconsolara-lhe	desconsolar+V.ele.DAT.3.SG+PQP+1+SG
desconsolara-lhe	desconsolar+V.ele.DAT.3.SG+PQP+3+SG
