desconsagrar-lhe-á	desconsagrar+V.ele.DAT.3.SG+FUT+3+SG
desconsagrar-lhe-ão	desconsagrar+V.ele.DAT.3.SG+FUT+3+PL
desconsagrar-lhe-ás	desconsagrar+V.ele.DAT.3.SG+FUT+2+SG
desconsagrar-lhe	desconsagrar+V.ele.DAT.3.SG+INF
desconsagrar-lhe	desconsagrar+V.ele.DAT.3.SG+INF+1+SG
desconsagrar-lhe	desconsagrar+V.ele.DAT.3.SG+INF+3+SG
desconsagrar-lhe	desconsagrar+V.ele.DAT.3.SG+SBJF+1+SG
desconsagrar-lhe	desconsagrar+V.ele.DAT.3.SG+SBJF+3+SG
desconsagrar-lhe-ei	desconsagrar+V.ele.DAT.3.SG+FUT+1+SG
desconsagrar-lhe-eis	desconsagrar+V.ele.DAT.3.SG+FUT+2+PL
desconsagrar-lhe-emos	desconsagrar+V.ele.DAT.3.SG+FUT+1+PL
desconsagrar-lhe-ia	desconsagrar+V.ele.DAT.3.SG+COND+1+SG
desconsagrar-lhe-ia	desconsagrar+V.ele.DAT.3.SG+COND+3+SG
desconsagrar-lhe-iam	desconsagrar+V.ele.DAT.3.SG+COND+3+PL
desconsagrar-lhe-íamos	desconsagrar+V.ele.DAT.3.SG+COND+1+PL
desconsagrar-lhe-ias	desconsagrar+V.ele.DAT.3.SG+COND+2+SG
desconsagrar-lhe-íeis	desconsagrar+V.ele.DAT.3.SG+COND+2+PL
desconsagrar-lhes-á	desconsagrar+V.ele.DAT.3.PL+FUT+3+SG
desconsagrar-lhes-ão	desconsagrar+V.ele.DAT.3.PL+FUT+3+PL
desconsagrar-lhes-ás	desconsagrar+V.ele.DAT.3.PL+FUT+2+SG
desconsagrar-lhes	desconsagrar+V.ele.DAT.3.PL+INF
desconsagrar-lhes	desconsagrar+V.ele.DAT.3.PL+INF+1+SG
desconsagrar-lhes	desconsagrar+V.ele.DAT.3.PL+INF+3+SG
desconsagrar-lhes	desconsagrar+V.ele.DAT.3.PL+SBJF+1+SG
desconsagrar-lhes	desconsagrar+V.ele.DAT.3.PL+SBJF+3+SG
desconsagrar-lhes-ei	desconsagrar+V.ele.DAT.3.PL+FUT+1+SG
desconsagrar-lhes-eis	desconsagrar+V.ele.DAT.3.PL+FUT+2+PL
desconsagrar-lhes-emos	desconsagrar+V.ele.DAT.3.PL+FUT+1+PL
desconsagrar-lhes-ia	desconsagrar+V.ele.DAT.3.PL+COND+1+SG
desconsagrar-lhes-ia	desconsagrar+V.ele.DAT.3.PL+COND+3+SG
desconsagrar-lhes-iam	desconsagrar+V.ele.DAT.3.PL+COND+3+PL
desconsagrar-lhes-íamos	desconsagrar+V.ele.DAT.3.PL+COND+1+PL
desconsagrar-lhes-ias	desconsagrar+V.ele.DAT.3.PL+COND+2+SG
desconsagrar-lhes-íeis	desconsagrar+V.ele.DAT.3.PL+COND+2+PL
desconsagrar-me-á	desconsagrar+V.eu.AD.1.SG+FUT+3+SG
desconsagrar-me-ão	desconsagrar+V.eu.AD.1.SG+FUT+3+PL
desconsagrar-me-ás	desconsagrar+V.eu.AD.1.SG+FUT+2+SG
desconsagrar-me	desconsagrar+V.eu.AD.1.SG+INF
desconsagrar-me	desconsagrar+V.eu.AD.1.SG+INF+1+SG
desconsagrar-me	desconsagrar+V.eu.AD.1.SG+INF+3+SG
desconsagrar-me	desconsagrar+V.eu.AD.1.SG+SBJF+1+SG
desconsagrar-me	desconsagrar+V.eu.AD.1.SG+SBJF+3+SG
desconsagrar-me-ei	desconsagrar+V.eu.AD.1.SG+FUT+1+SG
desconsagrar-me-eis	desconsagrar+V.eu.AD.1.SG+FUT+2+PL
desconsagrar-me-emos	desconsagrar+V.eu.AD.1.SG+FUT+1+PL
desconsagrar-me-ia	desconsagrar+V.eu.AD.1.SG+COND+1+SG
desconsagrar-me-ia	desconsagrar+V.eu.AD.1.SG+COND+3+SG
desconsagrar-me-iam	desconsagrar+V.eu.AD.1.SG+COND+3+PL
desconsagrar-me-íamos	desconsagrar+V.eu.AD.1.SG+COND+1+PL
desconsagrar-me-ias	desconsagrar+V.eu.AD.1.SG+COND+2+SG
desconsagrar-me-íeis	desconsagrar+V.eu.AD.1.SG+COND+2+PL
desconsagrarmo-la	desconsagrar+V.ele.ACC.3.F.SG+INF+1+PL
desconsagrarmo-la	desconsagrar+V.ele.ACC.3.F.SG+SBJF+1+PL
desconsagrarmo-las	desconsagrar+V.ele.ACC.3.F.PL+INF+1+PL
desconsagrarmo-las	desconsagrar+V.ele.ACC.3.F.PL+SBJF+1+PL
desconsagrarmo-lo	desconsagrar+V.ele.ACC.3.M.SG+INF+1+PL
desconsagrarmo-lo	desconsagrar+V.ele.ACC.3.M.SG+SBJF+1+PL
desconsagrarmo-los	desconsagrar+V.ele.ACC.3.M.PL+INF+1+PL
desconsagrarmo-los	desconsagrar+V.ele.ACC.3.M.PL+SBJF+1+PL
desconsagrarmo-nos	desconsagrar+nós.AD.1.PL+INF+1+PL
desconsagrarmo-nos	desconsagrar+nós.AD.1.PL+SBJF+1+PL
desconsagrarmos-lhe	desconsagrar+V.ele.DAT.3.SG+INF+1+PL
desconsagrarmos-lhe	desconsagrar+V.ele.DAT.3.SG+SBJF+1+PL
desconsagrarmos-lhes	desconsagrar+V.ele.DAT.3.PL+INF+1+PL
desconsagrarmos-lhes	desconsagrar+V.ele.DAT.3.PL+SBJF+1+PL
desconsagrarmos-me	desconsagrar+V.eu.AD.1.SG+INF+1+PL
desconsagrarmos-me	desconsagrar+V.eu.AD.1.SG+SBJF+1+PL
desconsagrarmos-te	desconsagrar+V.tu.AD.2.SG+INF+1+PL
desconsagrarmos-te	desconsagrar+V.tu.AD.2.SG+SBJF+1+PL
desconsagrarmos-vos	desconsagrar+V.vós.AD.2.PL+INF+1+PL
desconsagrarmos-vos	desconsagrar+V.vós.AD.2.PL+SBJF+1+PL
desconsagrar-nos-á	desconsagrar+nós.AD.1.PL+FUT+3+SG
desconsagrar-nos-ão	desconsagrar+nós.AD.1.PL+FUT+3+PL
desconsagrar-nos-ás	desconsagrar+nós.AD.1.PL+FUT+2+SG
desconsagrar-nos	desconsagrar+nós.AD.1.PL+INF
desconsagrar-nos	desconsagrar+nós.AD.1.PL+INF+1+SG
desconsagrar-nos	desconsagrar+nós.AD.1.PL+INF+3+SG
desconsagrar-nos	desconsagrar+nós.AD.1.PL+SBJF+1+SG
desconsagrar-nos	desconsagrar+nós.AD.1.PL+SBJF+3+SG
desconsagrar-nos-ei	desconsagrar+nós.AD.1.PL+FUT+1+SG
desconsagrar-nos-eis	desconsagrar+nós.AD.1.PL+FUT+2+PL
desconsagrar-nos-emos	desconsagrar+nós.AD.1.PL+FUT+1+PL
desconsagrar-nos-ia	desconsagrar+nós.AD.1.PL+COND+1+SG
desconsagrar-nos-ia	desconsagrar+nós.AD.1.PL+COND+3+SG
desconsagrar-nos-iam	desconsagrar+nós.AD.1.PL+COND+3+PL
desconsagrar-nos-íamos	desconsagrar+nós.AD.1.PL+COND+1+PL
desconsagrar-nos-ias	desconsagrar+nós.AD.1.PL+COND+2+SG
desconsagrar-nos-íeis	desconsagrar+nós.AD.1.PL+COND+2+PL
desconsagrar-se-á	desconsagrar+V.ele.REFL+FUT+3+SG
desconsagrar-se-ão	desconsagrar+V.ele.REFL+FUT+3+PL
desconsagrar-se	desconsagrar+V.ele.REFL+INF
desconsagrar-se	desconsagrar+V.ele.REFL+INF+3+SG
desconsagrar-se	desconsagrar+V.ele.REFL+SBJF+3+SG
desconsagrar-se-ia	desconsagrar+V.ele.REFL+COND+3+SG
desconsagrar-se-iam	desconsagrar+V.ele.REFL+COND+3+PL
desconsagrar-te-á	desconsagrar+V.tu.AD.2.SG+FUT+3+SG
desconsagrar-te-ão	desconsagrar+V.tu.AD.2.SG+FUT+3+PL
desconsagrar-te-ás	desconsagrar+V.tu.AD.2.SG+FUT+2+SG
desconsagrar-te	desconsagrar+V.tu.AD.2.SG+INF
desconsagrar-te	desconsagrar+V.tu.AD.2.SG+INF+1+SG
desconsagrar-te	desconsagrar+V.tu.AD.2.SG+INF+3+SG
desconsagrar-te	desconsagrar+V.tu.AD.2.SG+SBJF+1+SG
desconsagrar-te	desconsagrar+V.tu.AD.2.SG+SBJF+3+SG
desconsagrar-te-ei	desconsagrar+V.tu.AD.2.SG+FUT+1+SG
desconsagrar-te-eis	desconsagrar+V.tu.AD.2.SG+FUT+2+PL
desconsagrar-te-emos	desconsagrar+V.tu.AD.2.SG+FUT+1+PL
desconsagrar-te-ia	desconsagrar+V.tu.AD.2.SG+COND+1+SG
desconsagrar-te-ia	desconsagrar+V.tu.AD.2.SG+COND+3+SG
desconsagrar-te-iam	desconsagrar+V.tu.AD.2.SG+COND+3+PL
desconsagrar-te-íamos	desconsagrar+V.tu.AD.2.SG+COND+1+PL
desconsagrar-te-ias	desconsagrar+V.tu.AD.2.SG+COND+2+SG
desconsagrar-te-íeis	desconsagrar+V.tu.AD.2.SG+COND+2+PL
desconsagrar-vos-á	desconsagrar+V.vós.AD.2.PL+FUT+3+SG
desconsagrar-vos-ão	desconsagrar+V.vós.AD.2.PL+FUT+3+PL
desconsagrar-vos-ás	desconsagrar+V.vós.AD.2.PL+FUT+2+SG
desconsagrar-vos	desconsagrar+V.vós.AD.2.PL+INF
desconsagrar-vos	desconsagrar+V.vós.AD.2.PL+INF+1+SG
desconsagrar-vos	desconsagrar+V.vós.AD.2.PL+INF+3+SG
desconsagrar-vos	desconsagrar+V.vós.AD.2.PL+SBJF+1+SG
desconsagrar-vos	desconsagrar+V.vós.AD.2.PL+SBJF+3+SG
desconsagrar-vos-ei	desconsagrar+V.vós.AD.2.PL+FUT+1+SG
desconsagrar-vos-eis	desconsagrar+V.vós.AD.2.PL+FUT+2+PL
desconsagrar-vos-emos	desconsagrar+V.vós.AD.2.PL+FUT+1+PL
desconsagrar-vos-ia	desconsagrar+V.vós.AD.2.PL+COND+1+SG
desconsagrar-vos-ia	desconsagrar+V.vós.AD.2.PL+COND+3+SG
desconsagrar-vos-iam	desconsagrar+V.vós.AD.2.PL+COND+3+PL
desconsagrar-vos-íamos	desconsagrar+V.vós.AD.2.PL+COND+1+PL
desconsagrar-vos-ias	desconsagrar+V.vós.AD.2.PL+COND+2+SG
desconsagrar-vos-íeis	desconsagrar+V.vós.AD.2.PL+COND+2+PL
desconsagra-se	desconsagrar+V.ele.REFL+PRS+3+SG
desconsagras-lhe	desconsagrar+V.ele.DAT.3.SG+PRS+2+SG
desconsagras-lhes	desconsagrar+V.ele.DAT.3.PL+PRS+2+SG
desconsagras-me	desconsagrar+V.eu.AD.1.SG+PRS+2+SG
desconsagraste-a	desconsagrar+V.ele.ACC.3.F.SG+PRF+2+SG
desconsagraste-as	desconsagrar+V.ele.ACC.3.F.PL+PRF+2+SG
desconsagras-te	desconsagrar+V.tu.AD.2.SG+PRS+2+SG
desconsagraste-la	desconsagrar+V.ele.ACC.3.F.SG+PRF+2+PL
desconsagraste-las	desconsagrar+V.ele.ACC.3.F.PL+PRF+2+PL
desconsagraste-lhe	desconsagrar+V.ele.DAT.3.SG+PRF+2+SG
desconsagraste-lhes	desconsagrar+V.ele.DAT.3.PL+PRF+2+SG
desconsagraste-lo	desconsagrar+V.ele.ACC.3.M.SG+PRF+2+PL
desconsagraste-los	desconsagrar+V.ele.ACC.3.M.PL+PRF+2+PL
desconsagraste-me	desconsagrar+V.eu.AD.1.SG+PRF+2+SG
desconsagraste-nos	desconsagrar+nós.AD.1.PL+PRF+2+PL
desconsagraste-nos	desconsagrar+nós.AD.1.PL+PRF+2+SG
desconsagraste-o	desconsagrar+V.ele.ACC.3.M.SG+PRF+2+SG
desconsagraste-os	desconsagrar+V.ele.ACC.3.M.PL+PRF+2+SG
desconsagrastes-lhe	desconsagrar+V.ele.DAT.3.SG+PRF+2+PL
desconsagrastes-lhes	desconsagrar+V.ele.DAT.3.PL+PRF+2+PL
desconsagrastes-me	desconsagrar+V.eu.AD.1.SG+PRF+2+PL
desconsagrastes-te	desconsagrar+V.tu.AD.2.SG+PRF+2+PL
desconsagrastes-vos	desconsagrar+V.vós.AD.2.PL+PRF+2+PL
desconsagraste-te	desconsagrar+V.tu.AD.2.SG+PRF+2+SG
desconsagraste-vos	desconsagrar+V.vós.AD.2.PL+PRF+2+SG
desconsagras-vos	desconsagrar+V.vós.AD.2.PL+PRS+2+SG
desconsagra-te	desconsagrar+V.tu.AD.2.SG+PRS+3+SG
desconsagrava-a	desconsagrar+V.ele.ACC.3.F.SG+IMPF+1+SG
desconsagrava-a	desconsagrar+V.ele.ACC.3.F.SG+IMPF+3+SG
desconsagrava-as	desconsagrar+V.ele.ACC.3.F.PL+IMPF+1+SG
desconsagrava-as	desconsagrar+V.ele.ACC.3.F.PL+IMPF+3+SG
desconsagrava-la	desconsagrar+V.ele.ACC.3.F.SG+IMPF+2+SG
desconsagrava-las	desconsagrar+V.ele.ACC.3.F.PL+IMPF+2+SG
desconsagrava-lhe	desconsagrar+V.ele.DAT.3.SG+IMPF+1+SG
desconsagrava-lhe	desconsagrar+V.ele.DAT.3.SG+IMPF+3+SG
desconsagrava-lhes	desconsagrar+V.ele.DAT.3.PL+IMPF+1+SG
desconsagrava-lhes	desconsagrar+V.ele.DAT.3.PL+IMPF+3+SG
desconsagrava-lo	desconsagrar+V.ele.ACC.3.M.SG+IMPF+2+SG
desconsagrava-los	desconsagrar+V.ele.ACC.3.M.PL+IMPF+2+SG
desconsagrava-me	desconsagrar+V.eu.AD.1.SG+IMPF+1+SG
desconsagrava-me	desconsagrar+V.eu.AD.1.SG+IMPF+3+SG
desconsagravam-lhe	desconsagrar+V.ele.DAT.3.SG+IMPF+3+PL
desconsagravam-lhes	desconsagrar+V.ele.DAT.3.PL+IMPF+3+PL
desconsagravam-me	desconsagrar+V.eu.AD.1.SG+IMPF+3+PL
desconsagravam-na	desconsagrar+V.ele.ACC.3.F.SG+IMPF+3+PL
desconsagravam-nas	desconsagrar+V.ele.ACC.3.F.PL+IMPF+3+PL
desconsagravam-no	desconsagrar+V.ele.ACC.3.M.SG+IMPF+3+PL
desconsagravam-nos	desconsagrar+V.ele.ACC.3.M.PL+IMPF+3+PL
desconsagravam-nos	desconsagrar+V.nós.AD.1.PL+IMPF+3+PL
desconsagrávamo-la	desconsagrar+V.ele.ACC.3.F.SG+IMPF+1+PL
desconsagrávamo-las	desconsagrar+V.ele.ACC.3.F.PL+IMPF+1+PL
desconsagrávamo-lo	desconsagrar+V.ele.ACC.3.M.SG+IMPF+1+PL
desconsagrávamo-los	desconsagrar+V.ele.ACC.3.M.PL+IMPF+1+PL
desconsagrávamo-nos	desconsagrar+nós.AD.1.PL+IMPF+1+PL
desconsagrávamos-lhe	desconsagrar+V.ele.DAT.3.SG+IMPF+1+PL
desconsagrávamos-lhes	desconsagrar+V.ele.DAT.3.PL+IMPF+1+PL
desconsagrávamos-me	desconsagrar+V.eu.AD.1.SG+IMPF+1+PL
desconsagrávamos-te	desconsagrar+V.tu.AD.2.SG+IMPF+1+PL
desconsagrávamos-vos	desconsagrar+V.vós.AD.2.PL+IMPF+1+PL
desconsagravam-se	desconsagrar+V.ele.REFL+IMPF+3+PL
desconsagravam-te	desconsagrar+V.tu.AD.2.SG+IMPF+3+PL
desconsagravam-vos	desconsagrar+V.vós.AD.2.PL+IMPF+3+PL
desconsagrava-nos	desconsagrar+nós.AD.1.PL+IMPF+1+SG
desconsagrava-nos	desconsagrar+nós.AD.1.PL+IMPF+2+SG
desconsagrava-nos	desconsagrar+nós.AD.1.PL+IMPF+3+SG
desconsagrava-o	desconsagrar+V.ele.ACC.3.M.SG+IMPF+1+SG
desconsagrava-o	desconsagrar+V.ele.ACC.3.M.SG+IMPF+3+SG
desconsagrava-os	desconsagrar+V.ele.ACC.3.M.PL+IMPF+1+SG
desconsagrava-os	desconsagrar+V.ele.ACC.3.M.PL+IMPF+3+SG
desconsagrava-se	desconsagrar+V.ele.REFL+IMPF+1+SG
desconsagrava-se	desconsagrar+V.ele.REFL+IMPF+3+SG
desconsagravas-lhe	desconsagrar+V.ele.DAT.3.SG+IMPF+2+SG
desconsagravas-lhes	desconsagrar+V.ele.DAT.3.PL+IMPF+2+SG
desconsagravas-me	desconsagrar+V.eu.AD.1.SG+IMPF+2+SG
desconsagravas-te	desconsagrar+V.tu.AD.2.SG+IMPF+2+SG
desconsagravas-vos	desconsagrar+V.vós.AD.2.PL+IMPF+2+SG
desconsagrava-te	desconsagrar+V.tu.AD.2.SG+IMPF+1+SG
desconsagrava-te	desconsagrar+V.tu.AD.2.SG+IMPF+3+SG
desconsagrava-vos	desconsagrar+V.vós.AD.2.PL+IMPF+1+SG
desconsagrava-vos	desconsagrar+V.vós.AD.2.PL+IMPF+3+SG
desconsagrávei-la	desconsagrar+V.ele.ACC.3.F.SG+IMPF+2+PL
desconsagrávei-las	desconsagrar+V.ele.ACC.3.F.PL+IMPF+2+PL
desconsagrávei-lo	desconsagrar+V.ele.ACC.3.M.SG+IMPF+2+PL
desconsagrávei-los	desconsagrar+V.ele.ACC.3.M.PL+IMPF+2+PL
desconsagrávei-nos	desconsagrar+nós.AD.1.PL+IMPF+2+PL
desconsagráveis-lhe	desconsagrar+V.ele.DAT.3.SG+IMPF+2+PL
desconsagráveis-lhes	desconsagrar+V.ele.DAT.3.PL+IMPF+2+PL
desconsagráveis-me	desconsagrar+V.eu.AD.1.SG+IMPF+2+PL
desconsagráveis-te	desconsagrar+V.tu.AD.2.SG+IMPF+2+PL
desconsagráveis-vos	desconsagrar+V.vós.AD.2.PL+IMPF+2+PL
desconsagra-vos	desconsagrar+V.vós.AD.2.PL+PRS+3+SG
desconsagre-a	desconsagrar+V.ele.ACC.3.F.SG+IMP+3+SG
desconsagre-as	desconsagrar+V.ele.ACC.3.F.PL+IMP+3+SG
desconsagrei-a	desconsagrar+V.ele.ACC.3.F.SG+PRF+1+SG
desconsagrei-as	desconsagrar+V.ele.ACC.3.F.PL+PRF+1+SG
desconsagrei-lhe	desconsagrar+V.ele.DAT.3.SG+PRF+1+SG
desconsagrei-lhes	desconsagrar+V.ele.DAT.3.PL+PRF+1+SG
desconsagrei-me	desconsagrar+V.eu.AD.1.SG+PRF+1+SG
desconsagrei-nos	desconsagrar+nós.AD.1.PL+PRF+1+SG
desconsagrei-o	desconsagrar+V.ele.ACC.3.M.SG+PRF+1+SG
desconsagrei-os	desconsagrar+V.ele.ACC.3.M.PL+PRF+1+SG
desconsagrei-te	desconsagrar+V.tu.AD.2.SG+PRF+1+SG
desconsagrei-vos	desconsagrar+V.vós.AD.2.PL+PRF+1+SG
desconsagre-lhe	desconsagrar+V.ele.DAT.3.SG+IMP+3+SG
desconsagre-lhes	desconsagrar+V.ele.DAT.3.PL+IMP+3+SG
desconsagre-me	desconsagrar+V.eu.AD.1.SG+IMP+3+SG
desconsagrem-lhe	desconsagrar+V.ele.DAT.3.SG+IMP+3+PL
desconsagrem-lhes	desconsagrar+V.ele.DAT.3.PL+IMP+3+PL
desconsagrem-me	desconsagrar+V.eu.AD.1.SG+IMP+3+PL
desconsagrem-na	desconsagrar+V.ele.ACC.3.F.SG+IMP+3+PL
desconsagrem-nas	desconsagrar+V.ele.ACC.3.F.PL+IMP+3+PL
desconsagrem-no	desconsagrar+V.ele.ACC.3.M.SG+IMP+3+PL
desconsagrem-nos	desconsagrar+V.ele.ACC.3.M.PL+IMP+3+PL
desconsagrem-nos	desconsagrar+V.nós.AD.1.PL+IMP+3+PL
desconsagremo-la	desconsagrar+V.ele.ACC.3.F.SG+IMP+1+PL
desconsagremo-las	desconsagrar+V.ele.ACC.3.F.PL+IMP+1+PL
desconsagremo-lo	desconsagrar+V.ele.ACC.3.M.SG+IMP+1+PL
desconsagremo-los	desconsagrar+V.ele.ACC.3.M.PL+IMP+1+PL
desconsagremo-nos	desconsagrar+nós.AD.1.PL+IMP+1+PL
desconsagremos-lhe	desconsagrar+V.ele.DAT.3.SG+IMP+1+PL
desconsagremos-lhes	desconsagrar+V.ele.DAT.3.PL+IMP+1+PL
desconsagremos-me	desconsagrar+V.eu.AD.1.SG+IMP+1+PL
desconsagremos-te	desconsagrar+V.tu.AD.2.SG+IMP+1+PL
desconsagremos-vos	desconsagrar+V.vós.AD.2.PL+IMP+1+PL
desconsagrem-se	desconsagrar+V.ele.REFL+IMP+3+PL
desconsagrem-te	desconsagrar+V.tu.AD.2.SG+IMP+3+PL
desconsagrem-vos	desconsagrar+V.vós.AD.2.PL+IMP+3+PL
desconsagre-nos	desconsagrar+nós.AD.1.PL+IMP+3+SG
desconsagre-o	desconsagrar+V.ele.ACC.3.M.SG+IMP+3+SG
desconsagre-os	desconsagrar+V.ele.ACC.3.M.PL+IMP+3+SG
desconsagre-se	desconsagrar+V.ele.REFL+IMP+3+SG
desconsagre-te	desconsagrar+V.tu.AD.2.SG+IMP+3+SG
desconsagre-vos	desconsagrar+V.vós.AD.2.PL+IMP+3+SG
desconsagro-a	desconsagrar+V.ele.ACC.3.F.SG+PRS+1+SG
desconsagro-as	desconsagrar+V.ele.ACC.3.F.PL+PRS+1+SG
desconsagro-lhe	desconsagrar+V.ele.DAT.3.SG+PRS+1+SG
desconsagro-lhes	desconsagrar+V.ele.DAT.3.PL+PRS+1+SG
desconsagro-me	desconsagrar+V.eu.AD.1.SG+PRS+1+SG
desconsagro-nos	desconsagrar+nós.AD.1.PL+PRS+1+SG
desconsagro-o	desconsagrar+V.ele.ACC.3.M.SG+PRS+1+SG
desconsagro-os	desconsagrar+V.ele.ACC.3.M.PL+PRS+1+SG
desconsagro-te	desconsagrar+V.tu.AD.2.SG+PRS+1+SG
desconsagrou-a	desconsagrar+V.ele.ACC.3.F.SG+PRF+3+SG
desconsagrou-as	desconsagrar+V.ele.ACC.3.F.PL+PRF+3+SG
desconsagrou-lhe	desconsagrar+V.ele.DAT.3.SG+PRF+3+SG
desconsagrou-lhes	desconsagrar+V.ele.DAT.3.PL+PRF+3+SG
desconsagrou-me	desconsagrar+V.eu.AD.1.SG+PRF+3+SG
desconsagrou-nos	desconsagrar+nós.AD.1.PL+PRF+3+SG
desconsagrou-o	desconsagrar+V.ele.ACC.3.M.SG+PRF+3+SG
desconsagrou-os	desconsagrar+V.ele.ACC.3.M.PL+PRF+3+SG
desconsagrou-se	desconsagrar+V.ele.REFL+PRF+3+SG
desconsagrou-te	desconsagrar+V.tu.AD.2.SG+PRF+3+SG
desconsagrou-vos	desconsagrar+V.vós.AD.2.PL+PRF+3+SG
desconsagro-vos	desconsagrar+V.vós.AD.2.PL+PRS+1+SG
desconsente-a	desconsentir+V.ele.ACC.3.F.SG+PRS+3+SG
desconsente-as	desconsentir+V.ele.ACC.3.F.PL+PRS+3+SG
desconsente-la	desconsentir+V.ele.ACC.3.F.SG+PRS+2+SG
desconsente-las	desconsentir+V.ele.ACC.3.F.PL+PRS+2+SG
desconsente-lhe	desconsentir+V.ele.DAT.3.SG+PRS+3+SG
desconsente-lhes	desconsentir+V.ele.DAT.3.PL+PRS+3+SG
desconsente-lo	desconsentir+V.ele.ACC.3.M.SG+PRS+2+SG
desconsente-los	desconsentir+V.ele.ACC.3.M.PL+PRS+2+SG
desconsente-me	desconsentir+V.eu.AD.1.SG+PRS+3+SG
desconsentem-lhe	desconsentir+V.ele.DAT.3.SG+PRS+3+PL
desconsentem-lhes	desconsentir+V.ele.DAT.3.PL+PRS+3+PL
desconsentem-me	desconsentir+V.eu.AD.1.SG+PRS+3+PL
desconsentem-na	desconsentir+V.ele.ACC.3.F.SG+PRS+3+PL
desconsentem-nas	desconsentir+V.ele.ACC.3.F.PL+PRS+3+PL
desconsentem-no	desconsentir+V.ele.ACC.3.M.SG+PRS+3+PL
desconsentem-nos	desconsentir+V.ele.ACC.3.M.PL+PRS+3+PL
desconsentem-nos	desconsentir+V.nós.AD.1.PL+PRS+3+PL
desconsentem-se	desconsentir+V.ele.REFL+PRS+3+PL
desconsentem-te	desconsentir+V.tu.AD.2.SG+PRS+3+PL
desconsentem-vos	desconsentir+V.vós.AD.2.PL+PRS+3+PL
desconsente-nos	desconsentir+nós.AD.1.PL+PRS+2+SG
desconsente-nos	desconsentir+nós.AD.1.PL+PRS+3+SG
desconsente-o	desconsentir+V.ele.ACC.3.M.SG+PRS+3+SG
desconsente-os	desconsentir+V.ele.ACC.3.M.PL+PRS+3+SG
desconsente-se	desconsentir+V.ele.REFL+PRS+3+SG
desconsentes-lhe	desconsentir+V.ele.DAT.3.SG+PRS+2+SG
desconsentes-lhes	desconsentir+V.ele.DAT.3.PL+PRS+2+SG
desconsentes-me	desconsentir+V.eu.AD.1.SG+PRS+2+SG
desconsentes-te	desconsentir+V.tu.AD.2.SG+PRS+2+SG
desconsentes-vos	desconsentir+V.vós.AD.2.PL+PRS+2+SG
desconsente-te	desconsentir+V.tu.AD.2.SG+PRS+3+SG
desconsente-vos	desconsentir+V.vós.AD.2.PL+PRS+3+SG
desconsentia-a	desconsentir+V.ele.ACC.3.F.SG+IMPF+1+SG
desconsentia-a	desconsentir+V.ele.ACC.3.F.SG+IMPF+3+SG
desconsentia-as	desconsentir+V.ele.ACC.3.F.PL+IMPF+1+SG
desconsentia-as	desconsentir+V.ele.ACC.3.F.PL+IMPF+3+SG
desconsenti-a	desconsentir+V.ele.ACC.3.F.SG+PRF+1+SG
desconsentia-la	desconsentir+V.ele.ACC.3.F.SG+IMPF+2+SG
desconsentia-las	desconsentir+V.ele.ACC.3.F.PL+IMPF+2+SG
desconsentia-lhe	desconsentir+V.ele.DAT.3.SG+IMPF+1+SG
desconsentia-lhe	desconsentir+V.ele.DAT.3.SG+IMPF+3+SG
desconsentia-lhes	desconsentir+V.ele.DAT.3.PL+IMPF+1+SG
desconsentia-lhes	desconsentir+V.ele.DAT.3.PL+IMPF+3+SG
desconsentia-lo	desconsentir+V.ele.ACC.3.M.SG+IMPF+2+SG
desconsentia-los	desconsentir+V.ele.ACC.3.M.PL+IMPF+2+SG
desconsentia-me	desconsentir+V.eu.AD.1.SG+IMPF+1+SG
desconsentia-me	desconsentir+V.eu.AD.1.SG+IMPF+3+SG
desconsentiam-lhe	desconsentir+V.ele.DAT.3.SG+IMPF+3+PL
desconsentiam-lhes	desconsentir+V.ele.DAT.3.PL+IMPF+3+PL
desconsentiam-me	desconsentir+V.eu.AD.1.SG+IMPF+3+PL
desconsentiam-na	desconsentir+V.ele.ACC.3.F.SG+IMPF+3+PL
desconsentiam-nas	desconsentir+V.ele.ACC.3.F.PL+IMPF+3+PL
desconsentiam-no	desconsentir+V.ele.ACC.3.M.SG+IMPF+3+PL
desconsentiam-nos	desconsentir+V.ele.ACC.3.M.PL+IMPF+3+PL
desconsentiam-nos	desconsentir+V.nós.AD.1.PL+IMPF+3+PL
desconsentíamo-la	desconsentir+V.ele.ACC.3.F.SG+IMPF+1+PL
desconsentíamo-las	desconsentir+V.ele.ACC.3.F.PL+IMPF+1+PL
desconsentíamo-lo	desconsentir+V.ele.ACC.3.M.SG+IMPF+1+PL
desconsentíamo-los	desconsentir+V.ele.ACC.3.M.PL+IMPF+1+PL
desconsentíamo-nos	desconsentir+nós.AD.1.PL+IMPF+1+PL
desconsentíamos-lhe	desconsentir+V.ele.DAT.3.SG+IMPF+1+PL
desconsentíamos-lhes	desconsentir+V.ele.DAT.3.PL+IMPF+1+PL
desconsentíamos-me	desconsentir+V.eu.AD.1.SG+IMPF+1+PL
desconsentíamos-te	desconsentir+V.tu.AD.2.SG+IMPF+1+PL
desconsentíamos-vos	desconsentir+V.vós.AD.2.PL+IMPF+1+PL
desconsentiam-se	desconsentir+V.ele.REFL+IMPF+3+PL
desconsentiam-te	desconsentir+V.tu.AD.2.SG+IMPF+3+PL
desconsentiam-vos	desconsentir+V.vós.AD.2.PL+IMPF+3+PL
desconsentia-nos	desconsentir+nós.AD.1.PL+IMPF+1+SG
desconsentia-nos	desconsentir+nós.AD.1.PL+IMPF+2+SG
desconsentia-nos	desconsentir+nós.AD.1.PL+IMPF+3+SG
desconsentia-o	desconsentir+V.ele.ACC.3.M.SG+IMPF+1+SG
desconsentia-o	desconsentir+V.ele.ACC.3.M.SG+IMPF+3+SG
desconsentia-os	desconsentir+V.ele.ACC.3.M.PL+IMPF+1+SG
desconsentia-os	desconsentir+V.ele.ACC.3.M.PL+IMPF+3+SG
desconsenti-as	desconsentir+V.ele.ACC.3.F.PL+PRF+1+SG
desconsentia-se	desconsentir+V.ele.REFL+IMPF+3+SG
desconsentias-lhe	desconsentir+V.ele.DAT.3.SG+IMPF+2+SG
desconsentias-lhes	desconsentir+V.ele.DAT.3.PL+IMPF+2+SG
desconsentias-me	desconsentir+V.eu.AD.1.SG+IMPF+2+SG
desconsentias-te	desconsentir+V.tu.AD.2.SG+IMPF+2+SG
desconsentias-vos	desconsentir+V.vós.AD.2.PL+IMPF+2+SG
desconsentia-te	desconsentir+V.tu.AD.2.SG+IMPF+1+SG
desconsentia-te	desconsentir+V.tu.AD.2.SG+IMPF+3+SG
desconsentia-vos	desconsentir+V.vós.AD.2.PL+IMPF+1+SG
desconsentia-vos	desconsentir+V.vós.AD.2.PL+IMPF+3+SG
desconsentíei-la	desconsentir+V.ele.ACC.3.F.SG+IMPF+2+PL
desconsentíei-las	desconsentir+V.ele.ACC.3.F.PL+IMPF+2+PL
desconsentíei-lo	desconsentir+V.ele.ACC.3.M.SG+IMPF+2+PL
desconsentíei-los	desconsentir+V.ele.ACC.3.M.PL+IMPF+2+PL
desconsentíei-nos	desconsentir+nós.AD.1.PL+IMPF+2+PL
desconsentíeis-lhe	desconsentir+V.ele.DAT.3.SG+IMPF+2+PL
desconsentíeis-lhes	desconsentir+V.ele.DAT.3.PL+IMPF+2+PL
desconsentíeis-me	desconsentir+V.eu.AD.1.SG+IMPF+2+PL
desconsentíeis-te	desconsentir+V.tu.AD.2.SG+IMPF+2+PL
desconsentíeis-vos	desconsentir+V.vós.AD.2.PL+IMPF+2+PL
desconsenti-la-á	desconsentir+V.ele.ACC.3.F.SG+FUT+3+SG
desconsenti-la-ão	desconsentir+V.ele.ACC.3.F.SG+FUT+3+PL
desconsenti-la-ás	desconsentir+V.ele.ACC.3.F.SG+FUT+2+SG
desconsenti-la	desconsentir+V.ele.ACC.3.F.SG+INF+1+SG
desconsenti-la	desconsentir+V.ele.ACC.3.F.SG+INF+3+SG
desconsenti-la	desconsentir+V.ele.ACC.3.F.SG+PRS+2+PL
desconsenti-la	desconsentir+V.ele.ACC.3.F.SG+SBJF+1+SG
desconsenti-la	desconsentir+V.ele.ACC.3.F.SG+SBJF+3+SG
desconsenti-la-ei	desconsentir+V.ele.ACC.3.F.SG+FUT+1+SG
desconsenti-la-eis	desconsentir+V.ele.ACC.3.F.SG+FUT+2+PL
desconsenti-la-emos	desconsentir+V.ele.ACC.3.F.SG+FUT+1+PL
desconsenti-la-ia	desconsentir+V.ele.ACC.3.F.SG+COND+1+SG
desconsenti-la-ia	desconsentir+V.ele.ACC.3.F.SG+COND+3+SG
desconsenti-la-iam	desconsentir+V.ele.ACC.3.F.SG+COND+3+PL
desconsenti-la-íamos	desconsentir+V.ele.ACC.3.F.SG+COND+1+PL
desconsenti-la-ias	desconsentir+V.ele.ACC.3.F.SG+COND+2+SG
desconsenti-la-íeis	desconsentir+V.ele.ACC.3.F.SG+COND+2+PL
desconsenti-las-á	desconsentir+V.ele.ACC.3.F.PL+FUT+3+SG
desconsenti-las-ão	desconsentir+V.ele.ACC.3.F.PL+FUT+3+PL
desconsenti-las-ás	desconsentir+V.ele.ACC.3.F.PL+FUT+2+SG
desconsenti-las	desconsentir+V.ele.ACC.3.F.PL+INF+1+SG
desconsenti-las	desconsentir+V.ele.ACC.3.F.PL+INF+3+SG
desconsenti-las	desconsentir+V.ele.ACC.3.F.PL+PRS+2+PL
desconsenti-las	desconsentir+V.ele.ACC.3.F.PL+SBJF+1+SG
desconsenti-las	desconsentir+V.ele.ACC.3.F.PL+SBJF+3+SG
desconsenti-las-ei	desconsentir+V.ele.ACC.3.F.PL+FUT+1+SG
desconsenti-las-eis	desconsentir+V.ele.ACC.3.F.PL+FUT+2+PL
desconsenti-las-emos	desconsentir+V.ele.ACC.3.F.PL+FUT+1+PL
desconsenti-las-ia	desconsentir+V.ele.ACC.3.F.PL+COND+1+SG
desconsenti-las-ia	desconsentir+V.ele.ACC.3.F.PL+COND+3+SG
desconsenti-las-iam	desconsentir+V.ele.ACC.3.F.PL+COND+3+PL
desconsenti-las-íamos	desconsentir+V.ele.ACC.3.F.PL+COND+1+PL
desconsenti-las-ias	desconsentir+V.ele.ACC.3.F.PL+COND+2+SG
desconsenti-las-íeis	desconsentir+V.ele.ACC.3.F.PL+COND+2+PL
desconsenti-lhe	desconsentir+V.ele.DAT.3.SG+PRF+1+SG
desconsenti-lhes	desconsentir+V.ele.DAT.3.PL+PRF+1+SG
desconsenti-lo-á	desconsentir+V.ele.ACC.3.M.SG+FUT+3+SG
desconsenti-lo-ão	desconsentir+V.ele.ACC.3.M.SG+FUT+3+PL
desconsenti-lo-ás	desconsentir+V.ele.ACC.3.M.SG+FUT+2+SG
desconsenti-lo	desconsentir+V.ele.ACC.3.M.SG+INF+1+SG
desconsenti-lo	desconsentir+V.ele.ACC.3.M.SG+INF+3+SG
desconsenti-lo	desconsentir+V.ele.ACC.3.M.SG+PRS+2+PL
desconsenti-lo	desconsentir+V.ele.ACC.3.M.SG+SBJF+1+SG
desconsenti-lo	desconsentir+V.ele.ACC.3.M.SG+SBJF+3+SG
desconsenti-lo-ei	desconsentir+V.ele.ACC.3.M.SG+FUT+1+SG
desconsenti-lo-eis	desconsentir+V.ele.ACC.3.M.SG+FUT+2+PL
desconsenti-lo-emos	desconsentir+V.ele.ACC.3.M.SG+FUT+1+PL
desconsenti-lo-ia	desconsentir+V.ele.ACC.3.M.SG+COND+1+SG
desconsenti-lo-ia	desconsentir+V.ele.ACC.3.M.SG+COND+3+SG
desconsenti-lo-iam	desconsentir+V.ele.ACC.3.M.SG+COND+3+PL
desconsenti-lo-íamos	desconsentir+V.ele.ACC.3.M.SG+COND+1+PL
desconsenti-lo-ias	desconsentir+V.ele.ACC.3.M.SG+COND+2+SG
desconsenti-lo-íeis	desconsentir+V.ele.ACC.3.M.SG+COND+2+PL
desconsenti-los-á	desconsentir+V.ele.ACC.3.M.PL+FUT+3+SG
desconsenti-los-ão	desconsentir+V.ele.ACC.3.M.PL+FUT+3+PL
desconsenti-los-ás	desconsentir+V.ele.ACC.3.M.PL+FUT+2+SG
desconsenti-los	desconsentir+V.ele.ACC.3.M.PL+INF+1+SG
desconsenti-los	desconsentir+V.ele.ACC.3.M.PL+INF+3+SG
desconsenti-los	desconsentir+V.ele.ACC.3.M.PL+PRS+2+PL
desconsenti-los	desconsentir+V.ele.ACC.3.M.PL+SBJF+1+SG
desconsenti-los	desconsentir+V.ele.ACC.3.M.PL+SBJF+3+SG
desconsenti-los-ei	desconsentir+V.ele.ACC.3.M.PL+FUT+1+SG
desconsenti-los-eis	desconsentir+V.ele.ACC.3.M.PL+FUT+2+PL
desconsenti-los-emos	desconsentir+V.ele.ACC.3.M.PL+FUT+1+PL
desconsenti-los-ia	desconsentir+V.ele.ACC.3.M.PL+COND+1+SG
desconsenti-los-ia	desconsentir+V.ele.ACC.3.M.PL+COND+3+SG
desconsenti-los-iam	desconsentir+V.ele.ACC.3.M.PL+COND+3+PL
desconsenti-los-íamos	desconsentir+V.ele.ACC.3.M.PL+COND+1+PL
desconsenti-los-ias	desconsentir+V.ele.ACC.3.M.PL+COND+2+SG
desconsenti-los-íeis	desconsentir+V.ele.ACC.3.M.PL+COND+2+PL
desconsenti-me	desconsentir+V.eu.AD.1.SG+PRF+1+SG
desconsentimo-la	desconsentir+V.ele.ACC.3.F.SG+PRF+1+PL
desconsentimo-la	desconsentir+V.ele.ACC.3.F.SG+PRS+1+PL
desconsentimo-las	desconsentir+V.ele.ACC.3.F.PL+PRF+1+PL
desconsentimo-las	desconsentir+V.ele.ACC.3.F.PL+PRS+1+PL
desconsentimo-lo	desconsentir+V.ele.ACC.3.M.SG+PRF+1+PL
desconsentimo-lo	desconsentir+V.ele.ACC.3.M.SG+PRS+1+PL
desconsentimo-los	desconsentir+V.ele.ACC.3.M.PL+PRF+1+PL
desconsentimo-los	desconsentir+V.ele.ACC.3.M.PL+PRS+1+PL
desconsentimo-nos	desconsentir+nós.AD.1.PL+PRF+1+PL
desconsentimo-nos	desconsentir+nós.AD.1.PL+PRS+1+PL
desconsentimos-lhe	desconsentir+V.ele.DAT.3.SG+PRF+1+PL
desconsentimos-lhe	desconsentir+V.ele.DAT.3.SG+PRS+1+PL
desconsentimos-lhes	desconsentir+V.ele.DAT.3.PL+PRF+1+PL
desconsentimos-lhes	desconsentir+V.ele.DAT.3.PL+PRS+1+PL
desconsentimos-me	desconsentir+V.eu.AD.1.SG+PRF+1+PL
desconsentimos-me	desconsentir+V.eu.AD.1.SG+PRS+1+PL
desconsentimos-te	desconsentir+V.tu.AD.2.SG+PRF+1+PL
desconsentimos-te	desconsentir+V.tu.AD.2.SG+PRS+1+PL
desconsentimos-vos	desconsentir+V.vós.AD.2.PL+PRF+1+PL
desconsentimos-vos	desconsentir+V.vós.AD.2.PL+PRS+1+PL
desconsentindo-a	desconsentir+V.ele.ACC.3.F.SG+GRD
desconsentindo-as	desconsentir+V.ele.ACC.3.F.PL+GRD
desconsentindo-lhe	desconsentir+V.ele.DAT.3.SG+GRD
desconsentindo-lhes	desconsentir+V.ele.DAT.3.PL+GRD
desconsentindo-me	desconsentir+V.eu.AD.1.SG+GRD
desconsentindo-nos	desconsentir+nós.AD.1.PL+GRD
desconsentindo-o	desconsentir+V.ele.ACC.3.M.SG+GRD
desconsentindo-os	desconsentir+V.ele.ACC.3.M.PL+GRD
desconsentindo-se	desconsentir+V.ele.REFL+GRD
desconsentindo-te	desconsentir+V.tu.AD.2.SG+GRD
desconsentindo-vos	desconsentir+V.vós.AD.2.PL+GRD
desconsenti-nos	desconsentir+nós.AD.1.PL+PRF+1+SG
desconsenti-nos	desconsentir+nós.AD.1.PL+PRS+2+PL
desconsenti-o	desconsentir+V.ele.ACC.3.M.SG+PRF+1+SG
desconsenti-os	desconsentir+V.ele.ACC.3.M.PL+PRF+1+SG
desconsentiram-lhe	desconsentir+V.ele.DAT.3.SG+PRF+3+PL
desconsentiram-lhes	desconsentir+V.ele.DAT.3.PL+PRF+3+PL
desconsentiram-me	desconsentir+V.eu.AD.1.SG+PRF+3+PL
desconsentiram-na	desconsentir+V.ele.ACC.3.F.SG+PRF+3+PL
desconsentiram-nas	desconsentir+V.ele.ACC.3.F.PL+PRF+3+PL
desconsentiram-no	desconsentir+V.ele.ACC.3.M.SG+PRF+3+PL
desconsentiram-nos	desconsentir+V.ele.ACC.3.M.PL+PRF+3+PL
desconsentiram-nos	desconsentir+V.nós.AD.1.PL+PRF+3+PL
desconsentiram-se	desconsentir+V.ele.REFL+PRF+3+PL
desconsentiram-te	desconsentir+V.tu.AD.2.SG+PRF+3+PL
desconsentiram-vos	desconsentir+V.vós.AD.2.PL+PRF+3+PL
desconsentirde-la	desconsentir+V.ele.ACC.3.F.SG+INF+2+PL
desconsentirde-la	desconsentir+V.ele.ACC.3.F.SG+SBJF+2+PL
desconsentirde-las	desconsentir+V.ele.ACC.3.F.PL+INF+2+PL
desconsentirde-las	desconsentir+V.ele.ACC.3.F.PL+SBJF+2+PL
desconsentirde-lo	desconsentir+V.ele.ACC.3.M.SG+INF+2+PL
desconsentirde-lo	desconsentir+V.ele.ACC.3.M.SG+SBJF+2+PL
desconsentirde-los	desconsentir+V.ele.ACC.3.M.PL+INF+2+PL
desconsentirde-los	desconsentir+V.ele.ACC.3.M.PL+SBJF+2+PL
desconsentirde-nos	desconsentir+nós.AD.1.PL+INF+2+PL
desconsentirde-nos	desconsentir+nós.AD.1.PL+SBJF+2+PL
desconsentirdes-lhe	desconsentir+V.ele.DAT.3.SG+INF+2+PL
desconsentirdes-lhe	desconsentir+V.ele.DAT.3.SG+SBJF+2+PL
desconsentirdes-lhes	desconsentir+V.ele.DAT.3.PL+INF+2+PL
desconsentirdes-lhes	desconsentir+V.ele.DAT.3.PL+SBJF+2+PL
desconsentirdes-me	desconsentir+V.eu.AD.1.SG+INF+2+PL
desconsentirdes-me	desconsentir+V.eu.AD.1.SG+SBJF+2+PL
desconsentirdes-te	desconsentir+V.tu.AD.2.SG+INF+2+PL
desconsentirdes-te	desconsentir+V.tu.AD.2.SG+SBJF+2+PL
desconsentirdes-vos	desconsentir+V.vós.AD.2.PL+INF+2+PL
desconsentirdes-vos	desconsentir+V.vós.AD.2.PL+SBJF+2+PL
desconsentire-la	desconsentir+V.ele.ACC.3.F.SG+INF+2+SG
desconsentire-la	desconsentir+V.ele.ACC.3.F.SG+SBJF+2+SG
desconsentire-las	desconsentir+V.ele.ACC.3.F.PL+INF+2+SG
desconsentire-las	desconsentir+V.ele.ACC.3.F.PL+SBJF+2+SG
desconsentire-lo	desconsentir+V.ele.ACC.3.M.SG+INF+2+SG
desconsentire-lo	desconsentir+V.ele.ACC.3.M.SG+SBJF+2+SG
desconsentire-los	desconsentir+V.ele.ACC.3.M.PL+INF+2+SG
desconsentire-los	desconsentir+V.ele.ACC.3.M.PL+SBJF+2+SG
desconsentirem-lhe	desconsentir+V.ele.DAT.3.SG+INF+3+PL
desconsentirem-lhe	desconsentir+V.ele.DAT.3.SG+SBJF+3+PL
desconsentirem-lhes	desconsentir+V.ele.DAT.3.PL+INF+3+PL
desconsentirem-lhes	desconsentir+V.ele.DAT.3.PL+SBJF+3+PL
desconsentirem-me	desconsentir+V.eu.AD.1.SG+INF+3+PL
desconsentirem-me	desconsentir+V.eu.AD.1.SG+SBJF+3+PL
desconsentirem-na	desconsentir+V.ele.ACC.3.F.SG+INF+3+PL
desconsentirem-na	desconsentir+V.ele.ACC.3.F.SG+SBJF+3+PL
desconsentirem-nas	desconsentir+V.ele.ACC.3.F.PL+INF+3+PL
desconsentirem-nas	desconsentir+V.ele.ACC.3.F.PL+SBJF+3+PL
desconsentirem-no	desconsentir+V.ele.ACC.3.M.SG+INF+3+PL
desconsentirem-no	desconsentir+V.ele.ACC.3.M.SG+SBJF+3+PL
desconsentirem-nos	desconsentir+V.ele.ACC.3.M.PL+INF+3+PL
desconsentirem-nos	desconsentir+V.ele.ACC.3.M.PL+SBJF+3+PL
desconsentirem-nos	desconsentir+V.nós.AD.1.PL+INF+3+PL
desconsentirem-nos	desconsentir+V.nós.AD.1.PL+SBJF+3+PL
desconsentirem-se	desconsentir+V.ele.REFL+INF+3+PL
desconsentirem-se	desconsentir+V.ele.REFL+SBJF+3+PL
desconsentirem-te	desconsentir+V.tu.AD.2.SG+INF+3+PL
desconsentirem-te	desconsentir+V.tu.AD.2.SG+SBJF+3+PL
desconsentirem-vos	desconsentir+V.vós.AD.2.PL+INF+3+PL
desconsentirem-vos	desconsentir+V.vós.AD.2.PL+SBJF+3+PL
desconsentire-nos	desconsentir+nós.AD.1.PL+INF+2+SG
desconsentire-nos	desconsentir+nós.AD.1.PL+SBJF+2+SG
desconsentires-lhe	desconsentir+V.ele.DAT.3.SG+INF+2+SG
desconsentires-lhe	desconsentir+V.ele.DAT.3.SG+SBJF+2+SG
desconsentires-lhes	desconsentir+V.ele.DAT.3.PL+INF+2+SG
desconsentires-lhes	desconsentir+V.ele.DAT.3.PL+SBJF+2+SG
desconsentires-me	desconsentir+V.eu.AD.1.SG+INF+2+SG
desconsentires-me	desconsentir+V.eu.AD.1.SG+SBJF+2+SG
desconsentires-te	desconsentir+V.tu.AD.2.SG+INF+2+SG
desconsentires-te	desconsentir+V.tu.AD.2.SG+SBJF+2+SG
desconsentires-vos	desconsentir+V.vós.AD.2.PL+INF+2+SG
desconsentires-vos	desconsentir+V.vós.AD.2.PL+SBJF+2+SG
desconsentir-lhe-á	desconsentir+V.ele.DAT.3.SG+FUT+3+SG
desconsentir-lhe-ão	desconsentir+V.ele.DAT.3.SG+FUT+3+PL
desconsentir-lhe-ás	desconsentir+V.ele.DAT.3.SG+FUT+2+SG
desconsentir-lhe	desconsentir+V.ele.DAT.3.SG+INF
desconsentir-lhe	desconsentir+V.ele.DAT.3.SG+INF+1+SG
desconsentir-lhe	desconsentir+V.ele.DAT.3.SG+INF+3+SG
desconsentir-lhe	desconsentir+V.ele.DAT.3.SG+SBJF+1+SG
desconsentir-lhe	desconsentir+V.ele.DAT.3.SG+SBJF+3+SG
desconsentir-lhe-ei	desconsentir+V.ele.DAT.3.SG+FUT+1+SG
desconsentir-lhe-eis	desconsentir+V.ele.DAT.3.SG+FUT+2+PL
desconsentir-lhe-emos	desconsentir+V.ele.DAT.3.SG+FUT+1+PL
desconsentir-lhe-ia	desconsentir+V.ele.DAT.3.SG+COND+1+SG
desconsentir-lhe-ia	desconsentir+V.ele.DAT.3.SG+COND+3+SG
desconsentir-lhe-iam	desconsentir+V.ele.DAT.3.SG+COND+3+PL
desconsentir-lhe-íamos	desconsentir+V.ele.DAT.3.SG+COND+1+PL
desconsentir-lhe-ias	desconsentir+V.ele.DAT.3.SG+COND+2+SG
desconsentir-lhe-íeis	desconsentir+V.ele.DAT.3.SG+COND+2+PL
desconsentir-lhes-á	desconsentir+V.ele.DAT.3.PL+FUT+3+SG
desconsentir-lhes-ão	desconsentir+V.ele.DAT.3.PL+FUT+3+PL
desconsentir-lhes-ás	desconsentir+V.ele.DAT.3.PL+FUT+2+SG
desconsentir-lhes	desconsentir+V.ele.DAT.3.PL+INF
desconsentir-lhes	desconsentir+V.ele.DAT.3.PL+INF+1+SG
desconsentir-lhes	desconsentir+V.ele.DAT.3.PL+INF+3+SG
desconsentir-lhes	desconsentir+V.ele.DAT.3.PL+SBJF+1+SG
desconsentir-lhes	desconsentir+V.ele.DAT.3.PL+SBJF+3+SG
desconsentir-lhes-ei	desconsentir+V.ele.DAT.3.PL+FUT+1+SG
desconsentir-lhes-eis	desconsentir+V.ele.DAT.3.PL+FUT+2+PL
desconsentir-lhes-emos	desconsentir+V.ele.DAT.3.PL+FUT+1+PL
desconsentir-lhes-ia	desconsentir+V.ele.DAT.3.PL+COND+1+SG
desconsentir-lhes-ia	desconsentir+V.ele.DAT.3.PL+COND+3+SG
desconsentir-lhes-iam	desconsentir+V.ele.DAT.3.PL+COND+3+PL
desconsentir-lhes-íamos	desconsentir+V.ele.DAT.3.PL+COND+1+PL
desconsentir-lhes-ias	desconsentir+V.ele.DAT.3.PL+COND+2+SG
desconsentir-lhes-íeis	desconsentir+V.ele.DAT.3.PL+COND+2+PL
desconsentir-me-á	desconsentir+V.eu.AD.1.SG+FUT+3+SG
desconsentir-me-ão	desconsentir+V.eu.AD.1.SG+FUT+3+PL
desconsentir-me-ás	desconsentir+V.eu.AD.1.SG+FUT+2+SG
desconsentir-me	desconsentir+V.eu.AD.1.SG+INF
desconsentir-me	desconsentir+V.eu.AD.1.SG+INF+1+SG
desconsentir-me	desconsentir+V.eu.AD.1.SG+INF+3+SG
desconsentir-me	desconsentir+V.eu.AD.1.SG+SBJF+1+SG
desconsentir-me	desconsentir+V.eu.AD.1.SG+SBJF+3+SG
desconsentir-me-ei	desconsentir+V.eu.AD.1.SG+FUT+1+SG
desconsentir-me-eis	desconsentir+V.eu.AD.1.SG+FUT+2+PL
desconsentir-me-emos	desconsentir+V.eu.AD.1.SG+FUT+1+PL
desconsentir-me-ia	desconsentir+V.eu.AD.1.SG+COND+1+SG
desconsentir-me-ia	desconsentir+V.eu.AD.1.SG+COND+3+SG
desconsentir-me-iam	desconsentir+V.eu.AD.1.SG+COND+3+PL
desconsentir-me-íamos	desconsentir+V.eu.AD.1.SG+COND+1+PL
desconsentir-me-ias	desconsentir+V.eu.AD.1.SG+COND+2+SG
desconsentir-me-íeis	desconsentir+V.eu.AD.1.SG+COND+2+PL
desconsentirmo-la	desconsentir+V.ele.ACC.3.F.SG+INF+1+PL
desconsentirmo-la	desconsentir+V.ele.ACC.3.F.SG+SBJF+1+PL
desconsentirmo-las	desconsentir+V.ele.ACC.3.F.PL+INF+1+PL
desconsentirmo-las	desconsentir+V.ele.ACC.3.F.PL+SBJF+1+PL
desconsentirmo-lo	desconsentir+V.ele.ACC.3.M.SG+INF+1+PL
desconsentirmo-lo	desconsentir+V.ele.ACC.3.M.SG+SBJF+1+PL
desconsentirmo-los	desconsentir+V.ele.ACC.3.M.PL+INF+1+PL
desconsentirmo-los	desconsentir+V.ele.ACC.3.M.PL+SBJF+1+PL
desconsentirmo-nos	desconsentir+nós.AD.1.PL+INF+1+PL
desconsentirmo-nos	desconsentir+nós.AD.1.PL+SBJF+1+PL
desconsentirmos-lhe	desconsentir+V.ele.DAT.3.SG+INF+1+PL
desconsentirmos-lhe	desconsentir+V.ele.DAT.3.SG+SBJF+1+PL
desconsentirmos-lhes	desconsentir+V.ele.DAT.3.PL+INF+1+PL
desconsentirmos-lhes	desconsentir+V.ele.DAT.3.PL+SBJF+1+PL
desconsentirmos-me	desconsentir+V.eu.AD.1.SG+INF+1+PL
desconsentirmos-me	desconsentir+V.eu.AD.1.SG+SBJF+1+PL
desconsentirmos-te	desconsentir+V.tu.AD.2.SG+INF+1+PL
desconsentirmos-te	desconsentir+V.tu.AD.2.SG+SBJF+1+PL
desconsentirmos-vos	desconsentir+V.vós.AD.2.PL+INF+1+PL
desconsentirmos-vos	desconsentir+V.vós.AD.2.PL+SBJF+1+PL
desconsentir-nos-á	desconsentir+nós.AD.1.PL+FUT+3+SG
desconsentir-nos-ão	desconsentir+nós.AD.1.PL+FUT+3+PL
desconsentir-nos-ás	desconsentir+nós.AD.1.PL+FUT+2+SG
desconsentir-nos	desconsentir+nós.AD.1.PL+INF
desconsentir-nos	desconsentir+nós.AD.1.PL+INF+1+SG
desconsentir-nos	desconsentir+nós.AD.1.PL+INF+3+SG
desconsentir-nos	desconsentir+nós.AD.1.PL+SBJF+1+SG
desconsentir-nos	desconsentir+nós.AD.1.PL+SBJF+3+SG
desconsentir-nos-ei	desconsentir+nós.AD.1.PL+FUT+1+SG
desconsentir-nos-eis	desconsentir+nós.AD.1.PL+FUT+2+PL
desconsentir-nos-emos	desconsentir+nós.AD.1.PL+FUT+1+PL
desconsentir-nos-ia	desconsentir+nós.AD.1.PL+COND+1+SG
desconsentir-nos-ia	desconsentir+nós.AD.1.PL+COND+3+SG
desconsentir-nos-iam	desconsentir+nós.AD.1.PL+COND+3+PL
desconsentir-nos-íamos	desconsentir+nós.AD.1.PL+COND+1+PL
desconsentir-nos-ias	desconsentir+nós.AD.1.PL+COND+2+SG
desconsentir-nos-íeis	desconsentir+nós.AD.1.PL+COND+2+PL
desconsentir-se-á	desconsentir+V.ele.REFL+FUT+3+SG
desconsentir-se-ão	desconsentir+V.ele.REFL+FUT+3+PL
desconsentir-se	desconsentir+V.ele.REFL+INF
desconsentir-se	desconsentir+V.ele.REFL+INF+3+SG
desconsentir-se	desconsentir+V.ele.REFL+SBJF+3+SG
desconsentir-se-ia	desconsentir+V.ele.REFL+COND+3+SG
desconsentir-se-iam	desconsentir+V.ele.REFL+COND+3+PL
desconsentir-te-á	desconsentir+V.tu.AD.2.SG+FUT+3+SG
desconsentir-te-ão	desconsentir+V.tu.AD.2.SG+FUT+3+PL
desconsentir-te-ás	desconsentir+V.tu.AD.2.SG+FUT+2+SG
desconsentir-te	desconsentir+V.tu.AD.2.SG+INF
desconsentir-te	desconsentir+V.tu.AD.2.SG+INF+1+SG
desconsentir-te	desconsentir+V.tu.AD.2.SG+INF+3+SG
desconsentir-te	desconsentir+V.tu.AD.2.SG+SBJF+1+SG
desconsentir-te	desconsentir+V.tu.AD.2.SG+SBJF+3+SG
desconsentir-te-ei	desconsentir+V.tu.AD.2.SG+FUT+1+SG
desconsentir-te-eis	desconsentir+V.tu.AD.2.SG+FUT+2+PL
desconsentir-te-emos	desconsentir+V.tu.AD.2.SG+FUT+1+PL
desconsentir-te-ia	desconsentir+V.tu.AD.2.SG+COND+1+SG
desconsentir-te-ia	desconsentir+V.tu.AD.2.SG+COND+3+SG
desconsentir-te-iam	desconsentir+V.tu.AD.2.SG+COND+3+PL
desconsentir-te-íamos	desconsentir+V.tu.AD.2.SG+COND+1+PL
desconsentir-te-ias	desconsentir+V.tu.AD.2.SG+COND+2+SG
desconsentir-te-íeis	desconsentir+V.tu.AD.2.SG+COND+2+PL
desconsentir-vos-á	desconsentir+V.vós.AD.2.PL+FUT+3+SG
desconsentir-vos-ão	desconsentir+V.vós.AD.2.PL+FUT+3+PL
desconsentir-vos-ás	desconsentir+V.vós.AD.2.PL+FUT+2+SG
desconsentir-vos	desconsentir+V.vós.AD.2.PL+INF
desconsentir-vos	desconsentir+V.vós.AD.2.PL+INF+1+SG
desconsentir-vos	desconsentir+V.vós.AD.2.PL+INF+3+SG
desconsentir-vos	desconsentir+V.vós.AD.2.PL+SBJF+1+SG
desconsentir-vos	desconsentir+V.vós.AD.2.PL+SBJF+3+SG
desconsentir-vos-ei	desconsentir+V.vós.AD.2.PL+FUT+1+SG
desconsentir-vos-eis	desconsentir+V.vós.AD.2.PL+FUT+2+PL
desconsentir-vos-emos	desconsentir+V.vós.AD.2.PL+FUT+1+PL
desconsentir-vos-ia	desconsentir+V.vós.AD.2.PL+COND+1+SG
desconsentir-vos-ia	desconsentir+V.vós.AD.2.PL+COND+3+SG
desconsentir-vos-iam	desconsentir+V.vós.AD.2.PL+COND+3+PL
desconsentir-vos-íamos	desconsentir+V.vós.AD.2.PL+COND+1+PL
desconsentir-vos-ias	desconsentir+V.vós.AD.2.PL+COND+2+SG
desconsentir-vos-íeis	desconsentir+V.vós.AD.2.PL+COND+2+PL
desconsentis-lhe	desconsentir+V.ele.DAT.3.SG+PRS+2+PL
desconsentis-lhes	desconsentir+V.ele.DAT.3.PL+PRS+2+PL
desconsentis-me	desconsentir+V.eu.AD.1.SG+PRS+2+PL
desconsentiste-a	desconsentir+V.ele.ACC.3.F.SG+PRF+2+SG
desconsentiste-as	desconsentir+V.ele.ACC.3.F.PL+PRF+2+SG
desconsentis-te	desconsentir+V.tu.AD.2.SG+PRS+2+PL
desconsentiste-la	desconsentir+V.ele.ACC.3.F.SG+PRF+2+PL
desconsentiste-las	desconsentir+V.ele.ACC.3.F.PL+PRF+2+PL
desconsentiste-lhe	desconsentir+V.ele.DAT.3.SG+PRF+2+SG
desconsentiste-lhes	desconsentir+V.ele.DAT.3.PL+PRF+2+SG
desconsentiste-lo	desconsentir+V.ele.ACC.3.M.SG+PRF+2+PL
desconsentiste-los	desconsentir+V.ele.ACC.3.M.PL+PRF+2+PL
desconsentiste-me	desconsentir+V.eu.AD.1.SG+PRF+2+SG
desconsentiste-nos	desconsentir+nós.AD.1.PL+PRF+2+PL
desconsentiste-nos	desconsentir+nós.AD.1.PL+PRF+2+SG
desconsentiste-o	desconsentir+V.ele.ACC.3.M.SG+PRF+2+SG
desconsentiste-os	desconsentir+V.ele.ACC.3.M.PL+PRF+2+SG
desconsentistes-lhe	desconsentir+V.ele.DAT.3.SG+PRF+2+PL
desconsentistes-lhes	desconsentir+V.ele.DAT.3.PL+PRF+2+PL
desconsentistes-me	desconsentir+V.eu.AD.1.SG+PRF+2+PL
desconsentistes-te	desconsentir+V.tu.AD.2.SG+PRF+2+PL
desconsentistes-vos	desconsentir+V.vós.AD.2.PL+PRF+2+PL
desconsentiste-te	desconsentir+V.tu.AD.2.SG+PRF+2+SG
desconsentiste-vos	desconsentir+V.vós.AD.2.PL+PRF+2+SG
desconsentis-vos	desconsentir+V.vós.AD.2.PL+PRS+2+PL
desconsenti-te	desconsentir+V.tu.AD.2.SG+PRF+1+SG
desconsentiu-a	desconsentir+V.ele.ACC.3.F.SG+PRF+3+SG
desconsentiu-as	desconsentir+V.ele.ACC.3.F.PL+PRF+3+SG
desconsentiu-lhe	desconsentir+V.ele.DAT.3.SG+PRF+3+SG
desconsentiu-lhes	desconsentir+V.ele.DAT.3.PL+PRF+3+SG
desconsentiu-me	desconsentir+V.eu.AD.1.SG+PRF+3+SG
desconsentiu-nos	desconsentir+nós.AD.1.PL+PRF+3+SG
desconsentiu-o	desconsentir+V.ele.ACC.3.M.SG+PRF+3+SG
desconsentiu-os	desconsentir+V.ele.ACC.3.M.PL+PRF+3+SG
desconsentiu-se	desconsentir+V.ele.REFL+PRF+3+SG
desconsentiu-te	desconsentir+V.tu.AD.2.SG+PRF+3+SG
desconsentiu-vos	desconsentir+V.vós.AD.2.PL+PRF+3+SG
desconsenti-vos	desconsentir+V.vós.AD.2.PL+PRF+1+SG
desconserta-a	desconsertar+V.ele.ACC.3.F.SG+PRS+3+SG
desconserta-as	desconsertar+V.ele.ACC.3.F.PL+PRS+3+SG
desconsertai-la	desconsertar+V.ele.ACC.3.F.SG+PRS+2+PL
desconsertai-las	desconsertar+V.ele.ACC.3.F.PL+PRS+2+PL
desconsertai-lo	desconsertar+V.ele.ACC.3.M.SG+PRS+2+PL
desconsertai-los	desconsertar+V.ele.ACC.3.M.PL+PRS+2+PL
desconsertai-nos	desconsertar+nós.AD.1.PL+PRS+2+PL
desconsertais-lhe	desconsertar+V.ele.DAT.3.SG+PRS+2+PL
desconsertais-lhes	desconsertar+V.ele.DAT.3.PL+PRS+2+PL
desconsertais-me	desconsertar+V.eu.AD.1.SG+PRS+2+PL
desconsertais-te	desconsertar+V.tu.AD.2.SG+PRS+2+PL
desconsertais-vos	desconsertar+V.vós.AD.2.PL+PRS+2+PL
desconsertá-la-á	desconsertar+V.ele.ACC.3.F.SG+FUT+3+SG
desconsertá-la-ão	desconsertar+V.ele.ACC.3.F.SG+FUT+3+PL
desconsertá-la-ás	desconsertar+V.ele.ACC.3.F.SG+FUT+2+SG
desconsertá-la	desconsertar+V.ele.ACC.3.F.SG+INF+1+SG
desconsertá-la	desconsertar+V.ele.ACC.3.F.SG+INF+3+SG
desconserta-la	desconsertar+V.ele.ACC.3.F.SG+PRS+2+SG
desconsertá-la	desconsertar+V.ele.ACC.3.F.SG+SBJF+1+SG
desconsertá-la	desconsertar+V.ele.ACC.3.F.SG+SBJF+3+SG
desconsertá-la-ei	desconsertar+V.ele.ACC.3.F.SG+FUT+1+SG
desconsertá-la-eis	desconsertar+V.ele.ACC.3.F.SG+FUT+2+PL
desconsertá-la-emos	desconsertar+V.ele.ACC.3.F.SG+FUT+1+PL
desconsertá-la-ia	desconsertar+V.ele.ACC.3.F.SG+COND+1+SG
desconsertá-la-ia	desconsertar+V.ele.ACC.3.F.SG+COND+3+SG
desconsertá-la-iam	desconsertar+V.ele.ACC.3.F.SG+COND+3+PL
desconsertá-la-íamos	desconsertar+V.ele.ACC.3.F.SG+COND+1+PL
desconsertá-la-ias	desconsertar+V.ele.ACC.3.F.SG+COND+2+SG
desconsertá-la-íeis	desconsertar+V.ele.ACC.3.F.SG+COND+2+PL
desconsertá-las-á	desconsertar+V.ele.ACC.3.F.PL+FUT+3+SG
desconsertá-las-ão	desconsertar+V.ele.ACC.3.F.PL+FUT+3+PL
desconsertá-las-ás	desconsertar+V.ele.ACC.3.F.PL+FUT+2+SG
desconsertá-las	desconsertar+V.ele.ACC.3.F.PL+INF+1+SG
desconsertá-las	desconsertar+V.ele.ACC.3.F.PL+INF+3+SG
desconserta-las	desconsertar+V.ele.ACC.3.F.PL+PRS+2+SG
desconsertá-las	desconsertar+V.ele.ACC.3.F.PL+SBJF+1+SG
desconsertá-las	desconsertar+V.ele.ACC.3.F.PL+SBJF+3+SG
desconsertá-las-ei	desconsertar+V.ele.ACC.3.F.PL+FUT+1+SG
desconsertá-las-eis	desconsertar+V.ele.ACC.3.F.PL+FUT+2+PL
desconsertá-las-emos	desconsertar+V.ele.ACC.3.F.PL+FUT+1+PL
desconsertá-las-ia	desconsertar+V.ele.ACC.3.F.PL+COND+1+SG
desconsertá-las-ia	desconsertar+V.ele.ACC.3.F.PL+COND+3+SG
desconsertá-las-iam	desconsertar+V.ele.ACC.3.F.PL+COND+3+PL
desconsertá-las-íamos	desconsertar+V.ele.ACC.3.F.PL+COND+1+PL
desconsertá-las-ias	desconsertar+V.ele.ACC.3.F.PL+COND+2+SG
desconsertá-las-íeis	desconsertar+V.ele.ACC.3.F.PL+COND+2+PL
desconserta-lhe	desconsertar+V.ele.DAT.3.SG+PRS+3+SG
desconserta-lhes	desconsertar+V.ele.DAT.3.PL+PRS+3+SG
desconsertá-lo-á	desconsertar+V.ele.ACC.3.M.SG+FUT+3+SG
desconsertá-lo-ão	desconsertar+V.ele.ACC.3.M.SG+FUT+3+PL
desconsertá-lo-ás	desconsertar+V.ele.ACC.3.M.SG+FUT+2+SG
desconsertá-lo	desconsertar+V.ele.ACC.3.M.SG+INF+1+SG
desconsertá-lo	desconsertar+V.ele.ACC.3.M.SG+INF+3+SG
desconserta-lo	desconsertar+V.ele.ACC.3.M.SG+PRS+2+SG
desconsertá-lo	desconsertar+V.ele.ACC.3.M.SG+SBJF+1+SG
desconsertá-lo	desconsertar+V.ele.ACC.3.M.SG+SBJF+3+SG
desconsertá-lo-ei	desconsertar+V.ele.ACC.3.M.SG+FUT+1+SG
desconsertá-lo-eis	desconsertar+V.ele.ACC.3.M.SG+FUT+2+PL
desconsertá-lo-emos	desconsertar+V.ele.ACC.3.M.SG+FUT+1+PL
desconsertá-lo-ia	desconsertar+V.ele.ACC.3.M.SG+COND+1+SG
desconsertá-lo-ia	desconsertar+V.ele.ACC.3.M.SG+COND+3+SG
desconsertá-lo-iam	desconsertar+V.ele.ACC.3.M.SG+COND+3+PL
desconsertá-lo-íamos	desconsertar+V.ele.ACC.3.M.SG+COND+1+PL
desconsertá-lo-ias	desconsertar+V.ele.ACC.3.M.SG+COND+2+SG
desconsertá-lo-íeis	desconsertar+V.ele.ACC.3.M.SG+COND+2+PL
desconsertá-los-á	desconsertar+V.ele.ACC.3.M.PL+FUT+3+SG
desconsertá-los-ão	desconsertar+V.ele.ACC.3.M.PL+FUT+3+PL
desconsertá-los-ás	desconsertar+V.ele.ACC.3.M.PL+FUT+2+SG
desconsertá-los	desconsertar+V.ele.ACC.3.M.PL+INF+1+SG
desconsertá-los	desconsertar+V.ele.ACC.3.M.PL+INF+3+SG
desconserta-los	desconsertar+V.ele.ACC.3.M.PL+PRS+2+SG
desconsertá-los	desconsertar+V.ele.ACC.3.M.PL+SBJF+1+SG
desconsertá-los	desconsertar+V.ele.ACC.3.M.PL+SBJF+3+SG
desconsertá-los-ei	desconsertar+V.ele.ACC.3.M.PL+FUT+1+SG
desconsertá-los-eis	desconsertar+V.ele.ACC.3.M.PL+FUT+2+PL
desconsertá-los-emos	desconsertar+V.ele.ACC.3.M.PL+FUT+1+PL
desconsertá-los-ia	desconsertar+V.ele.ACC.3.M.PL+COND+1+SG
desconsertá-los-ia	desconsertar+V.ele.ACC.3.M.PL+COND+3+SG
desconsertá-los-iam	desconsertar+V.ele.ACC.3.M.PL+COND+3+PL
desconsertá-los-íamos	desconsertar+V.ele.ACC.3.M.PL+COND+1+PL
desconsertá-los-ias	desconsertar+V.ele.ACC.3.M.PL+COND+2+SG
desconsertá-los-íeis	desconsertar+V.ele.ACC.3.M.PL+COND+2+PL
desconserta-me	desconsertar+V.eu.AD.1.SG+PRS+3+SG
desconsertam-lhe	desconsertar+V.ele.DAT.3.SG+PRS+3+PL
desconsertam-lhes	desconsertar+V.ele.DAT.3.PL+PRS+3+PL
desconsertam-me	desconsertar+V.eu.AD.1.SG+PRS+3+PL
desconsertam-na	desconsertar+V.ele.ACC.3.F.SG+PRS+3+PL
desconsertam-nas	desconsertar+V.ele.ACC.3.F.PL+PRS+3+PL
desconsertam-no	desconsertar+V.ele.ACC.3.M.SG+PRS+3+PL
desconsertam-nos	desconsertar+V.ele.ACC.3.M.PL+PRS+3+PL
desconsertam-nos	desconsertar+V.nós.AD.1.PL+PRS+3+PL
desconsertamo-la	desconsertar+V.ele.ACC.3.F.SG+PRF+1+PL
desconsertamo-la	desconsertar+V.ele.ACC.3.F.SG+PRS+1+PL
desconsertamo-las	desconsertar+V.ele.ACC.3.F.PL+PRF+1+PL
desconsertamo-las	desconsertar+V.ele.ACC.3.F.PL+PRS+1+PL
desconsertamo-lo	desconsertar+V.ele.ACC.3.M.SG+PRF+1+PL
desconsertamo-lo	desconsertar+V.ele.ACC.3.M.SG+PRS+1+PL
desconsertamo-los	desconsertar+V.ele.ACC.3.M.PL+PRF+1+PL
desconsertamo-los	desconsertar+V.ele.ACC.3.M.PL+PRS+1+PL
desconsertamo-nos	desconsertar+nós.AD.1.PL+PRF+1+PL
desconsertamo-nos	desconsertar+nós.AD.1.PL+PRS+1+PL
desconsertamos-lhe	desconsertar+V.ele.DAT.3.SG+PRF+1+PL
desconsertamos-lhe	desconsertar+V.ele.DAT.3.SG+PRS+1+PL
desconsertamos-lhes	desconsertar+V.ele.DAT.3.PL+PRF+1+PL
desconsertamos-lhes	desconsertar+V.ele.DAT.3.PL+PRS+1+PL
desconsertamos-me	desconsertar+V.eu.AD.1.SG+PRF+1+PL
desconsertamos-me	desconsertar+V.eu.AD.1.SG+PRS+1+PL
desconsertamos-te	desconsertar+V.tu.AD.2.SG+PRF+1+PL
desconsertamos-te	desconsertar+V.tu.AD.2.SG+PRS+1+PL
desconsertamos-vos	desconsertar+V.vós.AD.2.PL+PRF+1+PL
desconsertamos-vos	desconsertar+V.vós.AD.2.PL+PRS+1+PL
desconsertam-se	desconsertar+V.ele.REFL+PRS+3+PL
desconsertam-te	desconsertar+V.tu.AD.2.SG+PRS+3+PL
desconsertam-vos	desconsertar+V.vós.AD.2.PL+PRS+3+PL
desconsertando-a	desconsertar+V.ele.ACC.3.F.SG+GRD
desconsertando-as	desconsertar+V.ele.ACC.3.F.PL+GRD
desconsertando-lhe	desconsertar+V.ele.DAT.3.SG+GRD
desconsertando-lhes	desconsertar+V.ele.DAT.3.PL+GRD
desconsertando-me	desconsertar+V.eu.AD.1.SG+GRD
desconsertando-nos	desconsertar+nós.AD.1.PL+GRD
desconsertando-o	desconsertar+V.ele.ACC.3.M.SG+GRD
desconsertando-os	desconsertar+V.ele.ACC.3.M.PL+GRD
desconsertando-se	desconsertar+V.ele.REFL+GRD
desconsertando-te	desconsertar+V.tu.AD.2.SG+GRD
desconsertando-vos	desconsertar+V.vós.AD.2.PL+GRD
desconserta-nos	desconsertar+nós.AD.1.PL+PRS+2+SG
desconserta-nos	desconsertar+nós.AD.1.PL+PRS+3+SG
desconserta-o	desconsertar+V.ele.ACC.3.M.SG+PRS+3+SG
desconserta-os	desconsertar+V.ele.ACC.3.M.PL+PRS+3+SG
desconsertara-a	desconsertar+V.ele.ACC.3.F.SG+PQP+1+SG
desconsertara-a	desconsertar+V.ele.ACC.3.F.SG+PQP+3+SG
desconsertara-as	desconsertar+V.ele.ACC.3.F.PL+PQP+1+SG
desconsertara-as	desconsertar+V.ele.ACC.3.F.PL+PQP+3+SG
desconsertara-la	desconsertar+V.ele.ACC.3.F.SG+PQP+2+SG
desconsertara-las	desconsertar+V.ele.ACC.3.F.PL+PQP+2+SG
desconsertara-lhe	desconsertar+V.ele.DAT.3.SG+PQP+1+SG
desconsertara-lhe	desconsertar+V.ele.DAT.3.SG+PQP+3+SG
desconsertara-lhes	desconsertar+V.ele.DAT.3.PL+PQP+1+SG
desconsertara-lhes	desconsertar+V.ele.DAT.3.PL+PQP+3+SG
desconsertara-lo	desconsertar+V.ele.ACC.3.M.SG+PQP+2+SG
desconsertara-los	desconsertar+V.ele.ACC.3.M.PL+PQP+2+SG
desconsertara-me	desconsertar+V.eu.AD.1.SG+PQP+1+SG
desconsertara-me	desconsertar+V.eu.AD.1.SG+PQP+3+SG
desconsertaram-lhe	desconsertar+V.ele.DAT.3.SG+PQP+3+PL
desconsertaram-lhe	desconsertar+V.ele.DAT.3.SG+PRF+3+PL
desconsertaram-lhes	desconsertar+V.ele.DAT.3.PL+PQP+3+PL
desconsertaram-lhes	desconsertar+V.ele.DAT.3.PL+PRF+3+PL
desconsertaram-me	desconsertar+V.eu.AD.1.SG+PQP+3+PL
desconsertaram-me	desconsertar+V.eu.AD.1.SG+PRF+3+PL
desconsertaram-na	desconsertar+V.ele.ACC.3.F.SG+PQP+3+PL
desconsertaram-na	desconsertar+V.ele.ACC.3.F.SG+PRF+3+PL
desconsertaram-nas	desconsertar+V.ele.ACC.3.F.PL+PQP+3+PL
desconsertaram-nas	desconsertar+V.ele.ACC.3.F.PL+PRF+3+PL
desconsertaram-no	desconsertar+V.ele.ACC.3.M.SG+PQP+3+PL
desconsertaram-no	desconsertar+V.ele.ACC.3.M.SG+PRF+3+PL
desconsertaram-nos	desconsertar+V.ele.ACC.3.M.PL+PQP+3+PL
desconsertaram-nos	desconsertar+V.ele.ACC.3.M.PL+PRF+3+PL
desconsertaram-nos	desconsertar+V.nós.AD.1.PL+PQP+3+PL
desconsertaram-nos	desconsertar+V.nós.AD.1.PL+PRF+3+PL
desconsertáramo-la	desconsertar+V.ele.ACC.3.F.SG+PQP+1+PL
desconsertáramo-las	desconsertar+V.ele.ACC.3.F.PL+PQP+1+PL
desconsertáramo-lo	desconsertar+V.ele.ACC.3.M.SG+PQP+1+PL
desconsertáramo-los	desconsertar+V.ele.ACC.3.M.PL+PQP+1+PL
desconsertáramo-nos	desconsertar+nós.AD.1.PL+PQP+1+PL
desconsertáramos-lhe	desconsertar+V.ele.DAT.3.SG+PQP+1+PL
desconsertáramos-lhes	desconsertar+V.ele.DAT.3.PL+PQP+1+PL
desconsertáramos-me	desconsertar+V.eu.AD.1.SG+PQP+1+PL
desconsertáramos-te	desconsertar+V.tu.AD.2.SG+PQP+1+PL
desconsertáramos-vos	desconsertar+V.vós.AD.2.PL+PQP+1+PL
desconsertaram-se	desconsertar+V.ele.REFL+PQP+3+PL
desconsertaram-se	desconsertar+V.ele.REFL+PRF+3+PL
desconsertaram-te	desconsertar+V.tu.AD.2.SG+PQP+3+PL
desconsertaram-te	desconsertar+V.tu.AD.2.SG+PRF+3+PL
desconsertaram-vos	desconsertar+V.vós.AD.2.PL+PQP+3+PL
desconsertaram-vos	desconsertar+V.vós.AD.2.PL+PRF+3+PL
desconsertara-nos	desconsertar+nós.AD.1.PL+PQP+1+SG
desconsertara-nos	desconsertar+nós.AD.1.PL+PQP+2+SG
desconsertara-nos	desconsertar+nós.AD.1.PL+PQP+3+SG
desconsertara-o	desconsertar+V.ele.ACC.3.M.SG+PQP+1+SG
desconsertara-o	desconsertar+V.ele.ACC.3.M.SG+PQP+3+SG
desconsertara-os	desconsertar+V.ele.ACC.3.M.PL+PQP+1+SG
desconsertara-os	desconsertar+V.ele.ACC.3.M.PL+PQP+3+SG
desconsertara-se	desconsertar+V.ele.REFL+PQP+1+SG
desconsertara-se	desconsertar+V.ele.REFL+PQP+3+SG
desconsertaras-lhe	desconsertar+V.ele.DAT.3.SG+PQP+2+SG
desconsertaras-lhes	desconsertar+V.ele.DAT.3.PL+PQP+2+SG
desconsertaras-me	desconsertar+V.eu.AD.1.SG+PQP+2+SG
desconsertaras-te	desconsertar+V.tu.AD.2.SG+PQP+2+SG
desconsertaras-vos	desconsertar+V.vós.AD.2.PL+PQP+2+SG
desconsertara-te	desconsertar+V.tu.AD.2.SG+PQP+1+SG
desconsertara-te	desconsertar+V.tu.AD.2.SG+PQP+3+SG
desconsertara-vos	desconsertar+V.vós.AD.2.PL+PQP+1+SG
desconsertara-vos	desconsertar+V.vós.AD.2.PL+PQP+3+SG
desconsertarde-la	desconsertar+V.ele.ACC.3.F.SG+INF+2+PL
desconsertarde-la	desconsertar+V.ele.ACC.3.F.SG+SBJF+2+PL
desconsertarde-las	desconsertar+V.ele.ACC.3.F.PL+INF+2+PL
desconsertarde-las	desconsertar+V.ele.ACC.3.F.PL+SBJF+2+PL
desconsertarde-lo	desconsertar+V.ele.ACC.3.M.SG+INF+2+PL
desconsertarde-lo	desconsertar+V.ele.ACC.3.M.SG+SBJF+2+PL
desconsertarde-los	desconsertar+V.ele.ACC.3.M.PL+INF+2+PL
desconsertarde-los	desconsertar+V.ele.ACC.3.M.PL+SBJF+2+PL
desconsertarde-nos	desconsertar+nós.AD.1.PL+INF+2+PL
desconsertarde-nos	desconsertar+nós.AD.1.PL+SBJF+2+PL
desconsertardes-lhe	desconsertar+V.ele.DAT.3.SG+INF+2+PL
desconsertardes-lhe	desconsertar+V.ele.DAT.3.SG+SBJF+2+PL
desconsertardes-lhes	desconsertar+V.ele.DAT.3.PL+INF+2+PL
desconsertardes-lhes	desconsertar+V.ele.DAT.3.PL+SBJF+2+PL
desconsertardes-me	desconsertar+V.eu.AD.1.SG+INF+2+PL
desconsertardes-me	desconsertar+V.eu.AD.1.SG+SBJF+2+PL
desconsertardes-te	desconsertar+V.tu.AD.2.SG+INF+2+PL
desconsertardes-te	desconsertar+V.tu.AD.2.SG+SBJF+2+PL
desconsertardes-vos	desconsertar+V.vós.AD.2.PL+INF+2+PL
desconsertardes-vos	desconsertar+V.vós.AD.2.PL+SBJF+2+PL
desconsertárei-la	desconsertar+V.ele.ACC.3.F.SG+PQP+2+PL
desconsertárei-las	desconsertar+V.ele.ACC.3.F.PL+PQP+2+PL
desconsertárei-lo	desconsertar+V.ele.ACC.3.M.SG+PQP+2+PL
desconsertárei-los	desconsertar+V.ele.ACC.3.M.PL+PQP+2+PL
desconsertárei-nos	desconsertar+nós.AD.1.PL+PQP+2+PL
desconsertáreis-lhe	desconsertar+V.ele.DAT.3.SG+PQP+2+PL
desconsertáreis-lhes	desconsertar+V.ele.DAT.3.PL+PQP+2+PL
desconsertáreis-me	desconsertar+V.eu.AD.1.SG+PQP+2+PL
desconsertáreis-te	desconsertar+V.tu.AD.2.SG+PQP+2+PL
desconsertáreis-vos	desconsertar+V.vós.AD.2.PL+PQP+2+PL
desconsertare-la	desconsertar+V.ele.ACC.3.F.SG+INF+2+SG
desconsertare-la	desconsertar+V.ele.ACC.3.F.SG+SBJF+2+SG
desconsertare-las	desconsertar+V.ele.ACC.3.F.PL+INF+2+SG
desconsertare-las	desconsertar+V.ele.ACC.3.F.PL+SBJF+2+SG
desconsertare-lo	desconsertar+V.ele.ACC.3.M.SG+INF+2+SG
desconsertare-lo	desconsertar+V.ele.ACC.3.M.SG+SBJF+2+SG
desconsertare-los	desconsertar+V.ele.ACC.3.M.PL+INF+2+SG
desconsertare-los	desconsertar+V.ele.ACC.3.M.PL+SBJF+2+SG
desconsertarem-lhe	desconsertar+V.ele.DAT.3.SG+INF+3+PL
desconsertarem-lhe	desconsertar+V.ele.DAT.3.SG+SBJF+3+PL
desconsertarem-lhes	desconsertar+V.ele.DAT.3.PL+INF+3+PL
desconsertarem-lhes	desconsertar+V.ele.DAT.3.PL+SBJF+3+PL
desconsertarem-me	desconsertar+V.eu.AD.1.SG+INF+3+PL
desconsertarem-me	desconsertar+V.eu.AD.1.SG+SBJF+3+PL
desconsertarem-na	desconsertar+V.ele.ACC.3.F.SG+INF+3+PL
desconsertarem-na	desconsertar+V.ele.ACC.3.F.SG+SBJF+3+PL
desconsertarem-nas	desconsertar+V.ele.ACC.3.F.PL+INF+3+PL
desconsertarem-nas	desconsertar+V.ele.ACC.3.F.PL+SBJF+3+PL
desconsertarem-no	desconsertar+V.ele.ACC.3.M.SG+INF+3+PL
desconsertarem-no	desconsertar+V.ele.ACC.3.M.SG+SBJF+3+PL
desconsertarem-nos	desconsertar+V.ele.ACC.3.M.PL+INF+3+PL
desconsertarem-nos	desconsertar+V.ele.ACC.3.M.PL+SBJF+3+PL
desconsertarem-nos	desconsertar+V.nós.AD.1.PL+INF+3+PL
desconsertarem-nos	desconsertar+V.nós.AD.1.PL+SBJF+3+PL
desconsertarem-se	desconsertar+V.ele.REFL+INF+3+PL
desconsertarem-se	desconsertar+V.ele.REFL+SBJF+3+PL
desconsertarem-te	desconsertar+V.tu.AD.2.SG+INF+3+PL
desconsertarem-te	desconsertar+V.tu.AD.2.SG+SBJF+3+PL
desconsertarem-vos	desconsertar+V.vós.AD.2.PL+INF+3+PL
desconsertarem-vos	desconsertar+V.vós.AD.2.PL+SBJF+3+PL
desconsertare-nos	desconsertar+nós.AD.1.PL+INF+2+SG
desconsertare-nos	desconsertar+nós.AD.1.PL+SBJF+2+SG
desconsertares-lhe	desconsertar+V.ele.DAT.3.SG+INF+2+SG
desconsertares-lhe	desconsertar+V.ele.DAT.3.SG+SBJF+2+SG
desconsertares-lhes	desconsertar+V.ele.DAT.3.PL+INF+2+SG
desconsertares-lhes	desconsertar+V.ele.DAT.3.PL+SBJF+2+SG
desconsertares-me	desconsertar+V.eu.AD.1.SG+INF+2+SG
desconsertares-me	desconsertar+V.eu.AD.1.SG+SBJF+2+SG
desconsertares-te	desconsertar+V.tu.AD.2.SG+INF+2+SG
desconsertares-te	desconsertar+V.tu.AD.2.SG+SBJF+2+SG
desconsertares-vos	desconsertar+V.vós.AD.2.PL+INF+2+SG
desconsertares-vos	desconsertar+V.vós.AD.2.PL+SBJF+2+SG
desconsertar-lhe-á	desconsertar+V.ele.DAT.3.SG+FUT+3+SG
desconsertar-lhe-ão	desconsertar+V.ele.DAT.3.SG+FUT+3+PL
desconsertar-lhe-ás	desconsertar+V.ele.DAT.3.SG+FUT+2+SG
desconsertar-lhe	desconsertar+V.ele.DAT.3.SG+INF
desconsertar-lhe	desconsertar+V.ele.DAT.3.SG+INF+1+SG
desconsertar-lhe	desconsertar+V.ele.DAT.3.SG+INF+3+SG
desconsertar-lhe	desconsertar+V.ele.DAT.3.SG+SBJF+1+SG
desconsertar-lhe	desconsertar+V.ele.DAT.3.SG+SBJF+3+SG
desconsertar-lhe-ei	desconsertar+V.ele.DAT.3.SG+FUT+1+SG
desconsertar-lhe-eis	desconsertar+V.ele.DAT.3.SG+FUT+2+PL
