desempachar-te-ia	desempachar+V.tu.AD.2.SG+COND+1+SG
desempachar-te-ia	desempachar+V.tu.AD.2.SG+COND+3+SG
desempachar-te-iam	desempachar+V.tu.AD.2.SG+COND+3+PL
desempachar-te-íamos	desempachar+V.tu.AD.2.SG+COND+1+PL
desempachar-te-ias	desempachar+V.tu.AD.2.SG+COND+2+SG
desempachar-te-íeis	desempachar+V.tu.AD.2.SG+COND+2+PL
desempachar-vos-á	desempachar+V.vós.AD.2.PL+FUT+3+SG
desempachar-vos-ão	desempachar+V.vós.AD.2.PL+FUT+3+PL
desempachar-vos-ás	desempachar+V.vós.AD.2.PL+FUT+2+SG
desempachar-vos	desempachar+V.vós.AD.2.PL+INF
desempachar-vos	desempachar+V.vós.AD.2.PL+INF+1+SG
desempachar-vos	desempachar+V.vós.AD.2.PL+INF+3+SG
desempachar-vos	desempachar+V.vós.AD.2.PL+SBJF+1+SG
desempachar-vos	desempachar+V.vós.AD.2.PL+SBJF+3+SG
desempachar-vos-ei	desempachar+V.vós.AD.2.PL+FUT+1+SG
desempachar-vos-eis	desempachar+V.vós.AD.2.PL+FUT+2+PL
desempachar-vos-emos	desempachar+V.vós.AD.2.PL+FUT+1+PL
desempachar-vos-ia	desempachar+V.vós.AD.2.PL+COND+1+SG
desempachar-vos-ia	desempachar+V.vós.AD.2.PL+COND+3+SG
desempachar-vos-iam	desempachar+V.vós.AD.2.PL+COND+3+PL
desempachar-vos-íamos	desempachar+V.vós.AD.2.PL+COND+1+PL
desempachar-vos-ias	desempachar+V.vós.AD.2.PL+COND+2+SG
desempachar-vos-íeis	desempachar+V.vós.AD.2.PL+COND+2+PL
desempacha-se	desempachar+V.ele.REFL+PRS+3+SG
desempachas-lhe	desempachar+V.ele.DAT.3.SG+PRS+2+SG
desempachas-lhes	desempachar+V.ele.DAT.3.PL+PRS+2+SG
desempachas-me	desempachar+V.eu.AD.1.SG+PRS+2+SG
desempachaste-a	desempachar+V.ele.ACC.3.F.SG+PRF+2+SG
desempachaste-as	desempachar+V.ele.ACC.3.F.PL+PRF+2+SG
desempachas-te	desempachar+V.tu.AD.2.SG+PRS+2+SG
desempachaste-la	desempachar+V.ele.ACC.3.F.SG+PRF+2+PL
desempachaste-las	desempachar+V.ele.ACC.3.F.PL+PRF+2+PL
desempachaste-lhe	desempachar+V.ele.DAT.3.SG+PRF+2+SG
desempachaste-lhes	desempachar+V.ele.DAT.3.PL+PRF+2+SG
desempachaste-lo	desempachar+V.ele.ACC.3.M.SG+PRF+2+PL
desempachaste-los	desempachar+V.ele.ACC.3.M.PL+PRF+2+PL
desempachaste-me	desempachar+V.eu.AD.1.SG+PRF+2+SG
desempachaste-nos	desempachar+nós.AD.1.PL+PRF+2+PL
desempachaste-nos	desempachar+nós.AD.1.PL+PRF+2+SG
desempachaste-o	desempachar+V.ele.ACC.3.M.SG+PRF+2+SG
desempachaste-os	desempachar+V.ele.ACC.3.M.PL+PRF+2+SG
desempachastes-lhe	desempachar+V.ele.DAT.3.SG+PRF+2+PL
desempachastes-lhes	desempachar+V.ele.DAT.3.PL+PRF+2+PL
desempachastes-me	desempachar+V.eu.AD.1.SG+PRF+2+PL
desempachastes-te	desempachar+V.tu.AD.2.SG+PRF+2+PL
desempachastes-vos	desempachar+V.vós.AD.2.PL+PRF+2+PL
desempachaste-te	desempachar+V.tu.AD.2.SG+PRF+2+SG
desempachaste-vos	desempachar+V.vós.AD.2.PL+PRF+2+SG
desempachas-vos	desempachar+V.vós.AD.2.PL+PRS+2+SG
desempacha-te	desempachar+V.tu.AD.2.SG+PRS+3+SG
desempachava-a	desempachar+V.ele.ACC.3.F.SG+IMPF+1+SG
desempachava-a	desempachar+V.ele.ACC.3.F.SG+IMPF+3+SG
desempachava-as	desempachar+V.ele.ACC.3.F.PL+IMPF+1+SG
desempachava-as	desempachar+V.ele.ACC.3.F.PL+IMPF+3+SG
desempachava-la	desempachar+V.ele.ACC.3.F.SG+IMPF+2+SG
desempachava-las	desempachar+V.ele.ACC.3.F.PL+IMPF+2+SG
desempachava-lhe	desempachar+V.ele.DAT.3.SG+IMPF+1+SG
desempachava-lhe	desempachar+V.ele.DAT.3.SG+IMPF+3+SG
desempachava-lhes	desempachar+V.ele.DAT.3.PL+IMPF+1+SG
desempachava-lhes	desempachar+V.ele.DAT.3.PL+IMPF+3+SG
desempachava-lo	desempachar+V.ele.ACC.3.M.SG+IMPF+2+SG
desempachava-los	desempachar+V.ele.ACC.3.M.PL+IMPF+2+SG
desempachava-me	desempachar+V.eu.AD.1.SG+IMPF+1+SG
desempachava-me	desempachar+V.eu.AD.1.SG+IMPF+3+SG
desempachavam-lhe	desempachar+V.ele.DAT.3.SG+IMPF+3+PL
desempachavam-lhes	desempachar+V.ele.DAT.3.PL+IMPF+3+PL
desempachavam-me	desempachar+V.eu.AD.1.SG+IMPF+3+PL
desempachavam-na	desempachar+V.ele.ACC.3.F.SG+IMPF+3+PL
desempachavam-nas	desempachar+V.ele.ACC.3.F.PL+IMPF+3+PL
desempachavam-no	desempachar+V.ele.ACC.3.M.SG+IMPF+3+PL
desempachavam-nos	desempachar+V.ele.ACC.3.M.PL+IMPF+3+PL
desempachavam-nos	desempachar+V.nós.AD.1.PL+IMPF+3+PL
desempachávamo-la	desempachar+V.ele.ACC.3.F.SG+IMPF+1+PL
desempachávamo-las	desempachar+V.ele.ACC.3.F.PL+IMPF+1+PL
desempachávamo-lo	desempachar+V.ele.ACC.3.M.SG+IMPF+1+PL
desempachávamo-los	desempachar+V.ele.ACC.3.M.PL+IMPF+1+PL
desempachávamo-nos	desempachar+nós.AD.1.PL+IMPF+1+PL
desempachávamos-lhe	desempachar+V.ele.DAT.3.SG+IMPF+1+PL
desempachávamos-lhes	desempachar+V.ele.DAT.3.PL+IMPF+1+PL
desempachávamos-me	desempachar+V.eu.AD.1.SG+IMPF+1+PL
desempachávamos-te	desempachar+V.tu.AD.2.SG+IMPF+1+PL
desempachávamos-vos	desempachar+V.vós.AD.2.PL+IMPF+1+PL
desempachavam-se	desempachar+V.ele.REFL+IMPF+3+PL
desempachavam-te	desempachar+V.tu.AD.2.SG+IMPF+3+PL
desempachavam-vos	desempachar+V.vós.AD.2.PL+IMPF+3+PL
desempachava-nos	desempachar+nós.AD.1.PL+IMPF+1+SG
desempachava-nos	desempachar+nós.AD.1.PL+IMPF+2+SG
desempachava-nos	desempachar+nós.AD.1.PL+IMPF+3+SG
desempachava-o	desempachar+V.ele.ACC.3.M.SG+IMPF+1+SG
desempachava-o	desempachar+V.ele.ACC.3.M.SG+IMPF+3+SG
desempachava-os	desempachar+V.ele.ACC.3.M.PL+IMPF+1+SG
desempachava-os	desempachar+V.ele.ACC.3.M.PL+IMPF+3+SG
desempachava-se	desempachar+V.ele.REFL+IMPF+1+SG
desempachava-se	desempachar+V.ele.REFL+IMPF+3+SG
desempachavas-lhe	desempachar+V.ele.DAT.3.SG+IMPF+2+SG
desempachavas-lhes	desempachar+V.ele.DAT.3.PL+IMPF+2+SG
desempachavas-me	desempachar+V.eu.AD.1.SG+IMPF+2+SG
desempachavas-te	desempachar+V.tu.AD.2.SG+IMPF+2+SG
desempachavas-vos	desempachar+V.vós.AD.2.PL+IMPF+2+SG
desempachava-te	desempachar+V.tu.AD.2.SG+IMPF+1+SG
desempachava-te	desempachar+V.tu.AD.2.SG+IMPF+3+SG
desempachava-vos	desempachar+V.vós.AD.2.PL+IMPF+1+SG
desempachava-vos	desempachar+V.vós.AD.2.PL+IMPF+3+SG
desempachávei-la	desempachar+V.ele.ACC.3.F.SG+IMPF+2+PL
desempachávei-las	desempachar+V.ele.ACC.3.F.PL+IMPF+2+PL
desempachávei-lo	desempachar+V.ele.ACC.3.M.SG+IMPF+2+PL
desempachávei-los	desempachar+V.ele.ACC.3.M.PL+IMPF+2+PL
desempachávei-nos	desempachar+nós.AD.1.PL+IMPF+2+PL
desempacháveis-lhe	desempachar+V.ele.DAT.3.SG+IMPF+2+PL
desempacháveis-lhes	desempachar+V.ele.DAT.3.PL+IMPF+2+PL
desempacháveis-me	desempachar+V.eu.AD.1.SG+IMPF+2+PL
desempacháveis-te	desempachar+V.tu.AD.2.SG+IMPF+2+PL
desempacháveis-vos	desempachar+V.vós.AD.2.PL+IMPF+2+PL
desempacha-vos	desempachar+V.vós.AD.2.PL+PRS+3+SG
desempache-a	desempachar+V.ele.ACC.3.F.SG+IMP+3+SG
desempache-as	desempachar+V.ele.ACC.3.F.PL+IMP+3+SG
desempachei-a	desempachar+V.ele.ACC.3.F.SG+PRF+1+SG
desempachei-as	desempachar+V.ele.ACC.3.F.PL+PRF+1+SG
desempachei-lhe	desempachar+V.ele.DAT.3.SG+PRF+1+SG
desempachei-lhes	desempachar+V.ele.DAT.3.PL+PRF+1+SG
desempachei-me	desempachar+V.eu.AD.1.SG+PRF+1+SG
desempachei-nos	desempachar+nós.AD.1.PL+PRF+1+SG
desempachei-o	desempachar+V.ele.ACC.3.M.SG+PRF+1+SG
desempachei-os	desempachar+V.ele.ACC.3.M.PL+PRF+1+SG
desempachei-te	desempachar+V.tu.AD.2.SG+PRF+1+SG
desempachei-vos	desempachar+V.vós.AD.2.PL+PRF+1+SG
desempache-lhe	desempachar+V.ele.DAT.3.SG+IMP+3+SG
desempache-lhes	desempachar+V.ele.DAT.3.PL+IMP+3+SG
desempache-me	desempachar+V.eu.AD.1.SG+IMP+3+SG
desempachem-lhe	desempachar+V.ele.DAT.3.SG+IMP+3+PL
desempachem-lhes	desempachar+V.ele.DAT.3.PL+IMP+3+PL
desempachem-me	desempachar+V.eu.AD.1.SG+IMP+3+PL
desempachem-na	desempachar+V.ele.ACC.3.F.SG+IMP+3+PL
desempachem-nas	desempachar+V.ele.ACC.3.F.PL+IMP+3+PL
desempachem-no	desempachar+V.ele.ACC.3.M.SG+IMP+3+PL
desempachem-nos	desempachar+V.ele.ACC.3.M.PL+IMP+3+PL
desempachem-nos	desempachar+V.nós.AD.1.PL+IMP+3+PL
desempachemo-la	desempachar+V.ele.ACC.3.F.SG+IMP+1+PL
desempachemo-las	desempachar+V.ele.ACC.3.F.PL+IMP+1+PL
desempachemo-lo	desempachar+V.ele.ACC.3.M.SG+IMP+1+PL
desempachemo-los	desempachar+V.ele.ACC.3.M.PL+IMP+1+PL
desempachemo-nos	desempachar+nós.AD.1.PL+IMP+1+PL
desempachemos-lhe	desempachar+V.ele.DAT.3.SG+IMP+1+PL
desempachemos-lhes	desempachar+V.ele.DAT.3.PL+IMP+1+PL
desempachemos-me	desempachar+V.eu.AD.1.SG+IMP+1+PL
desempachemos-te	desempachar+V.tu.AD.2.SG+IMP+1+PL
desempachemos-vos	desempachar+V.vós.AD.2.PL+IMP+1+PL
desempachem-se	desempachar+V.ele.REFL+IMP+3+PL
desempachem-te	desempachar+V.tu.AD.2.SG+IMP+3+PL
desempachem-vos	desempachar+V.vós.AD.2.PL+IMP+3+PL
desempache-nos	desempachar+nós.AD.1.PL+IMP+3+SG
desempache-o	desempachar+V.ele.ACC.3.M.SG+IMP+3+SG
desempache-os	desempachar+V.ele.ACC.3.M.PL+IMP+3+SG
desempache-se	desempachar+V.ele.REFL+IMP+3+SG
desempache-te	desempachar+V.tu.AD.2.SG+IMP+3+SG
desempache-vos	desempachar+V.vós.AD.2.PL+IMP+3+SG
desempacho-a	desempachar+V.ele.ACC.3.F.SG+PRS+1+SG
desempacho-as	desempachar+V.ele.ACC.3.F.PL+PRS+1+SG
desempacho-lhe	desempachar+V.ele.DAT.3.SG+PRS+1+SG
desempacho-lhes	desempachar+V.ele.DAT.3.PL+PRS+1+SG
desempacho-me	desempachar+V.eu.AD.1.SG+PRS+1+SG
desempacho-nos	desempachar+nós.AD.1.PL+PRS+1+SG
desempacho-o	desempachar+V.ele.ACC.3.M.SG+PRS+1+SG
desempacho-os	desempachar+V.ele.ACC.3.M.PL+PRS+1+SG
desempacho-te	desempachar+V.tu.AD.2.SG+PRS+1+SG
desempachou-a	desempachar+V.ele.ACC.3.F.SG+PRF+3+SG
desempachou-as	desempachar+V.ele.ACC.3.F.PL+PRF+3+SG
desempachou-lhe	desempachar+V.ele.DAT.3.SG+PRF+3+SG
desempachou-lhes	desempachar+V.ele.DAT.3.PL+PRF+3+SG
desempachou-me	desempachar+V.eu.AD.1.SG+PRF+3+SG
desempachou-nos	desempachar+nós.AD.1.PL+PRF+3+SG
desempachou-o	desempachar+V.ele.ACC.3.M.SG+PRF+3+SG
desempachou-os	desempachar+V.ele.ACC.3.M.PL+PRF+3+SG
desempachou-se	desempachar+V.ele.REFL+PRF+3+SG
desempachou-te	desempachar+V.tu.AD.2.SG+PRF+3+SG
desempachou-vos	desempachar+V.vós.AD.2.PL+PRF+3+SG
desempacho-vos	desempachar+V.vós.AD.2.PL+PRS+1+SG
desempaco-a	desempacar+V.ele.ACC.3.F.SG+PRS+1+SG
desempaco-as	desempacar+V.ele.ACC.3.F.PL+PRS+1+SG
desempaco-lhe	desempacar+V.ele.DAT.3.SG+PRS+1+SG
desempaco-lhes	desempacar+V.ele.DAT.3.PL+PRS+1+SG
desempaco-me	desempacar+V.eu.AD.1.SG+PRS+1+SG
desempaco-nos	desempacar+nós.AD.1.PL+PRS+1+SG
desempaco-o	desempacar+V.ele.ACC.3.M.SG+PRS+1+SG
desempaco-os	desempacar+V.ele.ACC.3.M.PL+PRS+1+SG
desempacota-a	desempacotar+V.ele.ACC.3.F.SG+PRS+3+SG
desempacota-as	desempacotar+V.ele.ACC.3.F.PL+PRS+3+SG
desempacotai-la	desempacotar+V.ele.ACC.3.F.SG+PRS+2+PL
desempacotai-las	desempacotar+V.ele.ACC.3.F.PL+PRS+2+PL
desempacotai-lo	desempacotar+V.ele.ACC.3.M.SG+PRS+2+PL
desempacotai-los	desempacotar+V.ele.ACC.3.M.PL+PRS+2+PL
desempacotai-nos	desempacotar+nós.AD.1.PL+PRS+2+PL
desempacotais-lhe	desempacotar+V.ele.DAT.3.SG+PRS+2+PL
desempacotais-lhes	desempacotar+V.ele.DAT.3.PL+PRS+2+PL
desempacotais-me	desempacotar+V.eu.AD.1.SG+PRS+2+PL
desempacotais-te	desempacotar+V.tu.AD.2.SG+PRS+2+PL
desempacotais-vos	desempacotar+V.vós.AD.2.PL+PRS+2+PL
desempacotá-la-á	desempacotar+V.ele.ACC.3.F.SG+FUT+3+SG
desempacotá-la-ão	desempacotar+V.ele.ACC.3.F.SG+FUT+3+PL
desempacotá-la-ás	desempacotar+V.ele.ACC.3.F.SG+FUT+2+SG
desempacotá-la	desempacotar+V.ele.ACC.3.F.SG+INF+1+SG
desempacotá-la	desempacotar+V.ele.ACC.3.F.SG+INF+3+SG
desempacota-la	desempacotar+V.ele.ACC.3.F.SG+PRS+2+SG
desempacotá-la	desempacotar+V.ele.ACC.3.F.SG+SBJF+1+SG
desempacotá-la	desempacotar+V.ele.ACC.3.F.SG+SBJF+3+SG
desempacotá-la-ei	desempacotar+V.ele.ACC.3.F.SG+FUT+1+SG
desempacotá-la-eis	desempacotar+V.ele.ACC.3.F.SG+FUT+2+PL
desempacotá-la-emos	desempacotar+V.ele.ACC.3.F.SG+FUT+1+PL
desempacotá-la-ia	desempacotar+V.ele.ACC.3.F.SG+COND+1+SG
desempacotá-la-ia	desempacotar+V.ele.ACC.3.F.SG+COND+3+SG
desempacotá-la-iam	desempacotar+V.ele.ACC.3.F.SG+COND+3+PL
desempacotá-la-íamos	desempacotar+V.ele.ACC.3.F.SG+COND+1+PL
desempacotá-la-ias	desempacotar+V.ele.ACC.3.F.SG+COND+2+SG
desempacotá-la-íeis	desempacotar+V.ele.ACC.3.F.SG+COND+2+PL
desempacotá-las-á	desempacotar+V.ele.ACC.3.F.PL+FUT+3+SG
desempacotá-las-ão	desempacotar+V.ele.ACC.3.F.PL+FUT+3+PL
desempacotá-las-ás	desempacotar+V.ele.ACC.3.F.PL+FUT+2+SG
desempacotá-las	desempacotar+V.ele.ACC.3.F.PL+INF+1+SG
desempacotá-las	desempacotar+V.ele.ACC.3.F.PL+INF+3+SG
desempacota-las	desempacotar+V.ele.ACC.3.F.PL+PRS+2+SG
desempacotá-las	desempacotar+V.ele.ACC.3.F.PL+SBJF+1+SG
desempacotá-las	desempacotar+V.ele.ACC.3.F.PL+SBJF+3+SG
desempacotá-las-ei	desempacotar+V.ele.ACC.3.F.PL+FUT+1+SG
desempacotá-las-eis	desempacotar+V.ele.ACC.3.F.PL+FUT+2+PL
desempacotá-las-emos	desempacotar+V.ele.ACC.3.F.PL+FUT+1+PL
desempacotá-las-ia	desempacotar+V.ele.ACC.3.F.PL+COND+1+SG
desempacotá-las-ia	desempacotar+V.ele.ACC.3.F.PL+COND+3+SG
desempacotá-las-iam	desempacotar+V.ele.ACC.3.F.PL+COND+3+PL
desempacotá-las-íamos	desempacotar+V.ele.ACC.3.F.PL+COND+1+PL
desempacotá-las-ias	desempacotar+V.ele.ACC.3.F.PL+COND+2+SG
desempacotá-las-íeis	desempacotar+V.ele.ACC.3.F.PL+COND+2+PL
desempacota-lhe	desempacotar+V.ele.DAT.3.SG+PRS+3+SG
desempacota-lhes	desempacotar+V.ele.DAT.3.PL+PRS+3+SG
desempacotá-lo-á	desempacotar+V.ele.ACC.3.M.SG+FUT+3+SG
desempacotá-lo-ão	desempacotar+V.ele.ACC.3.M.SG+FUT+3+PL
desempacotá-lo-ás	desempacotar+V.ele.ACC.3.M.SG+FUT+2+SG
desempacotá-lo	desempacotar+V.ele.ACC.3.M.SG+INF+1+SG
desempacotá-lo	desempacotar+V.ele.ACC.3.M.SG+INF+3+SG
desempacota-lo	desempacotar+V.ele.ACC.3.M.SG+PRS+2+SG
desempacotá-lo	desempacotar+V.ele.ACC.3.M.SG+SBJF+1+SG
desempacotá-lo	desempacotar+V.ele.ACC.3.M.SG+SBJF+3+SG
desempacotá-lo-ei	desempacotar+V.ele.ACC.3.M.SG+FUT+1+SG
desempacotá-lo-eis	desempacotar+V.ele.ACC.3.M.SG+FUT+2+PL
desempacotá-lo-emos	desempacotar+V.ele.ACC.3.M.SG+FUT+1+PL
desempacotá-lo-ia	desempacotar+V.ele.ACC.3.M.SG+COND+1+SG
desempacotá-lo-ia	desempacotar+V.ele.ACC.3.M.SG+COND+3+SG
desempacotá-lo-iam	desempacotar+V.ele.ACC.3.M.SG+COND+3+PL
desempacotá-lo-íamos	desempacotar+V.ele.ACC.3.M.SG+COND+1+PL
desempacotá-lo-ias	desempacotar+V.ele.ACC.3.M.SG+COND+2+SG
desempacotá-lo-íeis	desempacotar+V.ele.ACC.3.M.SG+COND+2+PL
desempacotá-los-á	desempacotar+V.ele.ACC.3.M.PL+FUT+3+SG
desempacotá-los-ão	desempacotar+V.ele.ACC.3.M.PL+FUT+3+PL
desempacotá-los-ás	desempacotar+V.ele.ACC.3.M.PL+FUT+2+SG
desempacotá-los	desempacotar+V.ele.ACC.3.M.PL+INF+1+SG
desempacotá-los	desempacotar+V.ele.ACC.3.M.PL+INF+3+SG
desempacota-los	desempacotar+V.ele.ACC.3.M.PL+PRS+2+SG
desempacotá-los	desempacotar+V.ele.ACC.3.M.PL+SBJF+1+SG
desempacotá-los	desempacotar+V.ele.ACC.3.M.PL+SBJF+3+SG
desempacotá-los-ei	desempacotar+V.ele.ACC.3.M.PL+FUT+1+SG
desempacotá-los-eis	desempacotar+V.ele.ACC.3.M.PL+FUT+2+PL
desempacotá-los-emos	desempacotar+V.ele.ACC.3.M.PL+FUT+1+PL
desempacotá-los-ia	desempacotar+V.ele.ACC.3.M.PL+COND+1+SG
desempacotá-los-ia	desempacotar+V.ele.ACC.3.M.PL+COND+3+SG
desempacotá-los-iam	desempacotar+V.ele.ACC.3.M.PL+COND+3+PL
desempacotá-los-íamos	desempacotar+V.ele.ACC.3.M.PL+COND+1+PL
desempacotá-los-ias	desempacotar+V.ele.ACC.3.M.PL+COND+2+SG
desempacotá-los-íeis	desempacotar+V.ele.ACC.3.M.PL+COND+2+PL
desempacota-me	desempacotar+V.eu.AD.1.SG+PRS+3+SG
desempacotam-lhe	desempacotar+V.ele.DAT.3.SG+PRS+3+PL
desempacotam-lhes	desempacotar+V.ele.DAT.3.PL+PRS+3+PL
desempacotam-me	desempacotar+V.eu.AD.1.SG+PRS+3+PL
desempacotam-na	desempacotar+V.ele.ACC.3.F.SG+PRS+3+PL
desempacotam-nas	desempacotar+V.ele.ACC.3.F.PL+PRS+3+PL
desempacotam-no	desempacotar+V.ele.ACC.3.M.SG+PRS+3+PL
desempacotam-nos	desempacotar+V.ele.ACC.3.M.PL+PRS+3+PL
desempacotam-nos	desempacotar+V.nós.AD.1.PL+PRS+3+PL
desempacotamo-la	desempacotar+V.ele.ACC.3.F.SG+PRF+1+PL
desempacotamo-la	desempacotar+V.ele.ACC.3.F.SG+PRS+1+PL
desempacotamo-las	desempacotar+V.ele.ACC.3.F.PL+PRF+1+PL
desempacotamo-las	desempacotar+V.ele.ACC.3.F.PL+PRS+1+PL
desempacotamo-lo	desempacotar+V.ele.ACC.3.M.SG+PRF+1+PL
desempacotamo-lo	desempacotar+V.ele.ACC.3.M.SG+PRS+1+PL
desempacotamo-los	desempacotar+V.ele.ACC.3.M.PL+PRF+1+PL
desempacotamo-los	desempacotar+V.ele.ACC.3.M.PL+PRS+1+PL
desempacotamo-nos	desempacotar+nós.AD.1.PL+PRF+1+PL
desempacotamo-nos	desempacotar+nós.AD.1.PL+PRS+1+PL
desempacotamos-lhe	desempacotar+V.ele.DAT.3.SG+PRF+1+PL
desempacotamos-lhe	desempacotar+V.ele.DAT.3.SG+PRS+1+PL
desempacotamos-lhes	desempacotar+V.ele.DAT.3.PL+PRF+1+PL
desempacotamos-lhes	desempacotar+V.ele.DAT.3.PL+PRS+1+PL
desempacotamos-me	desempacotar+V.eu.AD.1.SG+PRF+1+PL
desempacotamos-me	desempacotar+V.eu.AD.1.SG+PRS+1+PL
desempacotamos-te	desempacotar+V.tu.AD.2.SG+PRF+1+PL
desempacotamos-te	desempacotar+V.tu.AD.2.SG+PRS+1+PL
desempacotamos-vos	desempacotar+V.vós.AD.2.PL+PRF+1+PL
desempacotamos-vos	desempacotar+V.vós.AD.2.PL+PRS+1+PL
desempacotam-se	desempacotar+V.ele.REFL+PRS+3+PL
desempacotam-te	desempacotar+V.tu.AD.2.SG+PRS+3+PL
desempacotam-vos	desempacotar+V.vós.AD.2.PL+PRS+3+PL
desempacotando-a	desempacotar+V.ele.ACC.3.F.SG+GRD
desempacotando-as	desempacotar+V.ele.ACC.3.F.PL+GRD
desempacotando-lhe	desempacotar+V.ele.DAT.3.SG+GRD
desempacotando-lhes	desempacotar+V.ele.DAT.3.PL+GRD
desempacotando-me	desempacotar+V.eu.AD.1.SG+GRD
desempacotando-nos	desempacotar+nós.AD.1.PL+GRD
desempacotando-o	desempacotar+V.ele.ACC.3.M.SG+GRD
desempacotando-os	desempacotar+V.ele.ACC.3.M.PL+GRD
desempacotando-se	desempacotar+V.ele.REFL+GRD
desempacotando-te	desempacotar+V.tu.AD.2.SG+GRD
desempacotando-vos	desempacotar+V.vós.AD.2.PL+GRD
desempacota-nos	desempacotar+nós.AD.1.PL+PRS+2+SG
desempacota-nos	desempacotar+nós.AD.1.PL+PRS+3+SG
desempacota-o	desempacotar+V.ele.ACC.3.M.SG+PRS+3+SG
desempacota-os	desempacotar+V.ele.ACC.3.M.PL+PRS+3+SG
desempacotara-a	desempacotar+V.ele.ACC.3.F.SG+PQP+1+SG
desempacotara-a	desempacotar+V.ele.ACC.3.F.SG+PQP+3+SG
desempacotara-as	desempacotar+V.ele.ACC.3.F.PL+PQP+1+SG
desempacotara-as	desempacotar+V.ele.ACC.3.F.PL+PQP+3+SG
desempacotara-la	desempacotar+V.ele.ACC.3.F.SG+PQP+2+SG
desempacotara-las	desempacotar+V.ele.ACC.3.F.PL+PQP+2+SG
desempacotara-lhe	desempacotar+V.ele.DAT.3.SG+PQP+1+SG
desempacotara-lhe	desempacotar+V.ele.DAT.3.SG+PQP+3+SG
desempacotara-lhes	desempacotar+V.ele.DAT.3.PL+PQP+1+SG
desempacotara-lhes	desempacotar+V.ele.DAT.3.PL+PQP+3+SG
desempacotara-lo	desempacotar+V.ele.ACC.3.M.SG+PQP+2+SG
desempacotara-los	desempacotar+V.ele.ACC.3.M.PL+PQP+2+SG
desempacotara-me	desempacotar+V.eu.AD.1.SG+PQP+1+SG
desempacotara-me	desempacotar+V.eu.AD.1.SG+PQP+3+SG
desempacotaram-lhe	desempacotar+V.ele.DAT.3.SG+PQP+3+PL
desempacotaram-lhe	desempacotar+V.ele.DAT.3.SG+PRF+3+PL
desempacotaram-lhes	desempacotar+V.ele.DAT.3.PL+PQP+3+PL
desempacotaram-lhes	desempacotar+V.ele.DAT.3.PL+PRF+3+PL
desempacotaram-me	desempacotar+V.eu.AD.1.SG+PQP+3+PL
desempacotaram-me	desempacotar+V.eu.AD.1.SG+PRF+3+PL
desempacotaram-na	desempacotar+V.ele.ACC.3.F.SG+PQP+3+PL
desempacotaram-na	desempacotar+V.ele.ACC.3.F.SG+PRF+3+PL
desempacotaram-nas	desempacotar+V.ele.ACC.3.F.PL+PQP+3+PL
desempacotaram-nas	desempacotar+V.ele.ACC.3.F.PL+PRF+3+PL
desempacotaram-no	desempacotar+V.ele.ACC.3.M.SG+PQP+3+PL
desempacotaram-no	desempacotar+V.ele.ACC.3.M.SG+PRF+3+PL
desempacotaram-nos	desempacotar+V.ele.ACC.3.M.PL+PQP+3+PL
desempacotaram-nos	desempacotar+V.ele.ACC.3.M.PL+PRF+3+PL
desempacotaram-nos	desempacotar+V.nós.AD.1.PL+PQP+3+PL
desempacotaram-nos	desempacotar+V.nós.AD.1.PL+PRF+3+PL
desempacotáramo-la	desempacotar+V.ele.ACC.3.F.SG+PQP+1+PL
desempacotáramo-las	desempacotar+V.ele.ACC.3.F.PL+PQP+1+PL
desempacotáramo-lo	desempacotar+V.ele.ACC.3.M.SG+PQP+1+PL
desempacotáramo-los	desempacotar+V.ele.ACC.3.M.PL+PQP+1+PL
desempacotáramo-nos	desempacotar+nós.AD.1.PL+PQP+1+PL
desempacotáramos-lhe	desempacotar+V.ele.DAT.3.SG+PQP+1+PL
desempacotáramos-lhes	desempacotar+V.ele.DAT.3.PL+PQP+1+PL
desempacotáramos-me	desempacotar+V.eu.AD.1.SG+PQP+1+PL
desempacotáramos-te	desempacotar+V.tu.AD.2.SG+PQP+1+PL
desempacotáramos-vos	desempacotar+V.vós.AD.2.PL+PQP+1+PL
desempacotaram-se	desempacotar+V.ele.REFL+PQP+3+PL
desempacotaram-se	desempacotar+V.ele.REFL+PRF+3+PL
desempacotaram-te	desempacotar+V.tu.AD.2.SG+PQP+3+PL
desempacotaram-te	desempacotar+V.tu.AD.2.SG+PRF+3+PL
desempacotaram-vos	desempacotar+V.vós.AD.2.PL+PQP+3+PL
desempacotaram-vos	desempacotar+V.vós.AD.2.PL+PRF+3+PL
desempacotara-nos	desempacotar+nós.AD.1.PL+PQP+1+SG
desempacotara-nos	desempacotar+nós.AD.1.PL+PQP+2+SG
desempacotara-nos	desempacotar+nós.AD.1.PL+PQP+3+SG
desempacotara-o	desempacotar+V.ele.ACC.3.M.SG+PQP+1+SG
desempacotara-o	desempacotar+V.ele.ACC.3.M.SG+PQP+3+SG
desempacotara-os	desempacotar+V.ele.ACC.3.M.PL+PQP+1+SG
desempacotara-os	desempacotar+V.ele.ACC.3.M.PL+PQP+3+SG
desempacotara-se	desempacotar+V.ele.REFL+PQP+1+SG
desempacotara-se	desempacotar+V.ele.REFL+PQP+3+SG
desempacotaras-lhe	desempacotar+V.ele.DAT.3.SG+PQP+2+SG
desempacotaras-lhes	desempacotar+V.ele.DAT.3.PL+PQP+2+SG
desempacotaras-me	desempacotar+V.eu.AD.1.SG+PQP+2+SG
desempacotaras-te	desempacotar+V.tu.AD.2.SG+PQP+2+SG
desempacotaras-vos	desempacotar+V.vós.AD.2.PL+PQP+2+SG
desempacotara-te	desempacotar+V.tu.AD.2.SG+PQP+1+SG
desempacotara-te	desempacotar+V.tu.AD.2.SG+PQP+3+SG
desempacotara-vos	desempacotar+V.vós.AD.2.PL+PQP+1+SG
desempacotara-vos	desempacotar+V.vós.AD.2.PL+PQP+3+SG
desempacotarde-la	desempacotar+V.ele.ACC.3.F.SG+INF+2+PL
desempacotarde-la	desempacotar+V.ele.ACC.3.F.SG+SBJF+2+PL
desempacotarde-las	desempacotar+V.ele.ACC.3.F.PL+INF+2+PL
desempacotarde-las	desempacotar+V.ele.ACC.3.F.PL+SBJF+2+PL
desempacotarde-lo	desempacotar+V.ele.ACC.3.M.SG+INF+2+PL
desempacotarde-lo	desempacotar+V.ele.ACC.3.M.SG+SBJF+2+PL
desempacotarde-los	desempacotar+V.ele.ACC.3.M.PL+INF+2+PL
desempacotarde-los	desempacotar+V.ele.ACC.3.M.PL+SBJF+2+PL
desempacotarde-nos	desempacotar+nós.AD.1.PL+INF+2+PL
desempacotarde-nos	desempacotar+nós.AD.1.PL+SBJF+2+PL
desempacotardes-lhe	desempacotar+V.ele.DAT.3.SG+INF+2+PL
desempacotardes-lhe	desempacotar+V.ele.DAT.3.SG+SBJF+2+PL
desempacotardes-lhes	desempacotar+V.ele.DAT.3.PL+INF+2+PL
desempacotardes-lhes	desempacotar+V.ele.DAT.3.PL+SBJF+2+PL
desempacotardes-me	desempacotar+V.eu.AD.1.SG+INF+2+PL
desempacotardes-me	desempacotar+V.eu.AD.1.SG+SBJF+2+PL
desempacotardes-te	desempacotar+V.tu.AD.2.SG+INF+2+PL
desempacotardes-te	desempacotar+V.tu.AD.2.SG+SBJF+2+PL
desempacotardes-vos	desempacotar+V.vós.AD.2.PL+INF+2+PL
desempacotardes-vos	desempacotar+V.vós.AD.2.PL+SBJF+2+PL
desempacotárei-la	desempacotar+V.ele.ACC.3.F.SG+PQP+2+PL
desempacotárei-las	desempacotar+V.ele.ACC.3.F.PL+PQP+2+PL
desempacotárei-lo	desempacotar+V.ele.ACC.3.M.SG+PQP+2+PL
desempacotárei-los	desempacotar+V.ele.ACC.3.M.PL+PQP+2+PL
desempacotárei-nos	desempacotar+nós.AD.1.PL+PQP+2+PL
desempacotáreis-lhe	desempacotar+V.ele.DAT.3.SG+PQP+2+PL
desempacotáreis-lhes	desempacotar+V.ele.DAT.3.PL+PQP+2+PL
desempacotáreis-me	desempacotar+V.eu.AD.1.SG+PQP+2+PL
desempacotáreis-te	desempacotar+V.tu.AD.2.SG+PQP+2+PL
desempacotáreis-vos	desempacotar+V.vós.AD.2.PL+PQP+2+PL
desempacotare-la	desempacotar+V.ele.ACC.3.F.SG+INF+2+SG
desempacotare-la	desempacotar+V.ele.ACC.3.F.SG+SBJF+2+SG
desempacotare-las	desempacotar+V.ele.ACC.3.F.PL+INF+2+SG
desempacotare-las	desempacotar+V.ele.ACC.3.F.PL+SBJF+2+SG
desempacotare-lo	desempacotar+V.ele.ACC.3.M.SG+INF+2+SG
desempacotare-lo	desempacotar+V.ele.ACC.3.M.SG+SBJF+2+SG
desempacotare-los	desempacotar+V.ele.ACC.3.M.PL+INF+2+SG
desempacotare-los	desempacotar+V.ele.ACC.3.M.PL+SBJF+2+SG
desempacotarem-lhe	desempacotar+V.ele.DAT.3.SG+INF+3+PL
desempacotarem-lhe	desempacotar+V.ele.DAT.3.SG+SBJF+3+PL
desempacotarem-lhes	desempacotar+V.ele.DAT.3.PL+INF+3+PL
desempacotarem-lhes	desempacotar+V.ele.DAT.3.PL+SBJF+3+PL
desempacotarem-me	desempacotar+V.eu.AD.1.SG+INF+3+PL
desempacotarem-me	desempacotar+V.eu.AD.1.SG+SBJF+3+PL
desempacotarem-na	desempacotar+V.ele.ACC.3.F.SG+INF+3+PL
desempacotarem-na	desempacotar+V.ele.ACC.3.F.SG+SBJF+3+PL
desempacotarem-nas	desempacotar+V.ele.ACC.3.F.PL+INF+3+PL
desempacotarem-nas	desempacotar+V.ele.ACC.3.F.PL+SBJF+3+PL
desempacotarem-no	desempacotar+V.ele.ACC.3.M.SG+INF+3+PL
desempacotarem-no	desempacotar+V.ele.ACC.3.M.SG+SBJF+3+PL
desempacotarem-nos	desempacotar+V.ele.ACC.3.M.PL+INF+3+PL
desempacotarem-nos	desempacotar+V.ele.ACC.3.M.PL+SBJF+3+PL
desempacotarem-nos	desempacotar+V.nós.AD.1.PL+INF+3+PL
desempacotarem-nos	desempacotar+V.nós.AD.1.PL+SBJF+3+PL
desempacotarem-se	desempacotar+V.ele.REFL+INF+3+PL
desempacotarem-se	desempacotar+V.ele.REFL+SBJF+3+PL
desempacotarem-te	desempacotar+V.tu.AD.2.SG+INF+3+PL
desempacotarem-te	desempacotar+V.tu.AD.2.SG+SBJF+3+PL
desempacotarem-vos	desempacotar+V.vós.AD.2.PL+INF+3+PL
desempacotarem-vos	desempacotar+V.vós.AD.2.PL+SBJF+3+PL
desempacotare-nos	desempacotar+nós.AD.1.PL+INF+2+SG
desempacotare-nos	desempacotar+nós.AD.1.PL+SBJF+2+SG
desempacotares-lhe	desempacotar+V.ele.DAT.3.SG+INF+2+SG
desempacotares-lhe	desempacotar+V.ele.DAT.3.SG+SBJF+2+SG
desempacotares-lhes	desempacotar+V.ele.DAT.3.PL+INF+2+SG
desempacotares-lhes	desempacotar+V.ele.DAT.3.PL+SBJF+2+SG
desempacotares-me	desempacotar+V.eu.AD.1.SG+INF+2+SG
desempacotares-me	desempacotar+V.eu.AD.1.SG+SBJF+2+SG
desempacotares-te	desempacotar+V.tu.AD.2.SG+INF+2+SG
desempacotares-te	desempacotar+V.tu.AD.2.SG+SBJF+2+SG
desempacotares-vos	desempacotar+V.vós.AD.2.PL+INF+2+SG
desempacotares-vos	desempacotar+V.vós.AD.2.PL+SBJF+2+SG
desempacotar-lhe-á	desempacotar+V.ele.DAT.3.SG+FUT+3+SG
desempacotar-lhe-ão	desempacotar+V.ele.DAT.3.SG+FUT+3+PL
desempacotar-lhe-ás	desempacotar+V.ele.DAT.3.SG+FUT+2+SG
desempacotar-lhe	desempacotar+V.ele.DAT.3.SG+INF
desempacotar-lhe	desempacotar+V.ele.DAT.3.SG+INF+1+SG
desempacotar-lhe	desempacotar+V.ele.DAT.3.SG+INF+3+SG
desempacotar-lhe	desempacotar+V.ele.DAT.3.SG+SBJF+1+SG
desempacotar-lhe	desempacotar+V.ele.DAT.3.SG+SBJF+3+SG
desempacotar-lhe-ei	desempacotar+V.ele.DAT.3.SG+FUT+1+SG
desempacotar-lhe-eis	desempacotar+V.ele.DAT.3.SG+FUT+2+PL
desempacotar-lhe-emos	desempacotar+V.ele.DAT.3.SG+FUT+1+PL
desempacotar-lhe-ia	desempacotar+V.ele.DAT.3.SG+COND+1+SG
desempacotar-lhe-ia	desempacotar+V.ele.DAT.3.SG+COND+3+SG
desempacotar-lhe-iam	desempacotar+V.ele.DAT.3.SG+COND+3+PL
desempacotar-lhe-íamos	desempacotar+V.ele.DAT.3.SG+COND+1+PL
desempacotar-lhe-ias	desempacotar+V.ele.DAT.3.SG+COND+2+SG
desempacotar-lhe-íeis	desempacotar+V.ele.DAT.3.SG+COND+2+PL
desempacotar-lhes-á	desempacotar+V.ele.DAT.3.PL+FUT+3+SG
desempacotar-lhes-ão	desempacotar+V.ele.DAT.3.PL+FUT+3+PL
desempacotar-lhes-ás	desempacotar+V.ele.DAT.3.PL+FUT+2+SG
desempacotar-lhes	desempacotar+V.ele.DAT.3.PL+INF
desempacotar-lhes	desempacotar+V.ele.DAT.3.PL+INF+1+SG
desempacotar-lhes	desempacotar+V.ele.DAT.3.PL+INF+3+SG
desempacotar-lhes	desempacotar+V.ele.DAT.3.PL+SBJF+1+SG
desempacotar-lhes	desempacotar+V.ele.DAT.3.PL+SBJF+3+SG
desempacotar-lhes-ei	desempacotar+V.ele.DAT.3.PL+FUT+1+SG
desempacotar-lhes-eis	desempacotar+V.ele.DAT.3.PL+FUT+2+PL
desempacotar-lhes-emos	desempacotar+V.ele.DAT.3.PL+FUT+1+PL
desempacotar-lhes-ia	desempacotar+V.ele.DAT.3.PL+COND+1+SG
desempacotar-lhes-ia	desempacotar+V.ele.DAT.3.PL+COND+3+SG
desempacotar-lhes-iam	desempacotar+V.ele.DAT.3.PL+COND+3+PL
desempacotar-lhes-íamos	desempacotar+V.ele.DAT.3.PL+COND+1+PL
desempacotar-lhes-ias	desempacotar+V.ele.DAT.3.PL+COND+2+SG
desempacotar-lhes-íeis	desempacotar+V.ele.DAT.3.PL+COND+2+PL
desempacotar-me-á	desempacotar+V.eu.AD.1.SG+FUT+3+SG
desempacotar-me-ão	desempacotar+V.eu.AD.1.SG+FUT+3+PL
desempacotar-me-ás	desempacotar+V.eu.AD.1.SG+FUT+2+SG
desempacotar-me	desempacotar+V.eu.AD.1.SG+INF
desempacotar-me	desempacotar+V.eu.AD.1.SG+INF+1+SG
desempacotar-me	desempacotar+V.eu.AD.1.SG+INF+3+SG
desempacotar-me	desempacotar+V.eu.AD.1.SG+SBJF+1+SG
desempacotar-me	desempacotar+V.eu.AD.1.SG+SBJF+3+SG
desempacotar-me-ei	desempacotar+V.eu.AD.1.SG+FUT+1+SG
desempacotar-me-eis	desempacotar+V.eu.AD.1.SG+FUT+2+PL
desempacotar-me-emos	desempacotar+V.eu.AD.1.SG+FUT+1+PL
desempacotar-me-ia	desempacotar+V.eu.AD.1.SG+COND+1+SG
desempacotar-me-ia	desempacotar+V.eu.AD.1.SG+COND+3+SG
desempacotar-me-iam	desempacotar+V.eu.AD.1.SG+COND+3+PL
desempacotar-me-íamos	desempacotar+V.eu.AD.1.SG+COND+1+PL
desempacotar-me-ias	desempacotar+V.eu.AD.1.SG+COND+2+SG
desempacotar-me-íeis	desempacotar+V.eu.AD.1.SG+COND+2+PL
desempacotarmo-la	desempacotar+V.ele.ACC.3.F.SG+INF+1+PL
desempacotarmo-la	desempacotar+V.ele.ACC.3.F.SG+SBJF+1+PL
desempacotarmo-las	desempacotar+V.ele.ACC.3.F.PL+INF+1+PL
desempacotarmo-las	desempacotar+V.ele.ACC.3.F.PL+SBJF+1+PL
desempacotarmo-lo	desempacotar+V.ele.ACC.3.M.SG+INF+1+PL
desempacotarmo-lo	desempacotar+V.ele.ACC.3.M.SG+SBJF+1+PL
desempacotarmo-los	desempacotar+V.ele.ACC.3.M.PL+INF+1+PL
desempacotarmo-los	desempacotar+V.ele.ACC.3.M.PL+SBJF+1+PL
desempacotarmo-nos	desempacotar+nós.AD.1.PL+INF+1+PL
desempacotarmo-nos	desempacotar+nós.AD.1.PL+SBJF+1+PL
desempacotarmos-lhe	desempacotar+V.ele.DAT.3.SG+INF+1+PL
desempacotarmos-lhe	desempacotar+V.ele.DAT.3.SG+SBJF+1+PL
desempacotarmos-lhes	desempacotar+V.ele.DAT.3.PL+INF+1+PL
desempacotarmos-lhes	desempacotar+V.ele.DAT.3.PL+SBJF+1+PL
desempacotarmos-me	desempacotar+V.eu.AD.1.SG+INF+1+PL
desempacotarmos-me	desempacotar+V.eu.AD.1.SG+SBJF+1+PL
desempacotarmos-te	desempacotar+V.tu.AD.2.SG+INF+1+PL
desempacotarmos-te	desempacotar+V.tu.AD.2.SG+SBJF+1+PL
desempacotarmos-vos	desempacotar+V.vós.AD.2.PL+INF+1+PL
desempacotarmos-vos	desempacotar+V.vós.AD.2.PL+SBJF+1+PL
desempacotar-nos-á	desempacotar+nós.AD.1.PL+FUT+3+SG
desempacotar-nos-ão	desempacotar+nós.AD.1.PL+FUT+3+PL
desempacotar-nos-ás	desempacotar+nós.AD.1.PL+FUT+2+SG
desempacotar-nos	desempacotar+nós.AD.1.PL+INF
desempacotar-nos	desempacotar+nós.AD.1.PL+INF+1+SG
desempacotar-nos	desempacotar+nós.AD.1.PL+INF+3+SG
desempacotar-nos	desempacotar+nós.AD.1.PL+SBJF+1+SG
desempacotar-nos	desempacotar+nós.AD.1.PL+SBJF+3+SG
desempacotar-nos-ei	desempacotar+nós.AD.1.PL+FUT+1+SG
desempacotar-nos-eis	desempacotar+nós.AD.1.PL+FUT+2+PL
desempacotar-nos-emos	desempacotar+nós.AD.1.PL+FUT+1+PL
desempacotar-nos-ia	desempacotar+nós.AD.1.PL+COND+1+SG
desempacotar-nos-ia	desempacotar+nós.AD.1.PL+COND+3+SG
desempacotar-nos-iam	desempacotar+nós.AD.1.PL+COND+3+PL
desempacotar-nos-íamos	desempacotar+nós.AD.1.PL+COND+1+PL
desempacotar-nos-ias	desempacotar+nós.AD.1.PL+COND+2+SG
desempacotar-nos-íeis	desempacotar+nós.AD.1.PL+COND+2+PL
desempacotar-se-á	desempacotar+V.ele.REFL+FUT+3+SG
desempacotar-se-ão	desempacotar+V.ele.REFL+FUT+3+PL
desempacotar-se	desempacotar+V.ele.REFL+INF
desempacotar-se	desempacotar+V.ele.REFL+INF+3+SG
desempacotar-se	desempacotar+V.ele.REFL+SBJF+3+SG
desempacotar-se-ia	desempacotar+V.ele.REFL+COND+3+SG
desempacotar-se-iam	desempacotar+V.ele.REFL+COND+3+PL
desempacotar-te-á	desempacotar+V.tu.AD.2.SG+FUT+3+SG
desempacotar-te-ão	desempacotar+V.tu.AD.2.SG+FUT+3+PL
desempacotar-te-ás	desempacotar+V.tu.AD.2.SG+FUT+2+SG
desempacotar-te	desempacotar+V.tu.AD.2.SG+INF
desempacotar-te	desempacotar+V.tu.AD.2.SG+INF+1+SG
desempacotar-te	desempacotar+V.tu.AD.2.SG+INF+3+SG
desempacotar-te	desempacotar+V.tu.AD.2.SG+SBJF+1+SG
desempacotar-te	desempacotar+V.tu.AD.2.SG+SBJF+3+SG
desempacotar-te-ei	desempacotar+V.tu.AD.2.SG+FUT+1+SG
desempacotar-te-eis	desempacotar+V.tu.AD.2.SG+FUT+2+PL
desempacotar-te-emos	desempacotar+V.tu.AD.2.SG+FUT+1+PL
desempacotar-te-ia	desempacotar+V.tu.AD.2.SG+COND+1+SG
desempacotar-te-ia	desempacotar+V.tu.AD.2.SG+COND+3+SG
desempacotar-te-iam	desempacotar+V.tu.AD.2.SG+COND+3+PL
desempacotar-te-íamos	desempacotar+V.tu.AD.2.SG+COND+1+PL
desempacotar-te-ias	desempacotar+V.tu.AD.2.SG+COND+2+SG
desempacotar-te-íeis	desempacotar+V.tu.AD.2.SG+COND+2+PL
desempacotar-vos-á	desempacotar+V.vós.AD.2.PL+FUT+3+SG
desempacotar-vos-ão	desempacotar+V.vós.AD.2.PL+FUT+3+PL
desempacotar-vos-ás	desempacotar+V.vós.AD.2.PL+FUT+2+SG
desempacotar-vos	desempacotar+V.vós.AD.2.PL+INF
desempacotar-vos	desempacotar+V.vós.AD.2.PL+INF+1+SG
desempacotar-vos	desempacotar+V.vós.AD.2.PL+INF+3+SG
desempacotar-vos	desempacotar+V.vós.AD.2.PL+SBJF+1+SG
desempacotar-vos	desempacotar+V.vós.AD.2.PL+SBJF+3+SG
desempacotar-vos-ei	desempacotar+V.vós.AD.2.PL+FUT+1+SG
desempacotar-vos-eis	desempacotar+V.vós.AD.2.PL+FUT+2+PL
desempacotar-vos-emos	desempacotar+V.vós.AD.2.PL+FUT+1+PL
desempacotar-vos-ia	desempacotar+V.vós.AD.2.PL+COND+1+SG
desempacotar-vos-ia	desempacotar+V.vós.AD.2.PL+COND+3+SG
desempacotar-vos-iam	desempacotar+V.vós.AD.2.PL+COND+3+PL
desempacotar-vos-íamos	desempacotar+V.vós.AD.2.PL+COND+1+PL
desempacotar-vos-ias	desempacotar+V.vós.AD.2.PL+COND+2+SG
desempacotar-vos-íeis	desempacotar+V.vós.AD.2.PL+COND+2+PL
desempacota-se	desempacotar+V.ele.REFL+PRS+3+SG
desempacotas-lhe	desempacotar+V.ele.DAT.3.SG+PRS+2+SG
desempacotas-lhes	desempacotar+V.ele.DAT.3.PL+PRS+2+SG
desempacotas-me	desempacotar+V.eu.AD.1.SG+PRS+2+SG
desempacotaste-a	desempacotar+V.ele.ACC.3.F.SG+PRF+2+SG
desempacotaste-as	desempacotar+V.ele.ACC.3.F.PL+PRF+2+SG
desempacotas-te	desempacotar+V.tu.AD.2.SG+PRS+2+SG
desempacotaste-la	desempacotar+V.ele.ACC.3.F.SG+PRF+2+PL
desempacotaste-las	desempacotar+V.ele.ACC.3.F.PL+PRF+2+PL
desempacotaste-lhe	desempacotar+V.ele.DAT.3.SG+PRF+2+SG
desempacotaste-lhes	desempacotar+V.ele.DAT.3.PL+PRF+2+SG
desempacotaste-lo	desempacotar+V.ele.ACC.3.M.SG+PRF+2+PL
desempacotaste-los	desempacotar+V.ele.ACC.3.M.PL+PRF+2+PL
desempacotaste-me	desempacotar+V.eu.AD.1.SG+PRF+2+SG
desempacotaste-nos	desempacotar+nós.AD.1.PL+PRF+2+PL
desempacotaste-nos	desempacotar+nós.AD.1.PL+PRF+2+SG
desempacotaste-o	desempacotar+V.ele.ACC.3.M.SG+PRF+2+SG
desempacotaste-os	desempacotar+V.ele.ACC.3.M.PL+PRF+2+SG
desempacotastes-lhe	desempacotar+V.ele.DAT.3.SG+PRF+2+PL
desempacotastes-lhes	desempacotar+V.ele.DAT.3.PL+PRF+2+PL
desempacotastes-me	desempacotar+V.eu.AD.1.SG+PRF+2+PL
desempacotastes-te	desempacotar+V.tu.AD.2.SG+PRF+2+PL
desempacotastes-vos	desempacotar+V.vós.AD.2.PL+PRF+2+PL
desempacotaste-te	desempacotar+V.tu.AD.2.SG+PRF+2+SG
desempacotaste-vos	desempacotar+V.vós.AD.2.PL+PRF+2+SG
desempacotas-vos	desempacotar+V.vós.AD.2.PL+PRS+2+SG
desempacota-te	desempacotar+V.tu.AD.2.SG+PRS+3+SG
desempacotava-a	desempacotar+V.ele.ACC.3.F.SG+IMPF+1+SG
desempacotava-a	desempacotar+V.ele.ACC.3.F.SG+IMPF+3+SG
desempacotava-as	desempacotar+V.ele.ACC.3.F.PL+IMPF+1+SG
desempacotava-as	desempacotar+V.ele.ACC.3.F.PL+IMPF+3+SG
desempacotava-la	desempacotar+V.ele.ACC.3.F.SG+IMPF+2+SG
desempacotava-las	desempacotar+V.ele.ACC.3.F.PL+IMPF+2+SG
desempacotava-lhe	desempacotar+V.ele.DAT.3.SG+IMPF+1+SG
desempacotava-lhe	desempacotar+V.ele.DAT.3.SG+IMPF+3+SG
desempacotava-lhes	desempacotar+V.ele.DAT.3.PL+IMPF+1+SG
desempacotava-lhes	desempacotar+V.ele.DAT.3.PL+IMPF+3+SG
desempacotava-lo	desempacotar+V.ele.ACC.3.M.SG+IMPF+2+SG
desempacotava-los	desempacotar+V.ele.ACC.3.M.PL+IMPF+2+SG
desempacotava-me	desempacotar+V.eu.AD.1.SG+IMPF+1+SG
desempacotava-me	desempacotar+V.eu.AD.1.SG+IMPF+3+SG
desempacotavam-lhe	desempacotar+V.ele.DAT.3.SG+IMPF+3+PL
desempacotavam-lhes	desempacotar+V.ele.DAT.3.PL+IMPF+3+PL
desempacotavam-me	desempacotar+V.eu.AD.1.SG+IMPF+3+PL
desempacotavam-na	desempacotar+V.ele.ACC.3.F.SG+IMPF+3+PL
desempacotavam-nas	desempacotar+V.ele.ACC.3.F.PL+IMPF+3+PL
desempacotavam-no	desempacotar+V.ele.ACC.3.M.SG+IMPF+3+PL
desempacotavam-nos	desempacotar+V.ele.ACC.3.M.PL+IMPF+3+PL
desempacotavam-nos	desempacotar+V.nós.AD.1.PL+IMPF+3+PL
desempacotávamo-la	desempacotar+V.ele.ACC.3.F.SG+IMPF+1+PL
desempacotávamo-las	desempacotar+V.ele.ACC.3.F.PL+IMPF+1+PL
desempacotávamo-lo	desempacotar+V.ele.ACC.3.M.SG+IMPF+1+PL
desempacotávamo-los	desempacotar+V.ele.ACC.3.M.PL+IMPF+1+PL
desempacotávamo-nos	desempacotar+nós.AD.1.PL+IMPF+1+PL
desempacotávamos-lhe	desempacotar+V.ele.DAT.3.SG+IMPF+1+PL
desempacotávamos-lhes	desempacotar+V.ele.DAT.3.PL+IMPF+1+PL
desempacotávamos-me	desempacotar+V.eu.AD.1.SG+IMPF+1+PL
desempacotávamos-te	desempacotar+V.tu.AD.2.SG+IMPF+1+PL
desempacotávamos-vos	desempacotar+V.vós.AD.2.PL+IMPF+1+PL
desempacotavam-se	desempacotar+V.ele.REFL+IMPF+3+PL
desempacotavam-te	desempacotar+V.tu.AD.2.SG+IMPF+3+PL
desempacotavam-vos	desempacotar+V.vós.AD.2.PL+IMPF+3+PL
desempacotava-nos	desempacotar+nós.AD.1.PL+IMPF+1+SG
desempacotava-nos	desempacotar+nós.AD.1.PL+IMPF+2+SG
desempacotava-nos	desempacotar+nós.AD.1.PL+IMPF+3+SG
desempacotava-o	desempacotar+V.ele.ACC.3.M.SG+IMPF+1+SG
desempacotava-o	desempacotar+V.ele.ACC.3.M.SG+IMPF+3+SG
desempacotava-os	desempacotar+V.ele.ACC.3.M.PL+IMPF+1+SG
desempacotava-os	desempacotar+V.ele.ACC.3.M.PL+IMPF+3+SG
desempacotava-se	desempacotar+V.ele.REFL+IMPF+1+SG
desempacotava-se	desempacotar+V.ele.REFL+IMPF+3+SG
desempacotavas-lhe	desempacotar+V.ele.DAT.3.SG+IMPF+2+SG
desempacotavas-lhes	desempacotar+V.ele.DAT.3.PL+IMPF+2+SG
desempacotavas-me	desempacotar+V.eu.AD.1.SG+IMPF+2+SG
desempacotavas-te	desempacotar+V.tu.AD.2.SG+IMPF+2+SG
desempacotavas-vos	desempacotar+V.vós.AD.2.PL+IMPF+2+SG
desempacotava-te	desempacotar+V.tu.AD.2.SG+IMPF+1+SG
desempacotava-te	desempacotar+V.tu.AD.2.SG+IMPF+3+SG
desempacotava-vos	desempacotar+V.vós.AD.2.PL+IMPF+1+SG
desempacotava-vos	desempacotar+V.vós.AD.2.PL+IMPF+3+SG
desempacotávei-la	desempacotar+V.ele.ACC.3.F.SG+IMPF+2+PL
desempacotávei-las	desempacotar+V.ele.ACC.3.F.PL+IMPF+2+PL
desempacotávei-lo	desempacotar+V.ele.ACC.3.M.SG+IMPF+2+PL
desempacotávei-los	desempacotar+V.ele.ACC.3.M.PL+IMPF+2+PL
desempacotávei-nos	desempacotar+nós.AD.1.PL+IMPF+2+PL
desempacotáveis-lhe	desempacotar+V.ele.DAT.3.SG+IMPF+2+PL
desempacotáveis-lhes	desempacotar+V.ele.DAT.3.PL+IMPF+2+PL
desempacotáveis-me	desempacotar+V.eu.AD.1.SG+IMPF+2+PL
desempacotáveis-te	desempacotar+V.tu.AD.2.SG+IMPF+2+PL
desempacotáveis-vos	desempacotar+V.vós.AD.2.PL+IMPF+2+PL
desempacota-vos	desempacotar+V.vós.AD.2.PL+PRS+3+SG
desempacote-a	desempacotar+V.ele.ACC.3.F.SG+IMP+3+SG
desempacote-as	desempacotar+V.ele.ACC.3.F.PL+IMP+3+SG
desempaco-te	desempacar+V.tu.AD.2.SG+PRS+1+SG
desempacotei-a	desempacotar+V.ele.ACC.3.F.SG+PRF+1+SG
desempacotei-as	desempacotar+V.ele.ACC.3.F.PL+PRF+1+SG
desempacotei-lhe	desempacotar+V.ele.DAT.3.SG+PRF+1+SG
desempacotei-lhes	desempacotar+V.ele.DAT.3.PL+PRF+1+SG
desempacotei-me	desempacotar+V.eu.AD.1.SG+PRF+1+SG
desempacotei-nos	desempacotar+nós.AD.1.PL+PRF+1+SG
desempacotei-o	desempacotar+V.ele.ACC.3.M.SG+PRF+1+SG
desempacotei-os	desempacotar+V.ele.ACC.3.M.PL+PRF+1+SG
desempacotei-te	desempacotar+V.tu.AD.2.SG+PRF+1+SG
desempacotei-vos	desempacotar+V.vós.AD.2.PL+PRF+1+SG
desempacote-lhe	desempacotar+V.ele.DAT.3.SG+IMP+3+SG
desempacote-lhes	desempacotar+V.ele.DAT.3.PL+IMP+3+SG
desempacote-me	desempacotar+V.eu.AD.1.SG+IMP+3+SG
desempacotem-lhe	desempacotar+V.ele.DAT.3.SG+IMP+3+PL
desempacotem-lhes	desempacotar+V.ele.DAT.3.PL+IMP+3+PL
desempacotem-me	desempacotar+V.eu.AD.1.SG+IMP+3+PL
desempacotem-na	desempacotar+V.ele.ACC.3.F.SG+IMP+3+PL
desempacotem-nas	desempacotar+V.ele.ACC.3.F.PL+IMP+3+PL
desempacotem-no	desempacotar+V.ele.ACC.3.M.SG+IMP+3+PL
desempacotem-nos	desempacotar+V.ele.ACC.3.M.PL+IMP+3+PL
desempacotem-nos	desempacotar+V.nós.AD.1.PL+IMP+3+PL
desempacotemo-la	desempacotar+V.ele.ACC.3.F.SG+IMP+1+PL
desempacotemo-las	desempacotar+V.ele.ACC.3.F.PL+IMP+1+PL
desempacotemo-lo	desempacotar+V.ele.ACC.3.M.SG+IMP+1+PL
desempacotemo-los	desempacotar+V.ele.ACC.3.M.PL+IMP+1+PL
desempacotemo-nos	desempacotar+nós.AD.1.PL+IMP+1+PL
desempacotemos-lhe	desempacotar+V.ele.DAT.3.SG+IMP+1+PL
desempacotemos-lhes	desempacotar+V.ele.DAT.3.PL+IMP+1+PL
desempacotemos-me	desempacotar+V.eu.AD.1.SG+IMP+1+PL
desempacotemos-te	desempacotar+V.tu.AD.2.SG+IMP+1+PL
desempacotemos-vos	desempacotar+V.vós.AD.2.PL+IMP+1+PL
desempacotem-se	desempacotar+V.ele.REFL+IMP+3+PL
desempacotem-te	desempacotar+V.tu.AD.2.SG+IMP+3+PL
desempacotem-vos	desempacotar+V.vós.AD.2.PL+IMP+3+PL
desempacote-nos	desempacotar+nós.AD.1.PL+IMP+3+SG
desempacote-o	desempacotar+V.ele.ACC.3.M.SG+IMP+3+SG
desempacote-os	desempacotar+V.ele.ACC.3.M.PL+IMP+3+SG
desempacote-se	desempacotar+V.ele.REFL+IMP+3+SG
desempacote-te	desempacotar+V.tu.AD.2.SG+IMP+3+SG
desempacote-vos	desempacotar+V.vós.AD.2.PL+IMP+3+SG
desempacoto-a	desempacotar+V.ele.ACC.3.F.SG+PRS+1+SG
desempacoto-as	desempacotar+V.ele.ACC.3.F.PL+PRS+1+SG
desempacoto-lhe	desempacotar+V.ele.DAT.3.SG+PRS+1+SG
desempacoto-lhes	desempacotar+V.ele.DAT.3.PL+PRS+1+SG
desempacoto-me	desempacotar+V.eu.AD.1.SG+PRS+1+SG
desempacoto-nos	desempacotar+nós.AD.1.PL+PRS+1+SG
desempacoto-o	desempacotar+V.ele.ACC.3.M.SG+PRS+1+SG
desempacoto-os	desempacotar+V.ele.ACC.3.M.PL+PRS+1+SG
desempacoto-te	desempacotar+V.tu.AD.2.SG+PRS+1+SG
desempacotou-a	desempacotar+V.ele.ACC.3.F.SG+PRF+3+SG
desempacotou-as	desempacotar+V.ele.ACC.3.F.PL+PRF+3+SG
desempacotou-lhe	desempacotar+V.ele.DAT.3.SG+PRF+3+SG
desempacotou-lhes	desempacotar+V.ele.DAT.3.PL+PRF+3+SG
desempacotou-me	desempacotar+V.eu.AD.1.SG+PRF+3+SG
desempacotou-nos	desempacotar+nós.AD.1.PL+PRF+3+SG
desempacotou-o	desempacotar+V.ele.ACC.3.M.SG+PRF+3+SG
desempacotou-os	desempacotar+V.ele.ACC.3.M.PL+PRF+3+SG
desempacotou-se	desempacotar+V.ele.REFL+PRF+3+SG
desempacotou-te	desempacotar+V.tu.AD.2.SG+PRF+3+SG
desempacotou-vos	desempacotar+V.vós.AD.2.PL+PRF+3+SG
desempacoto-vos	desempacotar+V.vós.AD.2.PL+PRS+1+SG
desempacou-a	desempacar+V.ele.ACC.3.F.SG+PRF+3+SG
desempacou-as	desempacar+V.ele.ACC.3.F.PL+PRF+3+SG
desempacou-lhe	desempacar+V.ele.DAT.3.SG+PRF+3+SG
desempacou-lhes	desempacar+V.ele.DAT.3.PL+PRF+3+SG
desempacou-me	desempacar+V.eu.AD.1.SG+PRF+3+SG
desempacou-nos	desempacar+nós.AD.1.PL+PRF+3+SG
desempacou-o	desempacar+V.ele.ACC.3.M.SG+PRF+3+SG
desempacou-os	desempacar+V.ele.ACC.3.M.PL+PRF+3+SG
desempacou-se	desempacar+V.ele.REFL+PRF+3+SG
desempacou-te	desempacar+V.tu.AD.2.SG+PRF+3+SG
desempacou-vos	desempacar+V.vós.AD.2.PL+PRF+3+SG
desempaco-vos	desempacar+V.vós.AD.2.PL+PRS+1+SG
desempai-la	desempar+V.ele.ACC.3.F.SG+PRS+2+PL
desempai-las	desempar+V.ele.ACC.3.F.PL+PRS+2+PL
desempai-lo	desempar+V.ele.ACC.3.M.SG+PRS+2+PL
desempai-los	desempar+V.ele.ACC.3.M.PL+PRS+2+PL
desempai-nos	desempar+nós.AD.1.PL+PRS+2+PL
desempais-lhe	desempar+V.ele.DAT.3.SG+PRS+2+PL
desempais-lhes	desempar+V.ele.DAT.3.PL+PRS+2+PL
desempais-me	desempar+V.eu.AD.1.SG+PRS+2+PL
desempais-te	desempar+V.tu.AD.2.SG+PRS+2+PL
desempais-vos	desempar+V.vós.AD.2.PL+PRS+2+PL
desempala-a	desempalar+V.ele.ACC.3.F.SG+PRS+3+SG
desempá-la-á	desempar+V.ele.ACC.3.F.SG+FUT+3+SG
desempá-la-ão	desempar+V.ele.ACC.3.F.SG+FUT+3+PL
desempala-as	desempalar+V.ele.ACC.3.F.PL+PRS+3+SG
desempá-la-ás	desempar+V.ele.ACC.3.F.SG+FUT+2+SG
desempá-la	desempar+V.ele.ACC.3.F.SG+INF+1+SG
desempá-la	desempar+V.ele.ACC.3.F.SG+INF+3+SG
desempa-la	desempar+V.ele.ACC.3.F.SG+PRS+2+SG
desempá-la	desempar+V.ele.ACC.3.F.SG+SBJF+1+SG
desempá-la	desempar+V.ele.ACC.3.F.SG+SBJF+3+SG
desempá-la-ei	desempar+V.ele.ACC.3.F.SG+FUT+1+SG
desempá-la-eis	desempar+V.ele.ACC.3.F.SG+FUT+2+PL
desempá-la-emos	desempar+V.ele.ACC.3.F.SG+FUT+1+PL
desempá-la-ia	desempar+V.ele.ACC.3.F.SG+COND+1+SG
desempá-la-ia	desempar+V.ele.ACC.3.F.SG+COND+3+SG
desempá-la-iam	desempar+V.ele.ACC.3.F.SG+COND+3+PL
desempá-la-íamos	desempar+V.ele.ACC.3.F.SG+COND+1+PL
desempá-la-ias	desempar+V.ele.ACC.3.F.SG+COND+2+SG
desempá-la-íeis	desempar+V.ele.ACC.3.F.SG+COND+2+PL
desempalai-la	desempalar+V.ele.ACC.3.F.SG+PRS+2+PL
desempalai-las	desempalar+V.ele.ACC.3.F.PL+PRS+2+PL
desempalai-lo	desempalar+V.ele.ACC.3.M.SG+PRS+2+PL
desempalai-los	desempalar+V.ele.ACC.3.M.PL+PRS+2+PL
desempalai-nos	desempalar+nós.AD.1.PL+PRS+2+PL
desempalais-lhe	desempalar+V.ele.DAT.3.SG+PRS+2+PL
desempalais-lhes	desempalar+V.ele.DAT.3.PL+PRS+2+PL
desempalais-me	desempalar+V.eu.AD.1.SG+PRS+2+PL
desempalais-te	desempalar+V.tu.AD.2.SG+PRS+2+PL
desempalais-vos	desempalar+V.vós.AD.2.PL+PRS+2+PL
desempalá-la-á	desempalar+V.ele.ACC.3.F.SG+FUT+3+SG
desempalá-la-ão	desempalar+V.ele.ACC.3.F.SG+FUT+3+PL
desempalá-la-ás	desempalar+V.ele.ACC.3.F.SG+FUT+2+SG
desempalá-la	desempalar+V.ele.ACC.3.F.SG+INF+1+SG
desempalá-la	desempalar+V.ele.ACC.3.F.SG+INF+3+SG
desempala-la	desempalar+V.ele.ACC.3.F.SG+PRS+2+SG
desempalá-la	desempalar+V.ele.ACC.3.F.SG+SBJF+1+SG
desempalá-la	desempalar+V.ele.ACC.3.F.SG+SBJF+3+SG
desempalá-la-ei	desempalar+V.ele.ACC.3.F.SG+FUT+1+SG
desempalá-la-eis	desempalar+V.ele.ACC.3.F.SG+FUT+2+PL
desempalá-la-emos	desempalar+V.ele.ACC.3.F.SG+FUT+1+PL
desempalá-la-ia	desempalar+V.ele.ACC.3.F.SG+COND+1+SG
desempalá-la-ia	desempalar+V.ele.ACC.3.F.SG+COND+3+SG
desempalá-la-iam	desempalar+V.ele.ACC.3.F.SG+COND+3+PL
desempalá-la-íamos	desempalar+V.ele.ACC.3.F.SG+COND+1+PL
desempalá-la-ias	desempalar+V.ele.ACC.3.F.SG+COND+2+SG
desempalá-la-íeis	desempalar+V.ele.ACC.3.F.SG+COND+2+PL
desempalá-las-á	desempalar+V.ele.ACC.3.F.PL+FUT+3+SG
desempalá-las-ão	desempalar+V.ele.ACC.3.F.PL+FUT+3+PL
desempalá-las-ás	desempalar+V.ele.ACC.3.F.PL+FUT+2+SG
desempalá-las	desempalar+V.ele.ACC.3.F.PL+INF+1+SG
desempalá-las	desempalar+V.ele.ACC.3.F.PL+INF+3+SG
desempala-las	desempalar+V.ele.ACC.3.F.PL+PRS+2+SG
desempalá-las	desempalar+V.ele.ACC.3.F.PL+SBJF+1+SG
desempalá-las	desempalar+V.ele.ACC.3.F.PL+SBJF+3+SG
desempalá-las-ei	desempalar+V.ele.ACC.3.F.PL+FUT+1+SG
desempalá-las-eis	desempalar+V.ele.ACC.3.F.PL+FUT+2+PL
desempalá-las-emos	desempalar+V.ele.ACC.3.F.PL+FUT+1+PL
desempalá-las-ia	desempalar+V.ele.ACC.3.F.PL+COND+1+SG
desempalá-las-ia	desempalar+V.ele.ACC.3.F.PL+COND+3+SG
desempalá-las-iam	desempalar+V.ele.ACC.3.F.PL+COND+3+PL
desempalá-las-íamos	desempalar+V.ele.ACC.3.F.PL+COND+1+PL
desempalá-las-ias	desempalar+V.ele.ACC.3.F.PL+COND+2+SG
desempalá-las-íeis	desempalar+V.ele.ACC.3.F.PL+COND+2+PL
desempala-lhe	desempalar+V.ele.DAT.3.SG+PRS+3+SG
desempala-lhes	desempalar+V.ele.DAT.3.PL+PRS+3+SG
desempalá-lo-á	desempalar+V.ele.ACC.3.M.SG+FUT+3+SG
desempalá-lo-ão	desempalar+V.ele.ACC.3.M.SG+FUT+3+PL
desempalá-lo-ás	desempalar+V.ele.ACC.3.M.SG+FUT+2+SG
desempalá-lo	desempalar+V.ele.ACC.3.M.SG+INF+1+SG
desempalá-lo	desempalar+V.ele.ACC.3.M.SG+INF+3+SG
desempala-lo	desempalar+V.ele.ACC.3.M.SG+PRS+2+SG
desempalá-lo	desempalar+V.ele.ACC.3.M.SG+SBJF+1+SG
desempalá-lo	desempalar+V.ele.ACC.3.M.SG+SBJF+3+SG
desempalá-lo-ei	desempalar+V.ele.ACC.3.M.SG+FUT+1+SG
desempalá-lo-eis	desempalar+V.ele.ACC.3.M.SG+FUT+2+PL
desempalá-lo-emos	desempalar+V.ele.ACC.3.M.SG+FUT+1+PL
desempalá-lo-ia	desempalar+V.ele.ACC.3.M.SG+COND+1+SG
desempalá-lo-ia	desempalar+V.ele.ACC.3.M.SG+COND+3+SG
desempalá-lo-iam	desempalar+V.ele.ACC.3.M.SG+COND+3+PL
desempalá-lo-íamos	desempalar+V.ele.ACC.3.M.SG+COND+1+PL
desempalá-lo-ias	desempalar+V.ele.ACC.3.M.SG+COND+2+SG
desempalá-lo-íeis	desempalar+V.ele.ACC.3.M.SG+COND+2+PL
desempalá-los-á	desempalar+V.ele.ACC.3.M.PL+FUT+3+SG
desempalá-los-ão	desempalar+V.ele.ACC.3.M.PL+FUT+3+PL
desempalá-los-ás	desempalar+V.ele.ACC.3.M.PL+FUT+2+SG
desempalá-los	desempalar+V.ele.ACC.3.M.PL+INF+1+SG
desempalá-los	desempalar+V.ele.ACC.3.M.PL+INF+3+SG
desempala-los	desempalar+V.ele.ACC.3.M.PL+PRS+2+SG
desempalá-los	desempalar+V.ele.ACC.3.M.PL+SBJF+1+SG
desempalá-los	desempalar+V.ele.ACC.3.M.PL+SBJF+3+SG
desempalá-los-ei	desempalar+V.ele.ACC.3.M.PL+FUT+1+SG
desempalá-los-eis	desempalar+V.ele.ACC.3.M.PL+FUT+2+PL
desempalá-los-emos	desempalar+V.ele.ACC.3.M.PL+FUT+1+PL
desempalá-los-ia	desempalar+V.ele.ACC.3.M.PL+COND+1+SG
desempalá-los-ia	desempalar+V.ele.ACC.3.M.PL+COND+3+SG
desempalá-los-iam	desempalar+V.ele.ACC.3.M.PL+COND+3+PL
desempalá-los-íamos	desempalar+V.ele.ACC.3.M.PL+COND+1+PL
desempalá-los-ias	desempalar+V.ele.ACC.3.M.PL+COND+2+SG
desempalá-los-íeis	desempalar+V.ele.ACC.3.M.PL+COND+2+PL
desempala-me	desempalar+V.eu.AD.1.SG+PRS+3+SG
desempalam-lhe	desempalar+V.ele.DAT.3.SG+PRS+3+PL
desempalam-lhes	desempalar+V.ele.DAT.3.PL+PRS+3+PL
desempalam-me	desempalar+V.eu.AD.1.SG+PRS+3+PL
desempalam-na	desempalar+V.ele.ACC.3.F.SG+PRS+3+PL
desempalam-nas	desempalar+V.ele.ACC.3.F.PL+PRS+3+PL
desempalam-no	desempalar+V.ele.ACC.3.M.SG+PRS+3+PL
desempalam-nos	desempalar+V.ele.ACC.3.M.PL+PRS+3+PL
desempalam-nos	desempalar+V.nós.AD.1.PL+PRS+3+PL
desempalamo-la	desempalar+V.ele.ACC.3.F.SG+PRF+1+PL
desempalamo-la	desempalar+V.ele.ACC.3.F.SG+PRS+1+PL
desempalamo-las	desempalar+V.ele.ACC.3.F.PL+PRF+1+PL
desempalamo-las	desempalar+V.ele.ACC.3.F.PL+PRS+1+PL
desempalamo-lo	desempalar+V.ele.ACC.3.M.SG+PRF+1+PL
desempalamo-lo	desempalar+V.ele.ACC.3.M.SG+PRS+1+PL
desempalamo-los	desempalar+V.ele.ACC.3.M.PL+PRF+1+PL
desempalamo-los	desempalar+V.ele.ACC.3.M.PL+PRS+1+PL
desempalamo-nos	desempalar+nós.AD.1.PL+PRF+1+PL
desempalamo-nos	desempalar+nós.AD.1.PL+PRS+1+PL
desempalamos-lhe	desempalar+V.ele.DAT.3.SG+PRF+1+PL
desempalamos-lhe	desempalar+V.ele.DAT.3.SG+PRS+1+PL
desempalamos-lhes	desempalar+V.ele.DAT.3.PL+PRF+1+PL
desempalamos-lhes	desempalar+V.ele.DAT.3.PL+PRS+1+PL
desempalamos-me	desempalar+V.eu.AD.1.SG+PRF+1+PL
desempalamos-me	desempalar+V.eu.AD.1.SG+PRS+1+PL
desempalamos-te	desempalar+V.tu.AD.2.SG+PRF+1+PL
desempalamos-te	desempalar+V.tu.AD.2.SG+PRS+1+PL
desempalamos-vos	desempalar+V.vós.AD.2.PL+PRF+1+PL
desempalamos-vos	desempalar+V.vós.AD.2.PL+PRS+1+PL
desempalam-se	desempalar+V.ele.REFL+PRS+3+PL
desempalam-te	desempalar+V.tu.AD.2.SG+PRS+3+PL
desempalam-vos	desempalar+V.vós.AD.2.PL+PRS+3+PL
desempalando-a	desempalar+V.ele.ACC.3.F.SG+GRD
desempalando-as	desempalar+V.ele.ACC.3.F.PL+GRD
desempalando-lhe	desempalar+V.ele.DAT.3.SG+GRD
desempalando-lhes	desempalar+V.ele.DAT.3.PL+GRD
desempalando-me	desempalar+V.eu.AD.1.SG+GRD
desempalando-nos	desempalar+nós.AD.1.PL+GRD
desempalando-o	desempalar+V.ele.ACC.3.M.SG+GRD
desempalando-os	desempalar+V.ele.ACC.3.M.PL+GRD
desempalando-se	desempalar+V.ele.REFL+GRD
desempalando-te	desempalar+V.tu.AD.2.SG+GRD
desempalando-vos	desempalar+V.vós.AD.2.PL+GRD
desempala-nos	desempalar+nós.AD.1.PL+PRS+2+SG
desempala-nos	desempalar+nós.AD.1.PL+PRS+3+SG
desempala-o	desempalar+V.ele.ACC.3.M.SG+PRS+3+SG
desempala-os	desempalar+V.ele.ACC.3.M.PL+PRS+3+SG
desempalara-a	desempalar+V.ele.ACC.3.F.SG+PQP+1+SG
desempalara-a	desempalar+V.ele.ACC.3.F.SG+PQP+3+SG
desempalara-as	desempalar+V.ele.ACC.3.F.PL+PQP+1+SG
desempalara-as	desempalar+V.ele.ACC.3.F.PL+PQP+3+SG
desempalara-la	desempalar+V.ele.ACC.3.F.SG+PQP+2+SG
desempalara-las	desempalar+V.ele.ACC.3.F.PL+PQP+2+SG
desempalara-lhe	desempalar+V.ele.DAT.3.SG+PQP+1+SG
desempalara-lhe	desempalar+V.ele.DAT.3.SG+PQP+3+SG
desempalara-lhes	desempalar+V.ele.DAT.3.PL+PQP+1+SG
desempalara-lhes	desempalar+V.ele.DAT.3.PL+PQP+3+SG
desempalara-lo	desempalar+V.ele.ACC.3.M.SG+PQP+2+SG
desempalara-los	desempalar+V.ele.ACC.3.M.PL+PQP+2+SG
desempalara-me	desempalar+V.eu.AD.1.SG+PQP+1+SG
desempalara-me	desempalar+V.eu.AD.1.SG+PQP+3+SG
desempalaram-lhe	desempalar+V.ele.DAT.3.SG+PQP+3+PL
desempalaram-lhe	desempalar+V.ele.DAT.3.SG+PRF+3+PL
desempalaram-lhes	desempalar+V.ele.DAT.3.PL+PQP+3+PL
desempalaram-lhes	desempalar+V.ele.DAT.3.PL+PRF+3+PL
desempalaram-me	desempalar+V.eu.AD.1.SG+PQP+3+PL
desempalaram-me	desempalar+V.eu.AD.1.SG+PRF+3+PL
desempalaram-na	desempalar+V.ele.ACC.3.F.SG+PQP+3+PL
desempalaram-na	desempalar+V.ele.ACC.3.F.SG+PRF+3+PL
desempalaram-nas	desempalar+V.ele.ACC.3.F.PL+PQP+3+PL
desempalaram-nas	desempalar+V.ele.ACC.3.F.PL+PRF+3+PL
desempalaram-no	desempalar+V.ele.ACC.3.M.SG+PQP+3+PL
desempalaram-no	desempalar+V.ele.ACC.3.M.SG+PRF+3+PL
desempalaram-nos	desempalar+V.ele.ACC.3.M.PL+PQP+3+PL
desempalaram-nos	desempalar+V.ele.ACC.3.M.PL+PRF+3+PL
desempalaram-nos	desempalar+V.nós.AD.1.PL+PQP+3+PL
desempalaram-nos	desempalar+V.nós.AD.1.PL+PRF+3+PL
desempaláramo-la	desempalar+V.ele.ACC.3.F.SG+PQP+1+PL
desempaláramo-las	desempalar+V.ele.ACC.3.F.PL+PQP+1+PL
desempaláramo-lo	desempalar+V.ele.ACC.3.M.SG+PQP+1+PL
desempaláramo-los	desempalar+V.ele.ACC.3.M.PL+PQP+1+PL
desempaláramo-nos	desempalar+nós.AD.1.PL+PQP+1+PL
desempaláramos-lhe	desempalar+V.ele.DAT.3.SG+PQP+1+PL
desempaláramos-lhes	desempalar+V.ele.DAT.3.PL+PQP+1+PL
desempaláramos-me	desempalar+V.eu.AD.1.SG+PQP+1+PL
desempaláramos-te	desempalar+V.tu.AD.2.SG+PQP+1+PL
desempaláramos-vos	desempalar+V.vós.AD.2.PL+PQP+1+PL
desempalaram-se	desempalar+V.ele.REFL+PQP+3+PL
desempalaram-se	desempalar+V.ele.REFL+PRF+3+PL
desempalaram-te	desempalar+V.tu.AD.2.SG+PQP+3+PL
desempalaram-te	desempalar+V.tu.AD.2.SG+PRF+3+PL
desempalaram-vos	desempalar+V.vós.AD.2.PL+PQP+3+PL
desempalaram-vos	desempalar+V.vós.AD.2.PL+PRF+3+PL
desempalara-nos	desempalar+nós.AD.1.PL+PQP+1+SG
desempalara-nos	desempalar+nós.AD.1.PL+PQP+2+SG
desempalara-nos	desempalar+nós.AD.1.PL+PQP+3+SG
desempalara-o	desempalar+V.ele.ACC.3.M.SG+PQP+1+SG
desempalara-o	desempalar+V.ele.ACC.3.M.SG+PQP+3+SG
desempalara-os	desempalar+V.ele.ACC.3.M.PL+PQP+1+SG
desempalara-os	desempalar+V.ele.ACC.3.M.PL+PQP+3+SG
desempalara-se	desempalar+V.ele.REFL+PQP+1+SG
desempalara-se	desempalar+V.ele.REFL+PQP+3+SG
desempalaras-lhe	desempalar+V.ele.DAT.3.SG+PQP+2+SG
desempalaras-lhes	desempalar+V.ele.DAT.3.PL+PQP+2+SG
desempalaras-me	desempalar+V.eu.AD.1.SG+PQP+2+SG
desempalaras-te	desempalar+V.tu.AD.2.SG+PQP+2+SG
desempalaras-vos	desempalar+V.vós.AD.2.PL+PQP+2+SG
desempalara-te	desempalar+V.tu.AD.2.SG+PQP+1+SG
desempalara-te	desempalar+V.tu.AD.2.SG+PQP+3+SG
desempalara-vos	desempalar+V.vós.AD.2.PL+PQP+1+SG
desempalara-vos	desempalar+V.vós.AD.2.PL+PQP+3+SG
desempalarde-la	desempalar+V.ele.ACC.3.F.SG+INF+2+PL
desempalarde-la	desempalar+V.ele.ACC.3.F.SG+SBJF+2+PL
desempalarde-las	desempalar+V.ele.ACC.3.F.PL+INF+2+PL
desempalarde-las	desempalar+V.ele.ACC.3.F.PL+SBJF+2+PL
desempalarde-lo	desempalar+V.ele.ACC.3.M.SG+INF+2+PL
desempalarde-lo	desempalar+V.ele.ACC.3.M.SG+SBJF+2+PL
desempalarde-los	desempalar+V.ele.ACC.3.M.PL+INF+2+PL
desempalarde-los	desempalar+V.ele.ACC.3.M.PL+SBJF+2+PL
desempalarde-nos	desempalar+nós.AD.1.PL+INF+2+PL
desempalarde-nos	desempalar+nós.AD.1.PL+SBJF+2+PL
desempalardes-lhe	desempalar+V.ele.DAT.3.SG+INF+2+PL
desempalardes-lhe	desempalar+V.ele.DAT.3.SG+SBJF+2+PL
desempalardes-lhes	desempalar+V.ele.DAT.3.PL+INF+2+PL
desempalardes-lhes	desempalar+V.ele.DAT.3.PL+SBJF+2+PL
desempalardes-me	desempalar+V.eu.AD.1.SG+INF+2+PL
desempalardes-me	desempalar+V.eu.AD.1.SG+SBJF+2+PL
desempalardes-te	desempalar+V.tu.AD.2.SG+INF+2+PL
desempalardes-te	desempalar+V.tu.AD.2.SG+SBJF+2+PL
desempalardes-vos	desempalar+V.vós.AD.2.PL+INF+2+PL
desempalardes-vos	desempalar+V.vós.AD.2.PL+SBJF+2+PL
desempalárei-la	desempalar+V.ele.ACC.3.F.SG+PQP+2+PL
desempalárei-las	desempalar+V.ele.ACC.3.F.PL+PQP+2+PL
desempalárei-lo	desempalar+V.ele.ACC.3.M.SG+PQP+2+PL
desempalárei-los	desempalar+V.ele.ACC.3.M.PL+PQP+2+PL
desempalárei-nos	desempalar+nós.AD.1.PL+PQP+2+PL
desempaláreis-lhe	desempalar+V.ele.DAT.3.SG+PQP+2+PL
desempaláreis-lhes	desempalar+V.ele.DAT.3.PL+PQP+2+PL
desempaláreis-me	desempalar+V.eu.AD.1.SG+PQP+2+PL
desempaláreis-te	desempalar+V.tu.AD.2.SG+PQP+2+PL
desempaláreis-vos	desempalar+V.vós.AD.2.PL+PQP+2+PL
desempalare-la	desempalar+V.ele.ACC.3.F.SG+INF+2+SG
desempalare-la	desempalar+V.ele.ACC.3.F.SG+SBJF+2+SG
desempalare-las	desempalar+V.ele.ACC.3.F.PL+INF+2+SG
desempalare-las	desempalar+V.ele.ACC.3.F.PL+SBJF+2+SG
