desencabeçar-me	desencabeçar+V.eu.AD.1.SG+SBJF+3+SG
desencabeçar-me-ei	desencabeçar+V.eu.AD.1.SG+FUT+1+SG
desencabeçar-me-eis	desencabeçar+V.eu.AD.1.SG+FUT+2+PL
desencabeçar-me-emos	desencabeçar+V.eu.AD.1.SG+FUT+1+PL
desencabeçar-me-ia	desencabeçar+V.eu.AD.1.SG+COND+1+SG
desencabeçar-me-ia	desencabeçar+V.eu.AD.1.SG+COND+3+SG
desencabeçar-me-iam	desencabeçar+V.eu.AD.1.SG+COND+3+PL
desencabeçar-me-íamos	desencabeçar+V.eu.AD.1.SG+COND+1+PL
desencabeçar-me-ias	desencabeçar+V.eu.AD.1.SG+COND+2+SG
desencabeçar-me-íeis	desencabeçar+V.eu.AD.1.SG+COND+2+PL
desencabeçarmo-la	desencabeçar+V.ele.ACC.3.F.SG+INF+1+PL
desencabeçarmo-la	desencabeçar+V.ele.ACC.3.F.SG+SBJF+1+PL
desencabeçarmo-las	desencabeçar+V.ele.ACC.3.F.PL+INF+1+PL
desencabeçarmo-las	desencabeçar+V.ele.ACC.3.F.PL+SBJF+1+PL
desencabeçarmo-lo	desencabeçar+V.ele.ACC.3.M.SG+INF+1+PL
desencabeçarmo-lo	desencabeçar+V.ele.ACC.3.M.SG+SBJF+1+PL
desencabeçarmo-los	desencabeçar+V.ele.ACC.3.M.PL+INF+1+PL
desencabeçarmo-los	desencabeçar+V.ele.ACC.3.M.PL+SBJF+1+PL
desencabeçarmo-nos	desencabeçar+nós.AD.1.PL+INF+1+PL
desencabeçarmo-nos	desencabeçar+nós.AD.1.PL+SBJF+1+PL
desencabeçarmos-lhe	desencabeçar+V.ele.DAT.3.SG+INF+1+PL
desencabeçarmos-lhe	desencabeçar+V.ele.DAT.3.SG+SBJF+1+PL
desencabeçarmos-lhes	desencabeçar+V.ele.DAT.3.PL+INF+1+PL
desencabeçarmos-lhes	desencabeçar+V.ele.DAT.3.PL+SBJF+1+PL
desencabeçarmos-me	desencabeçar+V.eu.AD.1.SG+INF+1+PL
desencabeçarmos-me	desencabeçar+V.eu.AD.1.SG+SBJF+1+PL
desencabeçarmos-te	desencabeçar+V.tu.AD.2.SG+INF+1+PL
desencabeçarmos-te	desencabeçar+V.tu.AD.2.SG+SBJF+1+PL
desencabeçarmos-vos	desencabeçar+V.vós.AD.2.PL+INF+1+PL
desencabeçarmos-vos	desencabeçar+V.vós.AD.2.PL+SBJF+1+PL
desencabeçar-nos-á	desencabeçar+nós.AD.1.PL+FUT+3+SG
desencabeçar-nos-ão	desencabeçar+nós.AD.1.PL+FUT+3+PL
desencabeçar-nos-ás	desencabeçar+nós.AD.1.PL+FUT+2+SG
desencabeçar-nos	desencabeçar+nós.AD.1.PL+INF
desencabeçar-nos	desencabeçar+nós.AD.1.PL+INF+1+SG
desencabeçar-nos	desencabeçar+nós.AD.1.PL+INF+3+SG
desencabeçar-nos	desencabeçar+nós.AD.1.PL+SBJF+1+SG
desencabeçar-nos	desencabeçar+nós.AD.1.PL+SBJF+3+SG
desencabeçar-nos-ei	desencabeçar+nós.AD.1.PL+FUT+1+SG
desencabeçar-nos-eis	desencabeçar+nós.AD.1.PL+FUT+2+PL
desencabeçar-nos-emos	desencabeçar+nós.AD.1.PL+FUT+1+PL
desencabeçar-nos-ia	desencabeçar+nós.AD.1.PL+COND+1+SG
desencabeçar-nos-ia	desencabeçar+nós.AD.1.PL+COND+3+SG
desencabeçar-nos-iam	desencabeçar+nós.AD.1.PL+COND+3+PL
desencabeçar-nos-íamos	desencabeçar+nós.AD.1.PL+COND+1+PL
desencabeçar-nos-ias	desencabeçar+nós.AD.1.PL+COND+2+SG
desencabeçar-nos-íeis	desencabeçar+nós.AD.1.PL+COND+2+PL
desencabeçar-se-á	desencabeçar+V.ele.REFL+FUT+3+SG
desencabeçar-se-ão	desencabeçar+V.ele.REFL+FUT+3+PL
desencabeçar-se	desencabeçar+V.ele.REFL+INF
desencabeçar-se	desencabeçar+V.ele.REFL+INF+3+SG
desencabeçar-se	desencabeçar+V.ele.REFL+SBJF+3+SG
desencabeçar-se-ia	desencabeçar+V.ele.REFL+COND+3+SG
desencabeçar-se-iam	desencabeçar+V.ele.REFL+COND+3+PL
desencabeçar-te-á	desencabeçar+V.tu.AD.2.SG+FUT+3+SG
desencabeçar-te-ão	desencabeçar+V.tu.AD.2.SG+FUT+3+PL
desencabeçar-te-ás	desencabeçar+V.tu.AD.2.SG+FUT+2+SG
desencabeçar-te	desencabeçar+V.tu.AD.2.SG+INF
desencabeçar-te	desencabeçar+V.tu.AD.2.SG+INF+1+SG
desencabeçar-te	desencabeçar+V.tu.AD.2.SG+INF+3+SG
desencabeçar-te	desencabeçar+V.tu.AD.2.SG+SBJF+1+SG
desencabeçar-te	desencabeçar+V.tu.AD.2.SG+SBJF+3+SG
desencabeçar-te-ei	desencabeçar+V.tu.AD.2.SG+FUT+1+SG
desencabeçar-te-eis	desencabeçar+V.tu.AD.2.SG+FUT+2+PL
desencabeçar-te-emos	desencabeçar+V.tu.AD.2.SG+FUT+1+PL
desencabeçar-te-ia	desencabeçar+V.tu.AD.2.SG+COND+1+SG
desencabeçar-te-ia	desencabeçar+V.tu.AD.2.SG+COND+3+SG
desencabeçar-te-iam	desencabeçar+V.tu.AD.2.SG+COND+3+PL
desencabeçar-te-íamos	desencabeçar+V.tu.AD.2.SG+COND+1+PL
desencabeçar-te-ias	desencabeçar+V.tu.AD.2.SG+COND+2+SG
desencabeçar-te-íeis	desencabeçar+V.tu.AD.2.SG+COND+2+PL
desencabeçar-vos-á	desencabeçar+V.vós.AD.2.PL+FUT+3+SG
desencabeçar-vos-ão	desencabeçar+V.vós.AD.2.PL+FUT+3+PL
desencabeçar-vos-ás	desencabeçar+V.vós.AD.2.PL+FUT+2+SG
desencabeçar-vos	desencabeçar+V.vós.AD.2.PL+INF
desencabeçar-vos	desencabeçar+V.vós.AD.2.PL+INF+1+SG
desencabeçar-vos	desencabeçar+V.vós.AD.2.PL+INF+3+SG
desencabeçar-vos	desencabeçar+V.vós.AD.2.PL+SBJF+1+SG
desencabeçar-vos	desencabeçar+V.vós.AD.2.PL+SBJF+3+SG
desencabeçar-vos-ei	desencabeçar+V.vós.AD.2.PL+FUT+1+SG
desencabeçar-vos-eis	desencabeçar+V.vós.AD.2.PL+FUT+2+PL
desencabeçar-vos-emos	desencabeçar+V.vós.AD.2.PL+FUT+1+PL
desencabeçar-vos-ia	desencabeçar+V.vós.AD.2.PL+COND+1+SG
desencabeçar-vos-ia	desencabeçar+V.vós.AD.2.PL+COND+3+SG
desencabeçar-vos-iam	desencabeçar+V.vós.AD.2.PL+COND+3+PL
desencabeçar-vos-íamos	desencabeçar+V.vós.AD.2.PL+COND+1+PL
desencabeçar-vos-ias	desencabeçar+V.vós.AD.2.PL+COND+2+SG
desencabeçar-vos-íeis	desencabeçar+V.vós.AD.2.PL+COND+2+PL
desencabeça-se	desencabeçar+V.ele.REFL+PRS+3+SG
desencabeças-lhe	desencabeçar+V.ele.DAT.3.SG+PRS+2+SG
desencabeças-lhes	desencabeçar+V.ele.DAT.3.PL+PRS+2+SG
desencabeças-me	desencabeçar+V.eu.AD.1.SG+PRS+2+SG
desencabeças-te	desencabeçar+V.tu.AD.2.SG+PRS+2+SG
desencabeçaste-la	desencabeçar+V.ele.ACC.3.F.SG+PRF+2+PL
desencabeçaste-las	desencabeçar+V.ele.ACC.3.F.PL+PRF+2+PL
desencabeçaste-lo	desencabeçar+V.ele.ACC.3.M.SG+PRF+2+PL
desencabeçaste-los	desencabeçar+V.ele.ACC.3.M.PL+PRF+2+PL
desencabeçaste-nos	desencabeçar+nós.AD.1.PL+PRF+2+PL
desencabeçastes-lhe	desencabeçar+V.ele.DAT.3.SG+PRF+2+PL
desencabeçastes-lhes	desencabeçar+V.ele.DAT.3.PL+PRF+2+PL
desencabeçastes-me	desencabeçar+V.eu.AD.1.SG+PRF+2+PL
desencabeçastes-te	desencabeçar+V.tu.AD.2.SG+PRF+2+PL
desencabeçastes-vos	desencabeçar+V.vós.AD.2.PL+PRF+2+PL
desencabeças-vos	desencabeçar+V.vós.AD.2.PL+PRS+2+SG
desencabeça-te	desencabeçar+V.tu.AD.2.SG+PRS+3+SG
desencabeçava-a	desencabeçar+V.ele.ACC.3.F.SG+IMPF+1+SG
desencabeçava-a	desencabeçar+V.ele.ACC.3.F.SG+IMPF+3+SG
desencabeçava-as	desencabeçar+V.ele.ACC.3.F.PL+IMPF+1+SG
desencabeçava-as	desencabeçar+V.ele.ACC.3.F.PL+IMPF+3+SG
desencabeçava-la	desencabeçar+V.ele.ACC.3.F.SG+IMPF+2+SG
desencabeçava-las	desencabeçar+V.ele.ACC.3.F.PL+IMPF+2+SG
desencabeçava-lhe	desencabeçar+V.ele.DAT.3.SG+IMPF+1+SG
desencabeçava-lhe	desencabeçar+V.ele.DAT.3.SG+IMPF+3+SG
desencabeçava-lhes	desencabeçar+V.ele.DAT.3.PL+IMPF+1+SG
desencabeçava-lhes	desencabeçar+V.ele.DAT.3.PL+IMPF+3+SG
desencabeçava-lo	desencabeçar+V.ele.ACC.3.M.SG+IMPF+2+SG
desencabeçava-los	desencabeçar+V.ele.ACC.3.M.PL+IMPF+2+SG
desencabeçava-me	desencabeçar+V.eu.AD.1.SG+IMPF+1+SG
desencabeçava-me	desencabeçar+V.eu.AD.1.SG+IMPF+3+SG
desencabeçavam-lhe	desencabeçar+V.ele.DAT.3.SG+IMPF+3+PL
desencabeçavam-lhes	desencabeçar+V.ele.DAT.3.PL+IMPF+3+PL
desencabeçavam-me	desencabeçar+V.eu.AD.1.SG+IMPF+3+PL
desencabeçavam-na	desencabeçar+V.ele.ACC.3.F.SG+IMPF+3+PL
desencabeçavam-nas	desencabeçar+V.ele.ACC.3.F.PL+IMPF+3+PL
desencabeçavam-no	desencabeçar+V.ele.ACC.3.M.SG+IMPF+3+PL
desencabeçavam-nos	desencabeçar+nós.AD.1.PL+IMPF+3+PL
desencabeçávamo-la	desencabeçar+V.ele.ACC.3.F.SG+IMPF+1+PL
desencabeçávamo-las	desencabeçar+V.ele.ACC.3.F.PL+IMPF+1+PL
desencabeçávamo-lo	desencabeçar+V.ele.ACC.3.M.SG+IMPF+1+PL
desencabeçávamo-los	desencabeçar+V.ele.ACC.3.M.PL+IMPF+1+PL
desencabeçávamo-nos	desencabeçar+nós.AD.1.PL+IMPF+1+PL
desencabeçávamos-lhe	desencabeçar+V.ele.DAT.3.SG+IMPF+1+PL
desencabeçávamos-lhes	desencabeçar+V.ele.DAT.3.PL+IMPF+1+PL
desencabeçávamos-me	desencabeçar+V.eu.AD.1.SG+IMPF+1+PL
desencabeçávamos-te	desencabeçar+V.tu.AD.2.SG+IMPF+1+PL
desencabeçávamos-vos	desencabeçar+V.vós.AD.2.PL+IMPF+1+PL
desencabeçavam-se	desencabeçar+V.ele.REFL+IMPF+3+PL
desencabeçavam-te	desencabeçar+V.tu.AD.2.SG+IMPF+3+PL
desencabeçavam-vos	desencabeçar+V.vós.AD.2.PL+IMPF+3+PL
desencabeçava-nos	desencabeçar+nós.AD.1.PL+IMPF+1+SG
desencabeçava-nos	desencabeçar+nós.AD.1.PL+IMPF+2+SG
desencabeçava-nos	desencabeçar+nós.AD.1.PL+IMPF+3+SG
desencabeçava-o	desencabeçar+V.ele.ACC.3.M.SG+IMPF+1+SG
desencabeçava-o	desencabeçar+V.ele.ACC.3.M.SG+IMPF+3+SG
desencabeçava-os	desencabeçar+V.ele.ACC.3.M.PL+IMPF+1+SG
desencabeçava-os	desencabeçar+V.ele.ACC.3.M.PL+IMPF+3+SG
desencabeçava-se	desencabeçar+V.ele.REFL+IMPF+1+SG
desencabeçava-se	desencabeçar+V.ele.REFL+IMPF+3+SG
desencabeçavas-lhe	desencabeçar+V.ele.DAT.3.SG+IMPF+2+SG
desencabeçavas-lhes	desencabeçar+V.ele.DAT.3.PL+IMPF+2+SG
desencabeçavas-me	desencabeçar+V.eu.AD.1.SG+IMPF+2+SG
desencabeçavas-te	desencabeçar+V.tu.AD.2.SG+IMPF+2+SG
desencabeçavas-vos	desencabeçar+V.vós.AD.2.PL+IMPF+2+SG
desencabeçava-te	desencabeçar+V.tu.AD.2.SG+IMPF+1+SG
desencabeçava-te	desencabeçar+V.tu.AD.2.SG+IMPF+3+SG
desencabeçava-vos	desencabeçar+V.vós.AD.2.PL+IMPF+1+SG
desencabeçava-vos	desencabeçar+V.vós.AD.2.PL+IMPF+3+SG
desencabeçávei-la	desencabeçar+V.ele.ACC.3.F.SG+IMPF+2+PL
desencabeçávei-las	desencabeçar+V.ele.ACC.3.F.PL+IMPF+2+PL
desencabeçávei-lo	desencabeçar+V.ele.ACC.3.M.SG+IMPF+2+PL
desencabeçávei-los	desencabeçar+V.ele.ACC.3.M.PL+IMPF+2+PL
desencabeçávei-nos	desencabeçar+nós.AD.1.PL+IMPF+2+PL
desencabeçáveis-lhe	desencabeçar+V.ele.DAT.3.SG+IMPF+2+PL
desencabeçáveis-lhes	desencabeçar+V.ele.DAT.3.PL+IMPF+2+PL
desencabeçáveis-me	desencabeçar+V.eu.AD.1.SG+IMPF+2+PL
desencabeçáveis-te	desencabeçar+V.tu.AD.2.SG+IMPF+2+PL
desencabeçáveis-vos	desencabeçar+V.vós.AD.2.PL+IMPF+2+PL
desencabeça-vos	desencabeçar+V.vós.AD.2.PL+PRS+3+SG
desencabece-a	desencabeçar+V.ele.ACC.3.F.SG+IMP+3+SG
desencabece-as	desencabeçar+V.ele.ACC.3.F.PL+IMP+3+SG
desencabecei-a	desencabeçar+V.ele.ACC.3.F.SG+PRF+1+SG
desencabecei-as	desencabeçar+V.ele.ACC.3.F.PL+PRF+1+SG
desencabecei-lhe	desencabeçar+V.ele.DAT.3.SG+PRF+1+SG
desencabecei-lhes	desencabeçar+V.ele.DAT.3.PL+PRF+1+SG
desencabecei-me	desencabeçar+V.eu.AD.1.SG+PRF+1+SG
desencabecei-nos	desencabeçar+nós.AD.1.PL+PRF+1+SG
desencabecei-o	desencabeçar+V.ele.ACC.3.M.SG+PRF+1+SG
desencabecei-os	desencabeçar+V.ele.ACC.3.M.PL+PRF+1+SG
desencabecei-te	desencabeçar+V.tu.AD.2.SG+PRF+1+SG
desencabecei-vos	desencabeçar+V.vós.AD.2.PL+PRF+1+SG
desencabece-lhe	desencabeçar+V.ele.DAT.3.SG+IMP+3+SG
desencabece-lhes	desencabeçar+V.ele.DAT.3.PL+IMP+3+SG
desencabece-me	desencabeçar+V.eu.AD.1.SG+IMP+3+SG
desencabecem-lhe	desencabeçar+V.ele.DAT.3.SG+IMP+3+PL
desencabecem-lhes	desencabeçar+V.ele.DAT.3.PL+IMP+3+PL
desencabecem-me	desencabeçar+V.eu.AD.1.SG+IMP+3+PL
desencabecem-na	desencabeçar+V.ele.ACC.3.F.SG+IMP+3+PL
desencabecem-nas	desencabeçar+V.ele.ACC.3.F.PL+IMP+3+PL
desencabecem-no	desencabeçar+V.ele.ACC.3.M.SG+IMP+3+PL
desencabecem-nos	desencabeçar+V.ele.ACC.3.M.PL+IMP+3+PL
desencabecem-nos	desencabeçar+V.nós.AD.1.PL+IMP+3+PL
desencabecemo-la	desencabeçar+V.ele.ACC.3.F.SG+IMP+1+PL
desencabecemo-las	desencabeçar+V.ele.ACC.3.F.PL+IMP+1+PL
desencabecemo-lo	desencabeçar+V.ele.ACC.3.M.SG+IMP+1+PL
desencabecemo-los	desencabeçar+V.ele.ACC.3.M.PL+IMP+1+PL
desencabecemo-nos	desencabeçar+nós.AD.1.PL+IMP+1+PL
desencabecemos-lhe	desencabeçar+V.ele.DAT.3.SG+IMP+1+PL
desencabecemos-lhes	desencabeçar+V.ele.DAT.3.PL+IMP+1+PL
desencabecemos-me	desencabeçar+V.eu.AD.1.SG+IMP+1+PL
desencabecemos-te	desencabeçar+V.tu.AD.2.SG+IMP+1+PL
desencabecemos-vos	desencabeçar+V.vós.AD.2.PL+IMP+1+PL
desencabecem-se	desencabeçar+V.ele.REFL+IMP+3+PL
desencabecem-te	desencabeçar+V.tu.AD.2.SG+IMP+3+PL
desencabecem-vos	desencabeçar+V.vós.AD.2.PL+IMP+3+PL
desencabece-nos	desencabeçar+nós.AD.1.PL+IMP+3+SG
desencabece-o	desencabeçar+V.ele.ACC.3.M.SG+IMP+3+SG
desencabece-os	desencabeçar+V.ele.ACC.3.M.PL+IMP+3+SG
desencabece-se	desencabeçar+V.ele.REFL+IMP+3+SG
desencabece-te	desencabeçar+V.tu.AD.2.SG+IMP+3+SG
desencabece-vos	desencabeçar+V.vós.AD.2.PL+IMP+3+SG
desencabeço-a	desencabeçar+V.ele.ACC.3.F.SG+PRS+1+SG
desencabeço-as	desencabeçar+V.ele.ACC.3.F.PL+PRS+1+SG
desencabeço-lhe	desencabeçar+V.ele.DAT.3.SG+PRS+1+SG
desencabeço-lhes	desencabeçar+V.ele.DAT.3.PL+PRS+1+SG
desencabeço-me	desencabeçar+V.eu.AD.1.SG+PRS+1+SG
desencabeço-nos	desencabeçar+nós.AD.1.PL+PRS+1+SG
desencabeço-o	desencabeçar+V.ele.ACC.3.M.SG+PRS+1+SG
desencabeço-os	desencabeçar+V.ele.ACC.3.M.PL+PRS+1+SG
desencabeço-te	desencabeçar+V.tu.AD.2.SG+PRS+1+SG
desencabeçou-a	desencabeçar+V.ele.ACC.3.F.SG+PRF+3+SG
desencabeçou-as	desencabeçar+V.ele.ACC.3.F.PL+PRF+3+SG
desencabeçou-lhe	desencabeçar+V.ele.DAT.3.SG+PRF+3+SG
desencabeçou-lhes	desencabeçar+V.ele.DAT.3.PL+PRF+3+SG
desencabeçou-me	desencabeçar+V.eu.AD.1.SG+PRF+3+SG
desencabeçou-nos	desencabeçar+nós.AD.1.PL+PRF+3+SG
desencabeçou-o	desencabeçar+V.ele.ACC.3.M.SG+PRF+3+SG
desencabeçou-os	desencabeçar+V.ele.ACC.3.M.PL+PRF+3+SG
desencabeçou-se	desencabeçar+V.ele.REFL+PRF+3+SG
desencabeçou-te	desencabeçar+V.tu.AD.2.SG+PRF+3+SG
desencabeçou-vos	desencabeçar+V.vós.AD.2.PL+PRF+3+SG
desencabeço-vos	desencabeçar+V.vós.AD.2.PL+PRS+1+SG
desencabei-a	desencabar+V.ele.ACC.3.F.SG+PRF+1+SG
desencabei-as	desencabar+V.ele.ACC.3.F.PL+PRF+1+SG
desencabei-lhe	desencabar+V.ele.DAT.3.SG+PRF+1+SG
desencabei-lhes	desencabar+V.ele.DAT.3.PL+PRF+1+SG
desencabei-me	desencabar+V.eu.AD.1.SG+PRF+1+SG
desencabei-nos	desencabar+nós.AD.1.PL+PRF+1+SG
desencabei-o	desencabar+V.ele.ACC.3.M.SG+PRF+1+SG
desencabei-os	desencabar+V.ele.ACC.3.M.PL+PRF+1+SG
desencabei-te	desencabar+V.tu.AD.2.SG+PRF+1+SG
desencabei-vos	desencabar+V.vós.AD.2.PL+PRF+1+SG
desencabela-a	desencabelar+V.ele.ACC.3.F.SG+PRS+3+SG
desencabela-as	desencabelar+V.ele.ACC.3.F.PL+PRS+3+SG
desencabelai-la	desencabelar+V.ele.ACC.3.F.SG+PRS+2+PL
desencabelai-las	desencabelar+V.ele.ACC.3.F.PL+PRS+2+PL
desencabelai-lo	desencabelar+V.ele.ACC.3.M.SG+PRS+2+PL
desencabelai-los	desencabelar+V.ele.ACC.3.M.PL+PRS+2+PL
desencabelai-nos	desencabelar+nós.AD.1.PL+PRS+2+PL
desencabelais-lhe	desencabelar+V.ele.DAT.3.SG+PRS+2+PL
desencabelais-lhes	desencabelar+V.ele.DAT.3.PL+PRS+2+PL
desencabelais-me	desencabelar+V.eu.AD.1.SG+PRS+2+PL
desencabelais-te	desencabelar+V.tu.AD.2.SG+PRS+2+PL
desencabelais-vos	desencabelar+V.vós.AD.2.PL+PRS+2+PL
desencabelá-la-á	desencabelar+V.ele.ACC.3.F.SG+FUT+3+SG
desencabelá-la-ão	desencabelar+V.ele.ACC.3.F.SG+FUT+3+PL
desencabelá-la-ás	desencabelar+V.ele.ACC.3.F.SG+FUT+2+SG
desencabelá-la	desencabelar+V.ele.ACC.3.F.SG+INF+1+SG
desencabelá-la	desencabelar+V.ele.ACC.3.F.SG+INF+3+SG
desencabela-la	desencabelar+V.ele.ACC.3.F.SG+PRS+2+SG
desencabelá-la	desencabelar+V.ele.ACC.3.F.SG+SBJF+1+SG
desencabelá-la	desencabelar+V.ele.ACC.3.F.SG+SBJF+3+SG
desencabelá-la-ei	desencabelar+V.ele.ACC.3.F.SG+FUT+1+SG
desencabelá-la-eis	desencabelar+V.ele.ACC.3.F.SG+FUT+2+PL
desencabelá-la-emos	desencabelar+V.ele.ACC.3.F.SG+FUT+1+PL
desencabelá-la-ia	desencabelar+V.ele.ACC.3.F.SG+COND+1+SG
desencabelá-la-ia	desencabelar+V.ele.ACC.3.F.SG+COND+3+SG
desencabelá-la-iam	desencabelar+V.ele.ACC.3.F.SG+COND+3+PL
desencabelá-la-íamos	desencabelar+V.ele.ACC.3.F.SG+COND+1+PL
desencabelá-la-ias	desencabelar+V.ele.ACC.3.F.SG+COND+2+SG
desencabelá-la-íeis	desencabelar+V.ele.ACC.3.F.SG+COND+2+PL
desencabelá-las-á	desencabelar+V.ele.ACC.3.F.PL+FUT+3+SG
desencabelá-las-ão	desencabelar+V.ele.ACC.3.F.PL+FUT+3+PL
desencabelá-las-ás	desencabelar+V.ele.ACC.3.F.PL+FUT+2+SG
desencabelá-las	desencabelar+V.ele.ACC.3.F.PL+INF+1+SG
desencabelá-las	desencabelar+V.ele.ACC.3.F.PL+INF+3+SG
desencabela-las	desencabelar+V.ele.ACC.3.F.PL+PRS+2+SG
desencabelá-las	desencabelar+V.ele.ACC.3.F.PL+SBJF+1+SG
desencabelá-las	desencabelar+V.ele.ACC.3.F.PL+SBJF+3+SG
desencabelá-las-ei	desencabelar+V.ele.ACC.3.F.PL+FUT+1+SG
desencabelá-las-eis	desencabelar+V.ele.ACC.3.F.PL+FUT+2+PL
desencabelá-las-emos	desencabelar+V.ele.ACC.3.F.PL+FUT+1+PL
desencabelá-las-ia	desencabelar+V.ele.ACC.3.F.PL+COND+1+SG
desencabelá-las-ia	desencabelar+V.ele.ACC.3.F.PL+COND+3+SG
desencabelá-las-iam	desencabelar+V.ele.ACC.3.F.PL+COND+3+PL
desencabelá-las-íamos	desencabelar+V.ele.ACC.3.F.PL+COND+1+PL
desencabelá-las-ias	desencabelar+V.ele.ACC.3.F.PL+COND+2+SG
desencabelá-las-íeis	desencabelar+V.ele.ACC.3.F.PL+COND+2+PL
desencabela-lhe	desencabelar+V.ele.DAT.3.SG+PRS+3+SG
desencabela-lhes	desencabelar+V.ele.DAT.3.PL+PRS+3+SG
desencabelá-lo-á	desencabelar+V.ele.ACC.3.M.SG+FUT+3+SG
desencabelá-lo-ão	desencabelar+V.ele.ACC.3.M.SG+FUT+3+PL
desencabelá-lo-ás	desencabelar+V.ele.ACC.3.M.SG+FUT+2+SG
desencabelá-lo	desencabelar+V.ele.ACC.3.M.SG+INF+1+SG
desencabelá-lo	desencabelar+V.ele.ACC.3.M.SG+INF+3+SG
desencabela-lo	desencabelar+V.ele.ACC.3.M.SG+PRS+2+SG
desencabelá-lo	desencabelar+V.ele.ACC.3.M.SG+SBJF+1+SG
desencabelá-lo	desencabelar+V.ele.ACC.3.M.SG+SBJF+3+SG
desencabelá-lo-ei	desencabelar+V.ele.ACC.3.M.SG+FUT+1+SG
desencabelá-lo-eis	desencabelar+V.ele.ACC.3.M.SG+FUT+2+PL
desencabelá-lo-emos	desencabelar+V.ele.ACC.3.M.SG+FUT+1+PL
desencabelá-lo-ia	desencabelar+V.ele.ACC.3.M.SG+COND+1+SG
desencabelá-lo-ia	desencabelar+V.ele.ACC.3.M.SG+COND+3+SG
desencabelá-lo-iam	desencabelar+V.ele.ACC.3.M.SG+COND+3+PL
desencabelá-lo-íamos	desencabelar+V.ele.ACC.3.M.SG+COND+1+PL
desencabelá-lo-ias	desencabelar+V.ele.ACC.3.M.SG+COND+2+SG
desencabelá-lo-íeis	desencabelar+V.ele.ACC.3.M.SG+COND+2+PL
desencabelá-los-á	desencabelar+V.ele.ACC.3.M.PL+FUT+3+SG
desencabelá-los-ão	desencabelar+V.ele.ACC.3.M.PL+FUT+3+PL
desencabelá-los-ás	desencabelar+V.ele.ACC.3.M.PL+FUT+2+SG
desencabelá-los	desencabelar+V.ele.ACC.3.M.PL+INF+1+SG
desencabelá-los	desencabelar+V.ele.ACC.3.M.PL+INF+3+SG
desencabela-los	desencabelar+V.ele.ACC.3.M.PL+PRS+2+SG
desencabelá-los	desencabelar+V.ele.ACC.3.M.PL+SBJF+1+SG
desencabelá-los	desencabelar+V.ele.ACC.3.M.PL+SBJF+3+SG
desencabelá-los-ei	desencabelar+V.ele.ACC.3.M.PL+FUT+1+SG
desencabelá-los-eis	desencabelar+V.ele.ACC.3.M.PL+FUT+2+PL
desencabelá-los-emos	desencabelar+V.ele.ACC.3.M.PL+FUT+1+PL
desencabelá-los-ia	desencabelar+V.ele.ACC.3.M.PL+COND+1+SG
desencabelá-los-ia	desencabelar+V.ele.ACC.3.M.PL+COND+3+SG
desencabelá-los-iam	desencabelar+V.ele.ACC.3.M.PL+COND+3+PL
desencabelá-los-íamos	desencabelar+V.ele.ACC.3.M.PL+COND+1+PL
desencabelá-los-ias	desencabelar+V.ele.ACC.3.M.PL+COND+2+SG
desencabelá-los-íeis	desencabelar+V.ele.ACC.3.M.PL+COND+2+PL
desencabela-me	desencabelar+V.eu.AD.1.SG+PRS+3+SG
desencabelam-lhe	desencabelar+V.ele.DAT.3.SG+PRS+3+PL
desencabelam-lhes	desencabelar+V.ele.DAT.3.PL+PRS+3+PL
desencabelam-me	desencabelar+V.eu.AD.1.SG+PRS+3+PL
desencabelam-na	desencabelar+V.ele.ACC.3.F.SG+PRS+3+PL
desencabelam-nas	desencabelar+V.ele.ACC.3.F.PL+PRS+3+PL
desencabelam-no	desencabelar+V.ele.ACC.3.M.SG+PRS+3+PL
desencabelam-nos	desencabelar+V.ele.ACC.3.M.PL+PRS+3+PL
desencabelam-nos	desencabelar+V.nós.AD.1.PL+PRS+3+PL
desencabelamo-la	desencabelar+V.ele.ACC.3.F.SG+PRF+1+PL
desencabelamo-la	desencabelar+V.ele.ACC.3.F.SG+PRS+1+PL
desencabelamo-las	desencabelar+V.ele.ACC.3.F.PL+PRF+1+PL
desencabelamo-las	desencabelar+V.ele.ACC.3.F.PL+PRS+1+PL
desencabelamo-lo	desencabelar+V.ele.ACC.3.M.SG+PRF+1+PL
desencabelamo-lo	desencabelar+V.ele.ACC.3.M.SG+PRS+1+PL
desencabelamo-los	desencabelar+V.ele.ACC.3.M.PL+PRF+1+PL
desencabelamo-los	desencabelar+V.ele.ACC.3.M.PL+PRS+1+PL
desencabelamo-nos	desencabelar+nós.AD.1.PL+PRF+1+PL
desencabelamo-nos	desencabelar+nós.AD.1.PL+PRS+1+PL
desencabelamos-lhe	desencabelar+V.ele.DAT.3.SG+PRF+1+PL
desencabelamos-lhe	desencabelar+V.ele.DAT.3.SG+PRS+1+PL
desencabelamos-lhes	desencabelar+V.ele.DAT.3.PL+PRF+1+PL
desencabelamos-lhes	desencabelar+V.ele.DAT.3.PL+PRS+1+PL
desencabelamos-me	desencabelar+V.eu.AD.1.SG+PRF+1+PL
desencabelamos-me	desencabelar+V.eu.AD.1.SG+PRS+1+PL
desencabelamos-te	desencabelar+V.tu.AD.2.SG+PRF+1+PL
desencabelamos-te	desencabelar+V.tu.AD.2.SG+PRS+1+PL
desencabelamos-vos	desencabelar+V.vós.AD.2.PL+PRF+1+PL
desencabelamos-vos	desencabelar+V.vós.AD.2.PL+PRS+1+PL
desencabelam-se	desencabelar+V.ele.REFL+PRS+3+PL
desencabelam-te	desencabelar+V.tu.AD.2.SG+PRS+3+PL
desencabelam-vos	desencabelar+V.vós.AD.2.PL+PRS+3+PL
desencabelando-a	desencabelar+V.ele.ACC.3.F.SG+GRD
desencabelando-as	desencabelar+V.ele.ACC.3.F.PL+GRD
desencabelando-lhe	desencabelar+V.ele.DAT.3.SG+GRD
desencabelando-lhes	desencabelar+V.ele.DAT.3.PL+GRD
desencabelando-me	desencabelar+V.eu.AD.1.SG+GRD
desencabelando-nos	desencabelar+nós.AD.1.PL+GRD
desencabelando-o	desencabelar+V.ele.ACC.3.M.SG+GRD
desencabelando-os	desencabelar+V.ele.ACC.3.M.PL+GRD
desencabelando-se	desencabelar+V.ele.REFL+GRD
desencabelando-te	desencabelar+V.tu.AD.2.SG+GRD
desencabelando-vos	desencabelar+V.vós.AD.2.PL+GRD
desencabela-nos	desencabelar+nós.AD.1.PL+PRS+2+SG
desencabela-nos	desencabelar+nós.AD.1.PL+PRS+3+SG
desencabela-o	desencabelar+V.ele.ACC.3.M.SG+PRS+3+SG
desencabela-os	desencabelar+V.ele.ACC.3.M.PL+PRS+3+SG
desencabelara-a	desencabelar+V.ele.ACC.3.F.SG+PQP+1+SG
desencabelara-a	desencabelar+V.ele.ACC.3.F.SG+PQP+3+SG
desencabelara-as	desencabelar+V.ele.ACC.3.F.PL+PQP+1+SG
desencabelara-as	desencabelar+V.ele.ACC.3.F.PL+PQP+3+SG
desencabelara-la	desencabelar+V.ele.ACC.3.F.SG+PQP+2+SG
desencabelara-las	desencabelar+V.ele.ACC.3.F.PL+PQP+2+SG
desencabelara-lhe	desencabelar+V.ele.DAT.3.SG+PQP+1+SG
desencabelara-lhe	desencabelar+V.ele.DAT.3.SG+PQP+3+SG
desencabelara-lhes	desencabelar+V.ele.DAT.3.PL+PQP+1+SG
desencabelara-lhes	desencabelar+V.ele.DAT.3.PL+PQP+3+SG
desencabelara-lo	desencabelar+V.ele.ACC.3.M.SG+PQP+2+SG
desencabelara-los	desencabelar+V.ele.ACC.3.M.PL+PQP+2+SG
desencabelara-me	desencabelar+V.eu.AD.1.SG+PQP+1+SG
desencabelara-me	desencabelar+V.eu.AD.1.SG+PQP+3+SG
desencabelaram-lhe	desencabelar+V.ele.DAT.3.SG+PQP+3+PL
desencabelaram-lhe	desencabelar+V.ele.DAT.3.SG+PRF+3+PL
desencabelaram-lhes	desencabelar+V.ele.DAT.3.PL+PQP+3+PL
desencabelaram-lhes	desencabelar+V.ele.DAT.3.PL+PRF+3+PL
desencabelaram-me	desencabelar+V.eu.AD.1.SG+PQP+3+PL
desencabelaram-me	desencabelar+V.eu.AD.1.SG+PRF+3+PL
desencabelaram-na	desencabelar+V.ele.ACC.3.F.SG+PQP+3+PL
desencabelaram-na	desencabelar+V.ele.ACC.3.F.SG+PRF+3+PL
desencabelaram-nas	desencabelar+V.ele.ACC.3.F.PL+PQP+3+PL
desencabelaram-nas	desencabelar+V.ele.ACC.3.F.PL+PRF+3+PL
desencabelaram-no	desencabelar+V.ele.ACC.3.M.SG+PQP+3+PL
desencabelaram-no	desencabelar+V.ele.ACC.3.M.SG+PRF+3+PL
desencabelaram-nos	desencabelar+V.ele.ACC.3.M.PL+PQP+3+PL
desencabelaram-nos	desencabelar+V.ele.ACC.3.M.PL+PRF+3+PL
desencabelaram-nos	desencabelar+V.nós.AD.1.PL+PQP+3+PL
desencabelaram-nos	desencabelar+V.nós.AD.1.PL+PRF+3+PL
desencabeláramo-la	desencabelar+V.ele.ACC.3.F.SG+PQP+1+PL
desencabeláramo-las	desencabelar+V.ele.ACC.3.F.PL+PQP+1+PL
desencabeláramo-lo	desencabelar+V.ele.ACC.3.M.SG+PQP+1+PL
desencabeláramo-los	desencabelar+V.ele.ACC.3.M.PL+PQP+1+PL
desencabeláramo-nos	desencabelar+nós.AD.1.PL+PQP+1+PL
desencabeláramos-lhe	desencabelar+V.ele.DAT.3.SG+PQP+1+PL
desencabeláramos-lhes	desencabelar+V.ele.DAT.3.PL+PQP+1+PL
desencabeláramos-me	desencabelar+V.eu.AD.1.SG+PQP+1+PL
desencabeláramos-te	desencabelar+V.tu.AD.2.SG+PQP+1+PL
desencabeláramos-vos	desencabelar+V.vós.AD.2.PL+PQP+1+PL
desencabelaram-se	desencabelar+V.ele.REFL+PQP+3+PL
desencabelaram-se	desencabelar+V.ele.REFL+PRF+3+PL
desencabelaram-te	desencabelar+V.tu.AD.2.SG+PQP+3+PL
desencabelaram-te	desencabelar+V.tu.AD.2.SG+PRF+3+PL
desencabelaram-vos	desencabelar+V.vós.AD.2.PL+PQP+3+PL
desencabelaram-vos	desencabelar+V.vós.AD.2.PL+PRF+3+PL
desencabelara-nos	desencabelar+nós.AD.1.PL+PQP+1+SG
desencabelara-nos	desencabelar+nós.AD.1.PL+PQP+2+SG
desencabelara-nos	desencabelar+nós.AD.1.PL+PQP+3+SG
desencabelara-o	desencabelar+V.ele.ACC.3.M.SG+PQP+1+SG
desencabelara-o	desencabelar+V.ele.ACC.3.M.SG+PQP+3+SG
desencabelara-os	desencabelar+V.ele.ACC.3.M.PL+PQP+1+SG
desencabelara-os	desencabelar+V.ele.ACC.3.M.PL+PQP+3+SG
desencabelara-se	desencabelar+V.ele.REFL+PQP+1+SG
desencabelara-se	desencabelar+V.ele.REFL+PQP+3+SG
desencabelaras-lhe	desencabelar+V.ele.DAT.3.SG+PQP+2+SG
desencabelaras-lhes	desencabelar+V.ele.DAT.3.PL+PQP+2+SG
desencabelaras-me	desencabelar+V.eu.AD.1.SG+PQP+2+SG
desencabelaras-te	desencabelar+V.tu.AD.2.SG+PQP+2+SG
desencabelaras-vos	desencabelar+V.vós.AD.2.PL+PQP+2+SG
desencabelara-te	desencabelar+V.tu.AD.2.SG+PQP+1+SG
desencabelara-te	desencabelar+V.tu.AD.2.SG+PQP+3+SG
desencabelara-vos	desencabelar+V.vós.AD.2.PL+PQP+1+SG
desencabelara-vos	desencabelar+V.vós.AD.2.PL+PQP+3+SG
desencabelarde-la	desencabelar+V.ele.ACC.3.F.SG+INF+2+PL
desencabelarde-la	desencabelar+V.ele.ACC.3.F.SG+SBJF+2+PL
desencabelarde-las	desencabelar+V.ele.ACC.3.F.PL+INF+2+PL
desencabelarde-las	desencabelar+V.ele.ACC.3.F.PL+SBJF+2+PL
desencabelarde-lo	desencabelar+V.ele.ACC.3.M.SG+INF+2+PL
desencabelarde-lo	desencabelar+V.ele.ACC.3.M.SG+SBJF+2+PL
desencabelarde-los	desencabelar+V.ele.ACC.3.M.PL+INF+2+PL
desencabelarde-los	desencabelar+V.ele.ACC.3.M.PL+SBJF+2+PL
desencabelarde-nos	desencabelar+nós.AD.1.PL+INF+2+PL
desencabelarde-nos	desencabelar+nós.AD.1.PL+SBJF+2+PL
desencabelardes-lhe	desencabelar+V.ele.DAT.3.SG+INF+2+PL
desencabelardes-lhe	desencabelar+V.ele.DAT.3.SG+SBJF+2+PL
desencabelardes-lhes	desencabelar+V.ele.DAT.3.PL+INF+2+PL
desencabelardes-lhes	desencabelar+V.ele.DAT.3.PL+SBJF+2+PL
desencabelardes-me	desencabelar+V.eu.AD.1.SG+INF+2+PL
desencabelardes-me	desencabelar+V.eu.AD.1.SG+SBJF+2+PL
desencabelardes-te	desencabelar+V.tu.AD.2.SG+INF+2+PL
desencabelardes-te	desencabelar+V.tu.AD.2.SG+SBJF+2+PL
desencabelardes-vos	desencabelar+V.vós.AD.2.PL+INF+2+PL
desencabelardes-vos	desencabelar+V.vós.AD.2.PL+SBJF+2+PL
desencabelárei-la	desencabelar+V.ele.ACC.3.F.SG+PQP+2+PL
desencabelárei-las	desencabelar+V.ele.ACC.3.F.PL+PQP+2+PL
desencabelárei-lo	desencabelar+V.ele.ACC.3.M.SG+PQP+2+PL
desencabelárei-los	desencabelar+V.ele.ACC.3.M.PL+PQP+2+PL
desencabelárei-nos	desencabelar+nós.AD.1.PL+PQP+2+PL
desencabeláreis-lhe	desencabelar+V.ele.DAT.3.SG+PQP+2+PL
desencabeláreis-lhes	desencabelar+V.ele.DAT.3.PL+PQP+2+PL
desencabeláreis-me	desencabelar+V.eu.AD.1.SG+PQP+2+PL
desencabeláreis-te	desencabelar+V.tu.AD.2.SG+PQP+2+PL
desencabeláreis-vos	desencabelar+V.vós.AD.2.PL+PQP+2+PL
desencabelare-la	desencabelar+V.ele.ACC.3.F.SG+INF+2+SG
desencabelare-la	desencabelar+V.ele.ACC.3.F.SG+SBJF+2+SG
desencabelare-las	desencabelar+V.ele.ACC.3.F.PL+INF+2+SG
desencabelare-las	desencabelar+V.ele.ACC.3.F.PL+SBJF+2+SG
desencabelare-lo	desencabelar+V.ele.ACC.3.M.SG+INF+2+SG
desencabelare-lo	desencabelar+V.ele.ACC.3.M.SG+SBJF+2+SG
desencabelare-los	desencabelar+V.ele.ACC.3.M.PL+INF+2+SG
desencabelare-los	desencabelar+V.ele.ACC.3.M.PL+SBJF+2+SG
desencabelarem-lhe	desencabelar+V.ele.DAT.3.SG+INF+3+PL
desencabelarem-lhe	desencabelar+V.ele.DAT.3.SG+SBJF+3+PL
desencabelarem-lhes	desencabelar+V.ele.DAT.3.PL+INF+3+PL
desencabelarem-lhes	desencabelar+V.ele.DAT.3.PL+SBJF+3+PL
desencabelarem-me	desencabelar+V.eu.AD.1.SG+INF+3+PL
desencabelarem-me	desencabelar+V.eu.AD.1.SG+SBJF+3+PL
desencabelarem-na	desencabelar+V.ele.ACC.3.F.SG+INF+3+PL
desencabelarem-na	desencabelar+V.ele.ACC.3.F.SG+SBJF+3+PL
desencabelarem-nas	desencabelar+V.ele.ACC.3.F.PL+INF+3+PL
desencabelarem-nas	desencabelar+V.ele.ACC.3.F.PL+SBJF+3+PL
desencabelarem-no	desencabelar+V.ele.ACC.3.M.SG+INF+3+PL
desencabelarem-no	desencabelar+V.ele.ACC.3.M.SG+SBJF+3+PL
desencabelarem-nos	desencabelar+V.ele.ACC.3.M.PL+INF+3+PL
desencabelarem-nos	desencabelar+V.ele.ACC.3.M.PL+SBJF+3+PL
desencabelarem-nos	desencabelar+V.nós.AD.1.PL+INF+3+PL
desencabelarem-nos	desencabelar+V.nós.AD.1.PL+SBJF+3+PL
desencabelarem-se	desencabelar+V.ele.REFL+INF+3+PL
desencabelarem-se	desencabelar+V.ele.REFL+SBJF+3+PL
desencabelarem-te	desencabelar+V.tu.AD.2.SG+INF+3+PL
desencabelarem-te	desencabelar+V.tu.AD.2.SG+SBJF+3+PL
desencabelarem-vos	desencabelar+V.vós.AD.2.PL+INF+3+PL
desencabelarem-vos	desencabelar+V.vós.AD.2.PL+SBJF+3+PL
desencabelare-nos	desencabelar+nós.AD.1.PL+INF+2+SG
desencabelare-nos	desencabelar+nós.AD.1.PL+SBJF+2+SG
desencabelares-lhe	desencabelar+V.ele.DAT.3.SG+INF+2+SG
desencabelares-lhe	desencabelar+V.ele.DAT.3.SG+SBJF+2+SG
desencabelares-lhes	desencabelar+V.ele.DAT.3.PL+INF+2+SG
desencabelares-lhes	desencabelar+V.ele.DAT.3.PL+SBJF+2+SG
desencabelares-me	desencabelar+V.eu.AD.1.SG+INF+2+SG
desencabelares-me	desencabelar+V.eu.AD.1.SG+SBJF+2+SG
desencabelares-te	desencabelar+V.tu.AD.2.SG+INF+2+SG
desencabelares-te	desencabelar+V.tu.AD.2.SG+SBJF+2+SG
desencabelares-vos	desencabelar+V.vós.AD.2.PL+INF+2+SG
desencabelares-vos	desencabelar+V.vós.AD.2.PL+SBJF+2+SG
desencabelar-lhe-á	desencabelar+V.ele.DAT.3.SG+FUT+3+SG
desencabelar-lhe-ão	desencabelar+V.ele.DAT.3.SG+FUT+3+PL
desencabelar-lhe-ás	desencabelar+V.ele.DAT.3.SG+FUT+2+SG
desencabelar-lhe	desencabelar+V.ele.DAT.3.SG+INF
desencabelar-lhe	desencabelar+V.ele.DAT.3.SG+INF+1+SG
desencabelar-lhe	desencabelar+V.ele.DAT.3.SG+INF+3+SG
desencabelar-lhe	desencabelar+V.ele.DAT.3.SG+SBJF+1+SG
desencabelar-lhe	desencabelar+V.ele.DAT.3.SG+SBJF+3+SG
desencabelar-lhe-ei	desencabelar+V.ele.DAT.3.SG+FUT+1+SG
desencabelar-lhe-eis	desencabelar+V.ele.DAT.3.SG+FUT+2+PL
desencabelar-lhe-emos	desencabelar+V.ele.DAT.3.SG+FUT+1+PL
desencabelar-lhe-ia	desencabelar+V.ele.DAT.3.SG+COND+1+SG
desencabelar-lhe-ia	desencabelar+V.ele.DAT.3.SG+COND+3+SG
desencabelar-lhe-iam	desencabelar+V.ele.DAT.3.SG+COND+3+PL
desencabelar-lhe-íamos	desencabelar+V.ele.DAT.3.SG+COND+1+PL
desencabelar-lhe-ias	desencabelar+V.ele.DAT.3.SG+COND+2+SG
desencabelar-lhe-íeis	desencabelar+V.ele.DAT.3.SG+COND+2+PL
desencabelar-lhes-á	desencabelar+V.ele.DAT.3.PL+FUT+3+SG
desencabelar-lhes-ão	desencabelar+V.ele.DAT.3.PL+FUT+3+PL
desencabelar-lhes-ás	desencabelar+V.ele.DAT.3.PL+FUT+2+SG
desencabelar-lhes	desencabelar+V.ele.DAT.3.PL+INF
desencabelar-lhes	desencabelar+V.ele.DAT.3.PL+INF+1+SG
desencabelar-lhes	desencabelar+V.ele.DAT.3.PL+INF+3+SG
desencabelar-lhes	desencabelar+V.ele.DAT.3.PL+SBJF+1+SG
desencabelar-lhes	desencabelar+V.ele.DAT.3.PL+SBJF+3+SG
desencabelar-lhes-ei	desencabelar+V.ele.DAT.3.PL+FUT+1+SG
desencabelar-lhes-eis	desencabelar+V.ele.DAT.3.PL+FUT+2+PL
desencabelar-lhes-emos	desencabelar+V.ele.DAT.3.PL+FUT+1+PL
desencabelar-lhes-ia	desencabelar+V.ele.DAT.3.PL+COND+1+SG
desencabelar-lhes-ia	desencabelar+V.ele.DAT.3.PL+COND+3+SG
desencabelar-lhes-iam	desencabelar+V.ele.DAT.3.PL+COND+3+PL
desencabelar-lhes-íamos	desencabelar+V.ele.DAT.3.PL+COND+1+PL
desencabelar-lhes-ias	desencabelar+V.ele.DAT.3.PL+COND+2+SG
desencabelar-lhes-íeis	desencabelar+V.ele.DAT.3.PL+COND+2+PL
desencabelar-me-á	desencabelar+V.eu.AD.1.SG+FUT+3+SG
desencabelar-me-ão	desencabelar+V.eu.AD.1.SG+FUT+3+PL
desencabelar-me-ás	desencabelar+V.eu.AD.1.SG+FUT+2+SG
desencabelar-me	desencabelar+V.eu.AD.1.SG+INF
desencabelar-me	desencabelar+V.eu.AD.1.SG+INF+1+SG
desencabelar-me	desencabelar+V.eu.AD.1.SG+INF+3+SG
desencabelar-me	desencabelar+V.eu.AD.1.SG+SBJF+1+SG
desencabelar-me	desencabelar+V.eu.AD.1.SG+SBJF+3+SG
desencabelar-me-ei	desencabelar+V.eu.AD.1.SG+FUT+1+SG
desencabelar-me-eis	desencabelar+V.eu.AD.1.SG+FUT+2+PL
desencabelar-me-emos	desencabelar+V.eu.AD.1.SG+FUT+1+PL
desencabelar-me-ia	desencabelar+V.eu.AD.1.SG+COND+1+SG
desencabelar-me-ia	desencabelar+V.eu.AD.1.SG+COND+3+SG
desencabelar-me-iam	desencabelar+V.eu.AD.1.SG+COND+3+PL
desencabelar-me-íamos	desencabelar+V.eu.AD.1.SG+COND+1+PL
desencabelar-me-ias	desencabelar+V.eu.AD.1.SG+COND+2+SG
desencabelar-me-íeis	desencabelar+V.eu.AD.1.SG+COND+2+PL
desencabelarmo-la	desencabelar+V.ele.ACC.3.F.SG+INF+1+PL
desencabelarmo-la	desencabelar+V.ele.ACC.3.F.SG+SBJF+1+PL
desencabelarmo-las	desencabelar+V.ele.ACC.3.F.PL+INF+1+PL
desencabelarmo-las	desencabelar+V.ele.ACC.3.F.PL+SBJF+1+PL
desencabelarmo-lo	desencabelar+V.ele.ACC.3.M.SG+INF+1+PL
desencabelarmo-lo	desencabelar+V.ele.ACC.3.M.SG+SBJF+1+PL
desencabelarmo-los	desencabelar+V.ele.ACC.3.M.PL+INF+1+PL
desencabelarmo-los	desencabelar+V.ele.ACC.3.M.PL+SBJF+1+PL
desencabelarmo-nos	desencabelar+nós.AD.1.PL+INF+1+PL
desencabelarmo-nos	desencabelar+nós.AD.1.PL+SBJF+1+PL
desencabelarmos-lhe	desencabelar+V.ele.DAT.3.SG+INF+1+PL
desencabelarmos-lhe	desencabelar+V.ele.DAT.3.SG+SBJF+1+PL
desencabelarmos-lhes	desencabelar+V.ele.DAT.3.PL+INF+1+PL
desencabelarmos-lhes	desencabelar+V.ele.DAT.3.PL+SBJF+1+PL
desencabelarmos-me	desencabelar+V.eu.AD.1.SG+INF+1+PL
desencabelarmos-me	desencabelar+V.eu.AD.1.SG+SBJF+1+PL
desencabelarmos-te	desencabelar+V.tu.AD.2.SG+INF+1+PL
desencabelarmos-te	desencabelar+V.tu.AD.2.SG+SBJF+1+PL
desencabelarmos-vos	desencabelar+V.vós.AD.2.PL+INF+1+PL
desencabelarmos-vos	desencabelar+V.vós.AD.2.PL+SBJF+1+PL
desencabelar-nos-á	desencabelar+nós.AD.1.PL+FUT+3+SG
desencabelar-nos-ão	desencabelar+nós.AD.1.PL+FUT+3+PL
desencabelar-nos-ás	desencabelar+nós.AD.1.PL+FUT+2+SG
desencabelar-nos	desencabelar+nós.AD.1.PL+INF
desencabelar-nos	desencabelar+nós.AD.1.PL+INF+1+SG
desencabelar-nos	desencabelar+nós.AD.1.PL+INF+3+SG
desencabelar-nos	desencabelar+nós.AD.1.PL+SBJF+1+SG
desencabelar-nos	desencabelar+nós.AD.1.PL+SBJF+3+SG
desencabelar-nos-ei	desencabelar+nós.AD.1.PL+FUT+1+SG
desencabelar-nos-eis	desencabelar+nós.AD.1.PL+FUT+2+PL
desencabelar-nos-emos	desencabelar+nós.AD.1.PL+FUT+1+PL
desencabelar-nos-ia	desencabelar+nós.AD.1.PL+COND+1+SG
desencabelar-nos-ia	desencabelar+nós.AD.1.PL+COND+3+SG
desencabelar-nos-iam	desencabelar+nós.AD.1.PL+COND+3+PL
desencabelar-nos-íamos	desencabelar+nós.AD.1.PL+COND+1+PL
desencabelar-nos-ias	desencabelar+nós.AD.1.PL+COND+2+SG
desencabelar-nos-íeis	desencabelar+nós.AD.1.PL+COND+2+PL
desencabelar-se-á	desencabelar+V.ele.REFL+FUT+3+SG
desencabelar-se-ão	desencabelar+V.ele.REFL+FUT+3+PL
desencabelar-se	desencabelar+V.ele.REFL+INF
desencabelar-se	desencabelar+V.ele.REFL+INF+3+SG
desencabelar-se	desencabelar+V.ele.REFL+SBJF+3+SG
desencabelar-se-ia	desencabelar+V.ele.REFL+COND+3+SG
desencabelar-se-iam	desencabelar+V.ele.REFL+COND+3+PL
desencabelar-te-á	desencabelar+V.tu.AD.2.SG+FUT+3+SG
desencabelar-te-ão	desencabelar+V.tu.AD.2.SG+FUT+3+PL
desencabelar-te-ás	desencabelar+V.tu.AD.2.SG+FUT+2+SG
desencabelar-te	desencabelar+V.tu.AD.2.SG+INF
desencabelar-te	desencabelar+V.tu.AD.2.SG+INF+1+SG
desencabelar-te	desencabelar+V.tu.AD.2.SG+INF+3+SG
desencabelar-te	desencabelar+V.tu.AD.2.SG+SBJF+1+SG
desencabelar-te	desencabelar+V.tu.AD.2.SG+SBJF+3+SG
desencabelar-te-ei	desencabelar+V.tu.AD.2.SG+FUT+1+SG
desencabelar-te-eis	desencabelar+V.tu.AD.2.SG+FUT+2+PL
desencabelar-te-emos	desencabelar+V.tu.AD.2.SG+FUT+1+PL
desencabelar-te-ia	desencabelar+V.tu.AD.2.SG+COND+1+SG
desencabelar-te-ia	desencabelar+V.tu.AD.2.SG+COND+3+SG
desencabelar-te-iam	desencabelar+V.tu.AD.2.SG+COND+3+PL
desencabelar-te-íamos	desencabelar+V.tu.AD.2.SG+COND+1+PL
desencabelar-te-ias	desencabelar+V.tu.AD.2.SG+COND+2+SG
desencabelar-te-íeis	desencabelar+V.tu.AD.2.SG+COND+2+PL
desencabelar-vos-á	desencabelar+V.vós.AD.2.PL+FUT+3+SG
desencabelar-vos-ão	desencabelar+V.vós.AD.2.PL+FUT+3+PL
desencabelar-vos-ás	desencabelar+V.vós.AD.2.PL+FUT+2+SG
desencabelar-vos	desencabelar+V.vós.AD.2.PL+INF
desencabelar-vos	desencabelar+V.vós.AD.2.PL+INF+1+SG
desencabelar-vos	desencabelar+V.vós.AD.2.PL+INF+3+SG
desencabelar-vos	desencabelar+V.vós.AD.2.PL+SBJF+1+SG
desencabelar-vos	desencabelar+V.vós.AD.2.PL+SBJF+3+SG
desencabelar-vos-ei	desencabelar+V.vós.AD.2.PL+FUT+1+SG
desencabelar-vos-eis	desencabelar+V.vós.AD.2.PL+FUT+2+PL
desencabelar-vos-emos	desencabelar+V.vós.AD.2.PL+FUT+1+PL
desencabelar-vos-ia	desencabelar+V.vós.AD.2.PL+COND+1+SG
desencabelar-vos-ia	desencabelar+V.vós.AD.2.PL+COND+3+SG
desencabelar-vos-iam	desencabelar+V.vós.AD.2.PL+COND+3+PL
desencabelar-vos-íamos	desencabelar+V.vós.AD.2.PL+COND+1+PL
desencabelar-vos-ias	desencabelar+V.vós.AD.2.PL+COND+2+SG
desencabelar-vos-íeis	desencabelar+V.vós.AD.2.PL+COND+2+PL
desencabela-se	desencabelar+V.ele.REFL+PRS+3+SG
desencabelas-lhe	desencabelar+V.ele.DAT.3.SG+PRS+2+SG
desencabelas-lhes	desencabelar+V.ele.DAT.3.PL+PRS+2+SG
desencabelas-me	desencabelar+V.eu.AD.1.SG+PRS+2+SG
desencabelaste-a	desencabelar+V.ele.ACC.3.F.SG+PRF+2+SG
desencabelaste-as	desencabelar+V.ele.ACC.3.F.PL+PRF+2+SG
desencabelas-te	desencabelar+V.tu.AD.2.SG+PRS+2+SG
desencabelaste-la	desencabelar+V.ele.ACC.3.F.SG+PRF+2+PL
desencabelaste-las	desencabelar+V.ele.ACC.3.F.PL+PRF+2+PL
desencabelaste-lhe	desencabelar+V.ele.DAT.3.SG+PRF+2+SG
desencabelaste-lhes	desencabelar+V.ele.DAT.3.PL+PRF+2+SG
desencabelaste-lo	desencabelar+V.ele.ACC.3.M.SG+PRF+2+PL
desencabelaste-los	desencabelar+V.ele.ACC.3.M.PL+PRF+2+PL
desencabelaste-me	desencabelar+V.eu.AD.1.SG+PRF+2+SG
desencabelaste-nos	desencabelar+nós.AD.1.PL+PRF+2+PL
desencabelaste-nos	desencabelar+nós.AD.1.PL+PRF+2+SG
desencabelaste-o	desencabelar+V.ele.ACC.3.M.SG+PRF+2+SG
desencabelaste-os	desencabelar+V.ele.ACC.3.M.PL+PRF+2+SG
desencabelastes-lhe	desencabelar+V.ele.DAT.3.SG+PRF+2+PL
desencabelastes-lhes	desencabelar+V.ele.DAT.3.PL+PRF+2+PL
desencabelastes-me	desencabelar+V.eu.AD.1.SG+PRF+2+PL
desencabelastes-te	desencabelar+V.tu.AD.2.SG+PRF+2+PL
desencabelastes-vos	desencabelar+V.vós.AD.2.PL+PRF+2+PL
desencabelaste-te	desencabelar+V.tu.AD.2.SG+PRF+2+SG
desencabelaste-vos	desencabelar+V.vós.AD.2.PL+PRF+2+SG
desencabelas-vos	desencabelar+V.vós.AD.2.PL+PRS+2+SG
desencabela-te	desencabelar+V.tu.AD.2.SG+PRS+3+SG
desencabelava-a	desencabelar+V.ele.ACC.3.F.SG+IMPF+1+SG
desencabelava-a	desencabelar+V.ele.ACC.3.F.SG+IMPF+3+SG
desencabelava-as	desencabelar+V.ele.ACC.3.F.PL+IMPF+1+SG
desencabelava-as	desencabelar+V.ele.ACC.3.F.PL+IMPF+3+SG
desencabelava-la	desencabelar+V.ele.ACC.3.F.SG+IMPF+2+SG
desencabelava-las	desencabelar+V.ele.ACC.3.F.PL+IMPF+2+SG
desencabelava-lhe	desencabelar+V.ele.DAT.3.SG+IMPF+1+SG
desencabelava-lhe	desencabelar+V.ele.DAT.3.SG+IMPF+3+SG
desencabelava-lhes	desencabelar+V.ele.DAT.3.PL+IMPF+1+SG
desencabelava-lhes	desencabelar+V.ele.DAT.3.PL+IMPF+3+SG
desencabelava-lo	desencabelar+V.ele.ACC.3.M.SG+IMPF+2+SG
desencabelava-los	desencabelar+V.ele.ACC.3.M.PL+IMPF+2+SG
desencabelava-me	desencabelar+V.eu.AD.1.SG+IMPF+1+SG
desencabelava-me	desencabelar+V.eu.AD.1.SG+IMPF+3+SG
desencabelavam-lhe	desencabelar+V.ele.DAT.3.SG+IMPF+3+PL
desencabelavam-lhes	desencabelar+V.ele.DAT.3.PL+IMPF+3+PL
desencabelavam-me	desencabelar+V.eu.AD.1.SG+IMPF+3+PL
desencabelavam-na	desencabelar+V.ele.ACC.3.F.SG+IMPF+3+PL
desencabelavam-nas	desencabelar+V.ele.ACC.3.F.PL+IMPF+3+PL
desencabelavam-no	desencabelar+V.ele.ACC.3.M.SG+IMPF+3+PL
desencabelavam-nos	desencabelar+V.ele.ACC.3.M.PL+IMPF+3+PL
desencabelavam-nos	desencabelar+V.nós.AD.1.PL+IMPF+3+PL
desencabelávamo-la	desencabelar+V.ele.ACC.3.F.SG+IMPF+1+PL
desencabelávamo-las	desencabelar+V.ele.ACC.3.F.PL+IMPF+1+PL
desencabelávamo-lo	desencabelar+V.ele.ACC.3.M.SG+IMPF+1+PL
desencabelávamo-los	desencabelar+V.ele.ACC.3.M.PL+IMPF+1+PL
desencabelávamo-nos	desencabelar+nós.AD.1.PL+IMPF+1+PL
desencabelávamos-lhe	desencabelar+V.ele.DAT.3.SG+IMPF+1+PL
desencabelávamos-lhes	desencabelar+V.ele.DAT.3.PL+IMPF+1+PL
desencabelávamos-me	desencabelar+V.eu.AD.1.SG+IMPF+1+PL
desencabelávamos-te	desencabelar+V.tu.AD.2.SG+IMPF+1+PL
desencabelávamos-vos	desencabelar+V.vós.AD.2.PL+IMPF+1+PL
desencabelavam-se	desencabelar+V.ele.REFL+IMPF+3+PL
desencabelavam-te	desencabelar+V.tu.AD.2.SG+IMPF+3+PL
desencabelavam-vos	desencabelar+V.vós.AD.2.PL+IMPF+3+PL
desencabelava-nos	desencabelar+nós.AD.1.PL+IMPF+1+SG
desencabelava-nos	desencabelar+nós.AD.1.PL+IMPF+2+SG
desencabelava-nos	desencabelar+nós.AD.1.PL+IMPF+3+SG
desencabelava-o	desencabelar+V.ele.ACC.3.M.SG+IMPF+1+SG
desencabelava-o	desencabelar+V.ele.ACC.3.M.SG+IMPF+3+SG
desencabelava-os	desencabelar+V.ele.ACC.3.M.PL+IMPF+1+SG
desencabelava-os	desencabelar+V.ele.ACC.3.M.PL+IMPF+3+SG
desencabelava-se	desencabelar+V.ele.REFL+IMPF+1+SG
desencabelava-se	desencabelar+V.ele.REFL+IMPF+3+SG
desencabelavas-lhe	desencabelar+V.ele.DAT.3.SG+IMPF+2+SG
desencabelavas-lhes	desencabelar+V.ele.DAT.3.PL+IMPF+2+SG
desencabelavas-me	desencabelar+V.eu.AD.1.SG+IMPF+2+SG
desencabelavas-te	desencabelar+V.tu.AD.2.SG+IMPF+2+SG
desencabelavas-vos	desencabelar+V.vós.AD.2.PL+IMPF+2+SG
desencabelava-te	desencabelar+V.tu.AD.2.SG+IMPF+1+SG
desencabelava-te	desencabelar+V.tu.AD.2.SG+IMPF+3+SG
desencabelava-vos	desencabelar+V.vós.AD.2.PL+IMPF+1+SG
desencabelava-vos	desencabelar+V.vós.AD.2.PL+IMPF+3+SG
desencabelávei-la	desencabelar+V.ele.ACC.3.F.SG+IMPF+2+PL
desencabelávei-las	desencabelar+V.ele.ACC.3.F.PL+IMPF+2+PL
desencabelávei-lo	desencabelar+V.ele.ACC.3.M.SG+IMPF+2+PL
desencabelávei-los	desencabelar+V.ele.ACC.3.M.PL+IMPF+2+PL
desencabelávei-nos	desencabelar+nós.AD.1.PL+IMPF+2+PL
desencabeláveis-lhe	desencabelar+V.ele.DAT.3.SG+IMPF+2+PL
desencabeláveis-lhes	desencabelar+V.ele.DAT.3.PL+IMPF+2+PL
desencabeláveis-me	desencabelar+V.eu.AD.1.SG+IMPF+2+PL
desencabeláveis-te	desencabelar+V.tu.AD.2.SG+IMPF+2+PL
desencabeláveis-vos	desencabelar+V.vós.AD.2.PL+IMPF+2+PL
desencabela-vos	desencabelar+V.vós.AD.2.PL+PRS+3+SG
desencabele-a	desencabelar+V.ele.ACC.3.F.SG+IMP+3+SG
desencabele-as	desencabelar+V.ele.ACC.3.F.PL+IMP+3+SG
desencabelei-a	desencabelar+V.ele.ACC.3.F.SG+PRF+1+SG
desencabelei-as	desencabelar+V.ele.ACC.3.F.PL+PRF+1+SG
desencabelei-lhe	desencabelar+V.ele.DAT.3.SG+PRF+1+SG
desencabelei-lhes	desencabelar+V.ele.DAT.3.PL+PRF+1+SG
desencabelei-me	desencabelar+V.eu.AD.1.SG+PRF+1+SG
desencabelei-nos	desencabelar+nós.AD.1.PL+PRF+1+SG
desencabelei-o	desencabelar+V.ele.ACC.3.M.SG+PRF+1+SG
desencabelei-os	desencabelar+V.ele.ACC.3.M.PL+PRF+1+SG
desencabelei-te	desencabelar+V.tu.AD.2.SG+PRF+1+SG
desencabelei-vos	desencabelar+V.vós.AD.2.PL+PRF+1+SG
desencabele-lhe	desencabelar+V.ele.DAT.3.SG+IMP+3+SG
desencabele-lhes	desencabelar+V.ele.DAT.3.PL+IMP+3+SG
desencabele-me	desencabelar+V.eu.AD.1.SG+IMP+3+SG
desencabelem-lhe	desencabelar+V.ele.DAT.3.SG+IMP+3+PL
desencabelem-lhes	desencabelar+V.ele.DAT.3.PL+IMP+3+PL
desencabelem-me	desencabelar+V.eu.AD.1.SG+IMP+3+PL
desencabelem-na	desencabelar+V.ele.ACC.3.F.SG+IMP+3+PL
desencabelem-nas	desencabelar+V.ele.ACC.3.F.PL+IMP+3+PL
desencabelem-no	desencabelar+V.ele.ACC.3.M.SG+IMP+3+PL
desencabelem-nos	desencabelar+V.ele.ACC.3.M.PL+IMP+3+PL
desencabelem-nos	desencabelar+V.nós.AD.1.PL+IMP+3+PL
desencabelemo-la	desencabelar+V.ele.ACC.3.F.SG+IMP+1+PL
desencabelemo-las	desencabelar+V.ele.ACC.3.F.PL+IMP+1+PL
desencabelemo-lo	desencabelar+V.ele.ACC.3.M.SG+IMP+1+PL
desencabelemo-los	desencabelar+V.ele.ACC.3.M.PL+IMP+1+PL
desencabelemo-nos	desencabelar+nós.AD.1.PL+IMP+1+PL
desencabelemos-lhe	desencabelar+V.ele.DAT.3.SG+IMP+1+PL
desencabelemos-lhes	desencabelar+V.ele.DAT.3.PL+IMP+1+PL
desencabelemos-me	desencabelar+V.eu.AD.1.SG+IMP+1+PL
desencabelemos-te	desencabelar+V.tu.AD.2.SG+IMP+1+PL
desencabelemos-vos	desencabelar+V.vós.AD.2.PL+IMP+1+PL
desencabelem-se	desencabelar+V.ele.REFL+IMP+3+PL
desencabelem-te	desencabelar+V.tu.AD.2.SG+IMP+3+PL
desencabelem-vos	desencabelar+V.vós.AD.2.PL+IMP+3+PL
desencabele-nos	desencabelar+nós.AD.1.PL+IMP+3+SG
desencabele-o	desencabelar+V.ele.ACC.3.M.SG+IMP+3+SG
desencabele-os	desencabelar+V.ele.ACC.3.M.PL+IMP+3+SG
desencabele-se	desencabelar+V.ele.REFL+IMP+3+SG
desencabele-te	desencabelar+V.tu.AD.2.SG+IMP+3+SG
desencabele-vos	desencabelar+V.vós.AD.2.PL+IMP+3+SG
desencabe-lhe	desencabar+V.ele.DAT.3.SG+IMP+3+SG
desencabe-lhes	desencabar+V.ele.DAT.3.PL+IMP+3+SG
desencabelo-a	desencabelar+V.ele.ACC.3.F.SG+PRS+1+SG
desencabelo-as	desencabelar+V.ele.ACC.3.F.PL+PRS+1+SG
desencabelo-lhe	desencabelar+V.ele.DAT.3.SG+PRS+1+SG
desencabelo-lhes	desencabelar+V.ele.DAT.3.PL+PRS+1+SG
desencabelo-me	desencabelar+V.eu.AD.1.SG+PRS+1+SG
desencabelo-nos	desencabelar+nós.AD.1.PL+PRS+1+SG
desencabelo-o	desencabelar+V.ele.ACC.3.M.SG+PRS+1+SG
desencabelo-os	desencabelar+V.ele.ACC.3.M.PL+PRS+1+SG
desencabelo-te	desencabelar+V.tu.AD.2.SG+PRS+1+SG
desencabelou-a	desencabelar+V.ele.ACC.3.F.SG+PRF+3+SG
desencabelou-as	desencabelar+V.ele.ACC.3.F.PL+PRF+3+SG
desencabelou-lhe	desencabelar+V.ele.DAT.3.SG+PRF+3+SG
desencabelou-lhes	desencabelar+V.ele.DAT.3.PL+PRF+3+SG
desencabelou-me	desencabelar+V.eu.AD.1.SG+PRF+3+SG
desencabelou-nos	desencabelar+nós.AD.1.PL+PRF+3+SG
desencabelou-o	desencabelar+V.ele.ACC.3.M.SG+PRF+3+SG
desencabelou-os	desencabelar+V.ele.ACC.3.M.PL+PRF+3+SG
desencabelou-se	desencabelar+V.ele.REFL+PRF+3+SG
desencabelou-te	desencabelar+V.tu.AD.2.SG+PRF+3+SG
desencabelou-vos	desencabelar+V.vós.AD.2.PL+PRF+3+SG
desencabelo-vos	desencabelar+V.vós.AD.2.PL+PRS+1+SG
desencabe-me	desencabar+V.eu.AD.1.SG+IMP+3+SG
desencabem-lhe	desencabar+V.ele.DAT.3.SG+IMP+3+PL
desencabem-lhes	desencabar+V.ele.DAT.3.PL+IMP+3+PL
desencabem-me	desencabar+V.eu.AD.1.SG+IMP+3+PL
desencabem-na	desencabar+V.ele.ACC.3.F.SG+IMP+3+PL
desencabem-nas	desencabar+V.ele.ACC.3.F.PL+IMP+3+PL
desencabem-no	desencabar+V.ele.ACC.3.M.SG+IMP+3+PL
desencabem-nos	desencabar+V.ele.ACC.3.M.PL+IMP+3+PL
desencabem-nos	desencabar+V.nós.AD.1.PL+IMP+3+PL
desencabemo-la	desencabar+V.ele.ACC.3.F.SG+IMP+1+PL
desencabemo-las	desencabar+V.ele.ACC.3.F.PL+IMP+1+PL
desencabemo-lo	desencabar+V.ele.ACC.3.M.SG+IMP+1+PL
desencabemo-los	desencabar+V.ele.ACC.3.M.PL+IMP+1+PL
desencabemo-nos	desencabar+nós.AD.1.PL+IMP+1+PL
desencabemos-lhe	desencabar+V.ele.DAT.3.SG+IMP+1+PL
desencabemos-lhes	desencabar+V.ele.DAT.3.PL+IMP+1+PL
desencabemos-me	desencabar+V.eu.AD.1.SG+IMP+1+PL
desencabemos-te	desencabar+V.tu.AD.2.SG+IMP+1+PL
desencabemos-vos	desencabar+V.vós.AD.2.PL+IMP+1+PL
desencabem-se	desencabar+V.ele.REFL+IMP+3+PL
desencabem-te	desencabar+V.tu.AD.2.SG+IMP+3+PL
desencabem-vos	desencabar+V.vós.AD.2.PL+IMP+3+PL
desencabe-nos	desencabar+nós.AD.1.PL+IMP+3+SG
desencabe-o	desencabar+V.ele.ACC.3.M.SG+IMP+3+SG
desencabe-os	desencabar+V.ele.ACC.3.M.PL+IMP+3+SG
desencabe-se	desencabar+V.ele.REFL+IMP+3+SG
desencabe-te	desencabar+V.tu.AD.2.SG+IMP+3+SG
desencabe-vos	desencabar+V.vós.AD.2.PL+IMP+3+SG
desencabo-a	desencabar+V.ele.ACC.3.F.SG+PRS+1+SG
desencabo-as	desencabar+V.ele.ACC.3.F.PL+PRS+1+SG
desencabo-lhe	desencabar+V.ele.DAT.3.SG+PRS+1+SG
desencabo-lhes	desencabar+V.ele.DAT.3.PL+PRS+1+SG
desencabo-me	desencabar+V.eu.AD.1.SG+PRS+1+SG
desencabo-nos	desencabar+nós.AD.1.PL+PRS+1+SG
desencabo-o	desencabar+V.ele.ACC.3.M.SG+PRS+1+SG
desencabo-os	desencabar+V.ele.ACC.3.M.PL+PRS+1+SG
desencabo-te	desencabar+V.tu.AD.2.SG+PRS+1+SG
desencabou-a	desencabar+V.ele.ACC.3.F.SG+PRF+3+SG
desencabou-as	desencabar+V.ele.ACC.3.F.PL+PRF+3+SG
desencabou-lhe	desencabar+V.ele.DAT.3.SG+PRF+3+SG
desencabou-lhes	desencabar+V.ele.DAT.3.PL+PRF+3+SG
desencabou-me	desencabar+V.eu.AD.1.SG+PRF+3+SG
desencabou-nos	desencabar+nós.AD.1.PL+PRF+3+SG
desencabou-o	desencabar+V.ele.ACC.3.M.SG+PRF+3+SG
desencabou-os	desencabar+V.ele.ACC.3.M.PL+PRF+3+SG
desencabou-se	desencabar+V.ele.REFL+PRF+3+SG
desencabou-te	desencabar+V.tu.AD.2.SG+PRF+3+SG
desencabou-vos	desencabar+V.vós.AD.2.PL+PRF+3+SG
desencabo-vos	desencabar+V.vós.AD.2.PL+PRS+1+SG
desencabresta-a	desencabrestar+V.ele.ACC.3.F.SG+PRS+3+SG
desencabresta-as	desencabrestar+V.ele.ACC.3.F.PL+PRS+3+SG
desencabrestai-la	desencabrestar+V.ele.ACC.3.F.SG+PRS+2+PL
desencabrestai-las	desencabrestar+V.ele.ACC.3.F.PL+PRS+2+PL
desencabrestai-lo	desencabrestar+V.ele.ACC.3.M.SG+PRS+2+PL
desencabrestai-los	desencabrestar+V.ele.ACC.3.M.PL+PRS+2+PL
desencabrestai-nos	desencabrestar+nós.AD.1.PL+PRS+2+PL
desencabrestais-lhe	desencabrestar+V.ele.DAT.3.SG+PRS+2+PL
desencabrestais-lhes	desencabrestar+V.ele.DAT.3.PL+PRS+2+PL
desencabrestais-me	desencabrestar+V.eu.AD.1.SG+PRS+2+PL
desencabrestais-te	desencabrestar+V.tu.AD.2.SG+PRS+2+PL
desencabrestais-vos	desencabrestar+V.vós.AD.2.PL+PRS+2+PL
desencabrestá-la-á	desencabrestar+V.ele.ACC.3.F.SG+FUT+3+SG
desencabrestá-la-ão	desencabrestar+V.ele.ACC.3.F.SG+FUT+3+PL
desencabrestá-la-ás	desencabrestar+V.ele.ACC.3.F.SG+FUT+2+SG
desencabrestá-la	desencabrestar+V.ele.ACC.3.F.SG+INF+1+SG
desencabrestá-la	desencabrestar+V.ele.ACC.3.F.SG+INF+3+SG
desencabresta-la	desencabrestar+V.ele.ACC.3.F.SG+PRS+2+SG
desencabrestá-la	desencabrestar+V.ele.ACC.3.F.SG+SBJF+1+SG
desencabrestá-la	desencabrestar+V.ele.ACC.3.F.SG+SBJF+3+SG
desencabrestá-la-ei	desencabrestar+V.ele.ACC.3.F.SG+FUT+1+SG
desencabrestá-la-eis	desencabrestar+V.ele.ACC.3.F.SG+FUT+2+PL
desencabrestá-la-emos	desencabrestar+V.ele.ACC.3.F.SG+FUT+1+PL
desencabrestá-la-ia	desencabrestar+V.ele.ACC.3.F.SG+COND+1+SG
desencabrestá-la-ia	desencabrestar+V.ele.ACC.3.F.SG+COND+3+SG
desencabrestá-la-iam	desencabrestar+V.ele.ACC.3.F.SG+COND+3+PL
desencabrestá-la-íamos	desencabrestar+V.ele.ACC.3.F.SG+COND+1+PL
desencabrestá-la-ias	desencabrestar+V.ele.ACC.3.F.SG+COND+2+SG
desencabrestá-la-íeis	desencabrestar+V.ele.ACC.3.F.SG+COND+2+PL
desencabrestá-las-á	desencabrestar+V.ele.ACC.3.F.PL+FUT+3+SG
desencabrestá-las-ão	desencabrestar+V.ele.ACC.3.F.PL+FUT+3+PL
desencabrestá-las-ás	desencabrestar+V.ele.ACC.3.F.PL+FUT+2+SG
desencabrestá-las	desencabrestar+V.ele.ACC.3.F.PL+INF+1+SG
desencabrestá-las	desencabrestar+V.ele.ACC.3.F.PL+INF+3+SG
desencabresta-las	desencabrestar+V.ele.ACC.3.F.PL+PRS+2+SG
desencabrestá-las	desencabrestar+V.ele.ACC.3.F.PL+SBJF+1+SG
desencabrestá-las	desencabrestar+V.ele.ACC.3.F.PL+SBJF+3+SG
desencabrestá-las-ei	desencabrestar+V.ele.ACC.3.F.PL+FUT+1+SG
desencabrestá-las-eis	desencabrestar+V.ele.ACC.3.F.PL+FUT+2+PL
desencabrestá-las-emos	desencabrestar+V.ele.ACC.3.F.PL+FUT+1+PL
desencabrestá-las-ia	desencabrestar+V.ele.ACC.3.F.PL+COND+1+SG
desencabrestá-las-ia	desencabrestar+V.ele.ACC.3.F.PL+COND+3+SG
desencabrestá-las-iam	desencabrestar+V.ele.ACC.3.F.PL+COND+3+PL
desencabrestá-las-íamos	desencabrestar+V.ele.ACC.3.F.PL+COND+1+PL
desencabrestá-las-ias	desencabrestar+V.ele.ACC.3.F.PL+COND+2+SG
desencabrestá-las-íeis	desencabrestar+V.ele.ACC.3.F.PL+COND+2+PL
desencabresta-lhe	desencabrestar+V.ele.DAT.3.SG+PRS+3+SG
desencabresta-lhes	desencabrestar+V.ele.DAT.3.PL+PRS+3+SG
desencabrestá-lo-á	desencabrestar+V.ele.ACC.3.M.SG+FUT+3+SG
desencabrestá-lo-ão	desencabrestar+V.ele.ACC.3.M.SG+FUT+3+PL
desencabrestá-lo-ás	desencabrestar+V.ele.ACC.3.M.SG+FUT+2+SG
desencabrestá-lo	desencabrestar+V.ele.ACC.3.M.SG+INF+1+SG
desencabrestá-lo	desencabrestar+V.ele.ACC.3.M.SG+INF+3+SG
desencabresta-lo	desencabrestar+V.ele.ACC.3.M.SG+PRS+2+SG
desencabrestá-lo	desencabrestar+V.ele.ACC.3.M.SG+SBJF+1+SG
desencabrestá-lo	desencabrestar+V.ele.ACC.3.M.SG+SBJF+3+SG
desencabrestá-lo-ei	desencabrestar+V.ele.ACC.3.M.SG+FUT+1+SG
desencabrestá-lo-eis	desencabrestar+V.ele.ACC.3.M.SG+FUT+2+PL
desencabrestá-lo-emos	desencabrestar+V.ele.ACC.3.M.SG+FUT+1+PL
desencabrestá-lo-ia	desencabrestar+V.ele.ACC.3.M.SG+COND+1+SG
desencabrestá-lo-ia	desencabrestar+V.ele.ACC.3.M.SG+COND+3+SG
desencabrestá-lo-iam	desencabrestar+V.ele.ACC.3.M.SG+COND+3+PL
desencabrestá-lo-íamos	desencabrestar+V.ele.ACC.3.M.SG+COND+1+PL
desencabrestá-lo-ias	desencabrestar+V.ele.ACC.3.M.SG+COND+2+SG
desencabrestá-lo-íeis	desencabrestar+V.ele.ACC.3.M.SG+COND+2+PL
desencabrestá-los-á	desencabrestar+V.ele.ACC.3.M.PL+FUT+3+SG
desencabrestá-los-ão	desencabrestar+V.ele.ACC.3.M.PL+FUT+3+PL
desencabrestá-los-ás	desencabrestar+V.ele.ACC.3.M.PL+FUT+2+SG
desencabrestá-los	desencabrestar+V.ele.ACC.3.M.PL+INF+1+SG
desencabrestá-los	desencabrestar+V.ele.ACC.3.M.PL+INF+3+SG
desencabresta-los	desencabrestar+V.ele.ACC.3.M.PL+PRS+2+SG
desencabrestá-los	desencabrestar+V.ele.ACC.3.M.PL+SBJF+1+SG
desencabrestá-los	desencabrestar+V.ele.ACC.3.M.PL+SBJF+3+SG
desencabrestá-los-ei	desencabrestar+V.ele.ACC.3.M.PL+FUT+1+SG
desencabrestá-los-eis	desencabrestar+V.ele.ACC.3.M.PL+FUT+2+PL
desencabrestá-los-emos	desencabrestar+V.ele.ACC.3.M.PL+FUT+1+PL
desencabrestá-los-ia	desencabrestar+V.ele.ACC.3.M.PL+COND+1+SG
desencabrestá-los-ia	desencabrestar+V.ele.ACC.3.M.PL+COND+3+SG
desencabrestá-los-iam	desencabrestar+V.ele.ACC.3.M.PL+COND+3+PL
desencabrestá-los-íamos	desencabrestar+V.ele.ACC.3.M.PL+COND+1+PL
desencabrestá-los-ias	desencabrestar+V.ele.ACC.3.M.PL+COND+2+SG
desencabrestá-los-íeis	desencabrestar+V.ele.ACC.3.M.PL+COND+2+PL
desencabresta-me	desencabrestar+V.eu.AD.1.SG+PRS+3+SG
desencabrestam-lhe	desencabrestar+V.ele.DAT.3.SG+PRS+3+PL
desencabrestam-lhes	desencabrestar+V.ele.DAT.3.PL+PRS+3+PL
desencabrestam-me	desencabrestar+V.eu.AD.1.SG+PRS+3+PL
desencabrestam-na	desencabrestar+V.ele.ACC.3.F.SG+PRS+3+PL
desencabrestam-nas	desencabrestar+V.ele.ACC.3.F.PL+PRS+3+PL
desencabrestam-no	desencabrestar+V.ele.ACC.3.M.SG+PRS+3+PL
desencabrestam-nos	desencabrestar+V.ele.ACC.3.M.PL+PRS+3+PL
desencabrestam-nos	desencabrestar+V.nós.AD.1.PL+PRS+3+PL
desencabrestamo-la	desencabrestar+V.ele.ACC.3.F.SG+PRF+1+PL
desencabrestamo-la	desencabrestar+V.ele.ACC.3.F.SG+PRS+1+PL
desencabrestamo-las	desencabrestar+V.ele.ACC.3.F.PL+PRF+1+PL
desencabrestamo-las	desencabrestar+V.ele.ACC.3.F.PL+PRS+1+PL
desencabrestamo-lo	desencabrestar+V.ele.ACC.3.M.SG+PRF+1+PL
desencabrestamo-lo	desencabrestar+V.ele.ACC.3.M.SG+PRS+1+PL
desencabrestamo-los	desencabrestar+V.ele.ACC.3.M.PL+PRF+1+PL
desencabrestamo-los	desencabrestar+V.ele.ACC.3.M.PL+PRS+1+PL
desencabrestamo-nos	desencabrestar+nós.AD.1.PL+PRF+1+PL
desencabrestamo-nos	desencabrestar+nós.AD.1.PL+PRS+1+PL
desencabrestamos-lhe	desencabrestar+V.ele.DAT.3.SG+PRF+1+PL
desencabrestamos-lhe	desencabrestar+V.ele.DAT.3.SG+PRS+1+PL
desencabrestamos-lhes	desencabrestar+V.ele.DAT.3.PL+PRF+1+PL
desencabrestamos-lhes	desencabrestar+V.ele.DAT.3.PL+PRS+1+PL
desencabrestamos-me	desencabrestar+V.eu.AD.1.SG+PRF+1+PL
desencabrestamos-me	desencabrestar+V.eu.AD.1.SG+PRS+1+PL
desencabrestamos-te	desencabrestar+V.tu.AD.2.SG+PRF+1+PL
desencabrestamos-te	desencabrestar+V.tu.AD.2.SG+PRS+1+PL
desencabrestamos-vos	desencabrestar+V.vós.AD.2.PL+PRF+1+PL
desencabrestamos-vos	desencabrestar+V.vós.AD.2.PL+PRS+1+PL
desencabrestam-se	desencabrestar+V.ele.REFL+PRS+3+PL
desencabrestam-te	desencabrestar+V.tu.AD.2.SG+PRS+3+PL
desencabrestam-vos	desencabrestar+V.vós.AD.2.PL+PRS+3+PL
desencabrestando-a	desencabrestar+V.ele.ACC.3.F.SG+GRD
desencabrestando-as	desencabrestar+V.ele.ACC.3.F.PL+GRD
desencabrestando-lhe	desencabrestar+V.ele.DAT.3.SG+GRD
desencabrestando-lhes	desencabrestar+V.ele.DAT.3.PL+GRD
desencabrestando-me	desencabrestar+V.eu.AD.1.SG+GRD
desencabrestando-nos	desencabrestar+nós.AD.1.PL+GRD
desencabrestando-o	desencabrestar+V.ele.ACC.3.M.SG+GRD
desencabrestando-os	desencabrestar+V.ele.ACC.3.M.PL+GRD
desencabrestando-se	desencabrestar+V.ele.REFL+GRD
desencabrestando-te	desencabrestar+V.tu.AD.2.SG+GRD
desencabrestando-vos	desencabrestar+V.vós.AD.2.PL+GRD
desencabresta-nos	desencabrestar+nós.AD.1.PL+PRS+2+SG
desencabresta-nos	desencabrestar+nós.AD.1.PL+PRS+3+SG
desencabresta-o	desencabrestar+V.ele.ACC.3.M.SG+PRS+3+SG
desencabresta-os	desencabrestar+V.ele.ACC.3.M.PL+PRS+3+SG
desencabrestara-a	desencabrestar+V.ele.ACC.3.F.SG+PQP+1+SG
desencabrestara-a	desencabrestar+V.ele.ACC.3.F.SG+PQP+3+SG
desencabrestara-as	desencabrestar+V.ele.ACC.3.F.PL+PQP+1+SG
desencabrestara-as	desencabrestar+V.ele.ACC.3.F.PL+PQP+3+SG
desencabrestara-la	desencabrestar+V.ele.ACC.3.F.SG+PQP+2+SG
desencabrestara-las	desencabrestar+V.ele.ACC.3.F.PL+PQP+2+SG
desencabrestara-lhe	desencabrestar+V.ele.DAT.3.SG+PQP+1+SG
desencabrestara-lhe	desencabrestar+V.ele.DAT.3.SG+PQP+3+SG
desencabrestara-lhes	desencabrestar+V.ele.DAT.3.PL+PQP+1+SG
desencabrestara-lhes	desencabrestar+V.ele.DAT.3.PL+PQP+3+SG
desencabrestara-lo	desencabrestar+V.ele.ACC.3.M.SG+PQP+2+SG
desencabrestara-los	desencabrestar+V.ele.ACC.3.M.PL+PQP+2+SG
desencabrestara-me	desencabrestar+V.eu.AD.1.SG+PQP+1+SG
desencabrestara-me	desencabrestar+V.eu.AD.1.SG+PQP+3+SG
desencabrestaram-lhe	desencabrestar+V.ele.DAT.3.SG+PQP+3+PL
desencabrestaram-lhe	desencabrestar+V.ele.DAT.3.SG+PRF+3+PL
desencabrestaram-lhes	desencabrestar+V.ele.DAT.3.PL+PQP+3+PL
desencabrestaram-lhes	desencabrestar+V.ele.DAT.3.PL+PRF+3+PL
desencabrestaram-me	desencabrestar+V.eu.AD.1.SG+PQP+3+PL
desencabrestaram-me	desencabrestar+V.eu.AD.1.SG+PRF+3+PL
desencabrestaram-na	desencabrestar+V.ele.ACC.3.F.SG+PQP+3+PL
desencabrestaram-na	desencabrestar+V.ele.ACC.3.F.SG+PRF+3+PL
desencabrestaram-nas	desencabrestar+V.ele.ACC.3.F.PL+PQP+3+PL
desencabrestaram-nas	desencabrestar+V.ele.ACC.3.F.PL+PRF+3+PL
desencabrestaram-no	desencabrestar+V.ele.ACC.3.M.SG+PQP+3+PL
desencabrestaram-no	desencabrestar+V.ele.ACC.3.M.SG+PRF+3+PL
desencabrestaram-nos	desencabrestar+V.ele.ACC.3.M.PL+PQP+3+PL
desencabrestaram-nos	desencabrestar+V.ele.ACC.3.M.PL+PRF+3+PL
desencabrestaram-nos	desencabrestar+V.nós.AD.1.PL+PQP+3+PL
desencabrestaram-nos	desencabrestar+V.nós.AD.1.PL+PRF+3+PL
desencabrestáramo-la	desencabrestar+V.ele.ACC.3.F.SG+PQP+1+PL
