desenrolhares-lhe	desenrolhar+V.ele.DAT.3.SG+SBJF+2+SG
desenrolhares-lhes	desenrolhar+V.ele.DAT.3.PL+INF+2+SG
desenrolhares-lhes	desenrolhar+V.ele.DAT.3.PL+SBJF+2+SG
desenrolhares-me	desenrolhar+V.eu.AD.1.SG+INF+2+SG
desenrolhares-me	desenrolhar+V.eu.AD.1.SG+SBJF+2+SG
desenrolhares-te	desenrolhar+V.tu.AD.2.SG+INF+2+SG
desenrolhares-te	desenrolhar+V.tu.AD.2.SG+SBJF+2+SG
desenrolhares-vos	desenrolhar+V.vós.AD.2.PL+INF+2+SG
desenrolhares-vos	desenrolhar+V.vós.AD.2.PL+SBJF+2+SG
desenrolhar-lhe-á	desenrolhar+V.ele.DAT.3.SG+FUT+3+SG
desenrolhar-lhe-ão	desenrolhar+V.ele.DAT.3.SG+FUT+3+PL
desenrolhar-lhe-ás	desenrolhar+V.ele.DAT.3.SG+FUT+2+SG
desenrolhar-lhe	desenrolhar+V.ele.DAT.3.SG+INF
desenrolhar-lhe	desenrolhar+V.ele.DAT.3.SG+INF+1+SG
desenrolhar-lhe	desenrolhar+V.ele.DAT.3.SG+INF+3+SG
desenrolhar-lhe	desenrolhar+V.ele.DAT.3.SG+SBJF+1+SG
desenrolhar-lhe	desenrolhar+V.ele.DAT.3.SG+SBJF+3+SG
desenrolhar-lhe-ei	desenrolhar+V.ele.DAT.3.SG+FUT+1+SG
desenrolhar-lhe-eis	desenrolhar+V.ele.DAT.3.SG+FUT+2+PL
desenrolhar-lhe-emos	desenrolhar+V.ele.DAT.3.SG+FUT+1+PL
desenrolhar-lhe-ia	desenrolhar+V.ele.DAT.3.SG+COND+1+SG
desenrolhar-lhe-ia	desenrolhar+V.ele.DAT.3.SG+COND+3+SG
desenrolhar-lhe-iam	desenrolhar+V.ele.DAT.3.SG+COND+3+PL
desenrolhar-lhe-íamos	desenrolhar+V.ele.DAT.3.SG+COND+1+PL
desenrolhar-lhe-ias	desenrolhar+V.ele.DAT.3.SG+COND+2+SG
desenrolhar-lhe-íeis	desenrolhar+V.ele.DAT.3.SG+COND+2+PL
desenrolhar-lhes-á	desenrolhar+V.ele.DAT.3.PL+FUT+3+SG
desenrolhar-lhes-ão	desenrolhar+V.ele.DAT.3.PL+FUT+3+PL
desenrolhar-lhes-ás	desenrolhar+V.ele.DAT.3.PL+FUT+2+SG
desenrolhar-lhes	desenrolhar+V.ele.DAT.3.PL+INF
desenrolhar-lhes	desenrolhar+V.ele.DAT.3.PL+INF+1+SG
desenrolhar-lhes	desenrolhar+V.ele.DAT.3.PL+INF+3+SG
desenrolhar-lhes	desenrolhar+V.ele.DAT.3.PL+SBJF+1+SG
desenrolhar-lhes	desenrolhar+V.ele.DAT.3.PL+SBJF+3+SG
desenrolhar-lhes-ei	desenrolhar+V.ele.DAT.3.PL+FUT+1+SG
desenrolhar-lhes-eis	desenrolhar+V.ele.DAT.3.PL+FUT+2+PL
desenrolhar-lhes-emos	desenrolhar+V.ele.DAT.3.PL+FUT+1+PL
desenrolhar-lhes-ia	desenrolhar+V.ele.DAT.3.PL+COND+1+SG
desenrolhar-lhes-ia	desenrolhar+V.ele.DAT.3.PL+COND+3+SG
desenrolhar-lhes-iam	desenrolhar+V.ele.DAT.3.PL+COND+3+PL
desenrolhar-lhes-íamos	desenrolhar+V.ele.DAT.3.PL+COND+1+PL
desenrolhar-lhes-ias	desenrolhar+V.ele.DAT.3.PL+COND+2+SG
desenrolhar-lhes-íeis	desenrolhar+V.ele.DAT.3.PL+COND+2+PL
desenrolhar-me-á	desenrolhar+V.eu.AD.1.SG+FUT+3+SG
desenrolhar-me-ão	desenrolhar+V.eu.AD.1.SG+FUT+3+PL
desenrolhar-me-ás	desenrolhar+V.eu.AD.1.SG+FUT+2+SG
desenrolhar-me	desenrolhar+V.eu.AD.1.SG+INF
desenrolhar-me	desenrolhar+V.eu.AD.1.SG+INF+1+SG
desenrolhar-me	desenrolhar+V.eu.AD.1.SG+INF+3+SG
desenrolhar-me	desenrolhar+V.eu.AD.1.SG+SBJF+1+SG
desenrolhar-me	desenrolhar+V.eu.AD.1.SG+SBJF+3+SG
desenrolhar-me-ei	desenrolhar+V.eu.AD.1.SG+FUT+1+SG
desenrolhar-me-eis	desenrolhar+V.eu.AD.1.SG+FUT+2+PL
desenrolhar-me-emos	desenrolhar+V.eu.AD.1.SG+FUT+1+PL
desenrolhar-me-ia	desenrolhar+V.eu.AD.1.SG+COND+1+SG
desenrolhar-me-ia	desenrolhar+V.eu.AD.1.SG+COND+3+SG
desenrolhar-me-iam	desenrolhar+V.eu.AD.1.SG+COND+3+PL
desenrolhar-me-íamos	desenrolhar+V.eu.AD.1.SG+COND+1+PL
desenrolhar-me-ias	desenrolhar+V.eu.AD.1.SG+COND+2+SG
desenrolhar-me-íeis	desenrolhar+V.eu.AD.1.SG+COND+2+PL
desenrolharmo-la	desenrolhar+V.ele.ACC.3.F.SG+INF+1+PL
desenrolharmo-la	desenrolhar+V.ele.ACC.3.F.SG+SBJF+1+PL
desenrolharmo-las	desenrolhar+V.ele.ACC.3.F.PL+INF+1+PL
desenrolharmo-las	desenrolhar+V.ele.ACC.3.F.PL+SBJF+1+PL
desenrolharmo-lo	desenrolhar+V.ele.ACC.3.M.SG+INF+1+PL
desenrolharmo-lo	desenrolhar+V.ele.ACC.3.M.SG+SBJF+1+PL
desenrolharmo-los	desenrolhar+V.ele.ACC.3.M.PL+INF+1+PL
desenrolharmo-los	desenrolhar+V.ele.ACC.3.M.PL+SBJF+1+PL
desenrolharmo-nos	desenrolhar+nós.AD.1.PL+INF+1+PL
desenrolharmo-nos	desenrolhar+nós.AD.1.PL+SBJF+1+PL
desenrolharmos-lhe	desenrolhar+V.ele.DAT.3.SG+INF+1+PL
desenrolharmos-lhe	desenrolhar+V.ele.DAT.3.SG+SBJF+1+PL
desenrolharmos-lhes	desenrolhar+V.ele.DAT.3.PL+INF+1+PL
desenrolharmos-lhes	desenrolhar+V.ele.DAT.3.PL+SBJF+1+PL
desenrolharmos-me	desenrolhar+V.eu.AD.1.SG+INF+1+PL
desenrolharmos-me	desenrolhar+V.eu.AD.1.SG+SBJF+1+PL
desenrolharmos-te	desenrolhar+V.tu.AD.2.SG+INF+1+PL
desenrolharmos-te	desenrolhar+V.tu.AD.2.SG+SBJF+1+PL
desenrolharmos-vos	desenrolhar+V.vós.AD.2.PL+INF+1+PL
desenrolharmos-vos	desenrolhar+V.vós.AD.2.PL+SBJF+1+PL
desenrolhar-nos-á	desenrolhar+nós.AD.1.PL+FUT+3+SG
desenrolhar-nos-ão	desenrolhar+nós.AD.1.PL+FUT+3+PL
desenrolhar-nos-ás	desenrolhar+nós.AD.1.PL+FUT+2+SG
desenrolhar-nos	desenrolhar+nós.AD.1.PL+INF
desenrolhar-nos	desenrolhar+nós.AD.1.PL+INF+1+SG
desenrolhar-nos	desenrolhar+nós.AD.1.PL+INF+3+SG
desenrolhar-nos	desenrolhar+nós.AD.1.PL+SBJF+1+SG
desenrolhar-nos	desenrolhar+nós.AD.1.PL+SBJF+3+SG
desenrolhar-nos-ei	desenrolhar+nós.AD.1.PL+FUT+1+SG
desenrolhar-nos-eis	desenrolhar+nós.AD.1.PL+FUT+2+PL
desenrolhar-nos-emos	desenrolhar+nós.AD.1.PL+FUT+1+PL
desenrolhar-nos-ia	desenrolhar+nós.AD.1.PL+COND+1+SG
desenrolhar-nos-ia	desenrolhar+nós.AD.1.PL+COND+3+SG
desenrolhar-nos-iam	desenrolhar+nós.AD.1.PL+COND+3+PL
desenrolhar-nos-íamos	desenrolhar+nós.AD.1.PL+COND+1+PL
desenrolhar-nos-ias	desenrolhar+nós.AD.1.PL+COND+2+SG
desenrolhar-nos-íeis	desenrolhar+nós.AD.1.PL+COND+2+PL
desenrolhar-se-á	desenrolhar+V.ele.REFL+FUT+3+SG
desenrolhar-se-ão	desenrolhar+V.ele.REFL+FUT+3+PL
desenrolhar-se	desenrolhar+V.ele.REFL+INF
desenrolhar-se	desenrolhar+V.ele.REFL+INF+3+SG
desenrolhar-se	desenrolhar+V.ele.REFL+SBJF+3+SG
desenrolhar-se-ia	desenrolhar+V.ele.REFL+COND+3+SG
desenrolhar-se-iam	desenrolhar+V.ele.REFL+COND+3+PL
desenrolhar-te-á	desenrolhar+V.tu.AD.2.SG+FUT+3+SG
desenrolhar-te-ão	desenrolhar+V.tu.AD.2.SG+FUT+3+PL
desenrolhar-te-ás	desenrolhar+V.tu.AD.2.SG+FUT+2+SG
desenrolhar-te	desenrolhar+V.tu.AD.2.SG+INF
desenrolhar-te	desenrolhar+V.tu.AD.2.SG+INF+1+SG
desenrolhar-te	desenrolhar+V.tu.AD.2.SG+INF+3+SG
desenrolhar-te	desenrolhar+V.tu.AD.2.SG+SBJF+1+SG
desenrolhar-te	desenrolhar+V.tu.AD.2.SG+SBJF+3+SG
desenrolhar-te-ei	desenrolhar+V.tu.AD.2.SG+FUT+1+SG
desenrolhar-te-eis	desenrolhar+V.tu.AD.2.SG+FUT+2+PL
desenrolhar-te-emos	desenrolhar+V.tu.AD.2.SG+FUT+1+PL
desenrolhar-te-ia	desenrolhar+V.tu.AD.2.SG+COND+1+SG
desenrolhar-te-ia	desenrolhar+V.tu.AD.2.SG+COND+3+SG
desenrolhar-te-iam	desenrolhar+V.tu.AD.2.SG+COND+3+PL
desenrolhar-te-íamos	desenrolhar+V.tu.AD.2.SG+COND+1+PL
desenrolhar-te-ias	desenrolhar+V.tu.AD.2.SG+COND+2+SG
desenrolhar-te-íeis	desenrolhar+V.tu.AD.2.SG+COND+2+PL
desenrolhar-vos-á	desenrolhar+V.vós.AD.2.PL+FUT+3+SG
desenrolhar-vos-ão	desenrolhar+V.vós.AD.2.PL+FUT+3+PL
desenrolhar-vos-ás	desenrolhar+V.vós.AD.2.PL+FUT+2+SG
desenrolhar-vos	desenrolhar+V.vós.AD.2.PL+INF
desenrolhar-vos	desenrolhar+V.vós.AD.2.PL+INF+1+SG
desenrolhar-vos	desenrolhar+V.vós.AD.2.PL+INF+3+SG
desenrolhar-vos	desenrolhar+V.vós.AD.2.PL+SBJF+1+SG
desenrolhar-vos	desenrolhar+V.vós.AD.2.PL+SBJF+3+SG
desenrolhar-vos-ei	desenrolhar+V.vós.AD.2.PL+FUT+1+SG
desenrolhar-vos-eis	desenrolhar+V.vós.AD.2.PL+FUT+2+PL
desenrolhar-vos-emos	desenrolhar+V.vós.AD.2.PL+FUT+1+PL
desenrolhar-vos-ia	desenrolhar+V.vós.AD.2.PL+COND+1+SG
desenrolhar-vos-ia	desenrolhar+V.vós.AD.2.PL+COND+3+SG
desenrolhar-vos-iam	desenrolhar+V.vós.AD.2.PL+COND+3+PL
desenrolhar-vos-íamos	desenrolhar+V.vós.AD.2.PL+COND+1+PL
desenrolhar-vos-ias	desenrolhar+V.vós.AD.2.PL+COND+2+SG
desenrolhar-vos-íeis	desenrolhar+V.vós.AD.2.PL+COND+2+PL
desenrolha-se	desenrolhar+V.ele.REFL+PRS+3+SG
desenrolhas-lhe	desenrolhar+V.ele.DAT.3.SG+PRS+2+SG
desenrolhas-lhes	desenrolhar+V.ele.DAT.3.PL+PRS+2+SG
desenrolhas-me	desenrolhar+V.eu.AD.1.SG+PRS+2+SG
desenrolhaste-a	desenrolhar+V.ele.ACC.3.F.SG+PRF+2+SG
desenrolhaste-as	desenrolhar+V.ele.ACC.3.F.PL+PRF+2+SG
desenrolhas-te	desenrolhar+V.tu.AD.2.SG+PRS+2+SG
desenrolhaste-la	desenrolhar+V.ele.ACC.3.F.SG+PRF+2+PL
desenrolhaste-las	desenrolhar+V.ele.ACC.3.F.PL+PRF+2+PL
desenrolhaste-lhe	desenrolhar+V.ele.DAT.3.SG+PRF+2+SG
desenrolhaste-lhes	desenrolhar+V.ele.DAT.3.PL+PRF+2+SG
desenrolhaste-lo	desenrolhar+V.ele.ACC.3.M.SG+PRF+2+PL
desenrolhaste-los	desenrolhar+V.ele.ACC.3.M.PL+PRF+2+PL
desenrolhaste-me	desenrolhar+V.eu.AD.1.SG+PRF+2+SG
desenrolhaste-nos	desenrolhar+nós.AD.1.PL+PRF+2+PL
desenrolhaste-nos	desenrolhar+nós.AD.1.PL+PRF+2+SG
desenrolhaste-o	desenrolhar+V.ele.ACC.3.M.SG+PRF+2+SG
desenrolhaste-os	desenrolhar+V.ele.ACC.3.M.PL+PRF+2+SG
desenrolhastes-lhe	desenrolhar+V.ele.DAT.3.SG+PRF+2+PL
desenrolhastes-lhes	desenrolhar+V.ele.DAT.3.PL+PRF+2+PL
desenrolhastes-me	desenrolhar+V.eu.AD.1.SG+PRF+2+PL
desenrolhastes-te	desenrolhar+V.tu.AD.2.SG+PRF+2+PL
desenrolhastes-vos	desenrolhar+V.vós.AD.2.PL+PRF+2+PL
desenrolhaste-te	desenrolhar+V.tu.AD.2.SG+PRF+2+SG
desenrolhaste-vos	desenrolhar+V.vós.AD.2.PL+PRF+2+SG
desenrolhas-vos	desenrolhar+V.vós.AD.2.PL+PRS+2+SG
desenrolha-te	desenrolhar+V.tu.AD.2.SG+PRS+3+SG
desenrolhava-a	desenrolhar+V.ele.ACC.3.F.SG+IMPF+1+SG
desenrolhava-a	desenrolhar+V.ele.ACC.3.F.SG+IMPF+3+SG
desenrolhava-as	desenrolhar+V.ele.ACC.3.F.PL+IMPF+1+SG
desenrolhava-as	desenrolhar+V.ele.ACC.3.F.PL+IMPF+3+SG
desenrolhava-la	desenrolhar+V.ele.ACC.3.F.SG+IMPF+2+SG
desenrolhava-las	desenrolhar+V.ele.ACC.3.F.PL+IMPF+2+SG
desenrolhava-lhe	desenrolhar+V.ele.DAT.3.SG+IMPF+1+SG
desenrolhava-lhe	desenrolhar+V.ele.DAT.3.SG+IMPF+3+SG
desenrolhava-lhes	desenrolhar+V.ele.DAT.3.PL+IMPF+1+SG
desenrolhava-lhes	desenrolhar+V.ele.DAT.3.PL+IMPF+3+SG
desenrolhava-lo	desenrolhar+V.ele.ACC.3.M.SG+IMPF+2+SG
desenrolhava-los	desenrolhar+V.ele.ACC.3.M.PL+IMPF+2+SG
desenrolhava-me	desenrolhar+V.eu.AD.1.SG+IMPF+1+SG
desenrolhava-me	desenrolhar+V.eu.AD.1.SG+IMPF+3+SG
desenrolhavam-lhe	desenrolhar+V.ele.DAT.3.SG+IMPF+3+PL
desenrolhavam-lhes	desenrolhar+V.ele.DAT.3.PL+IMPF+3+PL
desenrolhavam-me	desenrolhar+V.eu.AD.1.SG+IMPF+3+PL
desenrolhavam-na	desenrolhar+V.ele.ACC.3.F.SG+IMPF+3+PL
desenrolhavam-nas	desenrolhar+V.ele.ACC.3.F.PL+IMPF+3+PL
desenrolhavam-no	desenrolhar+V.ele.ACC.3.M.SG+IMPF+3+PL
desenrolhavam-nos	desenrolhar+V.ele.ACC.3.M.PL+IMPF+3+PL
desenrolhavam-nos	desenrolhar+V.nós.AD.1.PL+IMPF+3+PL
desenrolhávamo-la	desenrolhar+V.ele.ACC.3.F.SG+IMPF+1+PL
desenrolhávamo-las	desenrolhar+V.ele.ACC.3.F.PL+IMPF+1+PL
desenrolhávamo-lo	desenrolhar+V.ele.ACC.3.M.SG+IMPF+1+PL
desenrolhávamo-los	desenrolhar+V.ele.ACC.3.M.PL+IMPF+1+PL
desenrolhávamo-nos	desenrolhar+nós.AD.1.PL+IMPF+1+PL
desenrolhávamos-lhe	desenrolhar+V.ele.DAT.3.SG+IMPF+1+PL
desenrolhávamos-lhes	desenrolhar+V.ele.DAT.3.PL+IMPF+1+PL
desenrolhávamos-me	desenrolhar+V.eu.AD.1.SG+IMPF+1+PL
desenrolhávamos-te	desenrolhar+V.tu.AD.2.SG+IMPF+1+PL
desenrolhávamos-vos	desenrolhar+V.vós.AD.2.PL+IMPF+1+PL
desenrolhavam-se	desenrolhar+V.ele.REFL+IMPF+3+PL
desenrolhavam-te	desenrolhar+V.tu.AD.2.SG+IMPF+3+PL
desenrolhavam-vos	desenrolhar+V.vós.AD.2.PL+IMPF+3+PL
desenrolhava-nos	desenrolhar+nós.AD.1.PL+IMPF+1+SG
desenrolhava-nos	desenrolhar+nós.AD.1.PL+IMPF+2+SG
desenrolhava-nos	desenrolhar+nós.AD.1.PL+IMPF+3+SG
desenrolhava-o	desenrolhar+V.ele.ACC.3.M.SG+IMPF+1+SG
desenrolhava-o	desenrolhar+V.ele.ACC.3.M.SG+IMPF+3+SG
desenrolhava-os	desenrolhar+V.ele.ACC.3.M.PL+IMPF+1+SG
desenrolhava-os	desenrolhar+V.ele.ACC.3.M.PL+IMPF+3+SG
desenrolhava-se	desenrolhar+V.ele.REFL+IMPF+1+SG
desenrolhava-se	desenrolhar+V.ele.REFL+IMPF+3+SG
desenrolhavas-lhe	desenrolhar+V.ele.DAT.3.SG+IMPF+2+SG
desenrolhavas-lhes	desenrolhar+V.ele.DAT.3.PL+IMPF+2+SG
desenrolhavas-me	desenrolhar+V.eu.AD.1.SG+IMPF+2+SG
desenrolhavas-te	desenrolhar+V.tu.AD.2.SG+IMPF+2+SG
desenrolhavas-vos	desenrolhar+V.vós.AD.2.PL+IMPF+2+SG
desenrolhava-te	desenrolhar+V.tu.AD.2.SG+IMPF+1+SG
desenrolhava-te	desenrolhar+V.tu.AD.2.SG+IMPF+3+SG
desenrolhava-vos	desenrolhar+V.vós.AD.2.PL+IMPF+1+SG
desenrolhava-vos	desenrolhar+V.vós.AD.2.PL+IMPF+3+SG
desenrolhávei-la	desenrolhar+V.ele.ACC.3.F.SG+IMPF+2+PL
desenrolhávei-las	desenrolhar+V.ele.ACC.3.F.PL+IMPF+2+PL
desenrolhávei-lo	desenrolhar+V.ele.ACC.3.M.SG+IMPF+2+PL
desenrolhávei-los	desenrolhar+V.ele.ACC.3.M.PL+IMPF+2+PL
desenrolhávei-nos	desenrolhar+nós.AD.1.PL+IMPF+2+PL
desenrolháveis-lhe	desenrolhar+V.ele.DAT.3.SG+IMPF+2+PL
desenrolháveis-lhes	desenrolhar+V.ele.DAT.3.PL+IMPF+2+PL
desenrolháveis-me	desenrolhar+V.eu.AD.1.SG+IMPF+2+PL
desenrolháveis-te	desenrolhar+V.tu.AD.2.SG+IMPF+2+PL
desenrolháveis-vos	desenrolhar+V.vós.AD.2.PL+IMPF+2+PL
desenrolha-vos	desenrolhar+V.vós.AD.2.PL+PRS+3+SG
desenrolhe-a	desenrolhar+V.ele.ACC.3.F.SG+IMP+3+SG
desenrolhe-as	desenrolhar+V.ele.ACC.3.F.PL+IMP+3+SG
desenrolhei-a	desenrolhar+V.ele.ACC.3.F.SG+PRF+1+SG
desenrolhei-as	desenrolhar+V.ele.ACC.3.F.PL+PRF+1+SG
desenrolhei-lhe	desenrolhar+V.ele.DAT.3.SG+PRF+1+SG
desenrolhei-lhes	desenrolhar+V.ele.DAT.3.PL+PRF+1+SG
desenrolhei-me	desenrolhar+V.eu.AD.1.SG+PRF+1+SG
desenrolhei-nos	desenrolhar+nós.AD.1.PL+PRF+1+SG
desenrolhei-o	desenrolhar+V.ele.ACC.3.M.SG+PRF+1+SG
desenrolhei-os	desenrolhar+V.ele.ACC.3.M.PL+PRF+1+SG
desenrolhei-te	desenrolhar+V.tu.AD.2.SG+PRF+1+SG
desenrolhei-vos	desenrolhar+V.vós.AD.2.PL+PRF+1+SG
desenrolhe-lhe	desenrolhar+V.ele.DAT.3.SG+IMP+3+SG
desenrolhe-lhes	desenrolhar+V.ele.DAT.3.PL+IMP+3+SG
desenrolhe-me	desenrolhar+V.eu.AD.1.SG+IMP+3+SG
desenrolhem-lhe	desenrolhar+V.ele.DAT.3.SG+IMP+3+PL
desenrolhem-lhes	desenrolhar+V.ele.DAT.3.PL+IMP+3+PL
desenrolhem-me	desenrolhar+V.eu.AD.1.SG+IMP+3+PL
desenrolhem-na	desenrolhar+V.ele.ACC.3.F.SG+IMP+3+PL
desenrolhem-nas	desenrolhar+V.ele.ACC.3.F.PL+IMP+3+PL
desenrolhem-no	desenrolhar+V.ele.ACC.3.M.SG+IMP+3+PL
desenrolhem-nos	desenrolhar+V.ele.ACC.3.M.PL+IMP+3+PL
desenrolhem-nos	desenrolhar+V.nós.AD.1.PL+IMP+3+PL
desenrolhemo-la	desenrolhar+V.ele.ACC.3.F.SG+IMP+1+PL
desenrolhemo-las	desenrolhar+V.ele.ACC.3.F.PL+IMP+1+PL
desenrolhemo-lo	desenrolhar+V.ele.ACC.3.M.SG+IMP+1+PL
desenrolhemo-los	desenrolhar+V.ele.ACC.3.M.PL+IMP+1+PL
desenrolhemo-nos	desenrolhar+nós.AD.1.PL+IMP+1+PL
desenrolhemos-lhe	desenrolhar+V.ele.DAT.3.SG+IMP+1+PL
desenrolhemos-lhes	desenrolhar+V.ele.DAT.3.PL+IMP+1+PL
desenrolhemos-me	desenrolhar+V.eu.AD.1.SG+IMP+1+PL
desenrolhemos-te	desenrolhar+V.tu.AD.2.SG+IMP+1+PL
desenrolhemos-vos	desenrolhar+V.vós.AD.2.PL+IMP+1+PL
desenrolhem-se	desenrolhar+V.ele.REFL+IMP+3+PL
desenrolhem-te	desenrolhar+V.tu.AD.2.SG+IMP+3+PL
desenrolhem-vos	desenrolhar+V.vós.AD.2.PL+IMP+3+PL
desenrolhe-nos	desenrolhar+nós.AD.1.PL+IMP+3+SG
desenrolhe-o	desenrolhar+V.ele.ACC.3.M.SG+IMP+3+SG
desenrolhe-os	desenrolhar+V.ele.ACC.3.M.PL+IMP+3+SG
desenrolhe-se	desenrolhar+V.ele.REFL+IMP+3+SG
desenrolhe-te	desenrolhar+V.tu.AD.2.SG+IMP+3+SG
desenrolhe-vos	desenrolhar+V.vós.AD.2.PL+IMP+3+SG
desenrolho-a	desenrolhar+V.ele.ACC.3.F.SG+PRS+1+SG
desenrolho-as	desenrolhar+V.ele.ACC.3.F.PL+PRS+1+SG
desenrolho-lhe	desenrolhar+V.ele.DAT.3.SG+PRS+1+SG
desenrolho-lhes	desenrolhar+V.ele.DAT.3.PL+PRS+1+SG
desenrolho-me	desenrolhar+V.eu.AD.1.SG+PRS+1+SG
desenrolho-nos	desenrolhar+nós.AD.1.PL+PRS+1+SG
desenrolho-o	desenrolhar+V.ele.ACC.3.M.SG+PRS+1+SG
desenrolho-os	desenrolhar+V.ele.ACC.3.M.PL+PRS+1+SG
desenrolho-te	desenrolhar+V.tu.AD.2.SG+PRS+1+SG
desenrolhou-a	desenrolhar+V.ele.ACC.3.F.SG+PRF+3+SG
desenrolhou-as	desenrolhar+V.ele.ACC.3.F.PL+PRF+3+SG
desenrolhou-lhe	desenrolhar+V.ele.DAT.3.SG+PRF+3+SG
desenrolhou-lhes	desenrolhar+V.ele.DAT.3.PL+PRF+3+SG
desenrolhou-me	desenrolhar+V.eu.AD.1.SG+PRF+3+SG
desenrolhou-nos	desenrolhar+nós.AD.1.PL+PRF+3+SG
desenrolhou-o	desenrolhar+V.ele.ACC.3.M.SG+PRF+3+SG
desenrolhou-os	desenrolhar+V.ele.ACC.3.M.PL+PRF+3+SG
desenrolhou-se	desenrolhar+V.ele.REFL+PRF+3+SG
desenrolhou-te	desenrolhar+V.tu.AD.2.SG+PRF+3+SG
desenrolhou-vos	desenrolhar+V.vós.AD.2.PL+PRF+3+SG
desenrolho-vos	desenrolhar+V.vós.AD.2.PL+PRS+1+SG
desenrolo-a	desenrolar+V.ele.ACC.3.F.SG+PRS+1+SG
desenrolo-as	desenrolar+V.ele.ACC.3.F.PL+PRS+1+SG
desenrolo-lhe	desenrolar+V.ele.DAT.3.SG+PRS+1+SG
desenrolo-lhes	desenrolar+V.ele.DAT.3.PL+PRS+1+SG
desenrolo-me	desenrolar+V.eu.AD.1.SG+PRS+1+SG
desenrolo-nos	desenrolar+nós.AD.1.PL+PRS+1+SG
desenrolo-o	desenrolar+V.ele.ACC.3.M.SG+PRS+1+SG
desenrolo-os	desenrolar+V.ele.ACC.3.M.PL+PRS+1+SG
desenrolo-te	desenrolar+V.tu.AD.2.SG+PRS+1+SG
desenrolou-a	desenrolar+V.ele.ACC.3.F.SG+PRF+3+SG
desenrolou-as	desenrolar+V.ele.ACC.3.F.PL+PRF+3+SG
desenrolou-lhe	desenrolar+V.ele.DAT.3.SG+PRF+3+SG
desenrolou-lhes	desenrolar+V.ele.DAT.3.PL+PRF+3+SG
desenrolou-me	desenrolar+V.eu.AD.1.SG+PRF+3+SG
desenrolou-nos	desenrolar+nós.AD.1.PL+PRF+3+SG
desenrolou-o	desenrolar+V.ele.ACC.3.M.SG+PRF+3+SG
desenrolou-os	desenrolar+V.ele.ACC.3.M.PL+PRF+3+SG
desenrolou-se	desenrolar+V.ele.REFL+PRF+3+SG
desenrolou-te	desenrolar+V.tu.AD.2.SG+PRF+3+SG
desenrolou-vos	desenrolar+V.vós.AD.2.PL+PRF+3+SG
desenrolo-vos	desenrolar+V.vós.AD.2.PL+PRS+1+SG
desenrosca-a	desenroscar+V.ele.ACC.3.F.SG+PRS+3+SG
desenrosca-as	desenroscar+V.ele.ACC.3.F.PL+PRS+3+SG
desenroscai-la	desenroscar+V.ele.ACC.3.F.SG+PRS+2+PL
desenroscai-las	desenroscar+V.ele.ACC.3.F.PL+PRS+2+PL
desenroscai-lo	desenroscar+V.ele.ACC.3.M.SG+PRS+2+PL
desenroscai-los	desenroscar+V.ele.ACC.3.M.PL+PRS+2+PL
desenroscai-nos	desenroscar+nós.AD.1.PL+PRS+2+PL
desenroscais-lhe	desenroscar+V.ele.DAT.3.SG+PRS+2+PL
desenroscais-lhes	desenroscar+V.ele.DAT.3.PL+PRS+2+PL
desenroscais-me	desenroscar+V.eu.AD.1.SG+PRS+2+PL
desenroscais-te	desenroscar+V.tu.AD.2.SG+PRS+2+PL
desenroscais-vos	desenroscar+V.vós.AD.2.PL+PRS+2+PL
desenroscá-la-á	desenroscar+V.ele.ACC.3.F.SG+FUT+3+SG
desenroscá-la-ão	desenroscar+V.ele.ACC.3.F.SG+FUT+3+PL
desenroscá-la-ás	desenroscar+V.ele.ACC.3.F.SG+FUT+2+SG
desenroscá-la	desenroscar+V.ele.ACC.3.F.SG+INF+1+SG
desenroscá-la	desenroscar+V.ele.ACC.3.F.SG+INF+3+SG
desenrosca-la	desenroscar+V.ele.ACC.3.F.SG+PRS+2+SG
desenroscá-la	desenroscar+V.ele.ACC.3.F.SG+SBJF+1+SG
desenroscá-la	desenroscar+V.ele.ACC.3.F.SG+SBJF+3+SG
desenroscá-la-ei	desenroscar+V.ele.ACC.3.F.SG+FUT+1+SG
desenroscá-la-eis	desenroscar+V.ele.ACC.3.F.SG+FUT+2+PL
desenroscá-la-emos	desenroscar+V.ele.ACC.3.F.SG+FUT+1+PL
desenroscá-la-ia	desenroscar+V.ele.ACC.3.F.SG+COND+1+SG
desenroscá-la-ia	desenroscar+V.ele.ACC.3.F.SG+COND+3+SG
desenroscá-la-iam	desenroscar+V.ele.ACC.3.F.SG+COND+3+PL
desenroscá-la-íamos	desenroscar+V.ele.ACC.3.F.SG+COND+1+PL
desenroscá-la-ias	desenroscar+V.ele.ACC.3.F.SG+COND+2+SG
desenroscá-la-íeis	desenroscar+V.ele.ACC.3.F.SG+COND+2+PL
desenroscá-las-á	desenroscar+V.ele.ACC.3.F.PL+FUT+3+SG
desenroscá-las-ão	desenroscar+V.ele.ACC.3.F.PL+FUT+3+PL
desenroscá-las-ás	desenroscar+V.ele.ACC.3.F.PL+FUT+2+SG
desenroscá-las	desenroscar+V.ele.ACC.3.F.PL+INF+1+SG
desenroscá-las	desenroscar+V.ele.ACC.3.F.PL+INF+3+SG
desenrosca-las	desenroscar+V.ele.ACC.3.F.PL+PRS+2+SG
desenroscá-las	desenroscar+V.ele.ACC.3.F.PL+SBJF+1+SG
desenroscá-las	desenroscar+V.ele.ACC.3.F.PL+SBJF+3+SG
desenroscá-las-ei	desenroscar+V.ele.ACC.3.F.PL+FUT+1+SG
desenroscá-las-eis	desenroscar+V.ele.ACC.3.F.PL+FUT+2+PL
desenroscá-las-emos	desenroscar+V.ele.ACC.3.F.PL+FUT+1+PL
desenroscá-las-ia	desenroscar+V.ele.ACC.3.F.PL+COND+1+SG
desenroscá-las-ia	desenroscar+V.ele.ACC.3.F.PL+COND+3+SG
desenroscá-las-iam	desenroscar+V.ele.ACC.3.F.PL+COND+3+PL
desenroscá-las-íamos	desenroscar+V.ele.ACC.3.F.PL+COND+1+PL
desenroscá-las-ias	desenroscar+V.ele.ACC.3.F.PL+COND+2+SG
desenroscá-las-íeis	desenroscar+V.ele.ACC.3.F.PL+COND+2+PL
desenrosca-lhe	desenroscar+V.ele.DAT.3.SG+PRS+3+SG
desenrosca-lhes	desenroscar+V.ele.DAT.3.PL+PRS+3+SG
desenroscá-lo-á	desenroscar+V.ele.ACC.3.M.SG+FUT+3+SG
desenroscá-lo-ão	desenroscar+V.ele.ACC.3.M.SG+FUT+3+PL
desenroscá-lo-ás	desenroscar+V.ele.ACC.3.M.SG+FUT+2+SG
desenroscá-lo	desenroscar+V.ele.ACC.3.M.SG+INF+1+SG
desenroscá-lo	desenroscar+V.ele.ACC.3.M.SG+INF+3+SG
desenrosca-lo	desenroscar+V.ele.ACC.3.M.SG+PRS+2+SG
desenroscá-lo	desenroscar+V.ele.ACC.3.M.SG+SBJF+1+SG
desenroscá-lo	desenroscar+V.ele.ACC.3.M.SG+SBJF+3+SG
desenroscá-lo-ei	desenroscar+V.ele.ACC.3.M.SG+FUT+1+SG
desenroscá-lo-eis	desenroscar+V.ele.ACC.3.M.SG+FUT+2+PL
desenroscá-lo-emos	desenroscar+V.ele.ACC.3.M.SG+FUT+1+PL
desenroscá-lo-ia	desenroscar+V.ele.ACC.3.M.SG+COND+1+SG
desenroscá-lo-ia	desenroscar+V.ele.ACC.3.M.SG+COND+3+SG
desenroscá-lo-iam	desenroscar+V.ele.ACC.3.M.SG+COND+3+PL
desenroscá-lo-íamos	desenroscar+V.ele.ACC.3.M.SG+COND+1+PL
desenroscá-lo-ias	desenroscar+V.ele.ACC.3.M.SG+COND+2+SG
desenroscá-lo-íeis	desenroscar+V.ele.ACC.3.M.SG+COND+2+PL
desenroscá-los-á	desenroscar+V.ele.ACC.3.M.PL+FUT+3+SG
desenroscá-los-ão	desenroscar+V.ele.ACC.3.M.PL+FUT+3+PL
desenroscá-los-ás	desenroscar+V.ele.ACC.3.M.PL+FUT+2+SG
desenroscá-los	desenroscar+V.ele.ACC.3.M.PL+INF+1+SG
desenroscá-los	desenroscar+V.ele.ACC.3.M.PL+INF+3+SG
desenrosca-los	desenroscar+V.ele.ACC.3.M.PL+PRS+2+SG
desenroscá-los	desenroscar+V.ele.ACC.3.M.PL+SBJF+1+SG
desenroscá-los	desenroscar+V.ele.ACC.3.M.PL+SBJF+3+SG
desenroscá-los-ei	desenroscar+V.ele.ACC.3.M.PL+FUT+1+SG
desenroscá-los-eis	desenroscar+V.ele.ACC.3.M.PL+FUT+2+PL
desenroscá-los-emos	desenroscar+V.ele.ACC.3.M.PL+FUT+1+PL
desenroscá-los-ia	desenroscar+V.ele.ACC.3.M.PL+COND+1+SG
desenroscá-los-ia	desenroscar+V.ele.ACC.3.M.PL+COND+3+SG
desenroscá-los-iam	desenroscar+V.ele.ACC.3.M.PL+COND+3+PL
desenroscá-los-íamos	desenroscar+V.ele.ACC.3.M.PL+COND+1+PL
desenroscá-los-ias	desenroscar+V.ele.ACC.3.M.PL+COND+2+SG
desenroscá-los-íeis	desenroscar+V.ele.ACC.3.M.PL+COND+2+PL
desenrosca-me	desenroscar+V.eu.AD.1.SG+PRS+3+SG
desenroscam-lhe	desenroscar+V.ele.DAT.3.SG+PRS+3+PL
desenroscam-lhes	desenroscar+V.ele.DAT.3.PL+PRS+3+PL
desenroscam-me	desenroscar+V.eu.AD.1.SG+PRS+3+PL
desenroscam-na	desenroscar+V.ele.ACC.3.F.SG+PRS+3+PL
desenroscam-nas	desenroscar+V.ele.ACC.3.F.PL+PRS+3+PL
desenroscam-no	desenroscar+V.ele.ACC.3.M.SG+PRS+3+PL
desenroscam-nos	desenroscar+V.ele.ACC.3.M.PL+PRS+3+PL
desenroscam-nos	desenroscar+V.nós.AD.1.PL+PRS+3+PL
desenroscamo-la	desenroscar+V.ele.ACC.3.F.SG+PRF+1+PL
desenroscamo-la	desenroscar+V.ele.ACC.3.F.SG+PRS+1+PL
desenroscamo-las	desenroscar+V.ele.ACC.3.F.PL+PRF+1+PL
desenroscamo-las	desenroscar+V.ele.ACC.3.F.PL+PRS+1+PL
desenroscamo-lo	desenroscar+V.ele.ACC.3.M.SG+PRF+1+PL
desenroscamo-lo	desenroscar+V.ele.ACC.3.M.SG+PRS+1+PL
desenroscamo-los	desenroscar+V.ele.ACC.3.M.PL+PRF+1+PL
desenroscamo-los	desenroscar+V.ele.ACC.3.M.PL+PRS+1+PL
desenroscamo-nos	desenroscar+nós.AD.1.PL+PRF+1+PL
desenroscamo-nos	desenroscar+nós.AD.1.PL+PRS+1+PL
desenroscamos-lhe	desenroscar+V.ele.DAT.3.SG+PRF+1+PL
desenroscamos-lhe	desenroscar+V.ele.DAT.3.SG+PRS+1+PL
desenroscamos-lhes	desenroscar+V.ele.DAT.3.PL+PRF+1+PL
desenroscamos-lhes	desenroscar+V.ele.DAT.3.PL+PRS+1+PL
desenroscamos-me	desenroscar+V.eu.AD.1.SG+PRF+1+PL
desenroscamos-me	desenroscar+V.eu.AD.1.SG+PRS+1+PL
desenroscamos-te	desenroscar+V.tu.AD.2.SG+PRF+1+PL
desenroscamos-te	desenroscar+V.tu.AD.2.SG+PRS+1+PL
desenroscamos-vos	desenroscar+V.vós.AD.2.PL+PRF+1+PL
desenroscamos-vos	desenroscar+V.vós.AD.2.PL+PRS+1+PL
desenroscam-se	desenroscar+V.ele.REFL+PRS+3+PL
desenroscam-te	desenroscar+V.tu.AD.2.SG+PRS+3+PL
desenroscam-vos	desenroscar+V.vós.AD.2.PL+PRS+3+PL
desenroscando-a	desenroscar+V.ele.ACC.3.F.SG+GRD
desenroscando-as	desenroscar+V.ele.ACC.3.F.PL+GRD
desenroscando-lhe	desenroscar+V.ele.DAT.3.SG+GRD
desenroscando-lhes	desenroscar+V.ele.DAT.3.PL+GRD
desenroscando-me	desenroscar+V.eu.AD.1.SG+GRD
desenroscando-nos	desenroscar+nós.AD.1.PL+GRD
desenroscando-o	desenroscar+V.ele.ACC.3.M.SG+GRD
desenroscando-os	desenroscar+V.ele.ACC.3.M.PL+GRD
desenroscando-se	desenroscar+V.ele.REFL+GRD
desenroscando-te	desenroscar+V.tu.AD.2.SG+GRD
desenroscando-vos	desenroscar+V.vós.AD.2.PL+GRD
desenrosca-nos	desenroscar+nós.AD.1.PL+PRS+2+SG
desenrosca-nos	desenroscar+nós.AD.1.PL+PRS+3+SG
desenrosca-o	desenroscar+V.ele.ACC.3.M.SG+PRS+3+SG
desenrosca-os	desenroscar+V.ele.ACC.3.M.PL+PRS+3+SG
desenroscara-a	desenroscar+V.ele.ACC.3.F.SG+PQP+1+SG
desenroscara-a	desenroscar+V.ele.ACC.3.F.SG+PQP+3+SG
desenroscara-as	desenroscar+V.ele.ACC.3.F.PL+PQP+1+SG
desenroscara-as	desenroscar+V.ele.ACC.3.F.PL+PQP+3+SG
desenroscara-la	desenroscar+V.ele.ACC.3.F.SG+PQP+2+SG
desenroscara-las	desenroscar+V.ele.ACC.3.F.PL+PQP+2+SG
desenroscara-lhe	desenroscar+V.ele.DAT.3.SG+PQP+1+SG
desenroscara-lhe	desenroscar+V.ele.DAT.3.SG+PQP+3+SG
desenroscara-lhes	desenroscar+V.ele.DAT.3.PL+PQP+1+SG
desenroscara-lhes	desenroscar+V.ele.DAT.3.PL+PQP+3+SG
desenroscara-lo	desenroscar+V.ele.ACC.3.M.SG+PQP+2+SG
desenroscara-los	desenroscar+V.ele.ACC.3.M.PL+PQP+2+SG
desenroscara-me	desenroscar+V.eu.AD.1.SG+PQP+1+SG
desenroscara-me	desenroscar+V.eu.AD.1.SG+PQP+3+SG
desenroscaram-lhe	desenroscar+V.ele.DAT.3.SG+PQP+3+PL
desenroscaram-lhe	desenroscar+V.ele.DAT.3.SG+PRF+3+PL
desenroscaram-lhes	desenroscar+V.ele.DAT.3.PL+PQP+3+PL
desenroscaram-lhes	desenroscar+V.ele.DAT.3.PL+PRF+3+PL
desenroscaram-me	desenroscar+V.eu.AD.1.SG+PQP+3+PL
desenroscaram-me	desenroscar+V.eu.AD.1.SG+PRF+3+PL
desenroscaram-na	desenroscar+V.ele.ACC.3.F.SG+PQP+3+PL
desenroscaram-na	desenroscar+V.ele.ACC.3.F.SG+PRF+3+PL
desenroscaram-nas	desenroscar+V.ele.ACC.3.F.PL+PQP+3+PL
desenroscaram-nas	desenroscar+V.ele.ACC.3.F.PL+PRF+3+PL
desenroscaram-no	desenroscar+V.ele.ACC.3.M.SG+PQP+3+PL
desenroscaram-no	desenroscar+V.ele.ACC.3.M.SG+PRF+3+PL
desenroscaram-nos	desenroscar+V.ele.ACC.3.M.PL+PQP+3+PL
desenroscaram-nos	desenroscar+V.ele.ACC.3.M.PL+PRF+3+PL
desenroscaram-nos	desenroscar+V.nós.AD.1.PL+PQP+3+PL
desenroscaram-nos	desenroscar+V.nós.AD.1.PL+PRF+3+PL
desenroscáramo-la	desenroscar+V.ele.ACC.3.F.SG+PQP+1+PL
desenroscáramo-las	desenroscar+V.ele.ACC.3.F.PL+PQP+1+PL
desenroscáramo-lo	desenroscar+V.ele.ACC.3.M.SG+PQP+1+PL
desenroscáramo-los	desenroscar+V.ele.ACC.3.M.PL+PQP+1+PL
desenroscáramo-nos	desenroscar+nós.AD.1.PL+PQP+1+PL
desenroscáramos-lhe	desenroscar+V.ele.DAT.3.SG+PQP+1+PL
desenroscáramos-lhes	desenroscar+V.ele.DAT.3.PL+PQP+1+PL
desenroscáramos-me	desenroscar+V.eu.AD.1.SG+PQP+1+PL
desenroscáramos-te	desenroscar+V.tu.AD.2.SG+PQP+1+PL
desenroscáramos-vos	desenroscar+V.vós.AD.2.PL+PQP+1+PL
desenroscaram-se	desenroscar+V.ele.REFL+PQP+3+PL
desenroscaram-se	desenroscar+V.ele.REFL+PRF+3+PL
desenroscaram-te	desenroscar+V.tu.AD.2.SG+PQP+3+PL
desenroscaram-te	desenroscar+V.tu.AD.2.SG+PRF+3+PL
desenroscaram-vos	desenroscar+V.vós.AD.2.PL+PQP+3+PL
desenroscaram-vos	desenroscar+V.vós.AD.2.PL+PRF+3+PL
desenroscara-nos	desenroscar+nós.AD.1.PL+PQP+1+SG
desenroscara-nos	desenroscar+nós.AD.1.PL+PQP+2+SG
desenroscara-nos	desenroscar+nós.AD.1.PL+PQP+3+SG
desenroscara-o	desenroscar+V.ele.ACC.3.M.SG+PQP+1+SG
desenroscara-o	desenroscar+V.ele.ACC.3.M.SG+PQP+3+SG
desenroscara-os	desenroscar+V.ele.ACC.3.M.PL+PQP+1+SG
desenroscara-os	desenroscar+V.ele.ACC.3.M.PL+PQP+3+SG
desenroscara-se	desenroscar+V.ele.REFL+PQP+1+SG
desenroscara-se	desenroscar+V.ele.REFL+PQP+3+SG
desenroscaras-lhe	desenroscar+V.ele.DAT.3.SG+PQP+2+SG
desenroscaras-lhes	desenroscar+V.ele.DAT.3.PL+PQP+2+SG
desenroscaras-me	desenroscar+V.eu.AD.1.SG+PQP+2+SG
desenroscaras-te	desenroscar+V.tu.AD.2.SG+PQP+2+SG
desenroscaras-vos	desenroscar+V.vós.AD.2.PL+PQP+2+SG
desenroscara-te	desenroscar+V.tu.AD.2.SG+PQP+1+SG
desenroscara-te	desenroscar+V.tu.AD.2.SG+PQP+3+SG
desenroscara-vos	desenroscar+V.vós.AD.2.PL+PQP+1+SG
desenroscara-vos	desenroscar+V.vós.AD.2.PL+PQP+3+SG
desenroscarde-la	desenroscar+V.ele.ACC.3.F.SG+INF+2+PL
desenroscarde-la	desenroscar+V.ele.ACC.3.F.SG+SBJF+2+PL
desenroscarde-las	desenroscar+V.ele.ACC.3.F.PL+INF+2+PL
desenroscarde-las	desenroscar+V.ele.ACC.3.F.PL+SBJF+2+PL
desenroscarde-lo	desenroscar+V.ele.ACC.3.M.SG+INF+2+PL
desenroscarde-lo	desenroscar+V.ele.ACC.3.M.SG+SBJF+2+PL
desenroscarde-los	desenroscar+V.ele.ACC.3.M.PL+INF+2+PL
desenroscarde-los	desenroscar+V.ele.ACC.3.M.PL+SBJF+2+PL
desenroscarde-nos	desenroscar+nós.AD.1.PL+INF+2+PL
desenroscarde-nos	desenroscar+nós.AD.1.PL+SBJF+2+PL
desenroscardes-lhe	desenroscar+V.ele.DAT.3.SG+INF+2+PL
desenroscardes-lhe	desenroscar+V.ele.DAT.3.SG+SBJF+2+PL
desenroscardes-lhes	desenroscar+V.ele.DAT.3.PL+INF+2+PL
desenroscardes-lhes	desenroscar+V.ele.DAT.3.PL+SBJF+2+PL
desenroscardes-me	desenroscar+V.eu.AD.1.SG+INF+2+PL
desenroscardes-me	desenroscar+V.eu.AD.1.SG+SBJF+2+PL
desenroscardes-te	desenroscar+V.tu.AD.2.SG+INF+2+PL
desenroscardes-te	desenroscar+V.tu.AD.2.SG+SBJF+2+PL
desenroscardes-vos	desenroscar+V.vós.AD.2.PL+INF+2+PL
desenroscardes-vos	desenroscar+V.vós.AD.2.PL+SBJF+2+PL
desenroscárei-la	desenroscar+V.ele.ACC.3.F.SG+PQP+2+PL
desenroscárei-las	desenroscar+V.ele.ACC.3.F.PL+PQP+2+PL
desenroscárei-lo	desenroscar+V.ele.ACC.3.M.SG+PQP+2+PL
desenroscárei-los	desenroscar+V.ele.ACC.3.M.PL+PQP+2+PL
desenroscárei-nos	desenroscar+nós.AD.1.PL+PQP+2+PL
desenroscáreis-lhe	desenroscar+V.ele.DAT.3.SG+PQP+2+PL
desenroscáreis-lhes	desenroscar+V.ele.DAT.3.PL+PQP+2+PL
desenroscáreis-me	desenroscar+V.eu.AD.1.SG+PQP+2+PL
desenroscáreis-te	desenroscar+V.tu.AD.2.SG+PQP+2+PL
desenroscáreis-vos	desenroscar+V.vós.AD.2.PL+PQP+2+PL
desenroscare-la	desenroscar+V.ele.ACC.3.F.SG+INF+2+SG
desenroscare-la	desenroscar+V.ele.ACC.3.F.SG+SBJF+2+SG
desenroscare-las	desenroscar+V.ele.ACC.3.F.PL+INF+2+SG
desenroscare-las	desenroscar+V.ele.ACC.3.F.PL+SBJF+2+SG
desenroscare-lo	desenroscar+V.ele.ACC.3.M.SG+INF+2+SG
desenroscare-lo	desenroscar+V.ele.ACC.3.M.SG+SBJF+2+SG
desenroscare-los	desenroscar+V.ele.ACC.3.M.PL+INF+2+SG
desenroscare-los	desenroscar+V.ele.ACC.3.M.PL+SBJF+2+SG
desenroscarem-lhe	desenroscar+V.ele.DAT.3.SG+INF+3+PL
desenroscarem-lhe	desenroscar+V.ele.DAT.3.SG+SBJF+3+PL
desenroscarem-lhes	desenroscar+V.ele.DAT.3.PL+INF+3+PL
desenroscarem-lhes	desenroscar+V.ele.DAT.3.PL+SBJF+3+PL
desenroscarem-me	desenroscar+V.eu.AD.1.SG+INF+3+PL
desenroscarem-me	desenroscar+V.eu.AD.1.SG+SBJF+3+PL
desenroscarem-na	desenroscar+V.ele.ACC.3.F.SG+INF+3+PL
desenroscarem-na	desenroscar+V.ele.ACC.3.F.SG+SBJF+3+PL
desenroscarem-nas	desenroscar+V.ele.ACC.3.F.PL+INF+3+PL
desenroscarem-nas	desenroscar+V.ele.ACC.3.F.PL+SBJF+3+PL
desenroscarem-no	desenroscar+V.ele.ACC.3.M.SG+INF+3+PL
desenroscarem-no	desenroscar+V.ele.ACC.3.M.SG+SBJF+3+PL
desenroscarem-nos	desenroscar+V.ele.ACC.3.M.PL+INF+3+PL
desenroscarem-nos	desenroscar+V.ele.ACC.3.M.PL+SBJF+3+PL
desenroscarem-nos	desenroscar+V.nós.AD.1.PL+INF+3+PL
desenroscarem-nos	desenroscar+V.nós.AD.1.PL+SBJF+3+PL
desenroscarem-se	desenroscar+V.ele.REFL+INF+3+PL
desenroscarem-se	desenroscar+V.ele.REFL+SBJF+3+PL
desenroscarem-te	desenroscar+V.tu.AD.2.SG+INF+3+PL
desenroscarem-te	desenroscar+V.tu.AD.2.SG+SBJF+3+PL
desenroscarem-vos	desenroscar+V.vós.AD.2.PL+INF+3+PL
desenroscarem-vos	desenroscar+V.vós.AD.2.PL+SBJF+3+PL
desenroscare-nos	desenroscar+nós.AD.1.PL+INF+2+SG
desenroscare-nos	desenroscar+nós.AD.1.PL+SBJF+2+SG
desenroscares-lhe	desenroscar+V.ele.DAT.3.SG+INF+2+SG
desenroscares-lhe	desenroscar+V.ele.DAT.3.SG+SBJF+2+SG
desenroscares-lhes	desenroscar+V.ele.DAT.3.PL+INF+2+SG
desenroscares-lhes	desenroscar+V.ele.DAT.3.PL+SBJF+2+SG
desenroscares-me	desenroscar+V.eu.AD.1.SG+INF+2+SG
desenroscares-me	desenroscar+V.eu.AD.1.SG+SBJF+2+SG
desenroscares-te	desenroscar+V.tu.AD.2.SG+INF+2+SG
desenroscares-te	desenroscar+V.tu.AD.2.SG+SBJF+2+SG
desenroscares-vos	desenroscar+V.vós.AD.2.PL+INF+2+SG
desenroscares-vos	desenroscar+V.vós.AD.2.PL+SBJF+2+SG
desenroscar-lhe-á	desenroscar+V.ele.DAT.3.SG+FUT+3+SG
desenroscar-lhe-ão	desenroscar+V.ele.DAT.3.SG+FUT+3+PL
desenroscar-lhe-ás	desenroscar+V.ele.DAT.3.SG+FUT+2+SG
desenroscar-lhe	desenroscar+V.ele.DAT.3.SG+INF
desenroscar-lhe	desenroscar+V.ele.DAT.3.SG+INF+1+SG
desenroscar-lhe	desenroscar+V.ele.DAT.3.SG+INF+3+SG
desenroscar-lhe	desenroscar+V.ele.DAT.3.SG+SBJF+1+SG
desenroscar-lhe	desenroscar+V.ele.DAT.3.SG+SBJF+3+SG
desenroscar-lhe-ei	desenroscar+V.ele.DAT.3.SG+FUT+1+SG
desenroscar-lhe-eis	desenroscar+V.ele.DAT.3.SG+FUT+2+PL
desenroscar-lhe-emos	desenroscar+V.ele.DAT.3.SG+FUT+1+PL
desenroscar-lhe-ia	desenroscar+V.ele.DAT.3.SG+COND+1+SG
desenroscar-lhe-ia	desenroscar+V.ele.DAT.3.SG+COND+3+SG
desenroscar-lhe-iam	desenroscar+V.ele.DAT.3.SG+COND+3+PL
desenroscar-lhe-íamos	desenroscar+V.ele.DAT.3.SG+COND+1+PL
desenroscar-lhe-ias	desenroscar+V.ele.DAT.3.SG+COND+2+SG
desenroscar-lhe-íeis	desenroscar+V.ele.DAT.3.SG+COND+2+PL
desenroscar-lhes-á	desenroscar+V.ele.DAT.3.PL+FUT+3+SG
desenroscar-lhes-ão	desenroscar+V.ele.DAT.3.PL+FUT+3+PL
desenroscar-lhes-ás	desenroscar+V.ele.DAT.3.PL+FUT+2+SG
desenroscar-lhes	desenroscar+V.ele.DAT.3.PL+INF
desenroscar-lhes	desenroscar+V.ele.DAT.3.PL+INF+1+SG
desenroscar-lhes	desenroscar+V.ele.DAT.3.PL+INF+3+SG
desenroscar-lhes	desenroscar+V.ele.DAT.3.PL+SBJF+1+SG
desenroscar-lhes	desenroscar+V.ele.DAT.3.PL+SBJF+3+SG
desenroscar-lhes-ei	desenroscar+V.ele.DAT.3.PL+FUT+1+SG
desenroscar-lhes-eis	desenroscar+V.ele.DAT.3.PL+FUT+2+PL
desenroscar-lhes-emos	desenroscar+V.ele.DAT.3.PL+FUT+1+PL
desenroscar-lhes-ia	desenroscar+V.ele.DAT.3.PL+COND+1+SG
desenroscar-lhes-ia	desenroscar+V.ele.DAT.3.PL+COND+3+SG
desenroscar-lhes-iam	desenroscar+V.ele.DAT.3.PL+COND+3+PL
desenroscar-lhes-íamos	desenroscar+V.ele.DAT.3.PL+COND+1+PL
desenroscar-lhes-ias	desenroscar+V.ele.DAT.3.PL+COND+2+SG
desenroscar-lhes-íeis	desenroscar+V.ele.DAT.3.PL+COND+2+PL
desenroscar-me-á	desenroscar+V.eu.AD.1.SG+FUT+3+SG
desenroscar-me-ão	desenroscar+V.eu.AD.1.SG+FUT+3+PL
desenroscar-me-ás	desenroscar+V.eu.AD.1.SG+FUT+2+SG
desenroscar-me	desenroscar+V.eu.AD.1.SG+INF
desenroscar-me	desenroscar+V.eu.AD.1.SG+INF+1+SG
desenroscar-me	desenroscar+V.eu.AD.1.SG+INF+3+SG
desenroscar-me	desenroscar+V.eu.AD.1.SG+SBJF+1+SG
desenroscar-me	desenroscar+V.eu.AD.1.SG+SBJF+3+SG
desenroscar-me-ei	desenroscar+V.eu.AD.1.SG+FUT+1+SG
desenroscar-me-eis	desenroscar+V.eu.AD.1.SG+FUT+2+PL
desenroscar-me-emos	desenroscar+V.eu.AD.1.SG+FUT+1+PL
desenroscar-me-ia	desenroscar+V.eu.AD.1.SG+COND+1+SG
desenroscar-me-ia	desenroscar+V.eu.AD.1.SG+COND+3+SG
desenroscar-me-iam	desenroscar+V.eu.AD.1.SG+COND+3+PL
desenroscar-me-íamos	desenroscar+V.eu.AD.1.SG+COND+1+PL
desenroscar-me-ias	desenroscar+V.eu.AD.1.SG+COND+2+SG
desenroscar-me-íeis	desenroscar+V.eu.AD.1.SG+COND+2+PL
desenroscarmo-la	desenroscar+V.ele.ACC.3.F.SG+INF+1+PL
desenroscarmo-la	desenroscar+V.ele.ACC.3.F.SG+SBJF+1+PL
desenroscarmo-las	desenroscar+V.ele.ACC.3.F.PL+INF+1+PL
desenroscarmo-las	desenroscar+V.ele.ACC.3.F.PL+SBJF+1+PL
desenroscarmo-lo	desenroscar+V.ele.ACC.3.M.SG+INF+1+PL
desenroscarmo-lo	desenroscar+V.ele.ACC.3.M.SG+SBJF+1+PL
desenroscarmo-los	desenroscar+V.ele.ACC.3.M.PL+INF+1+PL
desenroscarmo-los	desenroscar+V.ele.ACC.3.M.PL+SBJF+1+PL
desenroscarmo-nos	desenroscar+nós.AD.1.PL+INF+1+PL
desenroscarmo-nos	desenroscar+nós.AD.1.PL+SBJF+1+PL
desenroscarmos-lhe	desenroscar+V.ele.DAT.3.SG+INF+1+PL
desenroscarmos-lhe	desenroscar+V.ele.DAT.3.SG+SBJF+1+PL
desenroscarmos-lhes	desenroscar+V.ele.DAT.3.PL+INF+1+PL
desenroscarmos-lhes	desenroscar+V.ele.DAT.3.PL+SBJF+1+PL
desenroscarmos-me	desenroscar+V.eu.AD.1.SG+INF+1+PL
desenroscarmos-me	desenroscar+V.eu.AD.1.SG+SBJF+1+PL
desenroscarmos-te	desenroscar+V.tu.AD.2.SG+INF+1+PL
desenroscarmos-te	desenroscar+V.tu.AD.2.SG+SBJF+1+PL
desenroscarmos-vos	desenroscar+V.vós.AD.2.PL+INF+1+PL
desenroscarmos-vos	desenroscar+V.vós.AD.2.PL+SBJF+1+PL
desenroscar-nos-á	desenroscar+nós.AD.1.PL+FUT+3+SG
desenroscar-nos-ão	desenroscar+nós.AD.1.PL+FUT+3+PL
desenroscar-nos-ás	desenroscar+nós.AD.1.PL+FUT+2+SG
desenroscar-nos	desenroscar+nós.AD.1.PL+INF
desenroscar-nos	desenroscar+nós.AD.1.PL+INF+1+SG
desenroscar-nos	desenroscar+nós.AD.1.PL+INF+3+SG
desenroscar-nos	desenroscar+nós.AD.1.PL+SBJF+1+SG
desenroscar-nos	desenroscar+nós.AD.1.PL+SBJF+3+SG
desenroscar-nos-ei	desenroscar+nós.AD.1.PL+FUT+1+SG
desenroscar-nos-eis	desenroscar+nós.AD.1.PL+FUT+2+PL
desenroscar-nos-emos	desenroscar+nós.AD.1.PL+FUT+1+PL
desenroscar-nos-ia	desenroscar+nós.AD.1.PL+COND+1+SG
desenroscar-nos-ia	desenroscar+nós.AD.1.PL+COND+3+SG
desenroscar-nos-iam	desenroscar+nós.AD.1.PL+COND+3+PL
desenroscar-nos-íamos	desenroscar+nós.AD.1.PL+COND+1+PL
desenroscar-nos-ias	desenroscar+nós.AD.1.PL+COND+2+SG
desenroscar-nos-íeis	desenroscar+nós.AD.1.PL+COND+2+PL
desenroscar-se-á	desenroscar+V.ele.REFL+FUT+3+SG
desenroscar-se-ão	desenroscar+V.ele.REFL+FUT+3+PL
desenroscar-se	desenroscar+V.ele.REFL+INF
desenroscar-se	desenroscar+V.ele.REFL+INF+3+SG
desenroscar-se	desenroscar+V.ele.REFL+SBJF+3+SG
desenroscar-se-ia	desenroscar+V.ele.REFL+COND+3+SG
desenroscar-se-iam	desenroscar+V.ele.REFL+COND+3+PL
desenroscar-te-á	desenroscar+V.tu.AD.2.SG+FUT+3+SG
desenroscar-te-ão	desenroscar+V.tu.AD.2.SG+FUT+3+PL
desenroscar-te-ás	desenroscar+V.tu.AD.2.SG+FUT+2+SG
desenroscar-te	desenroscar+V.tu.AD.2.SG+INF
desenroscar-te	desenroscar+V.tu.AD.2.SG+INF+1+SG
desenroscar-te	desenroscar+V.tu.AD.2.SG+INF+3+SG
desenroscar-te	desenroscar+V.tu.AD.2.SG+SBJF+1+SG
desenroscar-te	desenroscar+V.tu.AD.2.SG+SBJF+3+SG
desenroscar-te-ei	desenroscar+V.tu.AD.2.SG+FUT+1+SG
desenroscar-te-eis	desenroscar+V.tu.AD.2.SG+FUT+2+PL
desenroscar-te-emos	desenroscar+V.tu.AD.2.SG+FUT+1+PL
desenroscar-te-ia	desenroscar+V.tu.AD.2.SG+COND+1+SG
desenroscar-te-ia	desenroscar+V.tu.AD.2.SG+COND+3+SG
desenroscar-te-iam	desenroscar+V.tu.AD.2.SG+COND+3+PL
desenroscar-te-íamos	desenroscar+V.tu.AD.2.SG+COND+1+PL
desenroscar-te-ias	desenroscar+V.tu.AD.2.SG+COND+2+SG
desenroscar-te-íeis	desenroscar+V.tu.AD.2.SG+COND+2+PL
desenroscar-vos-á	desenroscar+V.vós.AD.2.PL+FUT+3+SG
desenroscar-vos-ão	desenroscar+V.vós.AD.2.PL+FUT+3+PL
desenroscar-vos-ás	desenroscar+V.vós.AD.2.PL+FUT+2+SG
desenroscar-vos	desenroscar+V.vós.AD.2.PL+INF
desenroscar-vos	desenroscar+V.vós.AD.2.PL+INF+1+SG
desenroscar-vos	desenroscar+V.vós.AD.2.PL+INF+3+SG
desenroscar-vos	desenroscar+V.vós.AD.2.PL+SBJF+1+SG
desenroscar-vos	desenroscar+V.vós.AD.2.PL+SBJF+3+SG
desenroscar-vos-ei	desenroscar+V.vós.AD.2.PL+FUT+1+SG
desenroscar-vos-eis	desenroscar+V.vós.AD.2.PL+FUT+2+PL
desenroscar-vos-emos	desenroscar+V.vós.AD.2.PL+FUT+1+PL
desenroscar-vos-ia	desenroscar+V.vós.AD.2.PL+COND+1+SG
desenroscar-vos-ia	desenroscar+V.vós.AD.2.PL+COND+3+SG
desenroscar-vos-iam	desenroscar+V.vós.AD.2.PL+COND+3+PL
desenroscar-vos-íamos	desenroscar+V.vós.AD.2.PL+COND+1+PL
desenroscar-vos-ias	desenroscar+V.vós.AD.2.PL+COND+2+SG
desenroscar-vos-íeis	desenroscar+V.vós.AD.2.PL+COND+2+PL
desenrosca-se	desenroscar+V.ele.REFL+PRS+3+SG
desenroscas-lhe	desenroscar+V.ele.DAT.3.SG+PRS+2+SG
desenroscas-lhes	desenroscar+V.ele.DAT.3.PL+PRS+2+SG
desenroscas-me	desenroscar+V.eu.AD.1.SG+PRS+2+SG
desenroscas-te	desenroscar+V.tu.AD.2.SG+PRS+2+SG
desenroscaste-la	desenroscar+V.ele.ACC.3.F.SG+PRF+2+PL
desenroscaste-las	desenroscar+V.ele.ACC.3.F.PL+PRF+2+PL
desenroscaste-lo	desenroscar+V.ele.ACC.3.M.SG+PRF+2+PL
desenroscaste-los	desenroscar+V.ele.ACC.3.M.PL+PRF+2+PL
desenroscaste-nos	desenroscar+nós.AD.1.PL+PRF+2+PL
desenroscastes-lhe	desenroscar+V.ele.DAT.3.SG+PRF+2+PL
desenroscastes-lhes	desenroscar+V.ele.DAT.3.PL+PRF+2+PL
desenroscastes-me	desenroscar+V.eu.AD.1.SG+PRF+2+PL
desenroscastes-te	desenroscar+V.tu.AD.2.SG+PRF+2+PL
desenroscastes-vos	desenroscar+V.vós.AD.2.PL+PRF+2+PL
desenroscas-vos	desenroscar+V.vós.AD.2.PL+PRS+2+SG
desenrosca-te	desenroscar+V.tu.AD.2.SG+PRS+3+SG
desenroscava-a	desenroscar+V.ele.ACC.3.F.SG+IMPF+1+SG
desenroscava-a	desenroscar+V.ele.ACC.3.F.SG+IMPF+3+SG
desenroscava-as	desenroscar+V.ele.ACC.3.F.PL+IMPF+1+SG
desenroscava-as	desenroscar+V.ele.ACC.3.F.PL+IMPF+3+SG
desenroscava-la	desenroscar+V.ele.ACC.3.F.SG+IMPF+2+SG
desenroscava-las	desenroscar+V.ele.ACC.3.F.PL+IMPF+2+SG
desenroscava-lhe	desenroscar+V.ele.DAT.3.SG+IMPF+1+SG
desenroscava-lhe	desenroscar+V.ele.DAT.3.SG+IMPF+3+SG
desenroscava-lhes	desenroscar+V.ele.DAT.3.PL+IMPF+1+SG
desenroscava-lhes	desenroscar+V.ele.DAT.3.PL+IMPF+3+SG
desenroscava-lo	desenroscar+V.ele.ACC.3.M.SG+IMPF+2+SG
desenroscava-los	desenroscar+V.ele.ACC.3.M.PL+IMPF+2+SG
desenroscava-me	desenroscar+V.eu.AD.1.SG+IMPF+1+SG
desenroscava-me	desenroscar+V.eu.AD.1.SG+IMPF+3+SG
desenroscavam-lhe	desenroscar+V.ele.DAT.3.SG+IMPF+3+PL
desenroscavam-lhes	desenroscar+V.ele.DAT.3.PL+IMPF+3+PL
desenroscavam-me	desenroscar+V.eu.AD.1.SG+IMPF+3+PL
desenroscavam-na	desenroscar+V.ele.ACC.3.F.SG+IMPF+3+PL
desenroscavam-nas	desenroscar+V.ele.ACC.3.F.PL+IMPF+3+PL
desenroscavam-no	desenroscar+V.ele.ACC.3.M.SG+IMPF+3+PL
desenroscavam-nos	desenroscar+V.ele.ACC.3.M.PL+IMPF+3+PL
desenroscavam-nos	desenroscar+V.nós.AD.1.PL+IMPF+3+PL
desenroscávamo-la	desenroscar+V.ele.ACC.3.F.SG+IMPF+1+PL
desenroscávamo-las	desenroscar+V.ele.ACC.3.F.PL+IMPF+1+PL
desenroscávamo-lo	desenroscar+V.ele.ACC.3.M.SG+IMPF+1+PL
desenroscávamo-los	desenroscar+V.ele.ACC.3.M.PL+IMPF+1+PL
desenroscávamo-nos	desenroscar+nós.AD.1.PL+IMPF+1+PL
desenroscávamos-lhe	desenroscar+V.ele.DAT.3.SG+IMPF+1+PL
desenroscávamos-lhes	desenroscar+V.ele.DAT.3.PL+IMPF+1+PL
desenroscávamos-me	desenroscar+V.eu.AD.1.SG+IMPF+1+PL
desenroscávamos-te	desenroscar+V.tu.AD.2.SG+IMPF+1+PL
desenroscávamos-vos	desenroscar+V.vós.AD.2.PL+IMPF+1+PL
desenroscavam-se	desenroscar+V.ele.REFL+IMPF+3+PL
desenroscavam-te	desenroscar+V.tu.AD.2.SG+IMPF+3+PL
desenroscavam-vos	desenroscar+V.vós.AD.2.PL+IMPF+3+PL
desenroscava-nos	desenroscar+nós.AD.1.PL+IMPF+1+SG
desenroscava-nos	desenroscar+nós.AD.1.PL+IMPF+2+SG
desenroscava-nos	desenroscar+nós.AD.1.PL+IMPF+3+SG
desenroscava-o	desenroscar+V.ele.ACC.3.M.SG+IMPF+1+SG
desenroscava-o	desenroscar+V.ele.ACC.3.M.SG+IMPF+3+SG
desenroscava-os	desenroscar+V.ele.ACC.3.M.PL+IMPF+1+SG
desenroscava-os	desenroscar+V.ele.ACC.3.M.PL+IMPF+3+SG
desenroscava-se	desenroscar+V.ele.REFL+IMPF+1+SG
desenroscava-se	desenroscar+V.ele.REFL+IMPF+3+SG
desenroscavas-lhe	desenroscar+V.ele.DAT.3.SG+IMPF+2+SG
desenroscavas-lhes	desenroscar+V.ele.DAT.3.PL+IMPF+2+SG
desenroscavas-me	desenroscar+V.eu.AD.1.SG+IMPF+2+SG
desenroscavas-te	desenroscar+V.tu.AD.2.SG+IMPF+2+SG
desenroscavas-vos	desenroscar+V.vós.AD.2.PL+IMPF+2+SG
desenroscava-te	desenroscar+V.tu.AD.2.SG+IMPF+1+SG
desenroscava-te	desenroscar+V.tu.AD.2.SG+IMPF+3+SG
desenroscava-vos	desenroscar+V.vós.AD.2.PL+IMPF+1+SG
desenroscava-vos	desenroscar+V.vós.AD.2.PL+IMPF+3+SG
desenroscávei-la	desenroscar+V.ele.ACC.3.F.SG+IMPF+2+PL
desenroscávei-las	desenroscar+V.ele.ACC.3.F.PL+IMPF+2+PL
desenroscávei-lo	desenroscar+V.ele.ACC.3.M.SG+IMPF+2+PL
desenroscávei-los	desenroscar+V.ele.ACC.3.M.PL+IMPF+2+PL
desenroscávei-nos	desenroscar+nós.AD.1.PL+IMPF+2+PL
desenroscáveis-lhe	desenroscar+V.ele.DAT.3.SG+IMPF+2+PL
desenroscáveis-lhes	desenroscar+V.ele.DAT.3.PL+IMPF+2+PL
desenroscáveis-me	desenroscar+V.eu.AD.1.SG+IMPF+2+PL
desenroscáveis-te	desenroscar+V.tu.AD.2.SG+IMPF+2+PL
desenroscáveis-vos	desenroscar+V.vós.AD.2.PL+IMPF+2+PL
desenrosca-vos	desenroscar+V.vós.AD.2.PL+PRS+3+SG
desenrosco-a	desenroscar+V.ele.ACC.3.F.SG+PRS+1+SG
desenrosco-as	desenroscar+V.ele.ACC.3.F.PL+PRS+1+SG
desenrosco-lhe	desenroscar+V.ele.DAT.3.SG+PRS+1+SG
desenrosco-lhes	desenroscar+V.ele.DAT.3.PL+PRS+1+SG
desenrosco-me	desenroscar+V.eu.AD.1.SG+PRS+1+SG
desenrosco-nos	desenroscar+nós.AD.1.PL+PRS+1+SG
desenrosco-o	desenroscar+V.ele.ACC.3.M.SG+PRS+1+SG
desenrosco-os	desenroscar+V.ele.ACC.3.M.PL+PRS+1+SG
desenrosco-te	desenroscar+V.tu.AD.2.SG+PRS+1+SG
desenroscou-a	desenroscar+V.ele.ACC.3.F.SG+PRF+3+SG
desenroscou-as	desenroscar+V.ele.ACC.3.F.PL+PRF+3+SG
desenroscou-lhe	desenroscar+V.ele.DAT.3.SG+PRF+3+SG
desenroscou-lhes	desenroscar+V.ele.DAT.3.PL+PRF+3+SG
desenroscou-me	desenroscar+V.eu.AD.1.SG+PRF+3+SG
desenroscou-nos	desenroscar+nós.AD.1.PL+PRF+3+SG
desenroscou-o	desenroscar+V.ele.ACC.3.M.SG+PRF+3+SG
desenroscou-os	desenroscar+V.ele.ACC.3.M.PL+PRF+3+SG
desenroscou-se	desenroscar+V.ele.REFL+PRF+3+SG
desenroscou-te	desenroscar+V.tu.AD.2.SG+PRF+3+SG
desenroscou-vos	desenroscar+V.vós.AD.2.PL+PRF+3+SG
desenrosco-vos	desenroscar+V.vós.AD.2.PL+PRS+1+SG
desenrosque-a	desenroscar+V.ele.ACC.3.F.SG+IMP+3+SG
desenrosque-as	desenroscar+V.ele.ACC.3.F.PL+IMP+3+SG
desenrosquei-a	desenroscar+V.ele.ACC.3.F.SG+PRF+1+SG
desenrosquei-as	desenroscar+V.ele.ACC.3.F.PL+PRF+1+SG
desenrosquei-lhe	desenroscar+V.ele.DAT.3.SG+PRF+1+SG
desenrosquei-lhes	desenroscar+V.ele.DAT.3.PL+PRF+1+SG
desenrosquei-me	desenroscar+V.eu.AD.1.SG+PRF+1+SG
desenrosquei-nos	desenroscar+nós.AD.1.PL+PRF+1+SG
desenrosquei-o	desenroscar+V.ele.ACC.3.M.SG+PRF+1+SG
desenrosquei-os	desenroscar+V.ele.ACC.3.M.PL+PRF+1+SG
desenrosquei-te	desenroscar+V.tu.AD.2.SG+PRF+1+SG
desenrosquei-vos	desenroscar+V.vós.AD.2.PL+PRF+1+SG
desenrosque-lhe	desenroscar+V.ele.DAT.3.SG+IMP+3+SG
desenrosque-lhes	desenroscar+V.ele.DAT.3.PL+IMP+3+SG
desenrosque-me	desenroscar+V.eu.AD.1.SG+IMP+3+SG
desenrosquem-lhe	desenroscar+V.ele.DAT.3.SG+IMP+3+PL
desenrosquem-lhes	desenroscar+V.ele.DAT.3.PL+IMP+3+PL
desenrosquem-me	desenroscar+V.eu.AD.1.SG+IMP+3+PL
desenrosquem-na	desenroscar+V.ele.ACC.3.F.SG+IMP+3+PL
desenrosquem-nas	desenroscar+V.ele.ACC.3.F.PL+IMP+3+PL
desenrosquem-no	desenroscar+V.ele.ACC.3.M.SG+IMP+3+PL
desenrosquem-nos	desenroscar+V.ele.ACC.3.M.PL+IMP+3+PL
desenrosquem-nos	desenroscar+V.nós.AD.1.PL+IMP+3+PL
desenrosquemo-la	desenroscar+V.ele.ACC.3.F.SG+IMP+1+PL
desenrosquemo-las	desenroscar+V.ele.ACC.3.F.PL+IMP+1+PL
desenrosquemo-lo	desenroscar+V.ele.ACC.3.M.SG+IMP+1+PL
desenrosquemo-los	desenroscar+V.ele.ACC.3.M.PL+IMP+1+PL
desenrosquemo-nos	desenroscar+nós.AD.1.PL+IMP+1+PL
desenrosquemos-lhe	desenroscar+V.ele.DAT.3.SG+IMP+1+PL
desenrosquemos-lhes	desenroscar+V.ele.DAT.3.PL+IMP+1+PL
desenrosquemos-me	desenroscar+V.eu.AD.1.SG+IMP+1+PL
desenrosquemos-te	desenroscar+V.tu.AD.2.SG+IMP+1+PL
desenrosquemos-vos	desenroscar+V.vós.AD.2.PL+IMP+1+PL
desenrosquem-se	desenroscar+V.ele.REFL+IMP+3+PL
desenrosquem-te	desenroscar+V.tu.AD.2.SG+IMP+3+PL
desenrosquem-vos	desenroscar+V.vós.AD.2.PL+IMP+3+PL
desenrosque-nos	desenroscar+nós.AD.1.PL+IMP+3+SG
desenrosque-o	desenroscar+V.ele.ACC.3.M.SG+IMP+3+SG
desenrosque-os	desenroscar+V.ele.ACC.3.M.PL+IMP+3+SG
desenrosque-se	desenroscar+V.ele.REFL+IMP+3+SG
desenrosque-te	desenroscar+V.tu.AD.2.SG+IMP+3+SG
desenrosque-vos	desenroscar+V.vós.AD.2.PL+IMP+3+SG
desenroupa-a	desenroupar+V.ele.ACC.3.F.SG+PRS+3+SG
desenroupa-as	desenroupar+V.ele.ACC.3.F.PL+PRS+3+SG
desenroupai-la	desenroupar+V.ele.ACC.3.F.SG+PRS+2+PL
desenroupai-las	desenroupar+V.ele.ACC.3.F.PL+PRS+2+PL
desenroupai-lo	desenroupar+V.ele.ACC.3.M.SG+PRS+2+PL
desenroupai-los	desenroupar+V.ele.ACC.3.M.PL+PRS+2+PL
desenroupai-nos	desenroupar+nós.AD.1.PL+PRS+2+PL
desenroupais-lhe	desenroupar+V.ele.DAT.3.SG+PRS+2+PL
desenroupais-lhes	desenroupar+V.ele.DAT.3.PL+PRS+2+PL
desenroupais-me	desenroupar+V.eu.AD.1.SG+PRS+2+PL
desenroupais-te	desenroupar+V.tu.AD.2.SG+PRS+2+PL
desenroupais-vos	desenroupar+V.vós.AD.2.PL+PRS+2+PL
desenroupá-la-á	desenroupar+V.ele.ACC.3.F.SG+FUT+3+SG
desenroupá-la-ão	desenroupar+V.ele.ACC.3.F.SG+FUT+3+PL
desenroupá-la-ás	desenroupar+V.ele.ACC.3.F.SG+FUT+2+SG
desenroupá-la	desenroupar+V.ele.ACC.3.F.SG+INF+1+SG
desenroupá-la	desenroupar+V.ele.ACC.3.F.SG+INF+3+SG
desenroupa-la	desenroupar+V.ele.ACC.3.F.SG+PRS+2+SG
desenroupá-la	desenroupar+V.ele.ACC.3.F.SG+SBJF+1+SG
desenroupá-la	desenroupar+V.ele.ACC.3.F.SG+SBJF+3+SG
desenroupá-la-ei	desenroupar+V.ele.ACC.3.F.SG+FUT+1+SG
desenroupá-la-eis	desenroupar+V.ele.ACC.3.F.SG+FUT+2+PL
desenroupá-la-emos	desenroupar+V.ele.ACC.3.F.SG+FUT+1+PL
desenroupá-la-ia	desenroupar+V.ele.ACC.3.F.SG+COND+1+SG
desenroupá-la-ia	desenroupar+V.ele.ACC.3.F.SG+COND+3+SG
desenroupá-la-iam	desenroupar+V.ele.ACC.3.F.SG+COND+3+PL
desenroupá-la-íamos	desenroupar+V.ele.ACC.3.F.SG+COND+1+PL
desenroupá-la-ias	desenroupar+V.ele.ACC.3.F.SG+COND+2+SG
desenroupá-la-íeis	desenroupar+V.ele.ACC.3.F.SG+COND+2+PL
desenroupá-las-á	desenroupar+V.ele.ACC.3.F.PL+FUT+3+SG
desenroupá-las-ão	desenroupar+V.ele.ACC.3.F.PL+FUT+3+PL
desenroupá-las-ás	desenroupar+V.ele.ACC.3.F.PL+FUT+2+SG
desenroupá-las	desenroupar+V.ele.ACC.3.F.PL+INF+1+SG
desenroupá-las	desenroupar+V.ele.ACC.3.F.PL+INF+3+SG
desenroupa-las	desenroupar+V.ele.ACC.3.F.PL+PRS+2+SG
desenroupá-las	desenroupar+V.ele.ACC.3.F.PL+SBJF+1+SG
desenroupá-las	desenroupar+V.ele.ACC.3.F.PL+SBJF+3+SG
desenroupá-las-ei	desenroupar+V.ele.ACC.3.F.PL+FUT+1+SG
desenroupá-las-eis	desenroupar+V.ele.ACC.3.F.PL+FUT+2+PL
desenroupá-las-emos	desenroupar+V.ele.ACC.3.F.PL+FUT+1+PL
desenroupá-las-ia	desenroupar+V.ele.ACC.3.F.PL+COND+1+SG
desenroupá-las-ia	desenroupar+V.ele.ACC.3.F.PL+COND+3+SG
desenroupá-las-iam	desenroupar+V.ele.ACC.3.F.PL+COND+3+PL
desenroupá-las-íamos	desenroupar+V.ele.ACC.3.F.PL+COND+1+PL
desenroupá-las-ias	desenroupar+V.ele.ACC.3.F.PL+COND+2+SG
desenroupá-las-íeis	desenroupar+V.ele.ACC.3.F.PL+COND+2+PL
desenroupa-lhe	desenroupar+V.ele.DAT.3.SG+PRS+3+SG
desenroupa-lhes	desenroupar+V.ele.DAT.3.PL+PRS+3+SG
desenroupá-lo-á	desenroupar+V.ele.ACC.3.M.SG+FUT+3+SG
desenroupá-lo-ão	desenroupar+V.ele.ACC.3.M.SG+FUT+3+PL
desenroupá-lo-ás	desenroupar+V.ele.ACC.3.M.SG+FUT+2+SG
desenroupá-lo	desenroupar+V.ele.ACC.3.M.SG+INF+1+SG
desenroupá-lo	desenroupar+V.ele.ACC.3.M.SG+INF+3+SG
desenroupa-lo	desenroupar+V.ele.ACC.3.M.SG+PRS+2+SG
desenroupá-lo	desenroupar+V.ele.ACC.3.M.SG+SBJF+1+SG
desenroupá-lo	desenroupar+V.ele.ACC.3.M.SG+SBJF+3+SG
desenroupá-lo-ei	desenroupar+V.ele.ACC.3.M.SG+FUT+1+SG
desenroupá-lo-eis	desenroupar+V.ele.ACC.3.M.SG+FUT+2+PL
desenroupá-lo-emos	desenroupar+V.ele.ACC.3.M.SG+FUT+1+PL
desenroupá-lo-ia	desenroupar+V.ele.ACC.3.M.SG+COND+1+SG
desenroupá-lo-ia	desenroupar+V.ele.ACC.3.M.SG+COND+3+SG
desenroupá-lo-iam	desenroupar+V.ele.ACC.3.M.SG+COND+3+PL
desenroupá-lo-íamos	desenroupar+V.ele.ACC.3.M.SG+COND+1+PL
desenroupá-lo-ias	desenroupar+V.ele.ACC.3.M.SG+COND+2+SG
desenroupá-lo-íeis	desenroupar+V.ele.ACC.3.M.SG+COND+2+PL
desenroupá-los-á	desenroupar+V.ele.ACC.3.M.PL+FUT+3+SG
desenroupá-los-ão	desenroupar+V.ele.ACC.3.M.PL+FUT+3+PL
desenroupá-los-ás	desenroupar+V.ele.ACC.3.M.PL+FUT+2+SG
desenroupá-los	desenroupar+V.ele.ACC.3.M.PL+INF+1+SG
desenroupá-los	desenroupar+V.ele.ACC.3.M.PL+INF+3+SG
desenroupa-los	desenroupar+V.ele.ACC.3.M.PL+PRS+2+SG
desenroupá-los	desenroupar+V.ele.ACC.3.M.PL+SBJF+1+SG
desenroupá-los	desenroupar+V.ele.ACC.3.M.PL+SBJF+3+SG
desenroupá-los-ei	desenroupar+V.ele.ACC.3.M.PL+FUT+1+SG
desenroupá-los-eis	desenroupar+V.ele.ACC.3.M.PL+FUT+2+PL
desenroupá-los-emos	desenroupar+V.ele.ACC.3.M.PL+FUT+1+PL
desenroupá-los-ia	desenroupar+V.ele.ACC.3.M.PL+COND+1+SG
desenroupá-los-ia	desenroupar+V.ele.ACC.3.M.PL+COND+3+SG
desenroupá-los-iam	desenroupar+V.ele.ACC.3.M.PL+COND+3+PL
desenroupá-los-íamos	desenroupar+V.ele.ACC.3.M.PL+COND+1+PL
desenroupá-los-ias	desenroupar+V.ele.ACC.3.M.PL+COND+2+SG
desenroupá-los-íeis	desenroupar+V.ele.ACC.3.M.PL+COND+2+PL
desenroupa-me	desenroupar+V.eu.AD.1.SG+PRS+3+SG
desenroupam-lhe	desenroupar+V.ele.DAT.3.SG+PRS+3+PL
desenroupam-lhes	desenroupar+V.ele.DAT.3.PL+PRS+3+PL
desenroupam-me	desenroupar+V.eu.AD.1.SG+PRS+3+PL
desenroupam-na	desenroupar+V.ele.ACC.3.F.SG+PRS+3+PL
desenroupam-nas	desenroupar+V.ele.ACC.3.F.PL+PRS+3+PL
desenroupam-no	desenroupar+V.ele.ACC.3.M.SG+PRS+3+PL
desenroupam-nos	desenroupar+V.ele.ACC.3.M.PL+PRS+3+PL
desenroupam-nos	desenroupar+V.nós.AD.1.PL+PRS+3+PL
desenroupamo-la	desenroupar+V.ele.ACC.3.F.SG+PRF+1+PL
desenroupamo-la	desenroupar+V.ele.ACC.3.F.SG+PRS+1+PL
desenroupamo-las	desenroupar+V.ele.ACC.3.F.PL+PRF+1+PL
desenroupamo-las	desenroupar+V.ele.ACC.3.F.PL+PRS+1+PL
desenroupamo-lo	desenroupar+V.ele.ACC.3.M.SG+PRF+1+PL
desenroupamo-lo	desenroupar+V.ele.ACC.3.M.SG+PRS+1+PL
desenroupamo-los	desenroupar+V.ele.ACC.3.M.PL+PRF+1+PL
desenroupamo-los	desenroupar+V.ele.ACC.3.M.PL+PRS+1+PL
desenroupamo-nos	desenroupar+nós.AD.1.PL+PRF+1+PL
desenroupamo-nos	desenroupar+nós.AD.1.PL+PRS+1+PL
desenroupamos-lhe	desenroupar+V.ele.DAT.3.SG+PRF+1+PL
desenroupamos-lhe	desenroupar+V.ele.DAT.3.SG+PRS+1+PL
desenroupamos-lhes	desenroupar+V.ele.DAT.3.PL+PRF+1+PL
desenroupamos-lhes	desenroupar+V.ele.DAT.3.PL+PRS+1+PL
desenroupamos-me	desenroupar+V.eu.AD.1.SG+PRF+1+PL
desenroupamos-me	desenroupar+V.eu.AD.1.SG+PRS+1+PL
desenroupamos-te	desenroupar+V.tu.AD.2.SG+PRF+1+PL
desenroupamos-te	desenroupar+V.tu.AD.2.SG+PRS+1+PL
desenroupamos-vos	desenroupar+V.vós.AD.2.PL+PRF+1+PL
desenroupamos-vos	desenroupar+V.vós.AD.2.PL+PRS+1+PL
desenroupam-se	desenroupar+V.ele.REFL+PRS+3+PL
desenroupam-te	desenroupar+V.tu.AD.2.SG+PRS+3+PL
desenroupam-vos	desenroupar+V.vós.AD.2.PL+PRS+3+PL
desenroupando-a	desenroupar+V.ele.ACC.3.F.SG+GRD
desenroupando-as	desenroupar+V.ele.ACC.3.F.PL+GRD
desenroupando-lhe	desenroupar+V.ele.DAT.3.SG+GRD
desenroupando-lhes	desenroupar+V.ele.DAT.3.PL+GRD
desenroupando-me	desenroupar+V.eu.AD.1.SG+GRD
desenroupando-nos	desenroupar+nós.AD.1.PL+GRD
desenroupando-o	desenroupar+V.ele.ACC.3.M.SG+GRD
desenroupando-os	desenroupar+V.ele.ACC.3.M.PL+GRD
desenroupando-se	desenroupar+V.ele.REFL+GRD
desenroupando-te	desenroupar+V.tu.AD.2.SG+GRD
desenroupando-vos	desenroupar+V.vós.AD.2.PL+GRD
desenroupa-nos	desenroupar+nós.AD.1.PL+PRS+2+SG
desenroupa-nos	desenroupar+nós.AD.1.PL+PRS+3+SG
desenroupa-o	desenroupar+V.ele.ACC.3.M.SG+PRS+3+SG
desenroupa-os	desenroupar+V.ele.ACC.3.M.PL+PRS+3+SG
desenroupara-a	desenroupar+V.ele.ACC.3.F.SG+PQP+1+SG
desenroupara-a	desenroupar+V.ele.ACC.3.F.SG+PQP+3+SG
desenroupara-as	desenroupar+V.ele.ACC.3.F.PL+PQP+1+SG
desenroupara-as	desenroupar+V.ele.ACC.3.F.PL+PQP+3+SG
desenroupara-la	desenroupar+V.ele.ACC.3.F.SG+PQP+2+SG
desenroupara-las	desenroupar+V.ele.ACC.3.F.PL+PQP+2+SG
desenroupara-lhe	desenroupar+V.ele.DAT.3.SG+PQP+1+SG
desenroupara-lhe	desenroupar+V.ele.DAT.3.SG+PQP+3+SG
desenroupara-lhes	desenroupar+V.ele.DAT.3.PL+PQP+1+SG
desenroupara-lhes	desenroupar+V.ele.DAT.3.PL+PQP+3+SG
desenroupara-lo	desenroupar+V.ele.ACC.3.M.SG+PQP+2+SG
desenroupara-los	desenroupar+V.ele.ACC.3.M.PL+PQP+2+SG
desenroupara-me	desenroupar+V.eu.AD.1.SG+PQP+1+SG
desenroupara-me	desenroupar+V.eu.AD.1.SG+PQP+3+SG
desenrouparam-lhe	desenroupar+V.ele.DAT.3.SG+PQP+3+PL
desenrouparam-lhe	desenroupar+V.ele.DAT.3.SG+PRF+3+PL
desenrouparam-lhes	desenroupar+V.ele.DAT.3.PL+PQP+3+PL
desenrouparam-lhes	desenroupar+V.ele.DAT.3.PL+PRF+3+PL
desenrouparam-me	desenroupar+V.eu.AD.1.SG+PQP+3+PL
desenrouparam-me	desenroupar+V.eu.AD.1.SG+PRF+3+PL
