desfilhar-te	desfilhar+V.tu.AD.2.SG+INF+3+SG
desfilhar-te	desfilhar+V.tu.AD.2.SG+SBJF+1+SG
desfilhar-te	desfilhar+V.tu.AD.2.SG+SBJF+3+SG
desfilhar-te-ei	desfilhar+V.tu.AD.2.SG+FUT+1+SG
desfilhar-te-eis	desfilhar+V.tu.AD.2.SG+FUT+2+PL
desfilhar-te-emos	desfilhar+V.tu.AD.2.SG+FUT+1+PL
desfilhar-te-ia	desfilhar+V.tu.AD.2.SG+COND+1+SG
desfilhar-te-ia	desfilhar+V.tu.AD.2.SG+COND+3+SG
desfilhar-te-iam	desfilhar+V.tu.AD.2.SG+COND+3+PL
desfilhar-te-íamos	desfilhar+V.tu.AD.2.SG+COND+1+PL
desfilhar-te-ias	desfilhar+V.tu.AD.2.SG+COND+2+SG
desfilhar-te-íeis	desfilhar+V.tu.AD.2.SG+COND+2+PL
desfilhar-vos-á	desfilhar+V.vós.AD.2.PL+FUT+3+SG
desfilhar-vos-ão	desfilhar+V.vós.AD.2.PL+FUT+3+PL
desfilhar-vos-ás	desfilhar+V.vós.AD.2.PL+FUT+2+SG
desfilhar-vos	desfilhar+V.vós.AD.2.PL+INF
desfilhar-vos	desfilhar+V.vós.AD.2.PL+INF+1+SG
desfilhar-vos	desfilhar+V.vós.AD.2.PL+INF+3+SG
desfilhar-vos	desfilhar+V.vós.AD.2.PL+SBJF+1+SG
desfilhar-vos	desfilhar+V.vós.AD.2.PL+SBJF+3+SG
desfilhar-vos-ei	desfilhar+V.vós.AD.2.PL+FUT+1+SG
desfilhar-vos-eis	desfilhar+V.vós.AD.2.PL+FUT+2+PL
desfilhar-vos-emos	desfilhar+V.vós.AD.2.PL+FUT+1+PL
desfilhar-vos-ia	desfilhar+V.vós.AD.2.PL+COND+1+SG
desfilhar-vos-ia	desfilhar+V.vós.AD.2.PL+COND+3+SG
desfilhar-vos-iam	desfilhar+V.vós.AD.2.PL+COND+3+PL
desfilhar-vos-íamos	desfilhar+V.vós.AD.2.PL+COND+1+PL
desfilhar-vos-ias	desfilhar+V.vós.AD.2.PL+COND+2+SG
desfilhar-vos-íeis	desfilhar+V.vós.AD.2.PL+COND+2+PL
desfilha-se	desfilhar+V.ele.REFL+PRS+3+SG
desfilhas-lhe	desfilhar+V.ele.DAT.3.SG+PRS+2+SG
desfilhas-lhes	desfilhar+V.ele.DAT.3.PL+PRS+2+SG
desfilhas-me	desfilhar+V.eu.AD.1.SG+PRS+2+SG
desfilhaste-a	desfilhar+V.ele.ACC.3.F.SG+PRF+2+SG
desfilhaste-as	desfilhar+V.ele.ACC.3.F.PL+PRF+2+SG
desfilhas-te	desfilhar+V.tu.AD.2.SG+PRS+2+SG
desfilhaste-la	desfilhar+V.ele.ACC.3.F.SG+PRF+2+PL
desfilhaste-las	desfilhar+V.ele.ACC.3.F.PL+PRF+2+PL
desfilhaste-lhe	desfilhar+V.ele.DAT.3.SG+PRF+2+SG
desfilhaste-lhes	desfilhar+V.ele.DAT.3.PL+PRF+2+SG
desfilhaste-lo	desfilhar+V.ele.ACC.3.M.SG+PRF+2+PL
desfilhaste-los	desfilhar+V.ele.ACC.3.M.PL+PRF+2+PL
desfilhaste-me	desfilhar+V.eu.AD.1.SG+PRF+2+SG
desfilhaste-nos	desfilhar+nós.AD.1.PL+PRF+2+PL
desfilhaste-nos	desfilhar+nós.AD.1.PL+PRF+2+SG
desfilhaste-o	desfilhar+V.ele.ACC.3.M.SG+PRF+2+SG
desfilhaste-os	desfilhar+V.ele.ACC.3.M.PL+PRF+2+SG
desfilhastes-lhe	desfilhar+V.ele.DAT.3.SG+PRF+2+PL
desfilhastes-lhes	desfilhar+V.ele.DAT.3.PL+PRF+2+PL
desfilhastes-me	desfilhar+V.eu.AD.1.SG+PRF+2+PL
desfilhastes-te	desfilhar+V.tu.AD.2.SG+PRF+2+PL
desfilhastes-vos	desfilhar+V.vós.AD.2.PL+PRF+2+PL
desfilhaste-te	desfilhar+V.tu.AD.2.SG+PRF+2+SG
desfilhaste-vos	desfilhar+V.vós.AD.2.PL+PRF+2+SG
desfilhas-vos	desfilhar+V.vós.AD.2.PL+PRS+2+SG
desfilha-te	desfilhar+V.tu.AD.2.SG+PRS+3+SG
desfilhava-a	desfilhar+V.ele.ACC.3.F.SG+IMPF+1+SG
desfilhava-a	desfilhar+V.ele.ACC.3.F.SG+IMPF+3+SG
desfilhava-as	desfilhar+V.ele.ACC.3.F.PL+IMPF+1+SG
desfilhava-as	desfilhar+V.ele.ACC.3.F.PL+IMPF+3+SG
desfilhava-la	desfilhar+V.ele.ACC.3.F.SG+IMPF+2+SG
desfilhava-las	desfilhar+V.ele.ACC.3.F.PL+IMPF+2+SG
desfilhava-lhe	desfilhar+V.ele.DAT.3.SG+IMPF+1+SG
desfilhava-lhe	desfilhar+V.ele.DAT.3.SG+IMPF+3+SG
desfilhava-lhes	desfilhar+V.ele.DAT.3.PL+IMPF+1+SG
desfilhava-lhes	desfilhar+V.ele.DAT.3.PL+IMPF+3+SG
desfilhava-lo	desfilhar+V.ele.ACC.3.M.SG+IMPF+2+SG
desfilhava-los	desfilhar+V.ele.ACC.3.M.PL+IMPF+2+SG
desfilhava-me	desfilhar+V.eu.AD.1.SG+IMPF+1+SG
desfilhava-me	desfilhar+V.eu.AD.1.SG+IMPF+3+SG
desfilhavam-lhe	desfilhar+V.ele.DAT.3.SG+IMPF+3+PL
desfilhavam-lhes	desfilhar+V.ele.DAT.3.PL+IMPF+3+PL
desfilhavam-me	desfilhar+V.eu.AD.1.SG+IMPF+3+PL
desfilhavam-na	desfilhar+V.ele.ACC.3.F.SG+IMPF+3+PL
desfilhavam-nas	desfilhar+V.ele.ACC.3.F.PL+IMPF+3+PL
desfilhavam-no	desfilhar+V.ele.ACC.3.M.SG+IMPF+3+PL
desfilhavam-nos	desfilhar+V.ele.ACC.3.M.PL+IMPF+3+PL
desfilhavam-nos	desfilhar+V.nós.AD.1.PL+IMPF+3+PL
desfilhávamo-la	desfilhar+V.ele.ACC.3.F.SG+IMPF+1+PL
desfilhávamo-las	desfilhar+V.ele.ACC.3.F.PL+IMPF+1+PL
desfilhávamo-lo	desfilhar+V.ele.ACC.3.M.SG+IMPF+1+PL
desfilhávamo-los	desfilhar+V.ele.ACC.3.M.PL+IMPF+1+PL
desfilhávamo-nos	desfilhar+nós.AD.1.PL+IMPF+1+PL
desfilhávamos-lhe	desfilhar+V.ele.DAT.3.SG+IMPF+1+PL
desfilhávamos-lhes	desfilhar+V.ele.DAT.3.PL+IMPF+1+PL
desfilhávamos-me	desfilhar+V.eu.AD.1.SG+IMPF+1+PL
desfilhávamos-te	desfilhar+V.tu.AD.2.SG+IMPF+1+PL
desfilhávamos-vos	desfilhar+V.vós.AD.2.PL+IMPF+1+PL
desfilhavam-se	desfilhar+V.ele.REFL+IMPF+3+PL
desfilhavam-te	desfilhar+V.tu.AD.2.SG+IMPF+3+PL
desfilhavam-vos	desfilhar+V.vós.AD.2.PL+IMPF+3+PL
desfilhava-nos	desfilhar+nós.AD.1.PL+IMPF+1+SG
desfilhava-nos	desfilhar+nós.AD.1.PL+IMPF+2+SG
desfilhava-nos	desfilhar+nós.AD.1.PL+IMPF+3+SG
desfilhava-o	desfilhar+V.ele.ACC.3.M.SG+IMPF+1+SG
desfilhava-o	desfilhar+V.ele.ACC.3.M.SG+IMPF+3+SG
desfilhava-os	desfilhar+V.ele.ACC.3.M.PL+IMPF+1+SG
desfilhava-os	desfilhar+V.ele.ACC.3.M.PL+IMPF+3+SG
desfilhava-se	desfilhar+V.ele.REFL+IMPF+1+SG
desfilhava-se	desfilhar+V.ele.REFL+IMPF+3+SG
desfilhavas-lhe	desfilhar+V.ele.DAT.3.SG+IMPF+2+SG
desfilhavas-lhes	desfilhar+V.ele.DAT.3.PL+IMPF+2+SG
desfilhavas-me	desfilhar+V.eu.AD.1.SG+IMPF+2+SG
desfilhavas-te	desfilhar+V.tu.AD.2.SG+IMPF+2+SG
desfilhavas-vos	desfilhar+V.vós.AD.2.PL+IMPF+2+SG
desfilhava-te	desfilhar+V.tu.AD.2.SG+IMPF+1+SG
desfilhava-te	desfilhar+V.tu.AD.2.SG+IMPF+3+SG
desfilhava-vos	desfilhar+V.vós.AD.2.PL+IMPF+1+SG
desfilhava-vos	desfilhar+V.vós.AD.2.PL+IMPF+3+SG
desfilhávei-la	desfilhar+V.ele.ACC.3.F.SG+IMPF+2+PL
desfilhávei-las	desfilhar+V.ele.ACC.3.F.PL+IMPF+2+PL
desfilhávei-lo	desfilhar+V.ele.ACC.3.M.SG+IMPF+2+PL
desfilhávei-los	desfilhar+V.ele.ACC.3.M.PL+IMPF+2+PL
desfilhávei-nos	desfilhar+nós.AD.1.PL+IMPF+2+PL
desfilháveis-lhe	desfilhar+V.ele.DAT.3.SG+IMPF+2+PL
desfilháveis-lhes	desfilhar+V.ele.DAT.3.PL+IMPF+2+PL
desfilháveis-me	desfilhar+V.eu.AD.1.SG+IMPF+2+PL
desfilháveis-te	desfilhar+V.tu.AD.2.SG+IMPF+2+PL
desfilháveis-vos	desfilhar+V.vós.AD.2.PL+IMPF+2+PL
desfilha-vos	desfilhar+V.vós.AD.2.PL+PRS+3+SG
desfilhe-a	desfilhar+V.ele.ACC.3.F.SG+IMP+3+SG
desfilhe-as	desfilhar+V.ele.ACC.3.F.PL+IMP+3+SG
desfilhei-a	desfilhar+V.ele.ACC.3.F.SG+PRF+1+SG
desfilhei-as	desfilhar+V.ele.ACC.3.F.PL+PRF+1+SG
desfilhei-lhe	desfilhar+V.ele.DAT.3.SG+PRF+1+SG
desfilhei-lhes	desfilhar+V.ele.DAT.3.PL+PRF+1+SG
desfilhei-me	desfilhar+V.eu.AD.1.SG+PRF+1+SG
desfilhei-nos	desfilhar+nós.AD.1.PL+PRF+1+SG
desfilhei-o	desfilhar+V.ele.ACC.3.M.SG+PRF+1+SG
desfilhei-os	desfilhar+V.ele.ACC.3.M.PL+PRF+1+SG
desfilhei-te	desfilhar+V.tu.AD.2.SG+PRF+1+SG
desfilhei-vos	desfilhar+V.vós.AD.2.PL+PRF+1+SG
desfilhe-lhe	desfilhar+V.ele.DAT.3.SG+IMP+3+SG
desfilhe-lhes	desfilhar+V.ele.DAT.3.PL+IMP+3+SG
desfilhe-me	desfilhar+V.eu.AD.1.SG+IMP+3+SG
desfilhem-lhe	desfilhar+V.ele.DAT.3.SG+IMP+3+PL
desfilhem-lhes	desfilhar+V.ele.DAT.3.PL+IMP+3+PL
desfilhem-me	desfilhar+V.eu.AD.1.SG+IMP+3+PL
desfilhem-na	desfilhar+V.ele.ACC.3.F.SG+IMP+3+PL
desfilhem-nas	desfilhar+V.ele.ACC.3.F.PL+IMP+3+PL
desfilhem-no	desfilhar+V.ele.ACC.3.M.SG+IMP+3+PL
desfilhem-nos	desfilhar+V.ele.ACC.3.M.PL+IMP+3+PL
desfilhem-nos	desfilhar+V.nós.AD.1.PL+IMP+3+PL
desfilhemo-la	desfilhar+V.ele.ACC.3.F.SG+IMP+1+PL
desfilhemo-las	desfilhar+V.ele.ACC.3.F.PL+IMP+1+PL
desfilhemo-lo	desfilhar+V.ele.ACC.3.M.SG+IMP+1+PL
desfilhemo-los	desfilhar+V.ele.ACC.3.M.PL+IMP+1+PL
desfilhemo-nos	desfilhar+nós.AD.1.PL+IMP+1+PL
desfilhemos-lhe	desfilhar+V.ele.DAT.3.SG+IMP+1+PL
desfilhemos-lhes	desfilhar+V.ele.DAT.3.PL+IMP+1+PL
desfilhemos-me	desfilhar+V.eu.AD.1.SG+IMP+1+PL
desfilhemos-te	desfilhar+V.tu.AD.2.SG+IMP+1+PL
desfilhemos-vos	desfilhar+V.vós.AD.2.PL+IMP+1+PL
desfilhem-se	desfilhar+V.ele.REFL+IMP+3+PL
desfilhem-te	desfilhar+V.tu.AD.2.SG+IMP+3+PL
desfilhem-vos	desfilhar+V.vós.AD.2.PL+IMP+3+PL
desfilhe-nos	desfilhar+nós.AD.1.PL+IMP+3+SG
desfilhe-o	desfilhar+V.ele.ACC.3.M.SG+IMP+3+SG
desfilhe-os	desfilhar+V.ele.ACC.3.M.PL+IMP+3+SG
desfilhe-se	desfilhar+V.ele.REFL+IMP+3+SG
desfilhe-te	desfilhar+V.tu.AD.2.SG+IMP+3+SG
desfilhe-vos	desfilhar+V.vós.AD.2.PL+IMP+3+SG
desfilho-a	desfilhar+V.ele.ACC.3.F.SG+PRS+1+SG
desfilho-as	desfilhar+V.ele.ACC.3.F.PL+PRS+1+SG
desfilho-lhe	desfilhar+V.ele.DAT.3.SG+PRS+1+SG
desfilho-lhes	desfilhar+V.ele.DAT.3.PL+PRS+1+SG
desfilho-me	desfilhar+V.eu.AD.1.SG+PRS+1+SG
desfilho-nos	desfilhar+nós.AD.1.PL+PRS+1+SG
desfilho-o	desfilhar+V.ele.ACC.3.M.SG+PRS+1+SG
desfilho-os	desfilhar+V.ele.ACC.3.M.PL+PRS+1+SG
desfilho-te	desfilhar+V.tu.AD.2.SG+PRS+1+SG
desfilhou-a	desfilhar+V.ele.ACC.3.F.SG+PRF+3+SG
desfilhou-as	desfilhar+V.ele.ACC.3.F.PL+PRF+3+SG
desfilhou-lhe	desfilhar+V.ele.DAT.3.SG+PRF+3+SG
desfilhou-lhes	desfilhar+V.ele.DAT.3.PL+PRF+3+SG
desfilhou-me	desfilhar+V.eu.AD.1.SG+PRF+3+SG
desfilhou-nos	desfilhar+nós.AD.1.PL+PRF+3+SG
desfilhou-o	desfilhar+V.ele.ACC.3.M.SG+PRF+3+SG
desfilhou-os	desfilhar+V.ele.ACC.3.M.PL+PRF+3+SG
desfilhou-se	desfilhar+V.ele.REFL+PRF+3+SG
desfilhou-te	desfilhar+V.tu.AD.2.SG+PRF+3+SG
desfilhou-vos	desfilhar+V.vós.AD.2.PL+PRF+3+SG
desfilho-vos	desfilhar+V.vós.AD.2.PL+PRS+1+SG
desfilo-a	desfilar+V.ele.ACC.3.F.SG+PRS+1+SG
desfilo-as	desfilar+V.ele.ACC.3.F.PL+PRS+1+SG
desfi-lo	desfazer+V.ele.ACC.3.M.SG+PRF+1+SG
desfilo-lhe	desfilar+V.ele.DAT.3.SG+PRS+1+SG
desfilo-lhes	desfilar+V.ele.DAT.3.PL+PRS+1+SG
desfilo-me	desfilar+V.eu.AD.1.SG+PRS+1+SG
desfilo-nos	desfilar+nós.AD.1.PL+PRS+1+SG
desfilo-o	desfilar+V.ele.ACC.3.M.SG+PRS+1+SG
desfilo-os	desfilar+V.ele.ACC.3.M.PL+PRS+1+SG
desfi-los	desfazer+V.ele.ACC.3.M.PL+PRF+1+SG
desfilo-te	desfilar+V.tu.AD.2.SG+PRS+1+SG
desfilou-a	desfilar+V.ele.ACC.3.F.SG+PRF+3+SG
desfilou-as	desfilar+V.ele.ACC.3.F.PL+PRF+3+SG
desfilou-lhe	desfilar+V.ele.DAT.3.SG+PRF+3+SG
desfilou-lhes	desfilar+V.ele.DAT.3.PL+PRF+3+SG
desfilou-me	desfilar+V.eu.AD.1.SG+PRF+3+SG
desfilou-nos	desfilar+nós.AD.1.PL+PRF+3+SG
desfilou-o	desfilar+V.ele.ACC.3.M.SG+PRF+3+SG
desfilou-os	desfilar+V.ele.ACC.3.M.PL+PRF+3+SG
desfilou-se	desfilar+V.ele.REFL+PRF+3+SG
desfilou-te	desfilar+V.tu.AD.2.SG+PRF+3+SG
desfilou-vos	desfilar+V.vós.AD.2.PL+PRF+3+SG
desfilo-vos	desfilar+V.vós.AD.2.PL+PRS+1+SG
desfio-a	desfiar+V.ele.ACC.3.F.SG+PRS+1+SG
desfio-as	desfiar+V.ele.ACC.3.F.PL+PRS+1+SG
desfio-lhe	desfiar+V.ele.DAT.3.SG+PRS+1+SG
desfio-lhes	desfiar+V.ele.DAT.3.PL+PRS+1+SG
desfio-me	desfiar+V.eu.AD.1.SG+PRS+1+SG
desfio-nos	desfiar+nós.AD.1.PL+PRS+1+SG
desfio-o	desfiar+V.ele.ACC.3.M.SG+PRS+1+SG
desfio-os	desfiar+V.ele.ACC.3.M.PL+PRS+1+SG
desfio-te	desfiar+V.tu.AD.2.SG+PRS+1+SG
desfiou-a	desfiar+V.ele.ACC.3.F.SG+PRF+3+SG
desfiou-as	desfiar+V.ele.ACC.3.F.PL+PRF+3+SG
desfiou-lhe	desfiar+V.ele.DAT.3.SG+PRF+3+SG
desfiou-lhes	desfiar+V.ele.DAT.3.PL+PRF+3+SG
desfiou-me	desfiar+V.eu.AD.1.SG+PRF+3+SG
desfiou-nos	desfiar+nós.AD.1.PL+PRF+3+SG
desfiou-o	desfiar+V.ele.ACC.3.M.SG+PRF+3+SG
desfiou-os	desfiar+V.ele.ACC.3.M.PL+PRF+3+SG
desfiou-se	desfiar+V.ele.REFL+PRF+3+SG
desfiou-te	desfiar+V.tu.AD.2.SG+PRF+3+SG
desfiou-vos	desfiar+V.vós.AD.2.PL+PRF+3+SG
desfio-vos	desfiar+V.vós.AD.2.PL+PRS+1+SG
desfira-a	desferir+V.ele.ACC.3.F.SG+IMP+3+SG
desfira-as	desferir+V.ele.ACC.3.F.PL+IMP+3+SG
desfira-lhe	desferir+V.ele.DAT.3.SG+IMP+3+SG
desfira-lhes	desferir+V.ele.DAT.3.PL+IMP+3+SG
desfira-me	desferir+V.eu.AD.1.SG+IMP+3+SG
desfiram-lhe	desferir+V.ele.DAT.3.SG+IMP+3+PL
desfiram-lhes	desferir+V.ele.DAT.3.PL+IMP+3+PL
desfiram-me	desferir+V.eu.AD.1.SG+IMP+3+PL
desfiram-na	desferir+V.ele.ACC.3.F.SG+IMP+3+PL
desfiram-nas	desferir+V.ele.ACC.3.F.PL+IMP+3+PL
desfiram-no	desferir+V.ele.ACC.3.M.SG+IMP+3+PL
desfiram-nos	desferir+V.ele.ACC.3.M.PL+IMP+3+PL
desfiram-nos	desferir+V.nós.AD.1.PL+IMP+3+PL
desfiramo-la	desferir+V.ele.ACC.3.F.SG+IMP+1+PL
desfiramo-las	desferir+V.ele.ACC.3.F.PL+IMP+1+PL
desfiramo-lo	desferir+V.ele.ACC.3.M.SG+IMP+1+PL
desfiramo-los	desferir+V.ele.ACC.3.M.PL+IMP+1+PL
desfiramo-nos	desferir+nós.AD.1.PL+IMP+1+PL
desfiramos-lhe	desferir+V.ele.DAT.3.SG+IMP+1+PL
desfiramos-lhes	desferir+V.ele.DAT.3.PL+IMP+1+PL
desfiramos-me	desferir+V.eu.AD.1.SG+IMP+1+PL
desfiramos-te	desferir+V.tu.AD.2.SG+IMP+1+PL
desfiramos-vos	desferir+V.vós.AD.2.PL+IMP+1+PL
desfiram-se	desferir+V.ele.REFL+IMP+3+PL
desfiram-te	desferir+V.tu.AD.2.SG+IMP+3+PL
desfiram-vos	desferir+V.vós.AD.2.PL+IMP+3+PL
desfira-nos	desferir+nós.AD.1.PL+IMP+3+SG
desfira-o	desferir+V.ele.ACC.3.M.SG+IMP+3+SG
desfira-os	desferir+V.ele.ACC.3.M.PL+IMP+3+SG
desfira-se	desferir+V.ele.REFL+IMP+3+SG
desfira-te	desferir+V.tu.AD.2.SG+IMP+3+SG
desfira-vos	desferir+V.vós.AD.2.PL+IMP+3+SG
desfiro-a	desferir+V.ele.ACC.3.F.SG+PRS+1+SG
desfiro-as	desferir+V.ele.ACC.3.F.PL+PRS+1+SG
desfiro-lhe	desferir+V.ele.DAT.3.SG+PRS+1+SG
desfiro-lhes	desferir+V.ele.DAT.3.PL+PRS+1+SG
desfiro-me	desferir+V.eu.AD.1.SG+PRS+1+SG
desfiro-nos	desferir+nós.AD.1.PL+PRS+1+SG
desfiro-o	desferir+V.ele.ACC.3.M.SG+PRS+1+SG
desfiro-os	desferir+V.ele.ACC.3.M.PL+PRS+1+SG
desfiro-te	desferir+V.tu.AD.2.SG+PRS+1+SG
desfiro-vos	desferir+V.vós.AD.2.PL+PRS+1+SG
desfita-a	desfitar+V.ele.ACC.3.F.SG+PRS+3+SG
desfita-as	desfitar+V.ele.ACC.3.F.PL+PRS+3+SG
desfitai-la	desfitar+V.ele.ACC.3.F.SG+PRS+2+PL
desfitai-las	desfitar+V.ele.ACC.3.F.PL+PRS+2+PL
desfitai-lo	desfitar+V.ele.ACC.3.M.SG+PRS+2+PL
desfitai-los	desfitar+V.ele.ACC.3.M.PL+PRS+2+PL
desfitai-nos	desfitar+nós.AD.1.PL+PRS+2+PL
desfitais-lhe	desfitar+V.ele.DAT.3.SG+PRS+2+PL
desfitais-lhes	desfitar+V.ele.DAT.3.PL+PRS+2+PL
desfitais-me	desfitar+V.eu.AD.1.SG+PRS+2+PL
desfitais-te	desfitar+V.tu.AD.2.SG+PRS+2+PL
desfitais-vos	desfitar+V.vós.AD.2.PL+PRS+2+PL
desfitá-la-á	desfitar+V.ele.ACC.3.F.SG+FUT+3+SG
desfitá-la-ão	desfitar+V.ele.ACC.3.F.SG+FUT+3+PL
desfitá-la-ás	desfitar+V.ele.ACC.3.F.SG+FUT+2+SG
desfitá-la	desfitar+V.ele.ACC.3.F.SG+INF+1+SG
desfitá-la	desfitar+V.ele.ACC.3.F.SG+INF+3+SG
desfita-la	desfitar+V.ele.ACC.3.F.SG+PRS+2+SG
desfitá-la	desfitar+V.ele.ACC.3.F.SG+SBJF+1+SG
desfitá-la	desfitar+V.ele.ACC.3.F.SG+SBJF+3+SG
desfitá-la-ei	desfitar+V.ele.ACC.3.F.SG+FUT+1+SG
desfitá-la-eis	desfitar+V.ele.ACC.3.F.SG+FUT+2+PL
desfitá-la-emos	desfitar+V.ele.ACC.3.F.SG+FUT+1+PL
desfitá-la-ia	desfitar+V.ele.ACC.3.F.SG+COND+1+SG
desfitá-la-ia	desfitar+V.ele.ACC.3.F.SG+COND+3+SG
desfitá-la-iam	desfitar+V.ele.ACC.3.F.SG+COND+3+PL
desfitá-la-íamos	desfitar+V.ele.ACC.3.F.SG+COND+1+PL
desfitá-la-ias	desfitar+V.ele.ACC.3.F.SG+COND+2+SG
desfitá-la-íeis	desfitar+V.ele.ACC.3.F.SG+COND+2+PL
desfitá-las-á	desfitar+V.ele.ACC.3.F.PL+FUT+3+SG
desfitá-las-ão	desfitar+V.ele.ACC.3.F.PL+FUT+3+PL
desfitá-las-ás	desfitar+V.ele.ACC.3.F.PL+FUT+2+SG
desfitá-las	desfitar+V.ele.ACC.3.F.PL+INF+1+SG
desfitá-las	desfitar+V.ele.ACC.3.F.PL+INF+3+SG
desfita-las	desfitar+V.ele.ACC.3.F.PL+PRS+2+SG
desfitá-las	desfitar+V.ele.ACC.3.F.PL+SBJF+1+SG
desfitá-las	desfitar+V.ele.ACC.3.F.PL+SBJF+3+SG
desfitá-las-ei	desfitar+V.ele.ACC.3.F.PL+FUT+1+SG
desfitá-las-eis	desfitar+V.ele.ACC.3.F.PL+FUT+2+PL
desfitá-las-emos	desfitar+V.ele.ACC.3.F.PL+FUT+1+PL
desfitá-las-ia	desfitar+V.ele.ACC.3.F.PL+COND+1+SG
desfitá-las-ia	desfitar+V.ele.ACC.3.F.PL+COND+3+SG
desfitá-las-iam	desfitar+V.ele.ACC.3.F.PL+COND+3+PL
desfitá-las-íamos	desfitar+V.ele.ACC.3.F.PL+COND+1+PL
desfitá-las-ias	desfitar+V.ele.ACC.3.F.PL+COND+2+SG
desfitá-las-íeis	desfitar+V.ele.ACC.3.F.PL+COND+2+PL
desfita-lhe	desfitar+V.ele.DAT.3.SG+PRS+3+SG
desfita-lhes	desfitar+V.ele.DAT.3.PL+PRS+3+SG
desfitá-lo-á	desfitar+V.ele.ACC.3.M.SG+FUT+3+SG
desfitá-lo-ão	desfitar+V.ele.ACC.3.M.SG+FUT+3+PL
desfitá-lo-ás	desfitar+V.ele.ACC.3.M.SG+FUT+2+SG
desfitá-lo	desfitar+V.ele.ACC.3.M.SG+INF+1+SG
desfitá-lo	desfitar+V.ele.ACC.3.M.SG+INF+3+SG
desfita-lo	desfitar+V.ele.ACC.3.M.SG+PRS+2+SG
desfitá-lo	desfitar+V.ele.ACC.3.M.SG+SBJF+1+SG
desfitá-lo	desfitar+V.ele.ACC.3.M.SG+SBJF+3+SG
desfitá-lo-ei	desfitar+V.ele.ACC.3.M.SG+FUT+1+SG
desfitá-lo-eis	desfitar+V.ele.ACC.3.M.SG+FUT+2+PL
desfitá-lo-emos	desfitar+V.ele.ACC.3.M.SG+FUT+1+PL
desfitá-lo-ia	desfitar+V.ele.ACC.3.M.SG+COND+1+SG
desfitá-lo-ia	desfitar+V.ele.ACC.3.M.SG+COND+3+SG
desfitá-lo-iam	desfitar+V.ele.ACC.3.M.SG+COND+3+PL
desfitá-lo-íamos	desfitar+V.ele.ACC.3.M.SG+COND+1+PL
desfitá-lo-ias	desfitar+V.ele.ACC.3.M.SG+COND+2+SG
desfitá-lo-íeis	desfitar+V.ele.ACC.3.M.SG+COND+2+PL
desfitá-los-á	desfitar+V.ele.ACC.3.M.PL+FUT+3+SG
desfitá-los-ão	desfitar+V.ele.ACC.3.M.PL+FUT+3+PL
desfitá-los-ás	desfitar+V.ele.ACC.3.M.PL+FUT+2+SG
desfitá-los	desfitar+V.ele.ACC.3.M.PL+INF+1+SG
desfitá-los	desfitar+V.ele.ACC.3.M.PL+INF+3+SG
desfita-los	desfitar+V.ele.ACC.3.M.PL+PRS+2+SG
desfitá-los	desfitar+V.ele.ACC.3.M.PL+SBJF+1+SG
desfitá-los	desfitar+V.ele.ACC.3.M.PL+SBJF+3+SG
desfitá-los-ei	desfitar+V.ele.ACC.3.M.PL+FUT+1+SG
desfitá-los-eis	desfitar+V.ele.ACC.3.M.PL+FUT+2+PL
desfitá-los-emos	desfitar+V.ele.ACC.3.M.PL+FUT+1+PL
desfitá-los-ia	desfitar+V.ele.ACC.3.M.PL+COND+1+SG
desfitá-los-ia	desfitar+V.ele.ACC.3.M.PL+COND+3+SG
desfitá-los-iam	desfitar+V.ele.ACC.3.M.PL+COND+3+PL
desfitá-los-íamos	desfitar+V.ele.ACC.3.M.PL+COND+1+PL
desfitá-los-ias	desfitar+V.ele.ACC.3.M.PL+COND+2+SG
desfitá-los-íeis	desfitar+V.ele.ACC.3.M.PL+COND+2+PL
desfita-me	desfitar+V.eu.AD.1.SG+PRS+3+SG
desfitam-lhe	desfitar+V.ele.DAT.3.SG+PRS+3+PL
desfitam-lhes	desfitar+V.ele.DAT.3.PL+PRS+3+PL
desfitam-me	desfitar+V.eu.AD.1.SG+PRS+3+PL
desfitam-na	desfitar+V.ele.ACC.3.F.SG+PRS+3+PL
desfitam-nas	desfitar+V.ele.ACC.3.F.PL+PRS+3+PL
desfitam-no	desfitar+V.ele.ACC.3.M.SG+PRS+3+PL
desfitam-nos	desfitar+V.ele.ACC.3.M.PL+PRS+3+PL
desfitam-nos	desfitar+V.nós.AD.1.PL+PRS+3+PL
desfitamo-la	desfitar+V.ele.ACC.3.F.SG+PRF+1+PL
desfitamo-la	desfitar+V.ele.ACC.3.F.SG+PRS+1+PL
desfitamo-las	desfitar+V.ele.ACC.3.F.PL+PRF+1+PL
desfitamo-las	desfitar+V.ele.ACC.3.F.PL+PRS+1+PL
desfitamo-lo	desfitar+V.ele.ACC.3.M.SG+PRF+1+PL
desfitamo-lo	desfitar+V.ele.ACC.3.M.SG+PRS+1+PL
desfitamo-los	desfitar+V.ele.ACC.3.M.PL+PRF+1+PL
desfitamo-los	desfitar+V.ele.ACC.3.M.PL+PRS+1+PL
desfitamo-nos	desfitar+nós.AD.1.PL+PRF+1+PL
desfitamo-nos	desfitar+nós.AD.1.PL+PRS+1+PL
desfitamos-lhe	desfitar+V.ele.DAT.3.SG+PRF+1+PL
desfitamos-lhe	desfitar+V.ele.DAT.3.SG+PRS+1+PL
desfitamos-lhes	desfitar+V.ele.DAT.3.PL+PRF+1+PL
desfitamos-lhes	desfitar+V.ele.DAT.3.PL+PRS+1+PL
desfitamos-me	desfitar+V.eu.AD.1.SG+PRF+1+PL
desfitamos-me	desfitar+V.eu.AD.1.SG+PRS+1+PL
desfitamos-te	desfitar+V.tu.AD.2.SG+PRF+1+PL
desfitamos-te	desfitar+V.tu.AD.2.SG+PRS+1+PL
desfitamos-vos	desfitar+V.vós.AD.2.PL+PRF+1+PL
desfitamos-vos	desfitar+V.vós.AD.2.PL+PRS+1+PL
desfitam-se	desfitar+V.ele.REFL+PRS+3+PL
desfitam-te	desfitar+V.tu.AD.2.SG+PRS+3+PL
desfitam-vos	desfitar+V.vós.AD.2.PL+PRS+3+PL
desfitando-a	desfitar+V.ele.ACC.3.F.SG+GRD
desfitando-as	desfitar+V.ele.ACC.3.F.PL+GRD
desfitando-lhe	desfitar+V.ele.DAT.3.SG+GRD
desfitando-lhes	desfitar+V.ele.DAT.3.PL+GRD
desfitando-me	desfitar+V.eu.AD.1.SG+GRD
desfitando-nos	desfitar+nós.AD.1.PL+GRD
desfitando-o	desfitar+V.ele.ACC.3.M.SG+GRD
desfitando-os	desfitar+V.ele.ACC.3.M.PL+GRD
desfitando-se	desfitar+V.ele.REFL+GRD
desfitando-te	desfitar+V.tu.AD.2.SG+GRD
desfitando-vos	desfitar+V.vós.AD.2.PL+GRD
desfita-nos	desfitar+nós.AD.1.PL+PRS+2+SG
desfita-nos	desfitar+nós.AD.1.PL+PRS+3+SG
desfita-o	desfitar+V.ele.ACC.3.M.SG+PRS+3+SG
desfita-os	desfitar+V.ele.ACC.3.M.PL+PRS+3+SG
desfitara-a	desfitar+V.ele.ACC.3.F.SG+PQP+1+SG
desfitara-a	desfitar+V.ele.ACC.3.F.SG+PQP+3+SG
desfitara-as	desfitar+V.ele.ACC.3.F.PL+PQP+1+SG
desfitara-as	desfitar+V.ele.ACC.3.F.PL+PQP+3+SG
desfitara-la	desfitar+V.ele.ACC.3.F.SG+PQP+2+SG
desfitara-las	desfitar+V.ele.ACC.3.F.PL+PQP+2+SG
desfitara-lhe	desfitar+V.ele.DAT.3.SG+PQP+1+SG
desfitara-lhe	desfitar+V.ele.DAT.3.SG+PQP+3+SG
desfitara-lhes	desfitar+V.ele.DAT.3.PL+PQP+1+SG
desfitara-lhes	desfitar+V.ele.DAT.3.PL+PQP+3+SG
desfitara-lo	desfitar+V.ele.ACC.3.M.SG+PQP+2+SG
desfitara-los	desfitar+V.ele.ACC.3.M.PL+PQP+2+SG
desfitara-me	desfitar+V.eu.AD.1.SG+PQP+1+SG
desfitara-me	desfitar+V.eu.AD.1.SG+PQP+3+SG
desfitaram-lhe	desfitar+V.ele.DAT.3.SG+PQP+3+PL
desfitaram-lhe	desfitar+V.ele.DAT.3.SG+PRF+3+PL
desfitaram-lhes	desfitar+V.ele.DAT.3.PL+PQP+3+PL
desfitaram-lhes	desfitar+V.ele.DAT.3.PL+PRF+3+PL
desfitaram-me	desfitar+V.eu.AD.1.SG+PQP+3+PL
desfitaram-me	desfitar+V.eu.AD.1.SG+PRF+3+PL
desfitaram-na	desfitar+V.ele.ACC.3.F.SG+PQP+3+PL
desfitaram-na	desfitar+V.ele.ACC.3.F.SG+PRF+3+PL
desfitaram-nas	desfitar+V.ele.ACC.3.F.PL+PQP+3+PL
desfitaram-nas	desfitar+V.ele.ACC.3.F.PL+PRF+3+PL
desfitaram-no	desfitar+V.ele.ACC.3.M.SG+PQP+3+PL
desfitaram-no	desfitar+V.ele.ACC.3.M.SG+PRF+3+PL
desfitaram-nos	desfitar+V.ele.ACC.3.M.PL+PQP+3+PL
desfitaram-nos	desfitar+V.ele.ACC.3.M.PL+PRF+3+PL
desfitaram-nos	desfitar+V.nós.AD.1.PL+PQP+3+PL
desfitaram-nos	desfitar+V.nós.AD.1.PL+PRF+3+PL
desfitáramo-la	desfitar+V.ele.ACC.3.F.SG+PQP+1+PL
desfitáramo-las	desfitar+V.ele.ACC.3.F.PL+PQP+1+PL
desfitáramo-lo	desfitar+V.ele.ACC.3.M.SG+PQP+1+PL
desfitáramo-los	desfitar+V.ele.ACC.3.M.PL+PQP+1+PL
desfitáramo-nos	desfitar+nós.AD.1.PL+PQP+1+PL
desfitáramos-lhe	desfitar+V.ele.DAT.3.SG+PQP+1+PL
desfitáramos-lhes	desfitar+V.ele.DAT.3.PL+PQP+1+PL
desfitáramos-me	desfitar+V.eu.AD.1.SG+PQP+1+PL
desfitáramos-te	desfitar+V.tu.AD.2.SG+PQP+1+PL
desfitáramos-vos	desfitar+V.vós.AD.2.PL+PQP+1+PL
desfitaram-se	desfitar+V.ele.REFL+PQP+3+PL
desfitaram-se	desfitar+V.ele.REFL+PRF+3+PL
desfitaram-te	desfitar+V.tu.AD.2.SG+PQP+3+PL
desfitaram-te	desfitar+V.tu.AD.2.SG+PRF+3+PL
desfitaram-vos	desfitar+V.vós.AD.2.PL+PQP+3+PL
desfitaram-vos	desfitar+V.vós.AD.2.PL+PRF+3+PL
desfitara-nos	desfitar+nós.AD.1.PL+PQP+1+SG
desfitara-nos	desfitar+nós.AD.1.PL+PQP+2+SG
desfitara-nos	desfitar+nós.AD.1.PL+PQP+3+SG
desfitara-o	desfitar+V.ele.ACC.3.M.SG+PQP+1+SG
desfitara-o	desfitar+V.ele.ACC.3.M.SG+PQP+3+SG
desfitara-os	desfitar+V.ele.ACC.3.M.PL+PQP+1+SG
desfitara-os	desfitar+V.ele.ACC.3.M.PL+PQP+3+SG
desfitara-se	desfitar+V.ele.REFL+PQP+1+SG
desfitara-se	desfitar+V.ele.REFL+PQP+3+SG
desfitaras-lhe	desfitar+V.ele.DAT.3.SG+PQP+2+SG
desfitaras-lhes	desfitar+V.ele.DAT.3.PL+PQP+2+SG
desfitaras-me	desfitar+V.eu.AD.1.SG+PQP+2+SG
desfitaras-te	desfitar+V.tu.AD.2.SG+PQP+2+SG
desfitaras-vos	desfitar+V.vós.AD.2.PL+PQP+2+SG
desfitara-te	desfitar+V.tu.AD.2.SG+PQP+1+SG
desfitara-te	desfitar+V.tu.AD.2.SG+PQP+3+SG
desfitara-vos	desfitar+V.vós.AD.2.PL+PQP+1+SG
desfitara-vos	desfitar+V.vós.AD.2.PL+PQP+3+SG
desfitarde-la	desfitar+V.ele.ACC.3.F.SG+INF+2+PL
desfitarde-la	desfitar+V.ele.ACC.3.F.SG+SBJF+2+PL
desfitarde-las	desfitar+V.ele.ACC.3.F.PL+INF+2+PL
desfitarde-las	desfitar+V.ele.ACC.3.F.PL+SBJF+2+PL
desfitarde-lo	desfitar+V.ele.ACC.3.M.SG+INF+2+PL
desfitarde-lo	desfitar+V.ele.ACC.3.M.SG+SBJF+2+PL
desfitarde-los	desfitar+V.ele.ACC.3.M.PL+INF+2+PL
desfitarde-los	desfitar+V.ele.ACC.3.M.PL+SBJF+2+PL
desfitarde-nos	desfitar+nós.AD.1.PL+INF+2+PL
desfitarde-nos	desfitar+nós.AD.1.PL+SBJF+2+PL
desfitardes-lhe	desfitar+V.ele.DAT.3.SG+INF+2+PL
desfitardes-lhe	desfitar+V.ele.DAT.3.SG+SBJF+2+PL
desfitardes-lhes	desfitar+V.ele.DAT.3.PL+INF+2+PL
desfitardes-lhes	desfitar+V.ele.DAT.3.PL+SBJF+2+PL
desfitardes-me	desfitar+V.eu.AD.1.SG+INF+2+PL
desfitardes-me	desfitar+V.eu.AD.1.SG+SBJF+2+PL
desfitardes-te	desfitar+V.tu.AD.2.SG+INF+2+PL
desfitardes-te	desfitar+V.tu.AD.2.SG+SBJF+2+PL
desfitardes-vos	desfitar+V.vós.AD.2.PL+INF+2+PL
desfitardes-vos	desfitar+V.vós.AD.2.PL+SBJF+2+PL
desfitárei-la	desfitar+V.ele.ACC.3.F.SG+PQP+2+PL
desfitárei-las	desfitar+V.ele.ACC.3.F.PL+PQP+2+PL
desfitárei-lo	desfitar+V.ele.ACC.3.M.SG+PQP+2+PL
desfitárei-los	desfitar+V.ele.ACC.3.M.PL+PQP+2+PL
desfitárei-nos	desfitar+nós.AD.1.PL+PQP+2+PL
desfitáreis-lhe	desfitar+V.ele.DAT.3.SG+PQP+2+PL
desfitáreis-lhes	desfitar+V.ele.DAT.3.PL+PQP+2+PL
desfitáreis-me	desfitar+V.eu.AD.1.SG+PQP+2+PL
desfitáreis-te	desfitar+V.tu.AD.2.SG+PQP+2+PL
desfitáreis-vos	desfitar+V.vós.AD.2.PL+PQP+2+PL
desfitare-la	desfitar+V.ele.ACC.3.F.SG+INF+2+SG
desfitare-la	desfitar+V.ele.ACC.3.F.SG+SBJF+2+SG
desfitare-las	desfitar+V.ele.ACC.3.F.PL+INF+2+SG
desfitare-las	desfitar+V.ele.ACC.3.F.PL+SBJF+2+SG
desfitare-lo	desfitar+V.ele.ACC.3.M.SG+INF+2+SG
desfitare-lo	desfitar+V.ele.ACC.3.M.SG+SBJF+2+SG
desfitare-los	desfitar+V.ele.ACC.3.M.PL+INF+2+SG
desfitare-los	desfitar+V.ele.ACC.3.M.PL+SBJF+2+SG
desfitarem-lhe	desfitar+V.ele.DAT.3.SG+INF+3+PL
desfitarem-lhe	desfitar+V.ele.DAT.3.SG+SBJF+3+PL
desfitarem-lhes	desfitar+V.ele.DAT.3.PL+INF+3+PL
desfitarem-lhes	desfitar+V.ele.DAT.3.PL+SBJF+3+PL
desfitarem-me	desfitar+V.eu.AD.1.SG+INF+3+PL
desfitarem-me	desfitar+V.eu.AD.1.SG+SBJF+3+PL
desfitarem-na	desfitar+V.ele.ACC.3.F.SG+INF+3+PL
desfitarem-na	desfitar+V.ele.ACC.3.F.SG+SBJF+3+PL
desfitarem-nas	desfitar+V.ele.ACC.3.F.PL+INF+3+PL
desfitarem-nas	desfitar+V.ele.ACC.3.F.PL+SBJF+3+PL
desfitarem-no	desfitar+V.ele.ACC.3.M.SG+INF+3+PL
desfitarem-no	desfitar+V.ele.ACC.3.M.SG+SBJF+3+PL
desfitarem-nos	desfitar+V.ele.ACC.3.M.PL+INF+3+PL
desfitarem-nos	desfitar+V.ele.ACC.3.M.PL+SBJF+3+PL
desfitarem-nos	desfitar+V.nós.AD.1.PL+INF+3+PL
desfitarem-nos	desfitar+V.nós.AD.1.PL+SBJF+3+PL
desfitarem-se	desfitar+V.ele.REFL+INF+3+PL
desfitarem-se	desfitar+V.ele.REFL+SBJF+3+PL
desfitarem-te	desfitar+V.tu.AD.2.SG+INF+3+PL
desfitarem-te	desfitar+V.tu.AD.2.SG+SBJF+3+PL
desfitarem-vos	desfitar+V.vós.AD.2.PL+INF+3+PL
desfitarem-vos	desfitar+V.vós.AD.2.PL+SBJF+3+PL
desfitare-nos	desfitar+nós.AD.1.PL+INF+2+SG
desfitare-nos	desfitar+nós.AD.1.PL+SBJF+2+SG
desfitares-lhe	desfitar+V.ele.DAT.3.SG+INF+2+SG
desfitares-lhe	desfitar+V.ele.DAT.3.SG+SBJF+2+SG
desfitares-lhes	desfitar+V.ele.DAT.3.PL+INF+2+SG
desfitares-lhes	desfitar+V.ele.DAT.3.PL+SBJF+2+SG
desfitares-me	desfitar+V.eu.AD.1.SG+INF+2+SG
desfitares-me	desfitar+V.eu.AD.1.SG+SBJF+2+SG
desfitares-te	desfitar+V.tu.AD.2.SG+INF+2+SG
desfitares-te	desfitar+V.tu.AD.2.SG+SBJF+2+SG
desfitares-vos	desfitar+V.vós.AD.2.PL+INF+2+SG
desfitares-vos	desfitar+V.vós.AD.2.PL+SBJF+2+SG
desfitar-lhe-á	desfitar+V.ele.DAT.3.SG+FUT+3+SG
desfitar-lhe-ão	desfitar+V.ele.DAT.3.SG+FUT+3+PL
desfitar-lhe-ás	desfitar+V.ele.DAT.3.SG+FUT+2+SG
desfitar-lhe	desfitar+V.ele.DAT.3.SG+INF
desfitar-lhe	desfitar+V.ele.DAT.3.SG+INF+1+SG
desfitar-lhe	desfitar+V.ele.DAT.3.SG+INF+3+SG
desfitar-lhe	desfitar+V.ele.DAT.3.SG+SBJF+1+SG
desfitar-lhe	desfitar+V.ele.DAT.3.SG+SBJF+3+SG
desfitar-lhe-ei	desfitar+V.ele.DAT.3.SG+FUT+1+SG
desfitar-lhe-eis	desfitar+V.ele.DAT.3.SG+FUT+2+PL
desfitar-lhe-emos	desfitar+V.ele.DAT.3.SG+FUT+1+PL
desfitar-lhe-ia	desfitar+V.ele.DAT.3.SG+COND+1+SG
desfitar-lhe-ia	desfitar+V.ele.DAT.3.SG+COND+3+SG
desfitar-lhe-iam	desfitar+V.ele.DAT.3.SG+COND+3+PL
desfitar-lhe-íamos	desfitar+V.ele.DAT.3.SG+COND+1+PL
desfitar-lhe-ias	desfitar+V.ele.DAT.3.SG+COND+2+SG
desfitar-lhe-íeis	desfitar+V.ele.DAT.3.SG+COND+2+PL
desfitar-lhes-á	desfitar+V.ele.DAT.3.PL+FUT+3+SG
desfitar-lhes-ão	desfitar+V.ele.DAT.3.PL+FUT+3+PL
desfitar-lhes-ás	desfitar+V.ele.DAT.3.PL+FUT+2+SG
desfitar-lhes	desfitar+V.ele.DAT.3.PL+INF
desfitar-lhes	desfitar+V.ele.DAT.3.PL+INF+1+SG
desfitar-lhes	desfitar+V.ele.DAT.3.PL+INF+3+SG
desfitar-lhes	desfitar+V.ele.DAT.3.PL+SBJF+1+SG
desfitar-lhes	desfitar+V.ele.DAT.3.PL+SBJF+3+SG
desfitar-lhes-ei	desfitar+V.ele.DAT.3.PL+FUT+1+SG
desfitar-lhes-eis	desfitar+V.ele.DAT.3.PL+FUT+2+PL
desfitar-lhes-emos	desfitar+V.ele.DAT.3.PL+FUT+1+PL
desfitar-lhes-ia	desfitar+V.ele.DAT.3.PL+COND+1+SG
desfitar-lhes-ia	desfitar+V.ele.DAT.3.PL+COND+3+SG
desfitar-lhes-iam	desfitar+V.ele.DAT.3.PL+COND+3+PL
desfitar-lhes-íamos	desfitar+V.ele.DAT.3.PL+COND+1+PL
desfitar-lhes-ias	desfitar+V.ele.DAT.3.PL+COND+2+SG
desfitar-lhes-íeis	desfitar+V.ele.DAT.3.PL+COND+2+PL
desfitar-me-á	desfitar+V.eu.AD.1.SG+FUT+3+SG
desfitar-me-ão	desfitar+V.eu.AD.1.SG+FUT+3+PL
desfitar-me-ás	desfitar+V.eu.AD.1.SG+FUT+2+SG
desfitar-me	desfitar+V.eu.AD.1.SG+INF
desfitar-me	desfitar+V.eu.AD.1.SG+INF+1+SG
desfitar-me	desfitar+V.eu.AD.1.SG+INF+3+SG
desfitar-me	desfitar+V.eu.AD.1.SG+SBJF+1+SG
desfitar-me	desfitar+V.eu.AD.1.SG+SBJF+3+SG
desfitar-me-ei	desfitar+V.eu.AD.1.SG+FUT+1+SG
desfitar-me-eis	desfitar+V.eu.AD.1.SG+FUT+2+PL
desfitar-me-emos	desfitar+V.eu.AD.1.SG+FUT+1+PL
desfitar-me-ia	desfitar+V.eu.AD.1.SG+COND+1+SG
desfitar-me-ia	desfitar+V.eu.AD.1.SG+COND+3+SG
desfitar-me-iam	desfitar+V.eu.AD.1.SG+COND+3+PL
desfitar-me-íamos	desfitar+V.eu.AD.1.SG+COND+1+PL
desfitar-me-ias	desfitar+V.eu.AD.1.SG+COND+2+SG
desfitar-me-íeis	desfitar+V.eu.AD.1.SG+COND+2+PL
desfitarmo-la	desfitar+V.ele.ACC.3.F.SG+INF+1+PL
desfitarmo-la	desfitar+V.ele.ACC.3.F.SG+SBJF+1+PL
desfitarmo-las	desfitar+V.ele.ACC.3.F.PL+INF+1+PL
desfitarmo-las	desfitar+V.ele.ACC.3.F.PL+SBJF+1+PL
desfitarmo-lo	desfitar+V.ele.ACC.3.M.SG+INF+1+PL
desfitarmo-lo	desfitar+V.ele.ACC.3.M.SG+SBJF+1+PL
desfitarmo-los	desfitar+V.ele.ACC.3.M.PL+INF+1+PL
desfitarmo-los	desfitar+V.ele.ACC.3.M.PL+SBJF+1+PL
desfitarmo-nos	desfitar+nós.AD.1.PL+INF+1+PL
desfitarmo-nos	desfitar+nós.AD.1.PL+SBJF+1+PL
desfitarmos-lhe	desfitar+V.ele.DAT.3.SG+INF+1+PL
desfitarmos-lhe	desfitar+V.ele.DAT.3.SG+SBJF+1+PL
desfitarmos-lhes	desfitar+V.ele.DAT.3.PL+INF+1+PL
desfitarmos-lhes	desfitar+V.ele.DAT.3.PL+SBJF+1+PL
desfitarmos-me	desfitar+V.eu.AD.1.SG+INF+1+PL
desfitarmos-me	desfitar+V.eu.AD.1.SG+SBJF+1+PL
desfitarmos-te	desfitar+V.tu.AD.2.SG+INF+1+PL
desfitarmos-te	desfitar+V.tu.AD.2.SG+SBJF+1+PL
desfitarmos-vos	desfitar+V.vós.AD.2.PL+INF+1+PL
desfitarmos-vos	desfitar+V.vós.AD.2.PL+SBJF+1+PL
desfitar-nos-á	desfitar+nós.AD.1.PL+FUT+3+SG
desfitar-nos-ão	desfitar+nós.AD.1.PL+FUT+3+PL
desfitar-nos-ás	desfitar+nós.AD.1.PL+FUT+2+SG
desfitar-nos	desfitar+nós.AD.1.PL+INF
desfitar-nos	desfitar+nós.AD.1.PL+INF+1+SG
desfitar-nos	desfitar+nós.AD.1.PL+INF+3+SG
desfitar-nos	desfitar+nós.AD.1.PL+SBJF+1+SG
desfitar-nos	desfitar+nós.AD.1.PL+SBJF+3+SG
desfitar-nos-ei	desfitar+nós.AD.1.PL+FUT+1+SG
desfitar-nos-eis	desfitar+nós.AD.1.PL+FUT+2+PL
desfitar-nos-emos	desfitar+nós.AD.1.PL+FUT+1+PL
desfitar-nos-ia	desfitar+nós.AD.1.PL+COND+1+SG
desfitar-nos-ia	desfitar+nós.AD.1.PL+COND+3+SG
desfitar-nos-iam	desfitar+nós.AD.1.PL+COND+3+PL
desfitar-nos-íamos	desfitar+nós.AD.1.PL+COND+1+PL
desfitar-nos-ias	desfitar+nós.AD.1.PL+COND+2+SG
desfitar-nos-íeis	desfitar+nós.AD.1.PL+COND+2+PL
desfitar-se-á	desfitar+V.ele.REFL+FUT+3+SG
desfitar-se-ão	desfitar+V.ele.REFL+FUT+3+PL
desfitar-se	desfitar+V.ele.REFL+INF
desfitar-se	desfitar+V.ele.REFL+INF+3+SG
desfitar-se	desfitar+V.ele.REFL+SBJF+3+SG
desfitar-se-ia	desfitar+V.ele.REFL+COND+3+SG
desfitar-se-iam	desfitar+V.ele.REFL+COND+3+PL
desfitar-te-á	desfitar+V.tu.AD.2.SG+FUT+3+SG
desfitar-te-ão	desfitar+V.tu.AD.2.SG+FUT+3+PL
desfitar-te-ás	desfitar+V.tu.AD.2.SG+FUT+2+SG
desfitar-te	desfitar+V.tu.AD.2.SG+INF
desfitar-te	desfitar+V.tu.AD.2.SG+INF+1+SG
desfitar-te	desfitar+V.tu.AD.2.SG+INF+3+SG
desfitar-te	desfitar+V.tu.AD.2.SG+SBJF+1+SG
desfitar-te	desfitar+V.tu.AD.2.SG+SBJF+3+SG
desfitar-te-ei	desfitar+V.tu.AD.2.SG+FUT+1+SG
desfitar-te-eis	desfitar+V.tu.AD.2.SG+FUT+2+PL
desfitar-te-emos	desfitar+V.tu.AD.2.SG+FUT+1+PL
desfitar-te-ia	desfitar+V.tu.AD.2.SG+COND+1+SG
desfitar-te-ia	desfitar+V.tu.AD.2.SG+COND+3+SG
desfitar-te-iam	desfitar+V.tu.AD.2.SG+COND+3+PL
desfitar-te-íamos	desfitar+V.tu.AD.2.SG+COND+1+PL
desfitar-te-ias	desfitar+V.tu.AD.2.SG+COND+2+SG
desfitar-te-íeis	desfitar+V.tu.AD.2.SG+COND+2+PL
desfitar-vos-á	desfitar+V.vós.AD.2.PL+FUT+3+SG
desfitar-vos-ão	desfitar+V.vós.AD.2.PL+FUT+3+PL
desfitar-vos-ás	desfitar+V.vós.AD.2.PL+FUT+2+SG
desfitar-vos	desfitar+V.vós.AD.2.PL+INF
desfitar-vos	desfitar+V.vós.AD.2.PL+INF+1+SG
desfitar-vos	desfitar+V.vós.AD.2.PL+INF+3+SG
desfitar-vos	desfitar+V.vós.AD.2.PL+SBJF+1+SG
desfitar-vos	desfitar+V.vós.AD.2.PL+SBJF+3+SG
desfitar-vos-ei	desfitar+V.vós.AD.2.PL+FUT+1+SG
desfitar-vos-eis	desfitar+V.vós.AD.2.PL+FUT+2+PL
desfitar-vos-emos	desfitar+V.vós.AD.2.PL+FUT+1+PL
desfitar-vos-ia	desfitar+V.vós.AD.2.PL+COND+1+SG
desfitar-vos-ia	desfitar+V.vós.AD.2.PL+COND+3+SG
desfitar-vos-iam	desfitar+V.vós.AD.2.PL+COND+3+PL
desfitar-vos-íamos	desfitar+V.vós.AD.2.PL+COND+1+PL
desfitar-vos-ias	desfitar+V.vós.AD.2.PL+COND+2+SG
desfitar-vos-íeis	desfitar+V.vós.AD.2.PL+COND+2+PL
desfita-se	desfitar+V.ele.REFL+PRS+3+SG
desfitas-lhe	desfitar+V.ele.DAT.3.SG+PRS+2+SG
desfitas-lhes	desfitar+V.ele.DAT.3.PL+PRS+2+SG
desfitas-me	desfitar+V.eu.AD.1.SG+PRS+2+SG
desfitaste-a	desfitar+V.ele.ACC.3.F.SG+PRF+2+SG
desfitaste-as	desfitar+V.ele.ACC.3.F.PL+PRF+2+SG
desfitas-te	desfitar+V.tu.AD.2.SG+PRS+2+SG
desfitaste-la	desfitar+V.ele.ACC.3.F.SG+PRF+2+PL
desfitaste-las	desfitar+V.ele.ACC.3.F.PL+PRF+2+PL
desfitaste-lhe	desfitar+V.ele.DAT.3.SG+PRF+2+SG
desfitaste-lhes	desfitar+V.ele.DAT.3.PL+PRF+2+SG
desfitaste-lo	desfitar+V.ele.ACC.3.M.SG+PRF+2+PL
desfitaste-los	desfitar+V.ele.ACC.3.M.PL+PRF+2+PL
desfitaste-me	desfitar+V.eu.AD.1.SG+PRF+2+SG
desfitaste-nos	desfitar+nós.AD.1.PL+PRF+2+PL
desfitaste-nos	desfitar+nós.AD.1.PL+PRF+2+SG
desfitaste-o	desfitar+V.ele.ACC.3.M.SG+PRF+2+SG
desfitaste-os	desfitar+V.ele.ACC.3.M.PL+PRF+2+SG
desfitastes-lhe	desfitar+V.ele.DAT.3.SG+PRF+2+PL
desfitastes-lhes	desfitar+V.ele.DAT.3.PL+PRF+2+PL
desfitastes-me	desfitar+V.eu.AD.1.SG+PRF+2+PL
desfitastes-te	desfitar+V.tu.AD.2.SG+PRF+2+PL
desfitastes-vos	desfitar+V.vós.AD.2.PL+PRF+2+PL
desfitaste-te	desfitar+V.tu.AD.2.SG+PRF+2+SG
desfitaste-vos	desfitar+V.vós.AD.2.PL+PRF+2+SG
desfitas-vos	desfitar+V.vós.AD.2.PL+PRS+2+SG
desfita-te	desfitar+V.tu.AD.2.SG+PRS+3+SG
desfitava-a	desfitar+V.ele.ACC.3.F.SG+IMPF+1+SG
desfitava-a	desfitar+V.ele.ACC.3.F.SG+IMPF+3+SG
desfitava-as	desfitar+V.ele.ACC.3.F.PL+IMPF+1+SG
desfitava-as	desfitar+V.ele.ACC.3.F.PL+IMPF+3+SG
desfitava-la	desfitar+V.ele.ACC.3.F.SG+IMPF+2+SG
desfitava-las	desfitar+V.ele.ACC.3.F.PL+IMPF+2+SG
desfitava-lhe	desfitar+V.ele.DAT.3.SG+IMPF+1+SG
desfitava-lhe	desfitar+V.ele.DAT.3.SG+IMPF+3+SG
desfitava-lhes	desfitar+V.ele.DAT.3.PL+IMPF+1+SG
desfitava-lhes	desfitar+V.ele.DAT.3.PL+IMPF+3+SG
desfitava-lo	desfitar+V.ele.ACC.3.M.SG+IMPF+2+SG
desfitava-los	desfitar+V.ele.ACC.3.M.PL+IMPF+2+SG
desfitava-me	desfitar+V.eu.AD.1.SG+IMPF+1+SG
desfitava-me	desfitar+V.eu.AD.1.SG+IMPF+3+SG
desfitavam-lhe	desfitar+V.ele.DAT.3.SG+IMPF+3+PL
desfitavam-lhes	desfitar+V.ele.DAT.3.PL+IMPF+3+PL
desfitavam-me	desfitar+V.eu.AD.1.SG+IMPF+3+PL
desfitavam-na	desfitar+V.ele.ACC.3.F.SG+IMPF+3+PL
desfitavam-nas	desfitar+V.ele.ACC.3.F.PL+IMPF+3+PL
desfitavam-no	desfitar+V.ele.ACC.3.M.SG+IMPF+3+PL
desfitavam-nos	desfitar+V.ele.ACC.3.M.PL+IMPF+3+PL
desfitavam-nos	desfitar+V.nós.AD.1.PL+IMPF+3+PL
desfitávamo-la	desfitar+V.ele.ACC.3.F.SG+IMPF+1+PL
desfitávamo-las	desfitar+V.ele.ACC.3.F.PL+IMPF+1+PL
desfitávamo-lo	desfitar+V.ele.ACC.3.M.SG+IMPF+1+PL
desfitávamo-los	desfitar+V.ele.ACC.3.M.PL+IMPF+1+PL
desfitávamo-nos	desfitar+nós.AD.1.PL+IMPF+1+PL
desfitávamos-lhe	desfitar+V.ele.DAT.3.SG+IMPF+1+PL
desfitávamos-lhes	desfitar+V.ele.DAT.3.PL+IMPF+1+PL
desfitávamos-me	desfitar+V.eu.AD.1.SG+IMPF+1+PL
desfitávamos-te	desfitar+V.tu.AD.2.SG+IMPF+1+PL
desfitávamos-vos	desfitar+V.vós.AD.2.PL+IMPF+1+PL
desfitavam-se	desfitar+V.ele.REFL+IMPF+3+PL
desfitavam-te	desfitar+V.tu.AD.2.SG+IMPF+3+PL
desfitavam-vos	desfitar+V.vós.AD.2.PL+IMPF+3+PL
desfitava-nos	desfitar+nós.AD.1.PL+IMPF+1+SG
desfitava-nos	desfitar+nós.AD.1.PL+IMPF+2+SG
desfitava-nos	desfitar+nós.AD.1.PL+IMPF+3+SG
desfitava-o	desfitar+V.ele.ACC.3.M.SG+IMPF+1+SG
desfitava-o	desfitar+V.ele.ACC.3.M.SG+IMPF+3+SG
desfitava-os	desfitar+V.ele.ACC.3.M.PL+IMPF+1+SG
desfitava-os	desfitar+V.ele.ACC.3.M.PL+IMPF+3+SG
desfitava-se	desfitar+V.ele.REFL+IMPF+1+SG
desfitava-se	desfitar+V.ele.REFL+IMPF+3+SG
desfitavas-lhe	desfitar+V.ele.DAT.3.SG+IMPF+2+SG
desfitavas-lhes	desfitar+V.ele.DAT.3.PL+IMPF+2+SG
desfitavas-me	desfitar+V.eu.AD.1.SG+IMPF+2+SG
desfitavas-te	desfitar+V.tu.AD.2.SG+IMPF+2+SG
desfitavas-vos	desfitar+V.vós.AD.2.PL+IMPF+2+SG
desfitava-te	desfitar+V.tu.AD.2.SG+IMPF+1+SG
desfitava-te	desfitar+V.tu.AD.2.SG+IMPF+3+SG
desfitava-vos	desfitar+V.vós.AD.2.PL+IMPF+1+SG
desfitava-vos	desfitar+V.vós.AD.2.PL+IMPF+3+SG
desfitávei-la	desfitar+V.ele.ACC.3.F.SG+IMPF+2+PL
desfitávei-las	desfitar+V.ele.ACC.3.F.PL+IMPF+2+PL
desfitávei-lo	desfitar+V.ele.ACC.3.M.SG+IMPF+2+PL
desfitávei-los	desfitar+V.ele.ACC.3.M.PL+IMPF+2+PL
desfitávei-nos	desfitar+nós.AD.1.PL+IMPF+2+PL
desfitáveis-lhe	desfitar+V.ele.DAT.3.SG+IMPF+2+PL
desfitáveis-lhes	desfitar+V.ele.DAT.3.PL+IMPF+2+PL
desfitáveis-me	desfitar+V.eu.AD.1.SG+IMPF+2+PL
desfitáveis-te	desfitar+V.tu.AD.2.SG+IMPF+2+PL
desfitáveis-vos	desfitar+V.vós.AD.2.PL+IMPF+2+PL
desfita-vos	desfitar+V.vós.AD.2.PL+PRS+3+SG
desfite-a	desfitar+V.ele.ACC.3.F.SG+IMP+3+SG
desfite-as	desfitar+V.ele.ACC.3.F.PL+IMP+3+SG
desfitei-a	desfitar+V.ele.ACC.3.F.SG+PRF+1+SG
desfitei-as	desfitar+V.ele.ACC.3.F.PL+PRF+1+SG
desfitei-lhe	desfitar+V.ele.DAT.3.SG+PRF+1+SG
desfitei-lhes	desfitar+V.ele.DAT.3.PL+PRF+1+SG
desfitei-me	desfitar+V.eu.AD.1.SG+PRF+1+SG
desfitei-nos	desfitar+nós.AD.1.PL+PRF+1+SG
desfitei-o	desfitar+V.ele.ACC.3.M.SG+PRF+1+SG
desfitei-os	desfitar+V.ele.ACC.3.M.PL+PRF+1+SG
desfitei-te	desfitar+V.tu.AD.2.SG+PRF+1+SG
desfitei-vos	desfitar+V.vós.AD.2.PL+PRF+1+SG
desfite-lhe	desfitar+V.ele.DAT.3.SG+IMP+3+SG
desfite-lhes	desfitar+V.ele.DAT.3.PL+IMP+3+SG
desfite-me	desfitar+V.eu.AD.1.SG+IMP+3+SG
desfitem-lhe	desfitar+V.ele.DAT.3.SG+IMP+3+PL
desfitem-lhes	desfitar+V.ele.DAT.3.PL+IMP+3+PL
desfitem-me	desfitar+V.eu.AD.1.SG+IMP+3+PL
desfitem-na	desfitar+V.ele.ACC.3.F.SG+IMP+3+PL
desfitem-nas	desfitar+V.ele.ACC.3.F.PL+IMP+3+PL
desfitem-no	desfitar+V.ele.ACC.3.M.SG+IMP+3+PL
desfitem-nos	desfitar+V.ele.ACC.3.M.PL+IMP+3+PL
desfitem-nos	desfitar+V.nós.AD.1.PL+IMP+3+PL
desfitemo-la	desfitar+V.ele.ACC.3.F.SG+IMP+1+PL
desfitemo-las	desfitar+V.ele.ACC.3.F.PL+IMP+1+PL
desfitemo-lo	desfitar+V.ele.ACC.3.M.SG+IMP+1+PL
desfitemo-los	desfitar+V.ele.ACC.3.M.PL+IMP+1+PL
desfitemo-nos	desfitar+nós.AD.1.PL+IMP+1+PL
desfitemos-lhe	desfitar+V.ele.DAT.3.SG+IMP+1+PL
desfitemos-lhes	desfitar+V.ele.DAT.3.PL+IMP+1+PL
desfitemos-me	desfitar+V.eu.AD.1.SG+IMP+1+PL
desfitemos-te	desfitar+V.tu.AD.2.SG+IMP+1+PL
desfitemos-vos	desfitar+V.vós.AD.2.PL+IMP+1+PL
desfitem-se	desfitar+V.ele.REFL+IMP+3+PL
desfitem-te	desfitar+V.tu.AD.2.SG+IMP+3+PL
desfitem-vos	desfitar+V.vós.AD.2.PL+IMP+3+PL
desfite-nos	desfitar+nós.AD.1.PL+IMP+3+SG
desfite-o	desfitar+V.ele.ACC.3.M.SG+IMP+3+SG
desfite-os	desfitar+V.ele.ACC.3.M.PL+IMP+3+SG
desfite-se	desfitar+V.ele.REFL+IMP+3+SG
desfite-te	desfitar+V.tu.AD.2.SG+IMP+3+SG
desfite-vos	desfitar+V.vós.AD.2.PL+IMP+3+SG
desfito-a	desfitar+V.ele.ACC.3.F.SG+PRS+1+SG
desfito-as	desfitar+V.ele.ACC.3.F.PL+PRS+1+SG
desfito-lhe	desfitar+V.ele.DAT.3.SG+PRS+1+SG
desfito-lhes	desfitar+V.ele.DAT.3.PL+PRS+1+SG
desfito-me	desfitar+V.eu.AD.1.SG+PRS+1+SG
desfito-nos	desfitar+nós.AD.1.PL+PRS+1+SG
desfito-o	desfitar+V.ele.ACC.3.M.SG+PRS+1+SG
desfito-os	desfitar+V.ele.ACC.3.M.PL+PRS+1+SG
desfito-te	desfitar+V.tu.AD.2.SG+PRS+1+SG
desfitou-a	desfitar+V.ele.ACC.3.F.SG+PRF+3+SG
desfitou-as	desfitar+V.ele.ACC.3.F.PL+PRF+3+SG
desfitou-lhe	desfitar+V.ele.DAT.3.SG+PRF+3+SG
desfitou-lhes	desfitar+V.ele.DAT.3.PL+PRF+3+SG
desfitou-me	desfitar+V.eu.AD.1.SG+PRF+3+SG
desfitou-nos	desfitar+nós.AD.1.PL+PRF+3+SG
desfitou-o	desfitar+V.ele.ACC.3.M.SG+PRF+3+SG
desfitou-os	desfitar+V.ele.ACC.3.M.PL+PRF+3+SG
desfitou-se	desfitar+V.ele.REFL+PRF+3+SG
desfitou-te	desfitar+V.tu.AD.2.SG+PRF+3+SG
desfitou-vos	desfitar+V.vós.AD.2.PL+PRF+3+SG
desfito-vos	desfitar+V.vós.AD.2.PL+PRS+1+SG
desfivela-a	desfivelar+V.ele.ACC.3.F.SG+PRS+3+SG
desfivela-as	desfivelar+V.ele.ACC.3.F.PL+PRS+3+SG
desfivelai-la	desfivelar+V.ele.ACC.3.F.SG+PRS+2+PL
desfivelai-las	desfivelar+V.ele.ACC.3.F.PL+PRS+2+PL
desfivelai-lo	desfivelar+V.ele.ACC.3.M.SG+PRS+2+PL
desfivelai-los	desfivelar+V.ele.ACC.3.M.PL+PRS+2+PL
desfivelai-nos	desfivelar+nós.AD.1.PL+PRS+2+PL
desfivelais-lhe	desfivelar+V.ele.DAT.3.SG+PRS+2+PL
desfivelais-lhes	desfivelar+V.ele.DAT.3.PL+PRS+2+PL
desfivelais-me	desfivelar+V.eu.AD.1.SG+PRS+2+PL
desfivelais-te	desfivelar+V.tu.AD.2.SG+PRS+2+PL
desfivelais-vos	desfivelar+V.vós.AD.2.PL+PRS+2+PL
desfivelá-la-á	desfivelar+V.ele.ACC.3.F.SG+FUT+3+SG
desfivelá-la-ão	desfivelar+V.ele.ACC.3.F.SG+FUT+3+PL
desfivelá-la-ás	desfivelar+V.ele.ACC.3.F.SG+FUT+2+SG
desfivelá-la	desfivelar+V.ele.ACC.3.F.SG+INF+1+SG
desfivelá-la	desfivelar+V.ele.ACC.3.F.SG+INF+3+SG
desfivela-la	desfivelar+V.ele.ACC.3.F.SG+PRS+2+SG
desfivelá-la	desfivelar+V.ele.ACC.3.F.SG+SBJF+1+SG
desfivelá-la	desfivelar+V.ele.ACC.3.F.SG+SBJF+3+SG
desfivelá-la-ei	desfivelar+V.ele.ACC.3.F.SG+FUT+1+SG
desfivelá-la-eis	desfivelar+V.ele.ACC.3.F.SG+FUT+2+PL
desfivelá-la-emos	desfivelar+V.ele.ACC.3.F.SG+FUT+1+PL
desfivelá-la-ia	desfivelar+V.ele.ACC.3.F.SG+COND+1+SG
desfivelá-la-ia	desfivelar+V.ele.ACC.3.F.SG+COND+3+SG
desfivelá-la-iam	desfivelar+V.ele.ACC.3.F.SG+COND+3+PL
desfivelá-la-íamos	desfivelar+V.ele.ACC.3.F.SG+COND+1+PL
desfivelá-la-ias	desfivelar+V.ele.ACC.3.F.SG+COND+2+SG
desfivelá-la-íeis	desfivelar+V.ele.ACC.3.F.SG+COND+2+PL
desfivelá-las-á	desfivelar+V.ele.ACC.3.F.PL+FUT+3+SG
desfivelá-las-ão	desfivelar+V.ele.ACC.3.F.PL+FUT+3+PL
desfivelá-las-ás	desfivelar+V.ele.ACC.3.F.PL+FUT+2+SG
desfivelá-las	desfivelar+V.ele.ACC.3.F.PL+INF+1+SG
desfivelá-las	desfivelar+V.ele.ACC.3.F.PL+INF+3+SG
desfivela-las	desfivelar+V.ele.ACC.3.F.PL+PRS+2+SG
desfivelá-las	desfivelar+V.ele.ACC.3.F.PL+SBJF+1+SG
desfivelá-las	desfivelar+V.ele.ACC.3.F.PL+SBJF+3+SG
desfivelá-las-ei	desfivelar+V.ele.ACC.3.F.PL+FUT+1+SG
desfivelá-las-eis	desfivelar+V.ele.ACC.3.F.PL+FUT+2+PL
desfivelá-las-emos	desfivelar+V.ele.ACC.3.F.PL+FUT+1+PL
desfivelá-las-ia	desfivelar+V.ele.ACC.3.F.PL+COND+1+SG
desfivelá-las-ia	desfivelar+V.ele.ACC.3.F.PL+COND+3+SG
desfivelá-las-iam	desfivelar+V.ele.ACC.3.F.PL+COND+3+PL
desfivelá-las-íamos	desfivelar+V.ele.ACC.3.F.PL+COND+1+PL
desfivelá-las-ias	desfivelar+V.ele.ACC.3.F.PL+COND+2+SG
desfivelá-las-íeis	desfivelar+V.ele.ACC.3.F.PL+COND+2+PL
desfivela-lhe	desfivelar+V.ele.DAT.3.SG+PRS+3+SG
desfivela-lhes	desfivelar+V.ele.DAT.3.PL+PRS+3+SG
desfivelá-lo-á	desfivelar+V.ele.ACC.3.M.SG+FUT+3+SG
desfivelá-lo-ão	desfivelar+V.ele.ACC.3.M.SG+FUT+3+PL
desfivelá-lo-ás	desfivelar+V.ele.ACC.3.M.SG+FUT+2+SG
desfivelá-lo	desfivelar+V.ele.ACC.3.M.SG+INF+1+SG
desfivelá-lo	desfivelar+V.ele.ACC.3.M.SG+INF+3+SG
desfivela-lo	desfivelar+V.ele.ACC.3.M.SG+PRS+2+SG
desfivelá-lo	desfivelar+V.ele.ACC.3.M.SG+SBJF+1+SG
desfivelá-lo	desfivelar+V.ele.ACC.3.M.SG+SBJF+3+SG
desfivelá-lo-ei	desfivelar+V.ele.ACC.3.M.SG+FUT+1+SG
desfivelá-lo-eis	desfivelar+V.ele.ACC.3.M.SG+FUT+2+PL
desfivelá-lo-emos	desfivelar+V.ele.ACC.3.M.SG+FUT+1+PL
desfivelá-lo-ia	desfivelar+V.ele.ACC.3.M.SG+COND+1+SG
desfivelá-lo-ia	desfivelar+V.ele.ACC.3.M.SG+COND+3+SG
desfivelá-lo-iam	desfivelar+V.ele.ACC.3.M.SG+COND+3+PL
desfivelá-lo-íamos	desfivelar+V.ele.ACC.3.M.SG+COND+1+PL
desfivelá-lo-ias	desfivelar+V.ele.ACC.3.M.SG+COND+2+SG
desfivelá-lo-íeis	desfivelar+V.ele.ACC.3.M.SG+COND+2+PL
desfivelá-los-á	desfivelar+V.ele.ACC.3.M.PL+FUT+3+SG
desfivelá-los-ão	desfivelar+V.ele.ACC.3.M.PL+FUT+3+PL
desfivelá-los-ás	desfivelar+V.ele.ACC.3.M.PL+FUT+2+SG
desfivelá-los	desfivelar+V.ele.ACC.3.M.PL+INF+1+SG
desfivelá-los	desfivelar+V.ele.ACC.3.M.PL+INF+3+SG
desfivela-los	desfivelar+V.ele.ACC.3.M.PL+PRS+2+SG
desfivelá-los	desfivelar+V.ele.ACC.3.M.PL+SBJF+1+SG
desfivelá-los	desfivelar+V.ele.ACC.3.M.PL+SBJF+3+SG
desfivelá-los-ei	desfivelar+V.ele.ACC.3.M.PL+FUT+1+SG
desfivelá-los-eis	desfivelar+V.ele.ACC.3.M.PL+FUT+2+PL
desfivelá-los-emos	desfivelar+V.ele.ACC.3.M.PL+FUT+1+PL
desfivelá-los-ia	desfivelar+V.ele.ACC.3.M.PL+COND+1+SG
desfivelá-los-ia	desfivelar+V.ele.ACC.3.M.PL+COND+3+SG
desfivelá-los-iam	desfivelar+V.ele.ACC.3.M.PL+COND+3+PL
desfivelá-los-íamos	desfivelar+V.ele.ACC.3.M.PL+COND+1+PL
desfivelá-los-ias	desfivelar+V.ele.ACC.3.M.PL+COND+2+SG
desfivelá-los-íeis	desfivelar+V.ele.ACC.3.M.PL+COND+2+PL
desfivela-me	desfivelar+V.eu.AD.1.SG+PRS+3+SG
desfivelam-lhe	desfivelar+V.ele.DAT.3.SG+PRS+3+PL
desfivelam-lhes	desfivelar+V.ele.DAT.3.PL+PRS+3+PL
desfivelam-me	desfivelar+V.eu.AD.1.SG+PRS+3+PL
desfivelam-na	desfivelar+V.ele.ACC.3.F.SG+PRS+3+PL
desfivelam-nas	desfivelar+V.ele.ACC.3.F.PL+PRS+3+PL
desfivelam-no	desfivelar+V.ele.ACC.3.M.SG+PRS+3+PL
desfivelam-nos	desfivelar+V.ele.ACC.3.M.PL+PRS+3+PL
desfivelam-nos	desfivelar+V.nós.AD.1.PL+PRS+3+PL
desfivelamo-la	desfivelar+V.ele.ACC.3.F.SG+PRF+1+PL
desfivelamo-la	desfivelar+V.ele.ACC.3.F.SG+PRS+1+PL
desfivelamo-las	desfivelar+V.ele.ACC.3.F.PL+PRF+1+PL
desfivelamo-las	desfivelar+V.ele.ACC.3.F.PL+PRS+1+PL
desfivelamo-lo	desfivelar+V.ele.ACC.3.M.SG+PRF+1+PL
desfivelamo-lo	desfivelar+V.ele.ACC.3.M.SG+PRS+1+PL
desfivelamo-los	desfivelar+V.ele.ACC.3.M.PL+PRF+1+PL
desfivelamo-los	desfivelar+V.ele.ACC.3.M.PL+PRS+1+PL
desfivelamo-nos	desfivelar+nós.AD.1.PL+PRF+1+PL
desfivelamo-nos	desfivelar+nós.AD.1.PL+PRS+1+PL
desfivelamos-lhe	desfivelar+V.ele.DAT.3.SG+PRF+1+PL
desfivelamos-lhe	desfivelar+V.ele.DAT.3.SG+PRS+1+PL
desfivelamos-lhes	desfivelar+V.ele.DAT.3.PL+PRF+1+PL
desfivelamos-lhes	desfivelar+V.ele.DAT.3.PL+PRS+1+PL
desfivelamos-me	desfivelar+V.eu.AD.1.SG+PRF+1+PL
desfivelamos-me	desfivelar+V.eu.AD.1.SG+PRS+1+PL
desfivelamos-te	desfivelar+V.tu.AD.2.SG+PRF+1+PL
desfivelamos-te	desfivelar+V.tu.AD.2.SG+PRS+1+PL
desfivelamos-vos	desfivelar+V.vós.AD.2.PL+PRF+1+PL
desfivelamos-vos	desfivelar+V.vós.AD.2.PL+PRS+1+PL
desfivelam-se	desfivelar+V.ele.REFL+PRS+3+PL
desfivelam-te	desfivelar+V.tu.AD.2.SG+PRS+3+PL
desfivelam-vos	desfivelar+V.vós.AD.2.PL+PRS+3+PL
desfivelando-a	desfivelar+V.ele.ACC.3.F.SG+GRD
desfivelando-as	desfivelar+V.ele.ACC.3.F.PL+GRD
desfivelando-lhe	desfivelar+V.ele.DAT.3.SG+GRD
desfivelando-lhes	desfivelar+V.ele.DAT.3.PL+GRD
desfivelando-me	desfivelar+V.eu.AD.1.SG+GRD
desfivelando-nos	desfivelar+nós.AD.1.PL+GRD
desfivelando-o	desfivelar+V.ele.ACC.3.M.SG+GRD
desfivelando-os	desfivelar+V.ele.ACC.3.M.PL+GRD
desfivelando-se	desfivelar+V.ele.REFL+GRD
desfivelando-te	desfivelar+V.tu.AD.2.SG+GRD
desfivelando-vos	desfivelar+V.vós.AD.2.PL+GRD
desfivela-nos	desfivelar+nós.AD.1.PL+PRS+2+SG
desfivela-nos	desfivelar+nós.AD.1.PL+PRS+3+SG
desfivela-o	desfivelar+V.ele.ACC.3.M.SG+PRS+3+SG
desfivela-os	desfivelar+V.ele.ACC.3.M.PL+PRS+3+SG
desfivelara-a	desfivelar+V.ele.ACC.3.F.SG+PQP+1+SG
desfivelara-a	desfivelar+V.ele.ACC.3.F.SG+PQP+3+SG
desfivelara-as	desfivelar+V.ele.ACC.3.F.PL+PQP+1+SG
desfivelara-as	desfivelar+V.ele.ACC.3.F.PL+PQP+3+SG
desfivelara-la	desfivelar+V.ele.ACC.3.F.SG+PQP+2+SG
desfivelara-las	desfivelar+V.ele.ACC.3.F.PL+PQP+2+SG
desfivelara-lhe	desfivelar+V.ele.DAT.3.SG+PQP+1+SG
desfivelara-lhe	desfivelar+V.ele.DAT.3.SG+PQP+3+SG
desfivelara-lhes	desfivelar+V.ele.DAT.3.PL+PQP+1+SG
desfivelara-lhes	desfivelar+V.ele.DAT.3.PL+PQP+3+SG
desfivelara-lo	desfivelar+V.ele.ACC.3.M.SG+PQP+2+SG
desfivelara-los	desfivelar+V.ele.ACC.3.M.PL+PQP+2+SG
desfivelara-me	desfivelar+V.eu.AD.1.SG+PQP+1+SG
desfivelara-me	desfivelar+V.eu.AD.1.SG+PQP+3+SG
desfivelaram-lhe	desfivelar+V.ele.DAT.3.SG+PQP+3+PL
desfivelaram-lhe	desfivelar+V.ele.DAT.3.SG+PRF+3+PL
desfivelaram-lhes	desfivelar+V.ele.DAT.3.PL+PQP+3+PL
desfivelaram-lhes	desfivelar+V.ele.DAT.3.PL+PRF+3+PL
desfivelaram-me	desfivelar+V.eu.AD.1.SG+PQP+3+PL
desfivelaram-me	desfivelar+V.eu.AD.1.SG+PRF+3+PL
desfivelaram-na	desfivelar+V.ele.ACC.3.F.SG+PQP+3+PL
desfivelaram-na	desfivelar+V.ele.ACC.3.F.SG+PRF+3+PL
desfivelaram-nas	desfivelar+V.ele.ACC.3.F.PL+PQP+3+PL
desfivelaram-nas	desfivelar+V.ele.ACC.3.F.PL+PRF+3+PL
desfivelaram-no	desfivelar+V.ele.ACC.3.M.SG+PQP+3+PL
desfivelaram-no	desfivelar+V.ele.ACC.3.M.SG+PRF+3+PL
desfivelaram-nos	desfivelar+V.ele.ACC.3.M.PL+PQP+3+PL
desfivelaram-nos	desfivelar+V.ele.ACC.3.M.PL+PRF+3+PL
desfivelaram-nos	desfivelar+V.nós.AD.1.PL+PQP+3+PL
desfivelaram-nos	desfivelar+V.nós.AD.1.PL+PRF+3+PL
desfiveláramo-la	desfivelar+V.ele.ACC.3.F.SG+PQP+1+PL
desfiveláramo-las	desfivelar+V.ele.ACC.3.F.PL+PQP+1+PL
desfiveláramo-lo	desfivelar+V.ele.ACC.3.M.SG+PQP+1+PL
desfiveláramo-los	desfivelar+V.ele.ACC.3.M.PL+PQP+1+PL
desfiveláramo-nos	desfivelar+nós.AD.1.PL+PQP+1+PL
desfiveláramos-lhe	desfivelar+V.ele.DAT.3.SG+PQP+1+PL
desfiveláramos-lhes	desfivelar+V.ele.DAT.3.PL+PQP+1+PL
desfiveláramos-me	desfivelar+V.eu.AD.1.SG+PQP+1+PL
desfiveláramos-te	desfivelar+V.tu.AD.2.SG+PQP+1+PL
desfiveláramos-vos	desfivelar+V.vós.AD.2.PL+PQP+1+PL
desfivelaram-se	desfivelar+V.ele.REFL+PQP+3+PL
desfivelaram-se	desfivelar+V.ele.REFL+PRF+3+PL
desfivelaram-te	desfivelar+V.tu.AD.2.SG+PQP+3+PL
desfivelaram-te	desfivelar+V.tu.AD.2.SG+PRF+3+PL
desfivelaram-vos	desfivelar+V.vós.AD.2.PL+PQP+3+PL
desfivelaram-vos	desfivelar+V.vós.AD.2.PL+PRF+3+PL
desfivelara-nos	desfivelar+nós.AD.1.PL+PQP+1+SG
desfivelara-nos	desfivelar+nós.AD.1.PL+PQP+2+SG
desfivelara-nos	desfivelar+nós.AD.1.PL+PQP+3+SG
desfivelara-o	desfivelar+V.ele.ACC.3.M.SG+PQP+1+SG
desfivelara-o	desfivelar+V.ele.ACC.3.M.SG+PQP+3+SG
desfivelara-os	desfivelar+V.ele.ACC.3.M.PL+PQP+1+SG
desfivelara-os	desfivelar+V.ele.ACC.3.M.PL+PQP+3+SG
desfivelara-se	desfivelar+V.ele.REFL+PQP+1+SG
