desfrechavam-vos	desfrechar+V.vós.AD.2.PL+IMPF+3+PL
desfrechava-nos	desfrechar+nós.AD.1.PL+IMPF+1+SG
desfrechava-nos	desfrechar+nós.AD.1.PL+IMPF+2+SG
desfrechava-nos	desfrechar+nós.AD.1.PL+IMPF+3+SG
desfrechava-o	desfrechar+V.ele.ACC.3.M.SG+IMPF+1+SG
desfrechava-o	desfrechar+V.ele.ACC.3.M.SG+IMPF+3+SG
desfrechava-os	desfrechar+V.ele.ACC.3.M.PL+IMPF+1+SG
desfrechava-os	desfrechar+V.ele.ACC.3.M.PL+IMPF+3+SG
desfrechava-se	desfrechar+V.ele.REFL+IMPF+1+SG
desfrechava-se	desfrechar+V.ele.REFL+IMPF+3+SG
desfrechavas-lhe	desfrechar+V.ele.DAT.3.SG+IMPF+2+SG
desfrechavas-lhes	desfrechar+V.ele.DAT.3.PL+IMPF+2+SG
desfrechavas-me	desfrechar+V.eu.AD.1.SG+IMPF+2+SG
desfrechavas-te	desfrechar+V.tu.AD.2.SG+IMPF+2+SG
desfrechavas-vos	desfrechar+V.vós.AD.2.PL+IMPF+2+SG
desfrechava-te	desfrechar+V.tu.AD.2.SG+IMPF+1+SG
desfrechava-te	desfrechar+V.tu.AD.2.SG+IMPF+3+SG
desfrechava-vos	desfrechar+V.vós.AD.2.PL+IMPF+1+SG
desfrechava-vos	desfrechar+V.vós.AD.2.PL+IMPF+3+SG
desfrechávei-la	desfrechar+V.ele.ACC.3.F.SG+IMPF+2+PL
desfrechávei-las	desfrechar+V.ele.ACC.3.F.PL+IMPF+2+PL
desfrechávei-lo	desfrechar+V.ele.ACC.3.M.SG+IMPF+2+PL
desfrechávei-los	desfrechar+V.ele.ACC.3.M.PL+IMPF+2+PL
desfrechávei-nos	desfrechar+nós.AD.1.PL+IMPF+2+PL
desfrecháveis-lhe	desfrechar+V.ele.DAT.3.SG+IMPF+2+PL
desfrecháveis-lhes	desfrechar+V.ele.DAT.3.PL+IMPF+2+PL
desfrecháveis-me	desfrechar+V.eu.AD.1.SG+IMPF+2+PL
desfrecháveis-te	desfrechar+V.tu.AD.2.SG+IMPF+2+PL
desfrecháveis-vos	desfrechar+V.vós.AD.2.PL+IMPF+2+PL
desfrecha-vos	desfrechar+V.vós.AD.2.PL+PRS+3+SG
desfreche-a	desfrechar+V.ele.ACC.3.F.SG+IMP+3+SG
desfreche-as	desfrechar+V.ele.ACC.3.F.PL+IMP+3+SG
desfrechei-a	desfrechar+V.ele.ACC.3.F.SG+PRF+1+SG
desfrechei-as	desfrechar+V.ele.ACC.3.F.PL+PRF+1+SG
desfrechei-lhe	desfrechar+V.ele.DAT.3.SG+PRF+1+SG
desfrechei-lhes	desfrechar+V.ele.DAT.3.PL+PRF+1+SG
desfrechei-me	desfrechar+V.eu.AD.1.SG+PRF+1+SG
desfrechei-nos	desfrechar+nós.AD.1.PL+PRF+1+SG
desfrechei-o	desfrechar+V.ele.ACC.3.M.SG+PRF+1+SG
desfrechei-os	desfrechar+V.ele.ACC.3.M.PL+PRF+1+SG
desfrechei-te	desfrechar+V.tu.AD.2.SG+PRF+1+SG
desfrechei-vos	desfrechar+V.vós.AD.2.PL+PRF+1+SG
desfreche-lhe	desfrechar+V.ele.DAT.3.SG+IMP+3+SG
desfreche-lhes	desfrechar+V.ele.DAT.3.PL+IMP+3+SG
desfreche-me	desfrechar+V.eu.AD.1.SG+IMP+3+SG
desfrechem-lhe	desfrechar+V.ele.DAT.3.SG+IMP+3+PL
desfrechem-lhes	desfrechar+V.ele.DAT.3.PL+IMP+3+PL
desfrechem-me	desfrechar+V.eu.AD.1.SG+IMP+3+PL
desfrechem-na	desfrechar+V.ele.ACC.3.F.SG+IMP+3+PL
desfrechem-nas	desfrechar+V.ele.ACC.3.F.PL+IMP+3+PL
desfrechem-no	desfrechar+V.ele.ACC.3.M.SG+IMP+3+PL
desfrechem-nos	desfrechar+V.ele.ACC.3.M.PL+IMP+3+PL
desfrechem-nos	desfrechar+V.nós.AD.1.PL+IMP+3+PL
desfrechemo-la	desfrechar+V.ele.ACC.3.F.SG+IMP+1+PL
desfrechemo-las	desfrechar+V.ele.ACC.3.F.PL+IMP+1+PL
desfrechemo-lo	desfrechar+V.ele.ACC.3.M.SG+IMP+1+PL
desfrechemo-los	desfrechar+V.ele.ACC.3.M.PL+IMP+1+PL
desfrechemo-nos	desfrechar+nós.AD.1.PL+IMP+1+PL
desfrechemos-lhe	desfrechar+V.ele.DAT.3.SG+IMP+1+PL
desfrechemos-lhes	desfrechar+V.ele.DAT.3.PL+IMP+1+PL
desfrechemos-me	desfrechar+V.eu.AD.1.SG+IMP+1+PL
desfrechemos-te	desfrechar+V.tu.AD.2.SG+IMP+1+PL
desfrechemos-vos	desfrechar+V.vós.AD.2.PL+IMP+1+PL
desfrechem-se	desfrechar+V.ele.REFL+IMP+3+PL
desfrechem-te	desfrechar+V.tu.AD.2.SG+IMP+3+PL
desfrechem-vos	desfrechar+V.vós.AD.2.PL+IMP+3+PL
desfreche-nos	desfrechar+nós.AD.1.PL+IMP+3+SG
desfreche-o	desfrechar+V.ele.ACC.3.M.SG+IMP+3+SG
desfreche-os	desfrechar+V.ele.ACC.3.M.PL+IMP+3+SG
desfreche-se	desfrechar+V.ele.REFL+IMP+3+SG
desfreche-te	desfrechar+V.tu.AD.2.SG+IMP+3+SG
desfreche-vos	desfrechar+V.vós.AD.2.PL+IMP+3+SG
desfrecho-a	desfrechar+V.ele.ACC.3.F.SG+PRS+1+SG
desfrecho-as	desfrechar+V.ele.ACC.3.F.PL+PRS+1+SG
desfrecho-lhe	desfrechar+V.ele.DAT.3.SG+PRS+1+SG
desfrecho-lhes	desfrechar+V.ele.DAT.3.PL+PRS+1+SG
desfrecho-me	desfrechar+V.eu.AD.1.SG+PRS+1+SG
desfrecho-nos	desfrechar+nós.AD.1.PL+PRS+1+SG
desfrecho-o	desfrechar+V.ele.ACC.3.M.SG+PRS+1+SG
desfrecho-os	desfrechar+V.ele.ACC.3.M.PL+PRS+1+SG
desfrecho-te	desfrechar+V.tu.AD.2.SG+PRS+1+SG
desfrechou-a	desfrechar+V.ele.ACC.3.F.SG+PRF+3+SG
desfrechou-as	desfrechar+V.ele.ACC.3.F.PL+PRF+3+SG
desfrechou-lhe	desfrechar+V.ele.DAT.3.SG+PRF+3+SG
desfrechou-lhes	desfrechar+V.ele.DAT.3.PL+PRF+3+SG
desfrechou-me	desfrechar+V.eu.AD.1.SG+PRF+3+SG
desfrechou-nos	desfrechar+nós.AD.1.PL+PRF+3+SG
desfrechou-o	desfrechar+V.ele.ACC.3.M.SG+PRF+3+SG
desfrechou-os	desfrechar+V.ele.ACC.3.M.PL+PRF+3+SG
desfrechou-se	desfrechar+V.ele.REFL+PRF+3+SG
desfrechou-te	desfrechar+V.tu.AD.2.SG+PRF+3+SG
desfrechou-vos	desfrechar+V.vós.AD.2.PL+PRF+3+SG
desfrecho-vos	desfrechar+V.vós.AD.2.PL+PRS+1+SG
desfreei-a	desfrear+V.ele.ACC.3.F.SG+PRF+1+SG
desfreei-as	desfrear+V.ele.ACC.3.F.PL+PRF+1+SG
desfreei-lhe	desfrear+V.ele.DAT.3.SG+PRF+1+SG
desfreei-lhes	desfrear+V.ele.DAT.3.PL+PRF+1+SG
desfreei-me	desfrear+V.eu.AD.1.SG+PRF+1+SG
desfreei-nos	desfrear+nós.AD.1.PL+PRF+1+SG
desfreei-o	desfrear+V.ele.ACC.3.M.SG+PRF+1+SG
desfreei-os	desfrear+V.ele.ACC.3.M.PL+PRF+1+SG
desfreei-te	desfrear+V.tu.AD.2.SG+PRF+1+SG
desfreei-vos	desfrear+V.vós.AD.2.PL+PRF+1+SG
desfreia-a	desfrear+V.ele.ACC.3.F.SG+PRS+3+SG
desfreia-as	desfrear+V.ele.ACC.3.F.PL+PRS+3+SG
desfreia-la	desfrear+V.ele.ACC.3.F.SG+PRS+2+SG
desfreia-las	desfrear+V.ele.ACC.3.F.PL+PRS+2+SG
desfreia-lhe	desfrear+V.ele.DAT.3.SG+PRS+3+SG
desfreia-lhes	desfrear+V.ele.DAT.3.PL+PRS+3+SG
desfreia-lo	desfrear+V.ele.ACC.3.M.SG+PRS+2+SG
desfreia-los	desfrear+V.ele.ACC.3.M.PL+PRS+2+SG
desfreia-me	desfrear+V.eu.AD.1.SG+PRS+3+SG
desfreiam-lhe	desfrear+V.ele.DAT.3.SG+PRS+3+PL
desfreiam-lhes	desfrear+V.ele.DAT.3.PL+PRS+3+PL
desfreiam-me	desfrear+V.eu.AD.1.SG+PRS+3+PL
desfreiam-na	desfrear+V.ele.ACC.3.F.SG+PRS+3+PL
desfreiam-nas	desfrear+V.ele.ACC.3.F.PL+PRS+3+PL
desfreiam-no	desfrear+V.ele.ACC.3.M.SG+PRS+3+PL
desfreiam-nos	desfrear+V.ele.ACC.3.M.PL+PRS+3+PL
desfreiam-nos	desfrear+V.nós.AD.1.PL+PRS+3+PL
desfreiam-se	desfrear+V.ele.REFL+PRS+3+PL
desfreiam-te	desfrear+V.tu.AD.2.SG+PRS+3+PL
desfreiam-vos	desfrear+V.vós.AD.2.PL+PRS+3+PL
desfreia-nos	desfrear+nós.AD.1.PL+PRS+2+SG
desfreia-nos	desfrear+nós.AD.1.PL+PRS+3+SG
desfreia-o	desfrear+V.ele.ACC.3.M.SG+PRS+3+SG
desfreia-os	desfrear+V.ele.ACC.3.M.PL+PRS+3+SG
desfreia-se	desfrear+V.ele.REFL+PRS+3+SG
desfreias-lhe	desfrear+V.ele.DAT.3.SG+PRS+2+SG
desfreias-lhes	desfrear+V.ele.DAT.3.PL+PRS+2+SG
desfreias-me	desfrear+V.eu.AD.1.SG+PRS+2+SG
desfreias-te	desfrear+V.tu.AD.2.SG+PRS+2+SG
desfreias-vos	desfrear+V.vós.AD.2.PL+PRS+2+SG
desfreia-te	desfrear+V.tu.AD.2.SG+PRS+3+SG
desfreia-vos	desfrear+V.vós.AD.2.PL+PRS+3+SG
desfreio-a	desfrear+V.ele.ACC.3.F.SG+PRS+1+SG
desfreio-as	desfrear+V.ele.ACC.3.F.PL+PRS+1+SG
desfreio-lhe	desfrear+V.ele.DAT.3.SG+PRS+1+SG
desfreio-lhes	desfrear+V.ele.DAT.3.PL+PRS+1+SG
desfreio-me	desfrear+V.eu.AD.1.SG+PRS+1+SG
desfreio-nos	desfrear+nós.AD.1.PL+PRS+1+SG
desfreio-o	desfrear+V.ele.ACC.3.M.SG+PRS+1+SG
desfreio-os	desfrear+V.ele.ACC.3.M.PL+PRS+1+SG
desfreio-te	desfrear+V.tu.AD.2.SG+PRS+1+SG
desfreio-vos	desfrear+V.vós.AD.2.PL+PRS+1+SG
desfreou-a	desfrear+V.ele.ACC.3.F.SG+PRF+3+SG
desfreou-as	desfrear+V.ele.ACC.3.F.PL+PRF+3+SG
desfreou-lhe	desfrear+V.ele.DAT.3.SG+PRF+3+SG
desfreou-lhes	desfrear+V.ele.DAT.3.PL+PRF+3+SG
desfreou-me	desfrear+V.eu.AD.1.SG+PRF+3+SG
desfreou-nos	desfrear+nós.AD.1.PL+PRF+3+SG
desfreou-o	desfrear+V.ele.ACC.3.M.SG+PRF+3+SG
desfreou-os	desfrear+V.ele.ACC.3.M.PL+PRF+3+SG
desfreou-se	desfrear+V.ele.REFL+PRF+3+SG
desfreou-te	desfrear+V.tu.AD.2.SG+PRF+3+SG
desfreou-vos	desfrear+V.vós.AD.2.PL+PRF+3+SG
desfrequenta-a	desfrequentar+V.ele.ACC.3.F.SG+PRS+3+SG
desfrequenta-as	desfrequentar+V.ele.ACC.3.F.PL+PRS+3+SG
desfrequentai-la	desfrequentar+V.ele.ACC.3.F.SG+PRS+2+PL
desfrequentai-las	desfrequentar+V.ele.ACC.3.F.PL+PRS+2+PL
desfrequentai-lo	desfrequentar+V.ele.ACC.3.M.SG+PRS+2+PL
desfrequentai-los	desfrequentar+V.ele.ACC.3.M.PL+PRS+2+PL
desfrequentai-nos	desfrequentar+nós.AD.1.PL+PRS+2+PL
desfrequentais-lhe	desfrequentar+V.ele.DAT.3.SG+PRS+2+PL
desfrequentais-lhes	desfrequentar+V.ele.DAT.3.PL+PRS+2+PL
desfrequentais-me	desfrequentar+V.eu.AD.1.SG+PRS+2+PL
desfrequentais-te	desfrequentar+V.tu.AD.2.SG+PRS+2+PL
desfrequentais-vos	desfrequentar+V.vós.AD.2.PL+PRS+2+PL
desfrequentá-la-á	desfrequentar+V.ele.ACC.3.F.SG+FUT+3+SG
desfrequentá-la-ão	desfrequentar+V.ele.ACC.3.F.SG+FUT+3+PL
desfrequentá-la-ás	desfrequentar+V.ele.ACC.3.F.SG+FUT+2+SG
desfrequentá-la	desfrequentar+V.ele.ACC.3.F.SG+INF+1+SG
desfrequentá-la	desfrequentar+V.ele.ACC.3.F.SG+INF+3+SG
desfrequenta-la	desfrequentar+V.ele.ACC.3.F.SG+PRS+2+SG
desfrequentá-la	desfrequentar+V.ele.ACC.3.F.SG+SBJF+1+SG
desfrequentá-la	desfrequentar+V.ele.ACC.3.F.SG+SBJF+3+SG
desfrequentá-la-ei	desfrequentar+V.ele.ACC.3.F.SG+FUT+1+SG
desfrequentá-la-eis	desfrequentar+V.ele.ACC.3.F.SG+FUT+2+PL
desfrequentá-la-emos	desfrequentar+V.ele.ACC.3.F.SG+FUT+1+PL
desfrequentá-la-ia	desfrequentar+V.ele.ACC.3.F.SG+COND+1+SG
desfrequentá-la-ia	desfrequentar+V.ele.ACC.3.F.SG+COND+3+SG
desfrequentá-la-iam	desfrequentar+V.ele.ACC.3.F.SG+COND+3+PL
desfrequentá-la-íamos	desfrequentar+V.ele.ACC.3.F.SG+COND+1+PL
desfrequentá-la-ias	desfrequentar+V.ele.ACC.3.F.SG+COND+2+SG
desfrequentá-la-íeis	desfrequentar+V.ele.ACC.3.F.SG+COND+2+PL
desfrequentá-las-á	desfrequentar+V.ele.ACC.3.F.PL+FUT+3+SG
desfrequentá-las-ão	desfrequentar+V.ele.ACC.3.F.PL+FUT+3+PL
desfrequentá-las-ás	desfrequentar+V.ele.ACC.3.F.PL+FUT+2+SG
desfrequentá-las	desfrequentar+V.ele.ACC.3.F.PL+INF+1+SG
desfrequentá-las	desfrequentar+V.ele.ACC.3.F.PL+INF+3+SG
desfrequenta-las	desfrequentar+V.ele.ACC.3.F.PL+PRS+2+SG
desfrequentá-las	desfrequentar+V.ele.ACC.3.F.PL+SBJF+1+SG
desfrequentá-las	desfrequentar+V.ele.ACC.3.F.PL+SBJF+3+SG
desfrequentá-las-ei	desfrequentar+V.ele.ACC.3.F.PL+FUT+1+SG
desfrequentá-las-eis	desfrequentar+V.ele.ACC.3.F.PL+FUT+2+PL
desfrequentá-las-emos	desfrequentar+V.ele.ACC.3.F.PL+FUT+1+PL
desfrequentá-las-ia	desfrequentar+V.ele.ACC.3.F.PL+COND+1+SG
desfrequentá-las-ia	desfrequentar+V.ele.ACC.3.F.PL+COND+3+SG
desfrequentá-las-iam	desfrequentar+V.ele.ACC.3.F.PL+COND+3+PL
desfrequentá-las-íamos	desfrequentar+V.ele.ACC.3.F.PL+COND+1+PL
desfrequentá-las-ias	desfrequentar+V.ele.ACC.3.F.PL+COND+2+SG
desfrequentá-las-íeis	desfrequentar+V.ele.ACC.3.F.PL+COND+2+PL
desfrequenta-lhe	desfrequentar+V.ele.DAT.3.SG+PRS+3+SG
desfrequenta-lhes	desfrequentar+V.ele.DAT.3.PL+PRS+3+SG
desfrequentá-lo-á	desfrequentar+V.ele.ACC.3.M.SG+FUT+3+SG
desfrequentá-lo-ão	desfrequentar+V.ele.ACC.3.M.SG+FUT+3+PL
desfrequentá-lo-ás	desfrequentar+V.ele.ACC.3.M.SG+FUT+2+SG
desfrequentá-lo	desfrequentar+V.ele.ACC.3.M.SG+INF+1+SG
desfrequentá-lo	desfrequentar+V.ele.ACC.3.M.SG+INF+3+SG
desfrequenta-lo	desfrequentar+V.ele.ACC.3.M.SG+PRS+2+SG
desfrequentá-lo	desfrequentar+V.ele.ACC.3.M.SG+SBJF+1+SG
desfrequentá-lo	desfrequentar+V.ele.ACC.3.M.SG+SBJF+3+SG
desfrequentá-lo-ei	desfrequentar+V.ele.ACC.3.M.SG+FUT+1+SG
desfrequentá-lo-eis	desfrequentar+V.ele.ACC.3.M.SG+FUT+2+PL
desfrequentá-lo-emos	desfrequentar+V.ele.ACC.3.M.SG+FUT+1+PL
desfrequentá-lo-ia	desfrequentar+V.ele.ACC.3.M.SG+COND+1+SG
desfrequentá-lo-ia	desfrequentar+V.ele.ACC.3.M.SG+COND+3+SG
desfrequentá-lo-iam	desfrequentar+V.ele.ACC.3.M.SG+COND+3+PL
desfrequentá-lo-íamos	desfrequentar+V.ele.ACC.3.M.SG+COND+1+PL
desfrequentá-lo-ias	desfrequentar+V.ele.ACC.3.M.SG+COND+2+SG
desfrequentá-lo-íeis	desfrequentar+V.ele.ACC.3.M.SG+COND+2+PL
desfrequentá-los-á	desfrequentar+V.ele.ACC.3.M.PL+FUT+3+SG
desfrequentá-los-ão	desfrequentar+V.ele.ACC.3.M.PL+FUT+3+PL
desfrequentá-los-ás	desfrequentar+V.ele.ACC.3.M.PL+FUT+2+SG
desfrequentá-los	desfrequentar+V.ele.ACC.3.M.PL+INF+1+SG
desfrequentá-los	desfrequentar+V.ele.ACC.3.M.PL+INF+3+SG
desfrequenta-los	desfrequentar+V.ele.ACC.3.M.PL+PRS+2+SG
desfrequentá-los	desfrequentar+V.ele.ACC.3.M.PL+SBJF+1+SG
desfrequentá-los	desfrequentar+V.ele.ACC.3.M.PL+SBJF+3+SG
desfrequentá-los-ei	desfrequentar+V.ele.ACC.3.M.PL+FUT+1+SG
desfrequentá-los-eis	desfrequentar+V.ele.ACC.3.M.PL+FUT+2+PL
desfrequentá-los-emos	desfrequentar+V.ele.ACC.3.M.PL+FUT+1+PL
desfrequentá-los-ia	desfrequentar+V.ele.ACC.3.M.PL+COND+1+SG
desfrequentá-los-ia	desfrequentar+V.ele.ACC.3.M.PL+COND+3+SG
desfrequentá-los-iam	desfrequentar+V.ele.ACC.3.M.PL+COND+3+PL
desfrequentá-los-íamos	desfrequentar+V.ele.ACC.3.M.PL+COND+1+PL
desfrequentá-los-ias	desfrequentar+V.ele.ACC.3.M.PL+COND+2+SG
desfrequentá-los-íeis	desfrequentar+V.ele.ACC.3.M.PL+COND+2+PL
desfrequenta-me	desfrequentar+V.eu.AD.1.SG+PRS+3+SG
desfrequentam-lhe	desfrequentar+V.ele.DAT.3.SG+PRS+3+PL
desfrequentam-lhes	desfrequentar+V.ele.DAT.3.PL+PRS+3+PL
desfrequentam-me	desfrequentar+V.eu.AD.1.SG+PRS+3+PL
desfrequentam-na	desfrequentar+V.ele.ACC.3.F.SG+PRS+3+PL
desfrequentam-nas	desfrequentar+V.ele.ACC.3.F.PL+PRS+3+PL
desfrequentam-no	desfrequentar+V.ele.ACC.3.M.SG+PRS+3+PL
desfrequentam-nos	desfrequentar+V.ele.ACC.3.M.PL+PRS+3+PL
desfrequentam-nos	desfrequentar+V.nós.AD.1.PL+PRS+3+PL
desfrequentamo-la	desfrequentar+V.ele.ACC.3.F.SG+PRF+1+PL
desfrequentamo-la	desfrequentar+V.ele.ACC.3.F.SG+PRS+1+PL
desfrequentamo-las	desfrequentar+V.ele.ACC.3.F.PL+PRF+1+PL
desfrequentamo-las	desfrequentar+V.ele.ACC.3.F.PL+PRS+1+PL
desfrequentamo-lo	desfrequentar+V.ele.ACC.3.M.SG+PRF+1+PL
desfrequentamo-lo	desfrequentar+V.ele.ACC.3.M.SG+PRS+1+PL
desfrequentamo-los	desfrequentar+V.ele.ACC.3.M.PL+PRF+1+PL
desfrequentamo-los	desfrequentar+V.ele.ACC.3.M.PL+PRS+1+PL
desfrequentamo-nos	desfrequentar+nós.AD.1.PL+PRF+1+PL
desfrequentamo-nos	desfrequentar+nós.AD.1.PL+PRS+1+PL
desfrequentamos-lhe	desfrequentar+V.ele.DAT.3.SG+PRF+1+PL
desfrequentamos-lhe	desfrequentar+V.ele.DAT.3.SG+PRS+1+PL
desfrequentamos-lhes	desfrequentar+V.ele.DAT.3.PL+PRF+1+PL
desfrequentamos-lhes	desfrequentar+V.ele.DAT.3.PL+PRS+1+PL
desfrequentamos-me	desfrequentar+V.eu.AD.1.SG+PRF+1+PL
desfrequentamos-me	desfrequentar+V.eu.AD.1.SG+PRS+1+PL
desfrequentamos-te	desfrequentar+V.tu.AD.2.SG+PRF+1+PL
desfrequentamos-te	desfrequentar+V.tu.AD.2.SG+PRS+1+PL
desfrequentamos-vos	desfrequentar+V.vós.AD.2.PL+PRF+1+PL
desfrequentamos-vos	desfrequentar+V.vós.AD.2.PL+PRS+1+PL
desfrequentam-se	desfrequentar+V.ele.REFL+PRS+3+PL
desfrequentam-te	desfrequentar+V.tu.AD.2.SG+PRS+3+PL
desfrequentam-vos	desfrequentar+V.vós.AD.2.PL+PRS+3+PL
desfrequentando-a	desfrequentar+V.ele.ACC.3.F.SG+GRD
desfrequentando-as	desfrequentar+V.ele.ACC.3.F.PL+GRD
desfrequentando-lhe	desfrequentar+V.ele.DAT.3.SG+GRD
desfrequentando-lhes	desfrequentar+V.ele.DAT.3.PL+GRD
desfrequentando-me	desfrequentar+V.eu.AD.1.SG+GRD
desfrequentando-nos	desfrequentar+nós.AD.1.PL+GRD
desfrequentando-o	desfrequentar+V.ele.ACC.3.M.SG+GRD
desfrequentando-os	desfrequentar+V.ele.ACC.3.M.PL+GRD
desfrequentando-se	desfrequentar+V.ele.REFL+GRD
desfrequentando-te	desfrequentar+V.tu.AD.2.SG+GRD
desfrequentando-vos	desfrequentar+V.vós.AD.2.PL+GRD
desfrequenta-nos	desfrequentar+nós.AD.1.PL+PRS+2+SG
desfrequenta-nos	desfrequentar+nós.AD.1.PL+PRS+3+SG
desfrequenta-o	desfrequentar+V.ele.ACC.3.M.SG+PRS+3+SG
desfrequenta-os	desfrequentar+V.ele.ACC.3.M.PL+PRS+3+SG
desfrequentara-a	desfrequentar+V.ele.ACC.3.F.SG+PQP+1+SG
desfrequentara-a	desfrequentar+V.ele.ACC.3.F.SG+PQP+3+SG
desfrequentara-as	desfrequentar+V.ele.ACC.3.F.PL+PQP+1+SG
desfrequentara-as	desfrequentar+V.ele.ACC.3.F.PL+PQP+3+SG
desfrequentara-la	desfrequentar+V.ele.ACC.3.F.SG+PQP+2+SG
desfrequentara-las	desfrequentar+V.ele.ACC.3.F.PL+PQP+2+SG
desfrequentara-lhe	desfrequentar+V.ele.DAT.3.SG+PQP+1+SG
desfrequentara-lhe	desfrequentar+V.ele.DAT.3.SG+PQP+3+SG
desfrequentara-lhes	desfrequentar+V.ele.DAT.3.PL+PQP+1+SG
desfrequentara-lhes	desfrequentar+V.ele.DAT.3.PL+PQP+3+SG
desfrequentara-lo	desfrequentar+V.ele.ACC.3.M.SG+PQP+2+SG
desfrequentara-los	desfrequentar+V.ele.ACC.3.M.PL+PQP+2+SG
desfrequentara-me	desfrequentar+V.eu.AD.1.SG+PQP+1+SG
desfrequentara-me	desfrequentar+V.eu.AD.1.SG+PQP+3+SG
desfrequentaram-lhe	desfrequentar+V.ele.DAT.3.SG+PQP+3+PL
desfrequentaram-lhe	desfrequentar+V.ele.DAT.3.SG+PRF+3+PL
desfrequentaram-lhes	desfrequentar+V.ele.DAT.3.PL+PQP+3+PL
desfrequentaram-lhes	desfrequentar+V.ele.DAT.3.PL+PRF+3+PL
desfrequentaram-me	desfrequentar+V.eu.AD.1.SG+PQP+3+PL
desfrequentaram-me	desfrequentar+V.eu.AD.1.SG+PRF+3+PL
desfrequentaram-na	desfrequentar+V.ele.ACC.3.F.SG+PQP+3+PL
desfrequentaram-na	desfrequentar+V.ele.ACC.3.F.SG+PRF+3+PL
desfrequentaram-nas	desfrequentar+V.ele.ACC.3.F.PL+PQP+3+PL
desfrequentaram-nas	desfrequentar+V.ele.ACC.3.F.PL+PRF+3+PL
desfrequentaram-no	desfrequentar+V.ele.ACC.3.M.SG+PQP+3+PL
desfrequentaram-no	desfrequentar+V.ele.ACC.3.M.SG+PRF+3+PL
desfrequentaram-nos	desfrequentar+V.ele.ACC.3.M.PL+PQP+3+PL
desfrequentaram-nos	desfrequentar+V.ele.ACC.3.M.PL+PRF+3+PL
desfrequentaram-nos	desfrequentar+V.nós.AD.1.PL+PQP+3+PL
desfrequentaram-nos	desfrequentar+V.nós.AD.1.PL+PRF+3+PL
desfrequentáramo-la	desfrequentar+V.ele.ACC.3.F.SG+PQP+1+PL
desfrequentáramo-las	desfrequentar+V.ele.ACC.3.F.PL+PQP+1+PL
desfrequentáramo-lo	desfrequentar+V.ele.ACC.3.M.SG+PQP+1+PL
desfrequentáramo-los	desfrequentar+V.ele.ACC.3.M.PL+PQP+1+PL
desfrequentáramo-nos	desfrequentar+nós.AD.1.PL+PQP+1+PL
desfrequentáramos-lhe	desfrequentar+V.ele.DAT.3.SG+PQP+1+PL
desfrequentáramos-lhes	desfrequentar+V.ele.DAT.3.PL+PQP+1+PL
desfrequentáramos-me	desfrequentar+V.eu.AD.1.SG+PQP+1+PL
desfrequentáramos-te	desfrequentar+V.tu.AD.2.SG+PQP+1+PL
desfrequentáramos-vos	desfrequentar+V.vós.AD.2.PL+PQP+1+PL
desfrequentaram-se	desfrequentar+V.ele.REFL+PQP+3+PL
desfrequentaram-se	desfrequentar+V.ele.REFL+PRF+3+PL
desfrequentaram-te	desfrequentar+V.tu.AD.2.SG+PQP+3+PL
desfrequentaram-te	desfrequentar+V.tu.AD.2.SG+PRF+3+PL
desfrequentaram-vos	desfrequentar+V.vós.AD.2.PL+PQP+3+PL
desfrequentaram-vos	desfrequentar+V.vós.AD.2.PL+PRF+3+PL
desfrequentara-nos	desfrequentar+nós.AD.1.PL+PQP+1+SG
desfrequentara-nos	desfrequentar+nós.AD.1.PL+PQP+2+SG
desfrequentara-nos	desfrequentar+nós.AD.1.PL+PQP+3+SG
desfrequentara-o	desfrequentar+V.ele.ACC.3.M.SG+PQP+1+SG
desfrequentara-o	desfrequentar+V.ele.ACC.3.M.SG+PQP+3+SG
desfrequentara-os	desfrequentar+V.ele.ACC.3.M.PL+PQP+1+SG
desfrequentara-os	desfrequentar+V.ele.ACC.3.M.PL+PQP+3+SG
desfrequentara-se	desfrequentar+V.ele.REFL+PQP+1+SG
desfrequentara-se	desfrequentar+V.ele.REFL+PQP+3+SG
desfrequentaras-lhe	desfrequentar+V.ele.DAT.3.SG+PQP+2+SG
desfrequentaras-lhes	desfrequentar+V.ele.DAT.3.PL+PQP+2+SG
desfrequentaras-me	desfrequentar+V.eu.AD.1.SG+PQP+2+SG
desfrequentaras-te	desfrequentar+V.tu.AD.2.SG+PQP+2+SG
desfrequentaras-vos	desfrequentar+V.vós.AD.2.PL+PQP+2+SG
desfrequentara-te	desfrequentar+V.tu.AD.2.SG+PQP+1+SG
desfrequentara-te	desfrequentar+V.tu.AD.2.SG+PQP+3+SG
desfrequentara-vos	desfrequentar+V.vós.AD.2.PL+PQP+1+SG
desfrequentara-vos	desfrequentar+V.vós.AD.2.PL+PQP+3+SG
desfrequentarde-la	desfrequentar+V.ele.ACC.3.F.SG+INF+2+PL
desfrequentarde-la	desfrequentar+V.ele.ACC.3.F.SG+SBJF+2+PL
desfrequentarde-las	desfrequentar+V.ele.ACC.3.F.PL+INF+2+PL
desfrequentarde-las	desfrequentar+V.ele.ACC.3.F.PL+SBJF+2+PL
desfrequentarde-lo	desfrequentar+V.ele.ACC.3.M.SG+INF+2+PL
desfrequentarde-lo	desfrequentar+V.ele.ACC.3.M.SG+SBJF+2+PL
desfrequentarde-los	desfrequentar+V.ele.ACC.3.M.PL+INF+2+PL
desfrequentarde-los	desfrequentar+V.ele.ACC.3.M.PL+SBJF+2+PL
desfrequentarde-nos	desfrequentar+nós.AD.1.PL+INF+2+PL
desfrequentarde-nos	desfrequentar+nós.AD.1.PL+SBJF+2+PL
desfrequentardes-lhe	desfrequentar+V.ele.DAT.3.SG+INF+2+PL
desfrequentardes-lhe	desfrequentar+V.ele.DAT.3.SG+SBJF+2+PL
desfrequentardes-lhes	desfrequentar+V.ele.DAT.3.PL+INF+2+PL
desfrequentardes-lhes	desfrequentar+V.ele.DAT.3.PL+SBJF+2+PL
desfrequentardes-me	desfrequentar+V.eu.AD.1.SG+INF+2+PL
desfrequentardes-me	desfrequentar+V.eu.AD.1.SG+SBJF+2+PL
desfrequentardes-te	desfrequentar+V.tu.AD.2.SG+INF+2+PL
desfrequentardes-te	desfrequentar+V.tu.AD.2.SG+SBJF+2+PL
desfrequentardes-vos	desfrequentar+V.vós.AD.2.PL+INF+2+PL
desfrequentardes-vos	desfrequentar+V.vós.AD.2.PL+SBJF+2+PL
desfrequentárei-la	desfrequentar+V.ele.ACC.3.F.SG+PQP+2+PL
desfrequentárei-las	desfrequentar+V.ele.ACC.3.F.PL+PQP+2+PL
desfrequentárei-lo	desfrequentar+V.ele.ACC.3.M.SG+PQP+2+PL
desfrequentárei-los	desfrequentar+V.ele.ACC.3.M.PL+PQP+2+PL
desfrequentárei-nos	desfrequentar+nós.AD.1.PL+PQP+2+PL
desfrequentáreis-lhe	desfrequentar+V.ele.DAT.3.SG+PQP+2+PL
desfrequentáreis-lhes	desfrequentar+V.ele.DAT.3.PL+PQP+2+PL
desfrequentáreis-me	desfrequentar+V.eu.AD.1.SG+PQP+2+PL
desfrequentáreis-te	desfrequentar+V.tu.AD.2.SG+PQP+2+PL
desfrequentáreis-vos	desfrequentar+V.vós.AD.2.PL+PQP+2+PL
desfrequentare-la	desfrequentar+V.ele.ACC.3.F.SG+INF+2+SG
desfrequentare-la	desfrequentar+V.ele.ACC.3.F.SG+SBJF+2+SG
desfrequentare-las	desfrequentar+V.ele.ACC.3.F.PL+INF+2+SG
desfrequentare-las	desfrequentar+V.ele.ACC.3.F.PL+SBJF+2+SG
desfrequentare-lo	desfrequentar+V.ele.ACC.3.M.SG+INF+2+SG
desfrequentare-lo	desfrequentar+V.ele.ACC.3.M.SG+SBJF+2+SG
desfrequentare-los	desfrequentar+V.ele.ACC.3.M.PL+INF+2+SG
desfrequentare-los	desfrequentar+V.ele.ACC.3.M.PL+SBJF+2+SG
desfrequentarem-lhe	desfrequentar+V.ele.DAT.3.SG+INF+3+PL
desfrequentarem-lhe	desfrequentar+V.ele.DAT.3.SG+SBJF+3+PL
desfrequentarem-lhes	desfrequentar+V.ele.DAT.3.PL+INF+3+PL
desfrequentarem-lhes	desfrequentar+V.ele.DAT.3.PL+SBJF+3+PL
desfrequentarem-me	desfrequentar+V.eu.AD.1.SG+INF+3+PL
desfrequentarem-me	desfrequentar+V.eu.AD.1.SG+SBJF+3+PL
desfrequentarem-na	desfrequentar+V.ele.ACC.3.F.SG+INF+3+PL
desfrequentarem-na	desfrequentar+V.ele.ACC.3.F.SG+SBJF+3+PL
desfrequentarem-nas	desfrequentar+V.ele.ACC.3.F.PL+INF+3+PL
desfrequentarem-nas	desfrequentar+V.ele.ACC.3.F.PL+SBJF+3+PL
desfrequentarem-no	desfrequentar+V.ele.ACC.3.M.SG+INF+3+PL
desfrequentarem-no	desfrequentar+V.ele.ACC.3.M.SG+SBJF+3+PL
desfrequentarem-nos	desfrequentar+V.ele.ACC.3.M.PL+INF+3+PL
desfrequentarem-nos	desfrequentar+V.ele.ACC.3.M.PL+SBJF+3+PL
desfrequentarem-nos	desfrequentar+V.nós.AD.1.PL+INF+3+PL
desfrequentarem-nos	desfrequentar+V.nós.AD.1.PL+SBJF+3+PL
desfrequentarem-se	desfrequentar+V.ele.REFL+INF+3+PL
desfrequentarem-se	desfrequentar+V.ele.REFL+SBJF+3+PL
desfrequentarem-te	desfrequentar+V.tu.AD.2.SG+INF+3+PL
desfrequentarem-te	desfrequentar+V.tu.AD.2.SG+SBJF+3+PL
desfrequentarem-vos	desfrequentar+V.vós.AD.2.PL+INF+3+PL
desfrequentarem-vos	desfrequentar+V.vós.AD.2.PL+SBJF+3+PL
desfrequentare-nos	desfrequentar+nós.AD.1.PL+INF+2+SG
desfrequentare-nos	desfrequentar+nós.AD.1.PL+SBJF+2+SG
desfrequentares-lhe	desfrequentar+V.ele.DAT.3.SG+INF+2+SG
desfrequentares-lhe	desfrequentar+V.ele.DAT.3.SG+SBJF+2+SG
desfrequentares-lhes	desfrequentar+V.ele.DAT.3.PL+INF+2+SG
desfrequentares-lhes	desfrequentar+V.ele.DAT.3.PL+SBJF+2+SG
desfrequentares-me	desfrequentar+V.eu.AD.1.SG+INF+2+SG
desfrequentares-me	desfrequentar+V.eu.AD.1.SG+SBJF+2+SG
desfrequentares-te	desfrequentar+V.tu.AD.2.SG+INF+2+SG
desfrequentares-te	desfrequentar+V.tu.AD.2.SG+SBJF+2+SG
desfrequentares-vos	desfrequentar+V.vós.AD.2.PL+INF+2+SG
desfrequentares-vos	desfrequentar+V.vós.AD.2.PL+SBJF+2+SG
desfrequentar-lhe-á	desfrequentar+V.ele.DAT.3.SG+FUT+3+SG
desfrequentar-lhe-ão	desfrequentar+V.ele.DAT.3.SG+FUT+3+PL
desfrequentar-lhe-ás	desfrequentar+V.ele.DAT.3.SG+FUT+2+SG
desfrequentar-lhe	desfrequentar+V.ele.DAT.3.SG+INF
desfrequentar-lhe	desfrequentar+V.ele.DAT.3.SG+INF+1+SG
desfrequentar-lhe	desfrequentar+V.ele.DAT.3.SG+INF+3+SG
desfrequentar-lhe	desfrequentar+V.ele.DAT.3.SG+SBJF+1+SG
desfrequentar-lhe	desfrequentar+V.ele.DAT.3.SG+SBJF+3+SG
desfrequentar-lhe-ei	desfrequentar+V.ele.DAT.3.SG+FUT+1+SG
desfrequentar-lhe-eis	desfrequentar+V.ele.DAT.3.SG+FUT+2+PL
desfrequentar-lhe-emos	desfrequentar+V.ele.DAT.3.SG+FUT+1+PL
desfrequentar-lhe-ia	desfrequentar+V.ele.DAT.3.SG+COND+1+SG
desfrequentar-lhe-ia	desfrequentar+V.ele.DAT.3.SG+COND+3+SG
desfrequentar-lhe-iam	desfrequentar+V.ele.DAT.3.SG+COND+3+PL
desfrequentar-lhe-íamos	desfrequentar+V.ele.DAT.3.SG+COND+1+PL
desfrequentar-lhe-ias	desfrequentar+V.ele.DAT.3.SG+COND+2+SG
desfrequentar-lhe-íeis	desfrequentar+V.ele.DAT.3.SG+COND+2+PL
desfrequentar-lhes-á	desfrequentar+V.ele.DAT.3.PL+FUT+3+SG
desfrequentar-lhes-ão	desfrequentar+V.ele.DAT.3.PL+FUT+3+PL
desfrequentar-lhes-ás	desfrequentar+V.ele.DAT.3.PL+FUT+2+SG
desfrequentar-lhes	desfrequentar+V.ele.DAT.3.PL+INF
desfrequentar-lhes	desfrequentar+V.ele.DAT.3.PL+INF+1+SG
desfrequentar-lhes	desfrequentar+V.ele.DAT.3.PL+INF+3+SG
desfrequentar-lhes	desfrequentar+V.ele.DAT.3.PL+SBJF+1+SG
desfrequentar-lhes	desfrequentar+V.ele.DAT.3.PL+SBJF+3+SG
desfrequentar-lhes-ei	desfrequentar+V.ele.DAT.3.PL+FUT+1+SG
desfrequentar-lhes-eis	desfrequentar+V.ele.DAT.3.PL+FUT+2+PL
desfrequentar-lhes-emos	desfrequentar+V.ele.DAT.3.PL+FUT+1+PL
desfrequentar-lhes-ia	desfrequentar+V.ele.DAT.3.PL+COND+1+SG
desfrequentar-lhes-ia	desfrequentar+V.ele.DAT.3.PL+COND+3+SG
desfrequentar-lhes-iam	desfrequentar+V.ele.DAT.3.PL+COND+3+PL
desfrequentar-lhes-íamos	desfrequentar+V.ele.DAT.3.PL+COND+1+PL
desfrequentar-lhes-ias	desfrequentar+V.ele.DAT.3.PL+COND+2+SG
desfrequentar-lhes-íeis	desfrequentar+V.ele.DAT.3.PL+COND+2+PL
desfrequentar-me-á	desfrequentar+V.eu.AD.1.SG+FUT+3+SG
desfrequentar-me-ão	desfrequentar+V.eu.AD.1.SG+FUT+3+PL
desfrequentar-me-ás	desfrequentar+V.eu.AD.1.SG+FUT+2+SG
desfrequentar-me	desfrequentar+V.eu.AD.1.SG+INF
desfrequentar-me	desfrequentar+V.eu.AD.1.SG+INF+1+SG
desfrequentar-me	desfrequentar+V.eu.AD.1.SG+INF+3+SG
desfrequentar-me	desfrequentar+V.eu.AD.1.SG+SBJF+1+SG
desfrequentar-me	desfrequentar+V.eu.AD.1.SG+SBJF+3+SG
desfrequentar-me-ei	desfrequentar+V.eu.AD.1.SG+FUT+1+SG
desfrequentar-me-eis	desfrequentar+V.eu.AD.1.SG+FUT+2+PL
desfrequentar-me-emos	desfrequentar+V.eu.AD.1.SG+FUT+1+PL
desfrequentar-me-ia	desfrequentar+V.eu.AD.1.SG+COND+1+SG
desfrequentar-me-ia	desfrequentar+V.eu.AD.1.SG+COND+3+SG
desfrequentar-me-iam	desfrequentar+V.eu.AD.1.SG+COND+3+PL
desfrequentar-me-íamos	desfrequentar+V.eu.AD.1.SG+COND+1+PL
desfrequentar-me-ias	desfrequentar+V.eu.AD.1.SG+COND+2+SG
desfrequentar-me-íeis	desfrequentar+V.eu.AD.1.SG+COND+2+PL
desfrequentarmo-la	desfrequentar+V.ele.ACC.3.F.SG+INF+1+PL
desfrequentarmo-la	desfrequentar+V.ele.ACC.3.F.SG+SBJF+1+PL
desfrequentarmo-las	desfrequentar+V.ele.ACC.3.F.PL+INF+1+PL
desfrequentarmo-las	desfrequentar+V.ele.ACC.3.F.PL+SBJF+1+PL
desfrequentarmo-lo	desfrequentar+V.ele.ACC.3.M.SG+INF+1+PL
desfrequentarmo-lo	desfrequentar+V.ele.ACC.3.M.SG+SBJF+1+PL
desfrequentarmo-los	desfrequentar+V.ele.ACC.3.M.PL+INF+1+PL
desfrequentarmo-los	desfrequentar+V.ele.ACC.3.M.PL+SBJF+1+PL
desfrequentarmo-nos	desfrequentar+nós.AD.1.PL+INF+1+PL
desfrequentarmo-nos	desfrequentar+nós.AD.1.PL+SBJF+1+PL
desfrequentarmos-lhe	desfrequentar+V.ele.DAT.3.SG+INF+1+PL
desfrequentarmos-lhe	desfrequentar+V.ele.DAT.3.SG+SBJF+1+PL
desfrequentarmos-lhes	desfrequentar+V.ele.DAT.3.PL+INF+1+PL
desfrequentarmos-lhes	desfrequentar+V.ele.DAT.3.PL+SBJF+1+PL
desfrequentarmos-me	desfrequentar+V.eu.AD.1.SG+INF+1+PL
desfrequentarmos-me	desfrequentar+V.eu.AD.1.SG+SBJF+1+PL
desfrequentarmos-te	desfrequentar+V.tu.AD.2.SG+INF+1+PL
desfrequentarmos-te	desfrequentar+V.tu.AD.2.SG+SBJF+1+PL
desfrequentarmos-vos	desfrequentar+V.vós.AD.2.PL+INF+1+PL
desfrequentarmos-vos	desfrequentar+V.vós.AD.2.PL+SBJF+1+PL
desfrequentar-nos-á	desfrequentar+nós.AD.1.PL+FUT+3+SG
desfrequentar-nos-ão	desfrequentar+nós.AD.1.PL+FUT+3+PL
desfrequentar-nos-ás	desfrequentar+nós.AD.1.PL+FUT+2+SG
desfrequentar-nos	desfrequentar+nós.AD.1.PL+INF
desfrequentar-nos	desfrequentar+nós.AD.1.PL+INF+1+SG
desfrequentar-nos	desfrequentar+nós.AD.1.PL+INF+3+SG
desfrequentar-nos	desfrequentar+nós.AD.1.PL+SBJF+1+SG
desfrequentar-nos	desfrequentar+nós.AD.1.PL+SBJF+3+SG
desfrequentar-nos-ei	desfrequentar+nós.AD.1.PL+FUT+1+SG
desfrequentar-nos-eis	desfrequentar+nós.AD.1.PL+FUT+2+PL
desfrequentar-nos-emos	desfrequentar+nós.AD.1.PL+FUT+1+PL
desfrequentar-nos-ia	desfrequentar+nós.AD.1.PL+COND+1+SG
desfrequentar-nos-ia	desfrequentar+nós.AD.1.PL+COND+3+SG
desfrequentar-nos-iam	desfrequentar+nós.AD.1.PL+COND+3+PL
desfrequentar-nos-íamos	desfrequentar+nós.AD.1.PL+COND+1+PL
desfrequentar-nos-ias	desfrequentar+nós.AD.1.PL+COND+2+SG
desfrequentar-nos-íeis	desfrequentar+nós.AD.1.PL+COND+2+PL
desfrequentar-se-á	desfrequentar+V.ele.REFL+FUT+3+SG
desfrequentar-se-ão	desfrequentar+V.ele.REFL+FUT+3+PL
desfrequentar-se	desfrequentar+V.ele.REFL+INF
desfrequentar-se	desfrequentar+V.ele.REFL+INF+3+SG
desfrequentar-se	desfrequentar+V.ele.REFL+SBJF+3+SG
desfrequentar-se-ia	desfrequentar+V.ele.REFL+COND+3+SG
desfrequentar-se-iam	desfrequentar+V.ele.REFL+COND+3+PL
desfrequentar-te-á	desfrequentar+V.tu.AD.2.SG+FUT+3+SG
desfrequentar-te-ão	desfrequentar+V.tu.AD.2.SG+FUT+3+PL
desfrequentar-te-ás	desfrequentar+V.tu.AD.2.SG+FUT+2+SG
desfrequentar-te	desfrequentar+V.tu.AD.2.SG+INF
desfrequentar-te	desfrequentar+V.tu.AD.2.SG+INF+1+SG
desfrequentar-te	desfrequentar+V.tu.AD.2.SG+INF+3+SG
desfrequentar-te	desfrequentar+V.tu.AD.2.SG+SBJF+1+SG
desfrequentar-te	desfrequentar+V.tu.AD.2.SG+SBJF+3+SG
desfrequentar-te-ei	desfrequentar+V.tu.AD.2.SG+FUT+1+SG
desfrequentar-te-eis	desfrequentar+V.tu.AD.2.SG+FUT+2+PL
desfrequentar-te-emos	desfrequentar+V.tu.AD.2.SG+FUT+1+PL
desfrequentar-te-ia	desfrequentar+V.tu.AD.2.SG+COND+1+SG
desfrequentar-te-ia	desfrequentar+V.tu.AD.2.SG+COND+3+SG
desfrequentar-te-iam	desfrequentar+V.tu.AD.2.SG+COND+3+PL
desfrequentar-te-íamos	desfrequentar+V.tu.AD.2.SG+COND+1+PL
desfrequentar-te-ias	desfrequentar+V.tu.AD.2.SG+COND+2+SG
desfrequentar-te-íeis	desfrequentar+V.tu.AD.2.SG+COND+2+PL
desfrequentar-vos-á	desfrequentar+V.vós.AD.2.PL+FUT+3+SG
desfrequentar-vos-ão	desfrequentar+V.vós.AD.2.PL+FUT+3+PL
desfrequentar-vos-ás	desfrequentar+V.vós.AD.2.PL+FUT+2+SG
desfrequentar-vos	desfrequentar+V.vós.AD.2.PL+INF
desfrequentar-vos	desfrequentar+V.vós.AD.2.PL+INF+1+SG
desfrequentar-vos	desfrequentar+V.vós.AD.2.PL+INF+3+SG
desfrequentar-vos	desfrequentar+V.vós.AD.2.PL+SBJF+1+SG
desfrequentar-vos	desfrequentar+V.vós.AD.2.PL+SBJF+3+SG
desfrequentar-vos-ei	desfrequentar+V.vós.AD.2.PL+FUT+1+SG
desfrequentar-vos-eis	desfrequentar+V.vós.AD.2.PL+FUT+2+PL
desfrequentar-vos-emos	desfrequentar+V.vós.AD.2.PL+FUT+1+PL
desfrequentar-vos-ia	desfrequentar+V.vós.AD.2.PL+COND+1+SG
desfrequentar-vos-ia	desfrequentar+V.vós.AD.2.PL+COND+3+SG
desfrequentar-vos-iam	desfrequentar+V.vós.AD.2.PL+COND+3+PL
desfrequentar-vos-íamos	desfrequentar+V.vós.AD.2.PL+COND+1+PL
desfrequentar-vos-ias	desfrequentar+V.vós.AD.2.PL+COND+2+SG
desfrequentar-vos-íeis	desfrequentar+V.vós.AD.2.PL+COND+2+PL
desfrequenta-se	desfrequentar+V.ele.REFL+PRS+3+SG
desfrequentas-lhe	desfrequentar+V.ele.DAT.3.SG+PRS+2+SG
desfrequentas-lhes	desfrequentar+V.ele.DAT.3.PL+PRS+2+SG
desfrequentas-me	desfrequentar+V.eu.AD.1.SG+PRS+2+SG
desfrequentaste-a	desfrequentar+V.ele.ACC.3.F.SG+PRF+2+SG
desfrequentaste-as	desfrequentar+V.ele.ACC.3.F.PL+PRF+2+SG
desfrequentas-te	desfrequentar+V.tu.AD.2.SG+PRS+2+SG
desfrequentaste-la	desfrequentar+V.ele.ACC.3.F.SG+PRF+2+PL
desfrequentaste-las	desfrequentar+V.ele.ACC.3.F.PL+PRF+2+PL
desfrequentaste-lhe	desfrequentar+V.ele.DAT.3.SG+PRF+2+SG
desfrequentaste-lhes	desfrequentar+V.ele.DAT.3.PL+PRF+2+SG
desfrequentaste-lo	desfrequentar+V.ele.ACC.3.M.SG+PRF+2+PL
desfrequentaste-los	desfrequentar+V.ele.ACC.3.M.PL+PRF+2+PL
desfrequentaste-me	desfrequentar+V.eu.AD.1.SG+PRF+2+SG
desfrequentaste-nos	desfrequentar+nós.AD.1.PL+PRF+2+PL
desfrequentaste-nos	desfrequentar+nós.AD.1.PL+PRF+2+SG
desfrequentaste-o	desfrequentar+V.ele.ACC.3.M.SG+PRF+2+SG
desfrequentaste-os	desfrequentar+V.ele.ACC.3.M.PL+PRF+2+SG
desfrequentastes-lhe	desfrequentar+V.ele.DAT.3.SG+PRF+2+PL
desfrequentastes-lhes	desfrequentar+V.ele.DAT.3.PL+PRF+2+PL
desfrequentastes-me	desfrequentar+V.eu.AD.1.SG+PRF+2+PL
desfrequentastes-te	desfrequentar+V.tu.AD.2.SG+PRF+2+PL
desfrequentastes-vos	desfrequentar+V.vós.AD.2.PL+PRF+2+PL
desfrequentaste-te	desfrequentar+V.tu.AD.2.SG+PRF+2+SG
desfrequentaste-vos	desfrequentar+V.vós.AD.2.PL+PRF+2+SG
desfrequentas-vos	desfrequentar+V.vós.AD.2.PL+PRS+2+SG
desfrequenta-te	desfrequentar+V.tu.AD.2.SG+PRS+3+SG
desfrequentava-a	desfrequentar+V.ele.ACC.3.F.SG+IMPF+1+SG
desfrequentava-a	desfrequentar+V.ele.ACC.3.F.SG+IMPF+3+SG
desfrequentava-as	desfrequentar+V.ele.ACC.3.F.PL+IMPF+1+SG
desfrequentava-as	desfrequentar+V.ele.ACC.3.F.PL+IMPF+3+SG
desfrequentava-la	desfrequentar+V.ele.ACC.3.F.SG+IMPF+2+SG
desfrequentava-las	desfrequentar+V.ele.ACC.3.F.PL+IMPF+2+SG
desfrequentava-lhe	desfrequentar+V.ele.DAT.3.SG+IMPF+1+SG
desfrequentava-lhe	desfrequentar+V.ele.DAT.3.SG+IMPF+3+SG
desfrequentava-lhes	desfrequentar+V.ele.DAT.3.PL+IMPF+1+SG
desfrequentava-lhes	desfrequentar+V.ele.DAT.3.PL+IMPF+3+SG
desfrequentava-lo	desfrequentar+V.ele.ACC.3.M.SG+IMPF+2+SG
desfrequentava-los	desfrequentar+V.ele.ACC.3.M.PL+IMPF+2+SG
desfrequentava-me	desfrequentar+V.eu.AD.1.SG+IMPF+1+SG
desfrequentava-me	desfrequentar+V.eu.AD.1.SG+IMPF+3+SG
desfrequentavam-lhe	desfrequentar+V.ele.DAT.3.SG+IMPF+3+PL
desfrequentavam-lhes	desfrequentar+V.ele.DAT.3.PL+IMPF+3+PL
desfrequentavam-me	desfrequentar+V.eu.AD.1.SG+IMPF+3+PL
desfrequentavam-na	desfrequentar+V.ele.ACC.3.F.SG+IMPF+3+PL
desfrequentavam-nas	desfrequentar+V.ele.ACC.3.F.PL+IMPF+3+PL
desfrequentavam-no	desfrequentar+V.ele.ACC.3.M.SG+IMPF+3+PL
desfrequentavam-nos	desfrequentar+V.ele.ACC.3.M.PL+IMPF+3+PL
desfrequentavam-nos	desfrequentar+V.nós.AD.1.PL+IMPF+3+PL
desfrequentávamo-la	desfrequentar+V.ele.ACC.3.F.SG+IMPF+1+PL
desfrequentávamo-las	desfrequentar+V.ele.ACC.3.F.PL+IMPF+1+PL
desfrequentávamo-lo	desfrequentar+V.ele.ACC.3.M.SG+IMPF+1+PL
desfrequentávamo-los	desfrequentar+V.ele.ACC.3.M.PL+IMPF+1+PL
desfrequentávamo-nos	desfrequentar+nós.AD.1.PL+IMPF+1+PL
desfrequentávamos-lhe	desfrequentar+V.ele.DAT.3.SG+IMPF+1+PL
desfrequentávamos-lhes	desfrequentar+V.ele.DAT.3.PL+IMPF+1+PL
desfrequentávamos-me	desfrequentar+V.eu.AD.1.SG+IMPF+1+PL
desfrequentávamos-te	desfrequentar+V.tu.AD.2.SG+IMPF+1+PL
desfrequentávamos-vos	desfrequentar+V.vós.AD.2.PL+IMPF+1+PL
desfrequentavam-se	desfrequentar+V.ele.REFL+IMPF+3+PL
desfrequentavam-te	desfrequentar+V.tu.AD.2.SG+IMPF+3+PL
desfrequentavam-vos	desfrequentar+V.vós.AD.2.PL+IMPF+3+PL
desfrequentava-nos	desfrequentar+nós.AD.1.PL+IMPF+1+SG
desfrequentava-nos	desfrequentar+nós.AD.1.PL+IMPF+2+SG
desfrequentava-nos	desfrequentar+nós.AD.1.PL+IMPF+3+SG
desfrequentava-o	desfrequentar+V.ele.ACC.3.M.SG+IMPF+1+SG
desfrequentava-o	desfrequentar+V.ele.ACC.3.M.SG+IMPF+3+SG
desfrequentava-os	desfrequentar+V.ele.ACC.3.M.PL+IMPF+1+SG
desfrequentava-os	desfrequentar+V.ele.ACC.3.M.PL+IMPF+3+SG
desfrequentava-se	desfrequentar+V.ele.REFL+IMPF+1+SG
desfrequentava-se	desfrequentar+V.ele.REFL+IMPF+3+SG
desfrequentavas-lhe	desfrequentar+V.ele.DAT.3.SG+IMPF+2+SG
desfrequentavas-lhes	desfrequentar+V.ele.DAT.3.PL+IMPF+2+SG
desfrequentavas-me	desfrequentar+V.eu.AD.1.SG+IMPF+2+SG
desfrequentavas-te	desfrequentar+V.tu.AD.2.SG+IMPF+2+SG
desfrequentavas-vos	desfrequentar+V.vós.AD.2.PL+IMPF+2+SG
desfrequentava-te	desfrequentar+V.tu.AD.2.SG+IMPF+1+SG
desfrequentava-te	desfrequentar+V.tu.AD.2.SG+IMPF+3+SG
desfrequentava-vos	desfrequentar+V.vós.AD.2.PL+IMPF+1+SG
desfrequentava-vos	desfrequentar+V.vós.AD.2.PL+IMPF+3+SG
desfrequentávei-la	desfrequentar+V.ele.ACC.3.F.SG+IMPF+2+PL
desfrequentávei-las	desfrequentar+V.ele.ACC.3.F.PL+IMPF+2+PL
desfrequentávei-lo	desfrequentar+V.ele.ACC.3.M.SG+IMPF+2+PL
desfrequentávei-los	desfrequentar+V.ele.ACC.3.M.PL+IMPF+2+PL
desfrequentávei-nos	desfrequentar+nós.AD.1.PL+IMPF+2+PL
desfrequentáveis-lhe	desfrequentar+V.ele.DAT.3.SG+IMPF+2+PL
desfrequentáveis-lhes	desfrequentar+V.ele.DAT.3.PL+IMPF+2+PL
desfrequentáveis-me	desfrequentar+V.eu.AD.1.SG+IMPF+2+PL
desfrequentáveis-te	desfrequentar+V.tu.AD.2.SG+IMPF+2+PL
desfrequentáveis-vos	desfrequentar+V.vós.AD.2.PL+IMPF+2+PL
desfrequenta-vos	desfrequentar+V.vós.AD.2.PL+PRS+3+SG
desfrequente-a	desfrequentar+V.ele.ACC.3.F.SG+IMP+3+SG
desfrequente-as	desfrequentar+V.ele.ACC.3.F.PL+IMP+3+SG
desfrequentei-a	desfrequentar+V.ele.ACC.3.F.SG+PRF+1+SG
desfrequentei-as	desfrequentar+V.ele.ACC.3.F.PL+PRF+1+SG
desfrequentei-lhe	desfrequentar+V.ele.DAT.3.SG+PRF+1+SG
desfrequentei-lhes	desfrequentar+V.ele.DAT.3.PL+PRF+1+SG
desfrequentei-me	desfrequentar+V.eu.AD.1.SG+PRF+1+SG
desfrequentei-nos	desfrequentar+nós.AD.1.PL+PRF+1+SG
desfrequentei-o	desfrequentar+V.ele.ACC.3.M.SG+PRF+1+SG
desfrequentei-os	desfrequentar+V.ele.ACC.3.M.PL+PRF+1+SG
desfrequentei-te	desfrequentar+V.tu.AD.2.SG+PRF+1+SG
desfrequentei-vos	desfrequentar+V.vós.AD.2.PL+PRF+1+SG
desfrequente-lhe	desfrequentar+V.ele.DAT.3.SG+IMP+3+SG
desfrequente-lhes	desfrequentar+V.ele.DAT.3.PL+IMP+3+SG
desfrequente-me	desfrequentar+V.eu.AD.1.SG+IMP+3+SG
desfrequentem-lhe	desfrequentar+V.ele.DAT.3.SG+IMP+3+PL
desfrequentem-lhes	desfrequentar+V.ele.DAT.3.PL+IMP+3+PL
desfrequentem-me	desfrequentar+V.eu.AD.1.SG+IMP+3+PL
desfrequentem-na	desfrequentar+V.ele.ACC.3.F.SG+IMP+3+PL
desfrequentem-nas	desfrequentar+V.ele.ACC.3.F.PL+IMP+3+PL
desfrequentem-no	desfrequentar+V.ele.ACC.3.M.SG+IMP+3+PL
desfrequentem-nos	desfrequentar+V.ele.ACC.3.M.PL+IMP+3+PL
desfrequentem-nos	desfrequentar+V.nós.AD.1.PL+IMP+3+PL
desfrequentemo-la	desfrequentar+V.ele.ACC.3.F.SG+IMP+1+PL
desfrequentemo-las	desfrequentar+V.ele.ACC.3.F.PL+IMP+1+PL
desfrequentemo-lo	desfrequentar+V.ele.ACC.3.M.SG+IMP+1+PL
desfrequentemo-los	desfrequentar+V.ele.ACC.3.M.PL+IMP+1+PL
desfrequentemo-nos	desfrequentar+nós.AD.1.PL+IMP+1+PL
desfrequentemos-lhe	desfrequentar+V.ele.DAT.3.SG+IMP+1+PL
desfrequentemos-lhes	desfrequentar+V.ele.DAT.3.PL+IMP+1+PL
desfrequentemos-me	desfrequentar+V.eu.AD.1.SG+IMP+1+PL
desfrequentemos-te	desfrequentar+V.tu.AD.2.SG+IMP+1+PL
desfrequentemos-vos	desfrequentar+V.vós.AD.2.PL+IMP+1+PL
desfrequentem-se	desfrequentar+V.ele.REFL+IMP+3+PL
desfrequentem-te	desfrequentar+V.tu.AD.2.SG+IMP+3+PL
desfrequentem-vos	desfrequentar+V.vós.AD.2.PL+IMP+3+PL
desfrequente-nos	desfrequentar+nós.AD.1.PL+IMP+3+SG
desfrequente-o	desfrequentar+V.ele.ACC.3.M.SG+IMP+3+SG
desfrequente-os	desfrequentar+V.ele.ACC.3.M.PL+IMP+3+SG
desfrequente-se	desfrequentar+V.ele.REFL+IMP+3+SG
desfrequente-te	desfrequentar+V.tu.AD.2.SG+IMP+3+SG
desfrequente-vos	desfrequentar+V.vós.AD.2.PL+IMP+3+SG
desfrequento-a	desfrequentar+V.ele.ACC.3.F.SG+PRS+1+SG
desfrequento-as	desfrequentar+V.ele.ACC.3.F.PL+PRS+1+SG
desfrequento-lhe	desfrequentar+V.ele.DAT.3.SG+PRS+1+SG
desfrequento-lhes	desfrequentar+V.ele.DAT.3.PL+PRS+1+SG
desfrequento-me	desfrequentar+V.eu.AD.1.SG+PRS+1+SG
desfrequento-nos	desfrequentar+nós.AD.1.PL+PRS+1+SG
desfrequento-o	desfrequentar+V.ele.ACC.3.M.SG+PRS+1+SG
desfrequento-os	desfrequentar+V.ele.ACC.3.M.PL+PRS+1+SG
desfrequento-te	desfrequentar+V.tu.AD.2.SG+PRS+1+SG
desfrequentou-a	desfrequentar+V.ele.ACC.3.F.SG+PRF+3+SG
desfrequentou-as	desfrequentar+V.ele.ACC.3.F.PL+PRF+3+SG
desfrequentou-lhe	desfrequentar+V.ele.DAT.3.SG+PRF+3+SG
desfrequentou-lhes	desfrequentar+V.ele.DAT.3.PL+PRF+3+SG
desfrequentou-me	desfrequentar+V.eu.AD.1.SG+PRF+3+SG
desfrequentou-nos	desfrequentar+nós.AD.1.PL+PRF+3+SG
desfrequentou-o	desfrequentar+V.ele.ACC.3.M.SG+PRF+3+SG
desfrequentou-os	desfrequentar+V.ele.ACC.3.M.PL+PRF+3+SG
desfrequentou-se	desfrequentar+V.ele.REFL+PRF+3+SG
desfrequentou-te	desfrequentar+V.tu.AD.2.SG+PRF+3+SG
desfrequentou-vos	desfrequentar+V.vós.AD.2.PL+PRF+3+SG
desfrequento-vos	desfrequentar+V.vós.AD.2.PL+PRS+1+SG
desfrisa-a	desfrisar+V.ele.ACC.3.F.SG+PRS+3+SG
desfrisa-as	desfrisar+V.ele.ACC.3.F.PL+PRS+3+SG
desfrisai-la	desfrisar+V.ele.ACC.3.F.SG+PRS+2+PL
desfrisai-las	desfrisar+V.ele.ACC.3.F.PL+PRS+2+PL
desfrisai-lo	desfrisar+V.ele.ACC.3.M.SG+PRS+2+PL
desfrisai-los	desfrisar+V.ele.ACC.3.M.PL+PRS+2+PL
desfrisai-nos	desfrisar+nós.AD.1.PL+PRS+2+PL
desfrisais-lhe	desfrisar+V.ele.DAT.3.SG+PRS+2+PL
desfrisais-lhes	desfrisar+V.ele.DAT.3.PL+PRS+2+PL
desfrisais-me	desfrisar+V.eu.AD.1.SG+PRS+2+PL
desfrisais-te	desfrisar+V.tu.AD.2.SG+PRS+2+PL
desfrisais-vos	desfrisar+V.vós.AD.2.PL+PRS+2+PL
desfrisá-la-á	desfrisar+V.ele.ACC.3.F.SG+FUT+3+SG
desfrisá-la-ão	desfrisar+V.ele.ACC.3.F.SG+FUT+3+PL
desfrisá-la-ás	desfrisar+V.ele.ACC.3.F.SG+FUT+2+SG
desfrisá-la	desfrisar+V.ele.ACC.3.F.SG+INF+1+SG
desfrisá-la	desfrisar+V.ele.ACC.3.F.SG+INF+3+SG
desfrisa-la	desfrisar+V.ele.ACC.3.F.SG+PRS+2+SG
desfrisá-la	desfrisar+V.ele.ACC.3.F.SG+SBJF+1+SG
desfrisá-la	desfrisar+V.ele.ACC.3.F.SG+SBJF+3+SG
desfrisá-la-ei	desfrisar+V.ele.ACC.3.F.SG+FUT+1+SG
desfrisá-la-eis	desfrisar+V.ele.ACC.3.F.SG+FUT+2+PL
desfrisá-la-emos	desfrisar+V.ele.ACC.3.F.SG+FUT+1+PL
desfrisá-la-ia	desfrisar+V.ele.ACC.3.F.SG+COND+1+SG
desfrisá-la-ia	desfrisar+V.ele.ACC.3.F.SG+COND+3+SG
desfrisá-la-iam	desfrisar+V.ele.ACC.3.F.SG+COND+3+PL
desfrisá-la-íamos	desfrisar+V.ele.ACC.3.F.SG+COND+1+PL
desfrisá-la-ias	desfrisar+V.ele.ACC.3.F.SG+COND+2+SG
desfrisá-la-íeis	desfrisar+V.ele.ACC.3.F.SG+COND+2+PL
desfrisá-las-á	desfrisar+V.ele.ACC.3.F.PL+FUT+3+SG
desfrisá-las-ão	desfrisar+V.ele.ACC.3.F.PL+FUT+3+PL
desfrisá-las-ás	desfrisar+V.ele.ACC.3.F.PL+FUT+2+SG
desfrisá-las	desfrisar+V.ele.ACC.3.F.PL+INF+1+SG
desfrisá-las	desfrisar+V.ele.ACC.3.F.PL+INF+3+SG
desfrisa-las	desfrisar+V.ele.ACC.3.F.PL+PRS+2+SG
desfrisá-las	desfrisar+V.ele.ACC.3.F.PL+SBJF+1+SG
desfrisá-las	desfrisar+V.ele.ACC.3.F.PL+SBJF+3+SG
desfrisá-las-ei	desfrisar+V.ele.ACC.3.F.PL+FUT+1+SG
desfrisá-las-eis	desfrisar+V.ele.ACC.3.F.PL+FUT+2+PL
desfrisá-las-emos	desfrisar+V.ele.ACC.3.F.PL+FUT+1+PL
desfrisá-las-ia	desfrisar+V.ele.ACC.3.F.PL+COND+1+SG
desfrisá-las-ia	desfrisar+V.ele.ACC.3.F.PL+COND+3+SG
desfrisá-las-iam	desfrisar+V.ele.ACC.3.F.PL+COND+3+PL
desfrisá-las-íamos	desfrisar+V.ele.ACC.3.F.PL+COND+1+PL
desfrisá-las-ias	desfrisar+V.ele.ACC.3.F.PL+COND+2+SG
desfrisá-las-íeis	desfrisar+V.ele.ACC.3.F.PL+COND+2+PL
desfrisa-lhe	desfrisar+V.ele.DAT.3.SG+PRS+3+SG
desfrisa-lhes	desfrisar+V.ele.DAT.3.PL+PRS+3+SG
desfrisá-lo-á	desfrisar+V.ele.ACC.3.M.SG+FUT+3+SG
desfrisá-lo-ão	desfrisar+V.ele.ACC.3.M.SG+FUT+3+PL
desfrisá-lo-ás	desfrisar+V.ele.ACC.3.M.SG+FUT+2+SG
desfrisá-lo	desfrisar+V.ele.ACC.3.M.SG+INF+1+SG
desfrisá-lo	desfrisar+V.ele.ACC.3.M.SG+INF+3+SG
desfrisa-lo	desfrisar+V.ele.ACC.3.M.SG+PRS+2+SG
desfrisá-lo	desfrisar+V.ele.ACC.3.M.SG+SBJF+1+SG
desfrisá-lo	desfrisar+V.ele.ACC.3.M.SG+SBJF+3+SG
desfrisá-lo-ei	desfrisar+V.ele.ACC.3.M.SG+FUT+1+SG
desfrisá-lo-eis	desfrisar+V.ele.ACC.3.M.SG+FUT+2+PL
desfrisá-lo-emos	desfrisar+V.ele.ACC.3.M.SG+FUT+1+PL
desfrisá-lo-ia	desfrisar+V.ele.ACC.3.M.SG+COND+1+SG
desfrisá-lo-ia	desfrisar+V.ele.ACC.3.M.SG+COND+3+SG
desfrisá-lo-iam	desfrisar+V.ele.ACC.3.M.SG+COND+3+PL
desfrisá-lo-íamos	desfrisar+V.ele.ACC.3.M.SG+COND+1+PL
desfrisá-lo-ias	desfrisar+V.ele.ACC.3.M.SG+COND+2+SG
desfrisá-lo-íeis	desfrisar+V.ele.ACC.3.M.SG+COND+2+PL
desfrisá-los-á	desfrisar+V.ele.ACC.3.M.PL+FUT+3+SG
desfrisá-los-ão	desfrisar+V.ele.ACC.3.M.PL+FUT+3+PL
desfrisá-los-ás	desfrisar+V.ele.ACC.3.M.PL+FUT+2+SG
desfrisá-los	desfrisar+V.ele.ACC.3.M.PL+INF+1+SG
desfrisá-los	desfrisar+V.ele.ACC.3.M.PL+INF+3+SG
desfrisa-los	desfrisar+V.ele.ACC.3.M.PL+PRS+2+SG
desfrisá-los	desfrisar+V.ele.ACC.3.M.PL+SBJF+1+SG
desfrisá-los	desfrisar+V.ele.ACC.3.M.PL+SBJF+3+SG
desfrisá-los-ei	desfrisar+V.ele.ACC.3.M.PL+FUT+1+SG
desfrisá-los-eis	desfrisar+V.ele.ACC.3.M.PL+FUT+2+PL
desfrisá-los-emos	desfrisar+V.ele.ACC.3.M.PL+FUT+1+PL
desfrisá-los-ia	desfrisar+V.ele.ACC.3.M.PL+COND+1+SG
desfrisá-los-ia	desfrisar+V.ele.ACC.3.M.PL+COND+3+SG
desfrisá-los-iam	desfrisar+V.ele.ACC.3.M.PL+COND+3+PL
desfrisá-los-íamos	desfrisar+V.ele.ACC.3.M.PL+COND+1+PL
desfrisá-los-ias	desfrisar+V.ele.ACC.3.M.PL+COND+2+SG
desfrisá-los-íeis	desfrisar+V.ele.ACC.3.M.PL+COND+2+PL
desfrisa-me	desfrisar+V.eu.AD.1.SG+PRS+3+SG
desfrisam-lhe	desfrisar+V.ele.DAT.3.SG+PRS+3+PL
desfrisam-lhes	desfrisar+V.ele.DAT.3.PL+PRS+3+PL
desfrisam-me	desfrisar+V.eu.AD.1.SG+PRS+3+PL
desfrisam-na	desfrisar+V.ele.ACC.3.F.SG+PRS+3+PL
desfrisam-nas	desfrisar+V.ele.ACC.3.F.PL+PRS+3+PL
desfrisam-no	desfrisar+V.ele.ACC.3.M.SG+PRS+3+PL
desfrisam-nos	desfrisar+V.ele.ACC.3.M.PL+PRS+3+PL
desfrisam-nos	desfrisar+V.nós.AD.1.PL+PRS+3+PL
desfrisamo-la	desfrisar+V.ele.ACC.3.F.SG+PRF+1+PL
desfrisamo-la	desfrisar+V.ele.ACC.3.F.SG+PRS+1+PL
desfrisamo-las	desfrisar+V.ele.ACC.3.F.PL+PRF+1+PL
desfrisamo-las	desfrisar+V.ele.ACC.3.F.PL+PRS+1+PL
desfrisamo-lo	desfrisar+V.ele.ACC.3.M.SG+PRF+1+PL
desfrisamo-lo	desfrisar+V.ele.ACC.3.M.SG+PRS+1+PL
desfrisamo-los	desfrisar+V.ele.ACC.3.M.PL+PRF+1+PL
desfrisamo-los	desfrisar+V.ele.ACC.3.M.PL+PRS+1+PL
desfrisamo-nos	desfrisar+nós.AD.1.PL+PRF+1+PL
desfrisamo-nos	desfrisar+nós.AD.1.PL+PRS+1+PL
desfrisamos-lhe	desfrisar+V.ele.DAT.3.SG+PRF+1+PL
desfrisamos-lhe	desfrisar+V.ele.DAT.3.SG+PRS+1+PL
desfrisamos-lhes	desfrisar+V.ele.DAT.3.PL+PRF+1+PL
desfrisamos-lhes	desfrisar+V.ele.DAT.3.PL+PRS+1+PL
desfrisamos-me	desfrisar+V.eu.AD.1.SG+PRF+1+PL
desfrisamos-me	desfrisar+V.eu.AD.1.SG+PRS+1+PL
desfrisamos-te	desfrisar+V.tu.AD.2.SG+PRF+1+PL
desfrisamos-te	desfrisar+V.tu.AD.2.SG+PRS+1+PL
desfrisamos-vos	desfrisar+V.vós.AD.2.PL+PRF+1+PL
desfrisamos-vos	desfrisar+V.vós.AD.2.PL+PRS+1+PL
desfrisam-se	desfrisar+V.ele.REFL+PRS+3+PL
desfrisam-te	desfrisar+V.tu.AD.2.SG+PRS+3+PL
desfrisam-vos	desfrisar+V.vós.AD.2.PL+PRS+3+PL
desfrisando-a	desfrisar+V.ele.ACC.3.F.SG+GRD
desfrisando-as	desfrisar+V.ele.ACC.3.F.PL+GRD
desfrisando-lhe	desfrisar+V.ele.DAT.3.SG+GRD
desfrisando-lhes	desfrisar+V.ele.DAT.3.PL+GRD
desfrisando-me	desfrisar+V.eu.AD.1.SG+GRD
desfrisando-nos	desfrisar+nós.AD.1.PL+GRD
desfrisando-o	desfrisar+V.ele.ACC.3.M.SG+GRD
desfrisando-os	desfrisar+V.ele.ACC.3.M.PL+GRD
desfrisando-se	desfrisar+V.ele.REFL+GRD
desfrisando-te	desfrisar+V.tu.AD.2.SG+GRD
desfrisando-vos	desfrisar+V.vós.AD.2.PL+GRD
desfrisa-nos	desfrisar+nós.AD.1.PL+PRS+2+SG
desfrisa-nos	desfrisar+nós.AD.1.PL+PRS+3+SG
desfrisa-o	desfrisar+V.ele.ACC.3.M.SG+PRS+3+SG
desfrisa-os	desfrisar+V.ele.ACC.3.M.PL+PRS+3+SG
desfrisara-a	desfrisar+V.ele.ACC.3.F.SG+PQP+1+SG
desfrisara-a	desfrisar+V.ele.ACC.3.F.SG+PQP+3+SG
desfrisara-as	desfrisar+V.ele.ACC.3.F.PL+PQP+1+SG
desfrisara-as	desfrisar+V.ele.ACC.3.F.PL+PQP+3+SG
desfrisara-la	desfrisar+V.ele.ACC.3.F.SG+PQP+2+SG
desfrisara-las	desfrisar+V.ele.ACC.3.F.PL+PQP+2+SG
desfrisara-lhe	desfrisar+V.ele.DAT.3.SG+PQP+1+SG
desfrisara-lhe	desfrisar+V.ele.DAT.3.SG+PQP+3+SG
desfrisara-lhes	desfrisar+V.ele.DAT.3.PL+PQP+1+SG
desfrisara-lhes	desfrisar+V.ele.DAT.3.PL+PQP+3+SG
desfrisara-lo	desfrisar+V.ele.ACC.3.M.SG+PQP+2+SG
desfrisara-los	desfrisar+V.ele.ACC.3.M.PL+PQP+2+SG
desfrisara-me	desfrisar+V.eu.AD.1.SG+PQP+1+SG
desfrisara-me	desfrisar+V.eu.AD.1.SG+PQP+3+SG
desfrisaram-lhe	desfrisar+V.ele.DAT.3.SG+PQP+3+PL
desfrisaram-lhe	desfrisar+V.ele.DAT.3.SG+PRF+3+PL
desfrisaram-lhes	desfrisar+V.ele.DAT.3.PL+PQP+3+PL
desfrisaram-lhes	desfrisar+V.ele.DAT.3.PL+PRF+3+PL
desfrisaram-me	desfrisar+V.eu.AD.1.SG+PQP+3+PL
desfrisaram-me	desfrisar+V.eu.AD.1.SG+PRF+3+PL
desfrisaram-na	desfrisar+V.ele.ACC.3.F.SG+PQP+3+PL
desfrisaram-na	desfrisar+V.ele.ACC.3.F.SG+PRF+3+PL
desfrisaram-nas	desfrisar+V.ele.ACC.3.F.PL+PQP+3+PL
desfrisaram-nas	desfrisar+V.ele.ACC.3.F.PL+PRF+3+PL
desfrisaram-no	desfrisar+V.ele.ACC.3.M.SG+PQP+3+PL
desfrisaram-no	desfrisar+V.ele.ACC.3.M.SG+PRF+3+PL
desfrisaram-nos	desfrisar+V.ele.ACC.3.M.PL+PQP+3+PL
desfrisaram-nos	desfrisar+V.ele.ACC.3.M.PL+PRF+3+PL
desfrisaram-nos	desfrisar+V.nós.AD.1.PL+PQP+3+PL
desfrisaram-nos	desfrisar+V.nós.AD.1.PL+PRF+3+PL
desfrisáramo-la	desfrisar+V.ele.ACC.3.F.SG+PQP+1+PL
desfrisáramo-las	desfrisar+V.ele.ACC.3.F.PL+PQP+1+PL
desfrisáramo-lo	desfrisar+V.ele.ACC.3.M.SG+PQP+1+PL
desfrisáramo-los	desfrisar+V.ele.ACC.3.M.PL+PQP+1+PL
desfrisáramo-nos	desfrisar+nós.AD.1.PL+PQP+1+PL
desfrisáramos-lhe	desfrisar+V.ele.DAT.3.SG+PQP+1+PL
desfrisáramos-lhes	desfrisar+V.ele.DAT.3.PL+PQP+1+PL
desfrisáramos-me	desfrisar+V.eu.AD.1.SG+PQP+1+PL
desfrisáramos-te	desfrisar+V.tu.AD.2.SG+PQP+1+PL
desfrisáramos-vos	desfrisar+V.vós.AD.2.PL+PQP+1+PL
desfrisaram-se	desfrisar+V.ele.REFL+PQP+3+PL
desfrisaram-se	desfrisar+V.ele.REFL+PRF+3+PL
desfrisaram-te	desfrisar+V.tu.AD.2.SG+PQP+3+PL
desfrisaram-te	desfrisar+V.tu.AD.2.SG+PRF+3+PL
desfrisaram-vos	desfrisar+V.vós.AD.2.PL+PQP+3+PL
desfrisaram-vos	desfrisar+V.vós.AD.2.PL+PRF+3+PL
desfrisara-nos	desfrisar+nós.AD.1.PL+PQP+1+SG
desfrisara-nos	desfrisar+nós.AD.1.PL+PQP+2+SG
desfrisara-nos	desfrisar+nós.AD.1.PL+PQP+3+SG
desfrisara-o	desfrisar+V.ele.ACC.3.M.SG+PQP+1+SG
desfrisara-o	desfrisar+V.ele.ACC.3.M.SG+PQP+3+SG
desfrisara-os	desfrisar+V.ele.ACC.3.M.PL+PQP+1+SG
desfrisara-os	desfrisar+V.ele.ACC.3.M.PL+PQP+3+SG
desfrisara-se	desfrisar+V.ele.REFL+PQP+1+SG
desfrisara-se	desfrisar+V.ele.REFL+PQP+3+SG
desfrisaras-lhe	desfrisar+V.ele.DAT.3.SG+PQP+2+SG
desfrisaras-lhes	desfrisar+V.ele.DAT.3.PL+PQP+2+SG
desfrisaras-me	desfrisar+V.eu.AD.1.SG+PQP+2+SG
desfrisaras-te	desfrisar+V.tu.AD.2.SG+PQP+2+SG
desfrisaras-vos	desfrisar+V.vós.AD.2.PL+PQP+2+SG
desfrisara-te	desfrisar+V.tu.AD.2.SG+PQP+1+SG
desfrisara-te	desfrisar+V.tu.AD.2.SG+PQP+3+SG
desfrisara-vos	desfrisar+V.vós.AD.2.PL+PQP+1+SG
desfrisara-vos	desfrisar+V.vós.AD.2.PL+PQP+3+SG
desfrisarde-la	desfrisar+V.ele.ACC.3.F.SG+INF+2+PL
desfrisarde-la	desfrisar+V.ele.ACC.3.F.SG+SBJF+2+PL
desfrisarde-las	desfrisar+V.ele.ACC.3.F.PL+INF+2+PL
desfrisarde-las	desfrisar+V.ele.ACC.3.F.PL+SBJF+2+PL
desfrisarde-lo	desfrisar+V.ele.ACC.3.M.SG+INF+2+PL
desfrisarde-lo	desfrisar+V.ele.ACC.3.M.SG+SBJF+2+PL
desfrisarde-los	desfrisar+V.ele.ACC.3.M.PL+INF+2+PL
desfrisarde-los	desfrisar+V.ele.ACC.3.M.PL+SBJF+2+PL
desfrisarde-nos	desfrisar+nós.AD.1.PL+INF+2+PL
desfrisarde-nos	desfrisar+nós.AD.1.PL+SBJF+2+PL
desfrisardes-lhe	desfrisar+V.ele.DAT.3.SG+INF+2+PL
desfrisardes-lhe	desfrisar+V.ele.DAT.3.SG+SBJF+2+PL
desfrisardes-lhes	desfrisar+V.ele.DAT.3.PL+INF+2+PL
desfrisardes-lhes	desfrisar+V.ele.DAT.3.PL+SBJF+2+PL
desfrisardes-me	desfrisar+V.eu.AD.1.SG+INF+2+PL
desfrisardes-me	desfrisar+V.eu.AD.1.SG+SBJF+2+PL
desfrisardes-te	desfrisar+V.tu.AD.2.SG+INF+2+PL
desfrisardes-te	desfrisar+V.tu.AD.2.SG+SBJF+2+PL
desfrisardes-vos	desfrisar+V.vós.AD.2.PL+INF+2+PL
desfrisardes-vos	desfrisar+V.vós.AD.2.PL+SBJF+2+PL
desfrisárei-la	desfrisar+V.ele.ACC.3.F.SG+PQP+2+PL
desfrisárei-las	desfrisar+V.ele.ACC.3.F.PL+PQP+2+PL
desfrisárei-lo	desfrisar+V.ele.ACC.3.M.SG+PQP+2+PL
desfrisárei-los	desfrisar+V.ele.ACC.3.M.PL+PQP+2+PL
desfrisárei-nos	desfrisar+nós.AD.1.PL+PQP+2+PL
desfrisáreis-lhe	desfrisar+V.ele.DAT.3.SG+PQP+2+PL
desfrisáreis-lhes	desfrisar+V.ele.DAT.3.PL+PQP+2+PL
desfrisáreis-me	desfrisar+V.eu.AD.1.SG+PQP+2+PL
desfrisáreis-te	desfrisar+V.tu.AD.2.SG+PQP+2+PL
desfrisáreis-vos	desfrisar+V.vós.AD.2.PL+PQP+2+PL
desfrisare-la	desfrisar+V.ele.ACC.3.F.SG+INF+2+SG
desfrisare-la	desfrisar+V.ele.ACC.3.F.SG+SBJF+2+SG
desfrisare-las	desfrisar+V.ele.ACC.3.F.PL+INF+2+SG
desfrisare-las	desfrisar+V.ele.ACC.3.F.PL+SBJF+2+SG
desfrisare-lo	desfrisar+V.ele.ACC.3.M.SG+INF+2+SG
desfrisare-lo	desfrisar+V.ele.ACC.3.M.SG+SBJF+2+SG
desfrisare-los	desfrisar+V.ele.ACC.3.M.PL+INF+2+SG
desfrisare-los	desfrisar+V.ele.ACC.3.M.PL+SBJF+2+SG
desfrisarem-lhe	desfrisar+V.ele.DAT.3.SG+INF+3+PL
desfrisarem-lhe	desfrisar+V.ele.DAT.3.SG+SBJF+3+PL
desfrisarem-lhes	desfrisar+V.ele.DAT.3.PL+INF+3+PL
desfrisarem-lhes	desfrisar+V.ele.DAT.3.PL+SBJF+3+PL
desfrisarem-me	desfrisar+V.eu.AD.1.SG+INF+3+PL
desfrisarem-me	desfrisar+V.eu.AD.1.SG+SBJF+3+PL
desfrisarem-na	desfrisar+V.ele.ACC.3.F.SG+INF+3+PL
desfrisarem-na	desfrisar+V.ele.ACC.3.F.SG+SBJF+3+PL
desfrisarem-nas	desfrisar+V.ele.ACC.3.F.PL+INF+3+PL
desfrisarem-nas	desfrisar+V.ele.ACC.3.F.PL+SBJF+3+PL
desfrisarem-no	desfrisar+V.ele.ACC.3.M.SG+INF+3+PL
desfrisarem-no	desfrisar+V.ele.ACC.3.M.SG+SBJF+3+PL
desfrisarem-nos	desfrisar+V.ele.ACC.3.M.PL+INF+3+PL
desfrisarem-nos	desfrisar+V.ele.ACC.3.M.PL+SBJF+3+PL
desfrisarem-nos	desfrisar+V.nós.AD.1.PL+INF+3+PL
desfrisarem-nos	desfrisar+V.nós.AD.1.PL+SBJF+3+PL
desfrisarem-se	desfrisar+V.ele.REFL+INF+3+PL
desfrisarem-se	desfrisar+V.ele.REFL+SBJF+3+PL
desfrisarem-te	desfrisar+V.tu.AD.2.SG+INF+3+PL
desfrisarem-te	desfrisar+V.tu.AD.2.SG+SBJF+3+PL
desfrisarem-vos	desfrisar+V.vós.AD.2.PL+INF+3+PL
desfrisarem-vos	desfrisar+V.vós.AD.2.PL+SBJF+3+PL
desfrisare-nos	desfrisar+nós.AD.1.PL+INF+2+SG
desfrisare-nos	desfrisar+nós.AD.1.PL+SBJF+2+SG
desfrisares-lhe	desfrisar+V.ele.DAT.3.SG+INF+2+SG
desfrisares-lhe	desfrisar+V.ele.DAT.3.SG+SBJF+2+SG
desfrisares-lhes	desfrisar+V.ele.DAT.3.PL+INF+2+SG
desfrisares-lhes	desfrisar+V.ele.DAT.3.PL+SBJF+2+SG
desfrisares-me	desfrisar+V.eu.AD.1.SG+INF+2+SG
desfrisares-me	desfrisar+V.eu.AD.1.SG+SBJF+2+SG
desfrisares-te	desfrisar+V.tu.AD.2.SG+INF+2+SG
desfrisares-te	desfrisar+V.tu.AD.2.SG+SBJF+2+SG
desfrisares-vos	desfrisar+V.vós.AD.2.PL+INF+2+SG
desfrisares-vos	desfrisar+V.vós.AD.2.PL+SBJF+2+SG
desfrisar-lhe-á	desfrisar+V.ele.DAT.3.SG+FUT+3+SG
desfrisar-lhe-ão	desfrisar+V.ele.DAT.3.SG+FUT+3+PL
desfrisar-lhe-ás	desfrisar+V.ele.DAT.3.SG+FUT+2+SG
desfrisar-lhe	desfrisar+V.ele.DAT.3.SG+INF
desfrisar-lhe	desfrisar+V.ele.DAT.3.SG+INF+1+SG
desfrisar-lhe	desfrisar+V.ele.DAT.3.SG+INF+3+SG
desfrisar-lhe	desfrisar+V.ele.DAT.3.SG+SBJF+1+SG
desfrisar-lhe	desfrisar+V.ele.DAT.3.SG+SBJF+3+SG
desfrisar-lhe-ei	desfrisar+V.ele.DAT.3.SG+FUT+1+SG
desfrisar-lhe-eis	desfrisar+V.ele.DAT.3.SG+FUT+2+PL
desfrisar-lhe-emos	desfrisar+V.ele.DAT.3.SG+FUT+1+PL
desfrisar-lhe-ia	desfrisar+V.ele.DAT.3.SG+COND+1+SG
desfrisar-lhe-ia	desfrisar+V.ele.DAT.3.SG+COND+3+SG
desfrisar-lhe-iam	desfrisar+V.ele.DAT.3.SG+COND+3+PL
desfrisar-lhe-íamos	desfrisar+V.ele.DAT.3.SG+COND+1+PL
desfrisar-lhe-ias	desfrisar+V.ele.DAT.3.SG+COND+2+SG
desfrisar-lhe-íeis	desfrisar+V.ele.DAT.3.SG+COND+2+PL
desfrisar-lhes-á	desfrisar+V.ele.DAT.3.PL+FUT+3+SG
desfrisar-lhes-ão	desfrisar+V.ele.DAT.3.PL+FUT+3+PL
desfrisar-lhes-ás	desfrisar+V.ele.DAT.3.PL+FUT+2+SG
desfrisar-lhes	desfrisar+V.ele.DAT.3.PL+INF
desfrisar-lhes	desfrisar+V.ele.DAT.3.PL+INF+1+SG
desfrisar-lhes	desfrisar+V.ele.DAT.3.PL+INF+3+SG
desfrisar-lhes	desfrisar+V.ele.DAT.3.PL+SBJF+1+SG
desfrisar-lhes	desfrisar+V.ele.DAT.3.PL+SBJF+3+SG
desfrisar-lhes-ei	desfrisar+V.ele.DAT.3.PL+FUT+1+SG
desfrisar-lhes-eis	desfrisar+V.ele.DAT.3.PL+FUT+2+PL
desfrisar-lhes-emos	desfrisar+V.ele.DAT.3.PL+FUT+1+PL
desfrisar-lhes-ia	desfrisar+V.ele.DAT.3.PL+COND+1+SG
desfrisar-lhes-ia	desfrisar+V.ele.DAT.3.PL+COND+3+SG
desfrisar-lhes-iam	desfrisar+V.ele.DAT.3.PL+COND+3+PL
