desmelancolizar-nos	desmelancolizar+nós.AD.1.PL+INF
desmelancolizar-nos	desmelancolizar+nós.AD.1.PL+INF+1+SG
desmelancolizar-nos	desmelancolizar+nós.AD.1.PL+INF+3+SG
desmelancolizar-nos	desmelancolizar+nós.AD.1.PL+SBJF+1+SG
desmelancolizar-nos	desmelancolizar+nós.AD.1.PL+SBJF+3+SG
desmelancolizar-nos-ei	desmelancolizar+nós.AD.1.PL+FUT+1+SG
desmelancolizar-nos-eis	desmelancolizar+nós.AD.1.PL+FUT+2+PL
desmelancolizar-nos-emos	desmelancolizar+nós.AD.1.PL+FUT+1+PL
desmelancolizar-nos-ia	desmelancolizar+nós.AD.1.PL+COND+1+SG
desmelancolizar-nos-ia	desmelancolizar+nós.AD.1.PL+COND+3+SG
desmelancolizar-nos-iam	desmelancolizar+nós.AD.1.PL+COND+3+PL
desmelancolizar-nos-íamos	desmelancolizar+nós.AD.1.PL+COND+1+PL
desmelancolizar-nos-ias	desmelancolizar+nós.AD.1.PL+COND+2+SG
desmelancolizar-nos-íeis	desmelancolizar+nós.AD.1.PL+COND+2+PL
desmelancolizar-se-á	desmelancolizar+V.ele.REFL+FUT+3+SG
desmelancolizar-se-ão	desmelancolizar+V.ele.REFL+FUT+3+PL
desmelancolizar-se	desmelancolizar+V.ele.REFL+INF
desmelancolizar-se	desmelancolizar+V.ele.REFL+INF+3+SG
desmelancolizar-se	desmelancolizar+V.ele.REFL+SBJF+3+SG
desmelancolizar-se-ia	desmelancolizar+V.ele.REFL+COND+3+SG
desmelancolizar-se-iam	desmelancolizar+V.ele.REFL+COND+3+PL
desmelancolizar-te-á	desmelancolizar+V.tu.AD.2.SG+FUT+3+SG
desmelancolizar-te-ão	desmelancolizar+V.tu.AD.2.SG+FUT+3+PL
desmelancolizar-te-ás	desmelancolizar+V.tu.AD.2.SG+FUT+2+SG
desmelancolizar-te	desmelancolizar+V.tu.AD.2.SG+INF
desmelancolizar-te	desmelancolizar+V.tu.AD.2.SG+INF+1+SG
desmelancolizar-te	desmelancolizar+V.tu.AD.2.SG+INF+3+SG
desmelancolizar-te	desmelancolizar+V.tu.AD.2.SG+SBJF+1+SG
desmelancolizar-te	desmelancolizar+V.tu.AD.2.SG+SBJF+3+SG
desmelancolizar-te-ei	desmelancolizar+V.tu.AD.2.SG+FUT+1+SG
desmelancolizar-te-eis	desmelancolizar+V.tu.AD.2.SG+FUT+2+PL
desmelancolizar-te-emos	desmelancolizar+V.tu.AD.2.SG+FUT+1+PL
desmelancolizar-te-ia	desmelancolizar+V.tu.AD.2.SG+COND+1+SG
desmelancolizar-te-ia	desmelancolizar+V.tu.AD.2.SG+COND+3+SG
desmelancolizar-te-iam	desmelancolizar+V.tu.AD.2.SG+COND+3+PL
desmelancolizar-te-íamos	desmelancolizar+V.tu.AD.2.SG+COND+1+PL
desmelancolizar-te-ias	desmelancolizar+V.tu.AD.2.SG+COND+2+SG
desmelancolizar-te-íeis	desmelancolizar+V.tu.AD.2.SG+COND+2+PL
desmelancolizar-vos-á	desmelancolizar+V.vós.AD.2.PL+FUT+3+SG
desmelancolizar-vos-ão	desmelancolizar+V.vós.AD.2.PL+FUT+3+PL
desmelancolizar-vos-ás	desmelancolizar+V.vós.AD.2.PL+FUT+2+SG
desmelancolizar-vos	desmelancolizar+V.vós.AD.2.PL+INF
desmelancolizar-vos	desmelancolizar+V.vós.AD.2.PL+INF+1+SG
desmelancolizar-vos	desmelancolizar+V.vós.AD.2.PL+INF+3+SG
desmelancolizar-vos	desmelancolizar+V.vós.AD.2.PL+SBJF+1+SG
desmelancolizar-vos	desmelancolizar+V.vós.AD.2.PL+SBJF+3+SG
desmelancolizar-vos-ei	desmelancolizar+V.vós.AD.2.PL+FUT+1+SG
desmelancolizar-vos-eis	desmelancolizar+V.vós.AD.2.PL+FUT+2+PL
desmelancolizar-vos-emos	desmelancolizar+V.vós.AD.2.PL+FUT+1+PL
desmelancolizar-vos-ia	desmelancolizar+V.vós.AD.2.PL+COND+1+SG
desmelancolizar-vos-ia	desmelancolizar+V.vós.AD.2.PL+COND+3+SG
desmelancolizar-vos-iam	desmelancolizar+V.vós.AD.2.PL+COND+3+PL
desmelancolizar-vos-íamos	desmelancolizar+V.vós.AD.2.PL+COND+1+PL
desmelancolizar-vos-ias	desmelancolizar+V.vós.AD.2.PL+COND+2+SG
desmelancolizar-vos-íeis	desmelancolizar+V.vós.AD.2.PL+COND+2+PL
desmelancoliza-se	desmelancolizar+V.ele.REFL+PRS+3+SG
desmelancolizas-lhe	desmelancolizar+V.ele.DAT.3.SG+PRS+2+SG
desmelancolizas-lhes	desmelancolizar+V.ele.DAT.3.PL+PRS+2+SG
desmelancolizas-me	desmelancolizar+V.eu.AD.1.SG+PRS+2+SG
desmelancolizaste-a	desmelancolizar+V.ele.ACC.3.F.SG+PRF+2+SG
desmelancolizaste-as	desmelancolizar+V.ele.ACC.3.F.PL+PRF+2+SG
desmelancolizas-te	desmelancolizar+V.tu.AD.2.SG+PRS+2+SG
desmelancolizaste-la	desmelancolizar+V.ele.ACC.3.F.SG+PRF+2+PL
desmelancolizaste-las	desmelancolizar+V.ele.ACC.3.F.PL+PRF+2+PL
desmelancolizaste-lhe	desmelancolizar+V.ele.DAT.3.SG+PRF+2+SG
desmelancolizaste-lhes	desmelancolizar+V.ele.DAT.3.PL+PRF+2+SG
desmelancolizaste-lo	desmelancolizar+V.ele.ACC.3.M.SG+PRF+2+PL
desmelancolizaste-los	desmelancolizar+V.ele.ACC.3.M.PL+PRF+2+PL
desmelancolizaste-me	desmelancolizar+V.eu.AD.1.SG+PRF+2+SG
desmelancolizaste-nos	desmelancolizar+nós.AD.1.PL+PRF+2+PL
desmelancolizaste-nos	desmelancolizar+nós.AD.1.PL+PRF+2+SG
desmelancolizaste-o	desmelancolizar+V.ele.ACC.3.M.SG+PRF+2+SG
desmelancolizaste-os	desmelancolizar+V.ele.ACC.3.M.PL+PRF+2+SG
desmelancolizastes-lhe	desmelancolizar+V.ele.DAT.3.SG+PRF+2+PL
desmelancolizastes-lhes	desmelancolizar+V.ele.DAT.3.PL+PRF+2+PL
desmelancolizastes-me	desmelancolizar+V.eu.AD.1.SG+PRF+2+PL
desmelancolizastes-te	desmelancolizar+V.tu.AD.2.SG+PRF+2+PL
desmelancolizastes-vos	desmelancolizar+V.vós.AD.2.PL+PRF+2+PL
desmelancolizaste-te	desmelancolizar+V.tu.AD.2.SG+PRF+2+SG
desmelancolizaste-vos	desmelancolizar+V.vós.AD.2.PL+PRF+2+SG
desmelancolizas-vos	desmelancolizar+V.vós.AD.2.PL+PRS+2+SG
desmelancoliza-te	desmelancolizar+V.tu.AD.2.SG+PRS+3+SG
desmelancolizava-a	desmelancolizar+V.ele.ACC.3.F.SG+IMPF+1+SG
desmelancolizava-a	desmelancolizar+V.ele.ACC.3.F.SG+IMPF+3+SG
desmelancolizava-as	desmelancolizar+V.ele.ACC.3.F.PL+IMPF+1+SG
desmelancolizava-as	desmelancolizar+V.ele.ACC.3.F.PL+IMPF+3+SG
desmelancolizava-la	desmelancolizar+V.ele.ACC.3.F.SG+IMPF+2+SG
desmelancolizava-las	desmelancolizar+V.ele.ACC.3.F.PL+IMPF+2+SG
desmelancolizava-lhe	desmelancolizar+V.ele.DAT.3.SG+IMPF+1+SG
desmelancolizava-lhe	desmelancolizar+V.ele.DAT.3.SG+IMPF+3+SG
desmelancolizava-lhes	desmelancolizar+V.ele.DAT.3.PL+IMPF+1+SG
desmelancolizava-lhes	desmelancolizar+V.ele.DAT.3.PL+IMPF+3+SG
desmelancolizava-lo	desmelancolizar+V.ele.ACC.3.M.SG+IMPF+2+SG
desmelancolizava-los	desmelancolizar+V.ele.ACC.3.M.PL+IMPF+2+SG
desmelancolizava-me	desmelancolizar+V.eu.AD.1.SG+IMPF+1+SG
desmelancolizava-me	desmelancolizar+V.eu.AD.1.SG+IMPF+3+SG
desmelancolizavam-lhe	desmelancolizar+V.ele.DAT.3.SG+IMPF+3+PL
desmelancolizavam-lhes	desmelancolizar+V.ele.DAT.3.PL+IMPF+3+PL
desmelancolizavam-me	desmelancolizar+V.eu.AD.1.SG+IMPF+3+PL
desmelancolizavam-na	desmelancolizar+V.ele.ACC.3.F.SG+IMPF+3+PL
desmelancolizavam-nas	desmelancolizar+V.ele.ACC.3.F.PL+IMPF+3+PL
desmelancolizavam-no	desmelancolizar+V.ele.ACC.3.M.SG+IMPF+3+PL
desmelancolizavam-nos	desmelancolizar+V.ele.ACC.3.M.PL+IMPF+3+PL
desmelancolizavam-nos	desmelancolizar+V.nós.AD.1.PL+IMPF+3+PL
desmelancolizávamo-la	desmelancolizar+V.ele.ACC.3.F.SG+IMPF+1+PL
desmelancolizávamo-las	desmelancolizar+V.ele.ACC.3.F.PL+IMPF+1+PL
desmelancolizávamo-lo	desmelancolizar+V.ele.ACC.3.M.SG+IMPF+1+PL
desmelancolizávamo-los	desmelancolizar+V.ele.ACC.3.M.PL+IMPF+1+PL
desmelancolizávamo-nos	desmelancolizar+nós.AD.1.PL+IMPF+1+PL
desmelancolizávamos-lhe	desmelancolizar+V.ele.DAT.3.SG+IMPF+1+PL
desmelancolizávamos-lhes	desmelancolizar+V.ele.DAT.3.PL+IMPF+1+PL
desmelancolizávamos-me	desmelancolizar+V.eu.AD.1.SG+IMPF+1+PL
desmelancolizávamos-te	desmelancolizar+V.tu.AD.2.SG+IMPF+1+PL
desmelancolizávamos-vos	desmelancolizar+V.vós.AD.2.PL+IMPF+1+PL
desmelancolizavam-se	desmelancolizar+V.ele.REFL+IMPF+3+PL
desmelancolizavam-te	desmelancolizar+V.tu.AD.2.SG+IMPF+3+PL
desmelancolizavam-vos	desmelancolizar+V.vós.AD.2.PL+IMPF+3+PL
desmelancolizava-nos	desmelancolizar+nós.AD.1.PL+IMPF+1+SG
desmelancolizava-nos	desmelancolizar+nós.AD.1.PL+IMPF+2+SG
desmelancolizava-nos	desmelancolizar+nós.AD.1.PL+IMPF+3+SG
desmelancolizava-o	desmelancolizar+V.ele.ACC.3.M.SG+IMPF+1+SG
desmelancolizava-o	desmelancolizar+V.ele.ACC.3.M.SG+IMPF+3+SG
desmelancolizava-os	desmelancolizar+V.ele.ACC.3.M.PL+IMPF+1+SG
desmelancolizava-os	desmelancolizar+V.ele.ACC.3.M.PL+IMPF+3+SG
desmelancolizava-se	desmelancolizar+V.ele.REFL+IMPF+1+SG
desmelancolizava-se	desmelancolizar+V.ele.REFL+IMPF+3+SG
desmelancolizavas-lhe	desmelancolizar+V.ele.DAT.3.SG+IMPF+2+SG
desmelancolizavas-lhes	desmelancolizar+V.ele.DAT.3.PL+IMPF+2+SG
desmelancolizavas-me	desmelancolizar+V.eu.AD.1.SG+IMPF+2+SG
desmelancolizavas-te	desmelancolizar+V.tu.AD.2.SG+IMPF+2+SG
desmelancolizavas-vos	desmelancolizar+V.vós.AD.2.PL+IMPF+2+SG
desmelancolizava-te	desmelancolizar+V.tu.AD.2.SG+IMPF+1+SG
desmelancolizava-te	desmelancolizar+V.tu.AD.2.SG+IMPF+3+SG
desmelancolizava-vos	desmelancolizar+V.vós.AD.2.PL+IMPF+1+SG
desmelancolizava-vos	desmelancolizar+V.vós.AD.2.PL+IMPF+3+SG
desmelancolizávei-la	desmelancolizar+V.ele.ACC.3.F.SG+IMPF+2+PL
desmelancolizávei-las	desmelancolizar+V.ele.ACC.3.F.PL+IMPF+2+PL
desmelancolizávei-lo	desmelancolizar+V.ele.ACC.3.M.SG+IMPF+2+PL
desmelancolizávei-los	desmelancolizar+V.ele.ACC.3.M.PL+IMPF+2+PL
desmelancolizávei-nos	desmelancolizar+nós.AD.1.PL+IMPF+2+PL
desmelancolizáveis-lhe	desmelancolizar+V.ele.DAT.3.SG+IMPF+2+PL
desmelancolizáveis-lhes	desmelancolizar+V.ele.DAT.3.PL+IMPF+2+PL
desmelancolizáveis-me	desmelancolizar+V.eu.AD.1.SG+IMPF+2+PL
desmelancolizáveis-te	desmelancolizar+V.tu.AD.2.SG+IMPF+2+PL
desmelancolizáveis-vos	desmelancolizar+V.vós.AD.2.PL+IMPF+2+PL
desmelancoliza-vos	desmelancolizar+V.vós.AD.2.PL+PRS+3+SG
desmelancolize-a	desmelancolizar+V.ele.ACC.3.F.SG+IMP+3+SG
desmelancolize-as	desmelancolizar+V.ele.ACC.3.F.PL+IMP+3+SG
desmelancolizei-a	desmelancolizar+V.ele.ACC.3.F.SG+PRF+1+SG
desmelancolizei-as	desmelancolizar+V.ele.ACC.3.F.PL+PRF+1+SG
desmelancolizei-lhe	desmelancolizar+V.ele.DAT.3.SG+PRF+1+SG
desmelancolizei-lhes	desmelancolizar+V.ele.DAT.3.PL+PRF+1+SG
desmelancolizei-me	desmelancolizar+V.eu.AD.1.SG+PRF+1+SG
desmelancolizei-nos	desmelancolizar+nós.AD.1.PL+PRF+1+SG
desmelancolizei-o	desmelancolizar+V.ele.ACC.3.M.SG+PRF+1+SG
desmelancolizei-os	desmelancolizar+V.ele.ACC.3.M.PL+PRF+1+SG
desmelancolizei-te	desmelancolizar+V.tu.AD.2.SG+PRF+1+SG
desmelancolizei-vos	desmelancolizar+V.vós.AD.2.PL+PRF+1+SG
desmelancolize-lhe	desmelancolizar+V.ele.DAT.3.SG+IMP+3+SG
desmelancolize-lhes	desmelancolizar+V.ele.DAT.3.PL+IMP+3+SG
desmelancolize-me	desmelancolizar+V.eu.AD.1.SG+IMP+3+SG
desmelancolizem-lhe	desmelancolizar+V.ele.DAT.3.SG+IMP+3+PL
desmelancolizem-lhes	desmelancolizar+V.ele.DAT.3.PL+IMP+3+PL
desmelancolizem-me	desmelancolizar+V.eu.AD.1.SG+IMP+3+PL
desmelancolizem-na	desmelancolizar+V.ele.ACC.3.F.SG+IMP+3+PL
desmelancolizem-nas	desmelancolizar+V.ele.ACC.3.F.PL+IMP+3+PL
desmelancolizem-no	desmelancolizar+V.ele.ACC.3.M.SG+IMP+3+PL
desmelancolizem-nos	desmelancolizar+V.ele.ACC.3.M.PL+IMP+3+PL
desmelancolizem-nos	desmelancolizar+V.nós.AD.1.PL+IMP+3+PL
desmelancolizemo-la	desmelancolizar+V.ele.ACC.3.F.SG+IMP+1+PL
desmelancolizemo-las	desmelancolizar+V.ele.ACC.3.F.PL+IMP+1+PL
desmelancolizemo-lo	desmelancolizar+V.ele.ACC.3.M.SG+IMP+1+PL
desmelancolizemo-los	desmelancolizar+V.ele.ACC.3.M.PL+IMP+1+PL
desmelancolizemo-nos	desmelancolizar+nós.AD.1.PL+IMP+1+PL
desmelancolizemos-lhe	desmelancolizar+V.ele.DAT.3.SG+IMP+1+PL
desmelancolizemos-lhes	desmelancolizar+V.ele.DAT.3.PL+IMP+1+PL
desmelancolizemos-me	desmelancolizar+V.eu.AD.1.SG+IMP+1+PL
desmelancolizemos-te	desmelancolizar+V.tu.AD.2.SG+IMP+1+PL
desmelancolizemos-vos	desmelancolizar+V.vós.AD.2.PL+IMP+1+PL
desmelancolizem-se	desmelancolizar+V.ele.REFL+IMP+3+PL
desmelancolizem-te	desmelancolizar+V.tu.AD.2.SG+IMP+3+PL
desmelancolizem-vos	desmelancolizar+V.vós.AD.2.PL+IMP+3+PL
desmelancolize-nos	desmelancolizar+nós.AD.1.PL+IMP+3+SG
desmelancolize-o	desmelancolizar+V.ele.ACC.3.M.SG+IMP+3+SG
desmelancolize-os	desmelancolizar+V.ele.ACC.3.M.PL+IMP+3+SG
desmelancolize-se	desmelancolizar+V.ele.REFL+IMP+3+SG
desmelancolize-te	desmelancolizar+V.tu.AD.2.SG+IMP+3+SG
desmelancolize-vos	desmelancolizar+V.vós.AD.2.PL+IMP+3+SG
desmelancolizo-a	desmelancolizar+V.ele.ACC.3.F.SG+PRS+1+SG
desmelancolizo-as	desmelancolizar+V.ele.ACC.3.F.PL+PRS+1+SG
desmelancolizo-lhe	desmelancolizar+V.ele.DAT.3.SG+PRS+1+SG
desmelancolizo-lhes	desmelancolizar+V.ele.DAT.3.PL+PRS+1+SG
desmelancolizo-me	desmelancolizar+V.eu.AD.1.SG+PRS+1+SG
desmelancolizo-nos	desmelancolizar+nós.AD.1.PL+PRS+1+SG
desmelancolizo-o	desmelancolizar+V.ele.ACC.3.M.SG+PRS+1+SG
desmelancolizo-os	desmelancolizar+V.ele.ACC.3.M.PL+PRS+1+SG
desmelancolizo-te	desmelancolizar+V.tu.AD.2.SG+PRS+1+SG
desmelancolizou-a	desmelancolizar+V.ele.ACC.3.F.SG+PRF+3+SG
desmelancolizou-as	desmelancolizar+V.ele.ACC.3.F.PL+PRF+3+SG
desmelancolizou-lhe	desmelancolizar+V.ele.DAT.3.SG+PRF+3+SG
desmelancolizou-lhes	desmelancolizar+V.ele.DAT.3.PL+PRF+3+SG
desmelancolizou-me	desmelancolizar+V.eu.AD.1.SG+PRF+3+SG
desmelancolizou-nos	desmelancolizar+nós.AD.1.PL+PRF+3+SG
desmelancolizou-o	desmelancolizar+V.ele.ACC.3.M.SG+PRF+3+SG
desmelancolizou-os	desmelancolizar+V.ele.ACC.3.M.PL+PRF+3+SG
desmelancolizou-se	desmelancolizar+V.ele.REFL+PRF+3+SG
desmelancolizou-te	desmelancolizar+V.tu.AD.2.SG+PRF+3+SG
desmelancolizou-vos	desmelancolizar+V.vós.AD.2.PL+PRF+3+SG
desmelancolizo-vos	desmelancolizar+V.vós.AD.2.PL+PRS+1+SG
desmelhora-a	desmelhorar+V.ele.ACC.3.F.SG+PRS+3+SG
desmelhora-as	desmelhorar+V.ele.ACC.3.F.PL+PRS+3+SG
desmelhorai-la	desmelhorar+V.ele.ACC.3.F.SG+PRS+2+PL
desmelhorai-las	desmelhorar+V.ele.ACC.3.F.PL+PRS+2+PL
desmelhorai-lo	desmelhorar+V.ele.ACC.3.M.SG+PRS+2+PL
desmelhorai-los	desmelhorar+V.ele.ACC.3.M.PL+PRS+2+PL
desmelhorai-nos	desmelhorar+nós.AD.1.PL+PRS+2+PL
desmelhorais-lhe	desmelhorar+V.ele.DAT.3.SG+PRS+2+PL
desmelhorais-lhes	desmelhorar+V.ele.DAT.3.PL+PRS+2+PL
desmelhorais-me	desmelhorar+V.eu.AD.1.SG+PRS+2+PL
desmelhorais-te	desmelhorar+V.tu.AD.2.SG+PRS+2+PL
desmelhorais-vos	desmelhorar+V.vós.AD.2.PL+PRS+2+PL
desmelhorá-la-á	desmelhorar+V.ele.ACC.3.F.SG+FUT+3+SG
desmelhorá-la-ão	desmelhorar+V.ele.ACC.3.F.SG+FUT+3+PL
desmelhorá-la-ás	desmelhorar+V.ele.ACC.3.F.SG+FUT+2+SG
desmelhorá-la	desmelhorar+V.ele.ACC.3.F.SG+INF+1+SG
desmelhorá-la	desmelhorar+V.ele.ACC.3.F.SG+INF+3+SG
desmelhora-la	desmelhorar+V.ele.ACC.3.F.SG+PRS+2+SG
desmelhorá-la	desmelhorar+V.ele.ACC.3.F.SG+SBJF+1+SG
desmelhorá-la	desmelhorar+V.ele.ACC.3.F.SG+SBJF+3+SG
desmelhorá-la-ei	desmelhorar+V.ele.ACC.3.F.SG+FUT+1+SG
desmelhorá-la-eis	desmelhorar+V.ele.ACC.3.F.SG+FUT+2+PL
desmelhorá-la-emos	desmelhorar+V.ele.ACC.3.F.SG+FUT+1+PL
desmelhorá-la-ia	desmelhorar+V.ele.ACC.3.F.SG+COND+1+SG
desmelhorá-la-ia	desmelhorar+V.ele.ACC.3.F.SG+COND+3+SG
desmelhorá-la-iam	desmelhorar+V.ele.ACC.3.F.SG+COND+3+PL
desmelhorá-la-íamos	desmelhorar+V.ele.ACC.3.F.SG+COND+1+PL
desmelhorá-la-ias	desmelhorar+V.ele.ACC.3.F.SG+COND+2+SG
desmelhorá-la-íeis	desmelhorar+V.ele.ACC.3.F.SG+COND+2+PL
desmelhorá-las-á	desmelhorar+V.ele.ACC.3.F.PL+FUT+3+SG
desmelhorá-las-ão	desmelhorar+V.ele.ACC.3.F.PL+FUT+3+PL
desmelhorá-las-ás	desmelhorar+V.ele.ACC.3.F.PL+FUT+2+SG
desmelhorá-las	desmelhorar+V.ele.ACC.3.F.PL+INF+1+SG
desmelhorá-las	desmelhorar+V.ele.ACC.3.F.PL+INF+3+SG
desmelhora-las	desmelhorar+V.ele.ACC.3.F.PL+PRS+2+SG
desmelhorá-las	desmelhorar+V.ele.ACC.3.F.PL+SBJF+1+SG
desmelhorá-las	desmelhorar+V.ele.ACC.3.F.PL+SBJF+3+SG
desmelhorá-las-ei	desmelhorar+V.ele.ACC.3.F.PL+FUT+1+SG
desmelhorá-las-eis	desmelhorar+V.ele.ACC.3.F.PL+FUT+2+PL
desmelhorá-las-emos	desmelhorar+V.ele.ACC.3.F.PL+FUT+1+PL
desmelhorá-las-ia	desmelhorar+V.ele.ACC.3.F.PL+COND+1+SG
desmelhorá-las-ia	desmelhorar+V.ele.ACC.3.F.PL+COND+3+SG
desmelhorá-las-iam	desmelhorar+V.ele.ACC.3.F.PL+COND+3+PL
desmelhorá-las-íamos	desmelhorar+V.ele.ACC.3.F.PL+COND+1+PL
desmelhorá-las-ias	desmelhorar+V.ele.ACC.3.F.PL+COND+2+SG
desmelhorá-las-íeis	desmelhorar+V.ele.ACC.3.F.PL+COND+2+PL
desmelhora-lhe	desmelhorar+V.ele.DAT.3.SG+PRS+3+SG
desmelhora-lhes	desmelhorar+V.ele.DAT.3.PL+PRS+3+SG
desmelhorá-lo-á	desmelhorar+V.ele.ACC.3.M.SG+FUT+3+SG
desmelhorá-lo-ão	desmelhorar+V.ele.ACC.3.M.SG+FUT+3+PL
desmelhorá-lo-ás	desmelhorar+V.ele.ACC.3.M.SG+FUT+2+SG
desmelhorá-lo	desmelhorar+V.ele.ACC.3.M.SG+INF+1+SG
desmelhorá-lo	desmelhorar+V.ele.ACC.3.M.SG+INF+3+SG
desmelhora-lo	desmelhorar+V.ele.ACC.3.M.SG+PRS+2+SG
desmelhorá-lo	desmelhorar+V.ele.ACC.3.M.SG+SBJF+1+SG
desmelhorá-lo	desmelhorar+V.ele.ACC.3.M.SG+SBJF+3+SG
desmelhorá-lo-ei	desmelhorar+V.ele.ACC.3.M.SG+FUT+1+SG
desmelhorá-lo-eis	desmelhorar+V.ele.ACC.3.M.SG+FUT+2+PL
desmelhorá-lo-emos	desmelhorar+V.ele.ACC.3.M.SG+FUT+1+PL
desmelhorá-lo-ia	desmelhorar+V.ele.ACC.3.M.SG+COND+1+SG
desmelhorá-lo-ia	desmelhorar+V.ele.ACC.3.M.SG+COND+3+SG
desmelhorá-lo-iam	desmelhorar+V.ele.ACC.3.M.SG+COND+3+PL
desmelhorá-lo-íamos	desmelhorar+V.ele.ACC.3.M.SG+COND+1+PL
desmelhorá-lo-ias	desmelhorar+V.ele.ACC.3.M.SG+COND+2+SG
desmelhorá-lo-íeis	desmelhorar+V.ele.ACC.3.M.SG+COND+2+PL
desmelhorá-los-á	desmelhorar+V.ele.ACC.3.M.PL+FUT+3+SG
desmelhorá-los-ão	desmelhorar+V.ele.ACC.3.M.PL+FUT+3+PL
desmelhorá-los-ás	desmelhorar+V.ele.ACC.3.M.PL+FUT+2+SG
desmelhorá-los	desmelhorar+V.ele.ACC.3.M.PL+INF+1+SG
desmelhorá-los	desmelhorar+V.ele.ACC.3.M.PL+INF+3+SG
desmelhora-los	desmelhorar+V.ele.ACC.3.M.PL+PRS+2+SG
desmelhorá-los	desmelhorar+V.ele.ACC.3.M.PL+SBJF+1+SG
desmelhorá-los	desmelhorar+V.ele.ACC.3.M.PL+SBJF+3+SG
desmelhorá-los-ei	desmelhorar+V.ele.ACC.3.M.PL+FUT+1+SG
desmelhorá-los-eis	desmelhorar+V.ele.ACC.3.M.PL+FUT+2+PL
desmelhorá-los-emos	desmelhorar+V.ele.ACC.3.M.PL+FUT+1+PL
desmelhorá-los-ia	desmelhorar+V.ele.ACC.3.M.PL+COND+1+SG
desmelhorá-los-ia	desmelhorar+V.ele.ACC.3.M.PL+COND+3+SG
desmelhorá-los-iam	desmelhorar+V.ele.ACC.3.M.PL+COND+3+PL
desmelhorá-los-íamos	desmelhorar+V.ele.ACC.3.M.PL+COND+1+PL
desmelhorá-los-ias	desmelhorar+V.ele.ACC.3.M.PL+COND+2+SG
desmelhorá-los-íeis	desmelhorar+V.ele.ACC.3.M.PL+COND+2+PL
desmelhora-me	desmelhorar+V.eu.AD.1.SG+PRS+3+SG
desmelhoram-lhe	desmelhorar+V.ele.DAT.3.SG+PRS+3+PL
desmelhoram-lhes	desmelhorar+V.ele.DAT.3.PL+PRS+3+PL
desmelhoram-me	desmelhorar+V.eu.AD.1.SG+PRS+3+PL
desmelhoram-na	desmelhorar+V.ele.ACC.3.F.SG+PRS+3+PL
desmelhoram-nas	desmelhorar+V.ele.ACC.3.F.PL+PRS+3+PL
desmelhoram-no	desmelhorar+V.ele.ACC.3.M.SG+PRS+3+PL
desmelhoram-nos	desmelhorar+V.ele.ACC.3.M.PL+PRS+3+PL
desmelhoram-nos	desmelhorar+V.nós.AD.1.PL+PRS+3+PL
desmelhoramo-la	desmelhorar+V.ele.ACC.3.F.SG+PRF+1+PL
desmelhoramo-la	desmelhorar+V.ele.ACC.3.F.SG+PRS+1+PL
desmelhoramo-las	desmelhorar+V.ele.ACC.3.F.PL+PRF+1+PL
desmelhoramo-las	desmelhorar+V.ele.ACC.3.F.PL+PRS+1+PL
desmelhoramo-lo	desmelhorar+V.ele.ACC.3.M.SG+PRF+1+PL
desmelhoramo-lo	desmelhorar+V.ele.ACC.3.M.SG+PRS+1+PL
desmelhoramo-los	desmelhorar+V.ele.ACC.3.M.PL+PRF+1+PL
desmelhoramo-los	desmelhorar+V.ele.ACC.3.M.PL+PRS+1+PL
desmelhoramo-nos	desmelhorar+nós.AD.1.PL+PRF+1+PL
desmelhoramo-nos	desmelhorar+nós.AD.1.PL+PRS+1+PL
desmelhoramos-lhe	desmelhorar+V.ele.DAT.3.SG+PRF+1+PL
desmelhoramos-lhe	desmelhorar+V.ele.DAT.3.SG+PRS+1+PL
desmelhoramos-lhes	desmelhorar+V.ele.DAT.3.PL+PRF+1+PL
desmelhoramos-lhes	desmelhorar+V.ele.DAT.3.PL+PRS+1+PL
desmelhoramos-me	desmelhorar+V.eu.AD.1.SG+PRF+1+PL
desmelhoramos-me	desmelhorar+V.eu.AD.1.SG+PRS+1+PL
desmelhoramos-te	desmelhorar+V.tu.AD.2.SG+PRF+1+PL
desmelhoramos-te	desmelhorar+V.tu.AD.2.SG+PRS+1+PL
desmelhoramos-vos	desmelhorar+V.vós.AD.2.PL+PRF+1+PL
desmelhoramos-vos	desmelhorar+V.vós.AD.2.PL+PRS+1+PL
desmelhoram-se	desmelhorar+V.ele.REFL+PRS+3+PL
desmelhoram-te	desmelhorar+V.tu.AD.2.SG+PRS+3+PL
desmelhoram-vos	desmelhorar+V.vós.AD.2.PL+PRS+3+PL
desmelhorando-a	desmelhorar+V.ele.ACC.3.F.SG+GRD
desmelhorando-as	desmelhorar+V.ele.ACC.3.F.PL+GRD
desmelhorando-lhe	desmelhorar+V.ele.DAT.3.SG+GRD
desmelhorando-lhes	desmelhorar+V.ele.DAT.3.PL+GRD
desmelhorando-me	desmelhorar+V.eu.AD.1.SG+GRD
desmelhorando-nos	desmelhorar+nós.AD.1.PL+GRD
desmelhorando-o	desmelhorar+V.ele.ACC.3.M.SG+GRD
desmelhorando-os	desmelhorar+V.ele.ACC.3.M.PL+GRD
desmelhorando-se	desmelhorar+V.ele.REFL+GRD
desmelhorando-te	desmelhorar+V.tu.AD.2.SG+GRD
desmelhorando-vos	desmelhorar+V.vós.AD.2.PL+GRD
desmelhora-nos	desmelhorar+nós.AD.1.PL+PRS+2+SG
desmelhora-nos	desmelhorar+nós.AD.1.PL+PRS+3+SG
desmelhora-o	desmelhorar+V.ele.ACC.3.M.SG+PRS+3+SG
desmelhora-os	desmelhorar+V.ele.ACC.3.M.PL+PRS+3+SG
desmelhorara-a	desmelhorar+V.ele.ACC.3.F.SG+PQP+1+SG
desmelhorara-a	desmelhorar+V.ele.ACC.3.F.SG+PQP+3+SG
desmelhorara-as	desmelhorar+V.ele.ACC.3.F.PL+PQP+1+SG
desmelhorara-as	desmelhorar+V.ele.ACC.3.F.PL+PQP+3+SG
desmelhorara-la	desmelhorar+V.ele.ACC.3.F.SG+PQP+2+SG
desmelhorara-las	desmelhorar+V.ele.ACC.3.F.PL+PQP+2+SG
desmelhorara-lhe	desmelhorar+V.ele.DAT.3.SG+PQP+1+SG
desmelhorara-lhe	desmelhorar+V.ele.DAT.3.SG+PQP+3+SG
desmelhorara-lhes	desmelhorar+V.ele.DAT.3.PL+PQP+1+SG
desmelhorara-lhes	desmelhorar+V.ele.DAT.3.PL+PQP+3+SG
desmelhorara-lo	desmelhorar+V.ele.ACC.3.M.SG+PQP+2+SG
desmelhorara-los	desmelhorar+V.ele.ACC.3.M.PL+PQP+2+SG
desmelhorara-me	desmelhorar+V.eu.AD.1.SG+PQP+1+SG
desmelhorara-me	desmelhorar+V.eu.AD.1.SG+PQP+3+SG
desmelhoraram-lhe	desmelhorar+V.ele.DAT.3.SG+PQP+3+PL
desmelhoraram-lhe	desmelhorar+V.ele.DAT.3.SG+PRF+3+PL
desmelhoraram-lhes	desmelhorar+V.ele.DAT.3.PL+PQP+3+PL
desmelhoraram-lhes	desmelhorar+V.ele.DAT.3.PL+PRF+3+PL
desmelhoraram-me	desmelhorar+V.eu.AD.1.SG+PQP+3+PL
desmelhoraram-me	desmelhorar+V.eu.AD.1.SG+PRF+3+PL
desmelhoraram-na	desmelhorar+V.ele.ACC.3.F.SG+PQP+3+PL
desmelhoraram-na	desmelhorar+V.ele.ACC.3.F.SG+PRF+3+PL
desmelhoraram-nas	desmelhorar+V.ele.ACC.3.F.PL+PQP+3+PL
desmelhoraram-nas	desmelhorar+V.ele.ACC.3.F.PL+PRF+3+PL
desmelhoraram-no	desmelhorar+V.ele.ACC.3.M.SG+PQP+3+PL
desmelhoraram-no	desmelhorar+V.ele.ACC.3.M.SG+PRF+3+PL
desmelhoraram-nos	desmelhorar+V.ele.ACC.3.M.PL+PQP+3+PL
desmelhoraram-nos	desmelhorar+V.ele.ACC.3.M.PL+PRF+3+PL
desmelhoraram-nos	desmelhorar+V.nós.AD.1.PL+PQP+3+PL
desmelhoraram-nos	desmelhorar+V.nós.AD.1.PL+PRF+3+PL
desmelhoráramo-la	desmelhorar+V.ele.ACC.3.F.SG+PQP+1+PL
desmelhoráramo-las	desmelhorar+V.ele.ACC.3.F.PL+PQP+1+PL
desmelhoráramo-lo	desmelhorar+V.ele.ACC.3.M.SG+PQP+1+PL
desmelhoráramo-los	desmelhorar+V.ele.ACC.3.M.PL+PQP+1+PL
desmelhoráramo-nos	desmelhorar+nós.AD.1.PL+PQP+1+PL
desmelhoráramos-lhe	desmelhorar+V.ele.DAT.3.SG+PQP+1+PL
desmelhoráramos-lhes	desmelhorar+V.ele.DAT.3.PL+PQP+1+PL
desmelhoráramos-me	desmelhorar+V.eu.AD.1.SG+PQP+1+PL
desmelhoráramos-te	desmelhorar+V.tu.AD.2.SG+PQP+1+PL
desmelhoráramos-vos	desmelhorar+V.vós.AD.2.PL+PQP+1+PL
desmelhoraram-se	desmelhorar+V.ele.REFL+PQP+3+PL
desmelhoraram-se	desmelhorar+V.ele.REFL+PRF+3+PL
desmelhoraram-te	desmelhorar+V.tu.AD.2.SG+PQP+3+PL
desmelhoraram-te	desmelhorar+V.tu.AD.2.SG+PRF+3+PL
desmelhoraram-vos	desmelhorar+V.vós.AD.2.PL+PQP+3+PL
desmelhoraram-vos	desmelhorar+V.vós.AD.2.PL+PRF+3+PL
desmelhorara-nos	desmelhorar+nós.AD.1.PL+PQP+1+SG
desmelhorara-nos	desmelhorar+nós.AD.1.PL+PQP+2+SG
desmelhorara-nos	desmelhorar+nós.AD.1.PL+PQP+3+SG
desmelhorara-o	desmelhorar+V.ele.ACC.3.M.SG+PQP+1+SG
desmelhorara-o	desmelhorar+V.ele.ACC.3.M.SG+PQP+3+SG
desmelhorara-os	desmelhorar+V.ele.ACC.3.M.PL+PQP+1+SG
desmelhorara-os	desmelhorar+V.ele.ACC.3.M.PL+PQP+3+SG
desmelhorara-se	desmelhorar+V.ele.REFL+PQP+1+SG
desmelhorara-se	desmelhorar+V.ele.REFL+PQP+3+SG
desmelhoraras-lhe	desmelhorar+V.ele.DAT.3.SG+PQP+2+SG
desmelhoraras-lhes	desmelhorar+V.ele.DAT.3.PL+PQP+2+SG
desmelhoraras-me	desmelhorar+V.eu.AD.1.SG+PQP+2+SG
desmelhoraras-te	desmelhorar+V.tu.AD.2.SG+PQP+2+SG
desmelhoraras-vos	desmelhorar+V.vós.AD.2.PL+PQP+2+SG
desmelhorara-te	desmelhorar+V.tu.AD.2.SG+PQP+1+SG
desmelhorara-te	desmelhorar+V.tu.AD.2.SG+PQP+3+SG
desmelhorara-vos	desmelhorar+V.vós.AD.2.PL+PQP+1+SG
desmelhorara-vos	desmelhorar+V.vós.AD.2.PL+PQP+3+SG
desmelhorarde-la	desmelhorar+V.ele.ACC.3.F.SG+INF+2+PL
desmelhorarde-la	desmelhorar+V.ele.ACC.3.F.SG+SBJF+2+PL
desmelhorarde-las	desmelhorar+V.ele.ACC.3.F.PL+INF+2+PL
desmelhorarde-las	desmelhorar+V.ele.ACC.3.F.PL+SBJF+2+PL
desmelhorarde-lo	desmelhorar+V.ele.ACC.3.M.SG+INF+2+PL
desmelhorarde-lo	desmelhorar+V.ele.ACC.3.M.SG+SBJF+2+PL
desmelhorarde-los	desmelhorar+V.ele.ACC.3.M.PL+INF+2+PL
desmelhorarde-los	desmelhorar+V.ele.ACC.3.M.PL+SBJF+2+PL
desmelhorarde-nos	desmelhorar+nós.AD.1.PL+INF+2+PL
desmelhorarde-nos	desmelhorar+nós.AD.1.PL+SBJF+2+PL
desmelhorardes-lhe	desmelhorar+V.ele.DAT.3.SG+INF+2+PL
desmelhorardes-lhe	desmelhorar+V.ele.DAT.3.SG+SBJF+2+PL
desmelhorardes-lhes	desmelhorar+V.ele.DAT.3.PL+INF+2+PL
desmelhorardes-lhes	desmelhorar+V.ele.DAT.3.PL+SBJF+2+PL
desmelhorardes-me	desmelhorar+V.eu.AD.1.SG+INF+2+PL
desmelhorardes-me	desmelhorar+V.eu.AD.1.SG+SBJF+2+PL
desmelhorardes-te	desmelhorar+V.tu.AD.2.SG+INF+2+PL
desmelhorardes-te	desmelhorar+V.tu.AD.2.SG+SBJF+2+PL
desmelhorardes-vos	desmelhorar+V.vós.AD.2.PL+INF+2+PL
desmelhorardes-vos	desmelhorar+V.vós.AD.2.PL+SBJF+2+PL
desmelhorárei-la	desmelhorar+V.ele.ACC.3.F.SG+PQP+2+PL
desmelhorárei-las	desmelhorar+V.ele.ACC.3.F.PL+PQP+2+PL
desmelhorárei-lo	desmelhorar+V.ele.ACC.3.M.SG+PQP+2+PL
desmelhorárei-los	desmelhorar+V.ele.ACC.3.M.PL+PQP+2+PL
desmelhorárei-nos	desmelhorar+nós.AD.1.PL+PQP+2+PL
desmelhoráreis-lhe	desmelhorar+V.ele.DAT.3.SG+PQP+2+PL
desmelhoráreis-lhes	desmelhorar+V.ele.DAT.3.PL+PQP+2+PL
desmelhoráreis-me	desmelhorar+V.eu.AD.1.SG+PQP+2+PL
desmelhoráreis-te	desmelhorar+V.tu.AD.2.SG+PQP+2+PL
desmelhoráreis-vos	desmelhorar+V.vós.AD.2.PL+PQP+2+PL
desmelhorare-la	desmelhorar+V.ele.ACC.3.F.SG+INF+2+SG
desmelhorare-la	desmelhorar+V.ele.ACC.3.F.SG+SBJF+2+SG
desmelhorare-las	desmelhorar+V.ele.ACC.3.F.PL+INF+2+SG
desmelhorare-las	desmelhorar+V.ele.ACC.3.F.PL+SBJF+2+SG
desmelhorare-lo	desmelhorar+V.ele.ACC.3.M.SG+INF+2+SG
desmelhorare-lo	desmelhorar+V.ele.ACC.3.M.SG+SBJF+2+SG
desmelhorare-los	desmelhorar+V.ele.ACC.3.M.PL+INF+2+SG
desmelhorare-los	desmelhorar+V.ele.ACC.3.M.PL+SBJF+2+SG
desmelhorarem-lhe	desmelhorar+V.ele.DAT.3.SG+INF+3+PL
desmelhorarem-lhe	desmelhorar+V.ele.DAT.3.SG+SBJF+3+PL
desmelhorarem-lhes	desmelhorar+V.ele.DAT.3.PL+INF+3+PL
desmelhorarem-lhes	desmelhorar+V.ele.DAT.3.PL+SBJF+3+PL
desmelhorarem-me	desmelhorar+V.eu.AD.1.SG+INF+3+PL
desmelhorarem-me	desmelhorar+V.eu.AD.1.SG+SBJF+3+PL
desmelhorarem-na	desmelhorar+V.ele.ACC.3.F.SG+INF+3+PL
desmelhorarem-na	desmelhorar+V.ele.ACC.3.F.SG+SBJF+3+PL
desmelhorarem-nas	desmelhorar+V.ele.ACC.3.F.PL+INF+3+PL
desmelhorarem-nas	desmelhorar+V.ele.ACC.3.F.PL+SBJF+3+PL
desmelhorarem-no	desmelhorar+V.ele.ACC.3.M.SG+INF+3+PL
desmelhorarem-no	desmelhorar+V.ele.ACC.3.M.SG+SBJF+3+PL
desmelhorarem-nos	desmelhorar+V.ele.ACC.3.M.PL+INF+3+PL
desmelhorarem-nos	desmelhorar+V.ele.ACC.3.M.PL+SBJF+3+PL
desmelhorarem-nos	desmelhorar+V.nós.AD.1.PL+INF+3+PL
desmelhorarem-nos	desmelhorar+V.nós.AD.1.PL+SBJF+3+PL
desmelhorarem-se	desmelhorar+V.ele.REFL+INF+3+PL
desmelhorarem-se	desmelhorar+V.ele.REFL+SBJF+3+PL
desmelhorarem-te	desmelhorar+V.tu.AD.2.SG+INF+3+PL
desmelhorarem-te	desmelhorar+V.tu.AD.2.SG+SBJF+3+PL
desmelhorarem-vos	desmelhorar+V.vós.AD.2.PL+INF+3+PL
desmelhorarem-vos	desmelhorar+V.vós.AD.2.PL+SBJF+3+PL
desmelhorare-nos	desmelhorar+nós.AD.1.PL+INF+2+SG
desmelhorare-nos	desmelhorar+nós.AD.1.PL+SBJF+2+SG
desmelhorares-lhe	desmelhorar+V.ele.DAT.3.SG+INF+2+SG
desmelhorares-lhe	desmelhorar+V.ele.DAT.3.SG+SBJF+2+SG
desmelhorares-lhes	desmelhorar+V.ele.DAT.3.PL+INF+2+SG
desmelhorares-lhes	desmelhorar+V.ele.DAT.3.PL+SBJF+2+SG
desmelhorares-me	desmelhorar+V.eu.AD.1.SG+INF+2+SG
desmelhorares-me	desmelhorar+V.eu.AD.1.SG+SBJF+2+SG
desmelhorares-te	desmelhorar+V.tu.AD.2.SG+INF+2+SG
desmelhorares-te	desmelhorar+V.tu.AD.2.SG+SBJF+2+SG
desmelhorares-vos	desmelhorar+V.vós.AD.2.PL+INF+2+SG
desmelhorares-vos	desmelhorar+V.vós.AD.2.PL+SBJF+2+SG
desmelhorar-lhe-á	desmelhorar+V.ele.DAT.3.SG+FUT+3+SG
desmelhorar-lhe-ão	desmelhorar+V.ele.DAT.3.SG+FUT+3+PL
desmelhorar-lhe-ás	desmelhorar+V.ele.DAT.3.SG+FUT+2+SG
desmelhorar-lhe	desmelhorar+V.ele.DAT.3.SG+INF
desmelhorar-lhe	desmelhorar+V.ele.DAT.3.SG+INF+1+SG
desmelhorar-lhe	desmelhorar+V.ele.DAT.3.SG+INF+3+SG
desmelhorar-lhe	desmelhorar+V.ele.DAT.3.SG+SBJF+1+SG
desmelhorar-lhe	desmelhorar+V.ele.DAT.3.SG+SBJF+3+SG
desmelhorar-lhe-ei	desmelhorar+V.ele.DAT.3.SG+FUT+1+SG
desmelhorar-lhe-eis	desmelhorar+V.ele.DAT.3.SG+FUT+2+PL
desmelhorar-lhe-emos	desmelhorar+V.ele.DAT.3.SG+FUT+1+PL
desmelhorar-lhe-ia	desmelhorar+V.ele.DAT.3.SG+COND+1+SG
desmelhorar-lhe-ia	desmelhorar+V.ele.DAT.3.SG+COND+3+SG
desmelhorar-lhe-iam	desmelhorar+V.ele.DAT.3.SG+COND+3+PL
desmelhorar-lhe-íamos	desmelhorar+V.ele.DAT.3.SG+COND+1+PL
desmelhorar-lhe-ias	desmelhorar+V.ele.DAT.3.SG+COND+2+SG
desmelhorar-lhe-íeis	desmelhorar+V.ele.DAT.3.SG+COND+2+PL
desmelhorar-lhes-á	desmelhorar+V.ele.DAT.3.PL+FUT+3+SG
desmelhorar-lhes-ão	desmelhorar+V.ele.DAT.3.PL+FUT+3+PL
desmelhorar-lhes-ás	desmelhorar+V.ele.DAT.3.PL+FUT+2+SG
desmelhorar-lhes	desmelhorar+V.ele.DAT.3.PL+INF
desmelhorar-lhes	desmelhorar+V.ele.DAT.3.PL+INF+1+SG
desmelhorar-lhes	desmelhorar+V.ele.DAT.3.PL+INF+3+SG
desmelhorar-lhes	desmelhorar+V.ele.DAT.3.PL+SBJF+1+SG
desmelhorar-lhes	desmelhorar+V.ele.DAT.3.PL+SBJF+3+SG
desmelhorar-lhes-ei	desmelhorar+V.ele.DAT.3.PL+FUT+1+SG
desmelhorar-lhes-eis	desmelhorar+V.ele.DAT.3.PL+FUT+2+PL
desmelhorar-lhes-emos	desmelhorar+V.ele.DAT.3.PL+FUT+1+PL
desmelhorar-lhes-ia	desmelhorar+V.ele.DAT.3.PL+COND+1+SG
desmelhorar-lhes-ia	desmelhorar+V.ele.DAT.3.PL+COND+3+SG
desmelhorar-lhes-iam	desmelhorar+V.ele.DAT.3.PL+COND+3+PL
desmelhorar-lhes-íamos	desmelhorar+V.ele.DAT.3.PL+COND+1+PL
desmelhorar-lhes-ias	desmelhorar+V.ele.DAT.3.PL+COND+2+SG
desmelhorar-lhes-íeis	desmelhorar+V.ele.DAT.3.PL+COND+2+PL
desmelhorar-me-á	desmelhorar+V.eu.AD.1.SG+FUT+3+SG
desmelhorar-me-ão	desmelhorar+V.eu.AD.1.SG+FUT+3+PL
desmelhorar-me-ás	desmelhorar+V.eu.AD.1.SG+FUT+2+SG
desmelhorar-me	desmelhorar+V.eu.AD.1.SG+INF
desmelhorar-me	desmelhorar+V.eu.AD.1.SG+INF+1+SG
desmelhorar-me	desmelhorar+V.eu.AD.1.SG+INF+3+SG
desmelhorar-me	desmelhorar+V.eu.AD.1.SG+SBJF+1+SG
desmelhorar-me	desmelhorar+V.eu.AD.1.SG+SBJF+3+SG
desmelhorar-me-ei	desmelhorar+V.eu.AD.1.SG+FUT+1+SG
desmelhorar-me-eis	desmelhorar+V.eu.AD.1.SG+FUT+2+PL
desmelhorar-me-emos	desmelhorar+V.eu.AD.1.SG+FUT+1+PL
desmelhorar-me-ia	desmelhorar+V.eu.AD.1.SG+COND+1+SG
desmelhorar-me-ia	desmelhorar+V.eu.AD.1.SG+COND+3+SG
desmelhorar-me-iam	desmelhorar+V.eu.AD.1.SG+COND+3+PL
desmelhorar-me-íamos	desmelhorar+V.eu.AD.1.SG+COND+1+PL
desmelhorar-me-ias	desmelhorar+V.eu.AD.1.SG+COND+2+SG
desmelhorar-me-íeis	desmelhorar+V.eu.AD.1.SG+COND+2+PL
desmelhorarmo-la	desmelhorar+V.ele.ACC.3.F.SG+INF+1+PL
desmelhorarmo-la	desmelhorar+V.ele.ACC.3.F.SG+SBJF+1+PL
desmelhorarmo-las	desmelhorar+V.ele.ACC.3.F.PL+INF+1+PL
desmelhorarmo-las	desmelhorar+V.ele.ACC.3.F.PL+SBJF+1+PL
desmelhorarmo-lo	desmelhorar+V.ele.ACC.3.M.SG+INF+1+PL
desmelhorarmo-lo	desmelhorar+V.ele.ACC.3.M.SG+SBJF+1+PL
desmelhorarmo-los	desmelhorar+V.ele.ACC.3.M.PL+INF+1+PL
desmelhorarmo-los	desmelhorar+V.ele.ACC.3.M.PL+SBJF+1+PL
desmelhorarmo-nos	desmelhorar+nós.AD.1.PL+INF+1+PL
desmelhorarmo-nos	desmelhorar+nós.AD.1.PL+SBJF+1+PL
desmelhorarmos-lhe	desmelhorar+V.ele.DAT.3.SG+INF+1+PL
desmelhorarmos-lhe	desmelhorar+V.ele.DAT.3.SG+SBJF+1+PL
desmelhorarmos-lhes	desmelhorar+V.ele.DAT.3.PL+INF+1+PL
desmelhorarmos-lhes	desmelhorar+V.ele.DAT.3.PL+SBJF+1+PL
desmelhorarmos-me	desmelhorar+V.eu.AD.1.SG+INF+1+PL
desmelhorarmos-me	desmelhorar+V.eu.AD.1.SG+SBJF+1+PL
desmelhorarmos-te	desmelhorar+V.tu.AD.2.SG+INF+1+PL
desmelhorarmos-te	desmelhorar+V.tu.AD.2.SG+SBJF+1+PL
desmelhorarmos-vos	desmelhorar+V.vós.AD.2.PL+INF+1+PL
desmelhorarmos-vos	desmelhorar+V.vós.AD.2.PL+SBJF+1+PL
desmelhorar-nos-á	desmelhorar+nós.AD.1.PL+FUT+3+SG
desmelhorar-nos-ão	desmelhorar+nós.AD.1.PL+FUT+3+PL
desmelhorar-nos-ás	desmelhorar+nós.AD.1.PL+FUT+2+SG
desmelhorar-nos	desmelhorar+nós.AD.1.PL+INF
desmelhorar-nos	desmelhorar+nós.AD.1.PL+INF+1+SG
desmelhorar-nos	desmelhorar+nós.AD.1.PL+INF+3+SG
desmelhorar-nos	desmelhorar+nós.AD.1.PL+SBJF+1+SG
desmelhorar-nos	desmelhorar+nós.AD.1.PL+SBJF+3+SG
desmelhorar-nos-ei	desmelhorar+nós.AD.1.PL+FUT+1+SG
desmelhorar-nos-eis	desmelhorar+nós.AD.1.PL+FUT+2+PL
desmelhorar-nos-emos	desmelhorar+nós.AD.1.PL+FUT+1+PL
desmelhorar-nos-ia	desmelhorar+nós.AD.1.PL+COND+1+SG
desmelhorar-nos-ia	desmelhorar+nós.AD.1.PL+COND+3+SG
desmelhorar-nos-iam	desmelhorar+nós.AD.1.PL+COND+3+PL
desmelhorar-nos-íamos	desmelhorar+nós.AD.1.PL+COND+1+PL
desmelhorar-nos-ias	desmelhorar+nós.AD.1.PL+COND+2+SG
desmelhorar-nos-íeis	desmelhorar+nós.AD.1.PL+COND+2+PL
desmelhorar-se-á	desmelhorar+V.ele.REFL+FUT+3+SG
desmelhorar-se-ão	desmelhorar+V.ele.REFL+FUT+3+PL
desmelhorar-se	desmelhorar+V.ele.REFL+INF
desmelhorar-se	desmelhorar+V.ele.REFL+INF+3+SG
desmelhorar-se	desmelhorar+V.ele.REFL+SBJF+3+SG
desmelhorar-se-ia	desmelhorar+V.ele.REFL+COND+3+SG
desmelhorar-se-iam	desmelhorar+V.ele.REFL+COND+3+PL
desmelhorar-te-á	desmelhorar+V.tu.AD.2.SG+FUT+3+SG
desmelhorar-te-ão	desmelhorar+V.tu.AD.2.SG+FUT+3+PL
desmelhorar-te-ás	desmelhorar+V.tu.AD.2.SG+FUT+2+SG
desmelhorar-te	desmelhorar+V.tu.AD.2.SG+INF
desmelhorar-te	desmelhorar+V.tu.AD.2.SG+INF+1+SG
desmelhorar-te	desmelhorar+V.tu.AD.2.SG+INF+3+SG
desmelhorar-te	desmelhorar+V.tu.AD.2.SG+SBJF+1+SG
desmelhorar-te	desmelhorar+V.tu.AD.2.SG+SBJF+3+SG
desmelhorar-te-ei	desmelhorar+V.tu.AD.2.SG+FUT+1+SG
desmelhorar-te-eis	desmelhorar+V.tu.AD.2.SG+FUT+2+PL
desmelhorar-te-emos	desmelhorar+V.tu.AD.2.SG+FUT+1+PL
desmelhorar-te-ia	desmelhorar+V.tu.AD.2.SG+COND+1+SG
desmelhorar-te-ia	desmelhorar+V.tu.AD.2.SG+COND+3+SG
desmelhorar-te-iam	desmelhorar+V.tu.AD.2.SG+COND+3+PL
desmelhorar-te-íamos	desmelhorar+V.tu.AD.2.SG+COND+1+PL
desmelhorar-te-ias	desmelhorar+V.tu.AD.2.SG+COND+2+SG
desmelhorar-te-íeis	desmelhorar+V.tu.AD.2.SG+COND+2+PL
desmelhorar-vos-á	desmelhorar+V.vós.AD.2.PL+FUT+3+SG
desmelhorar-vos-ão	desmelhorar+V.vós.AD.2.PL+FUT+3+PL
desmelhorar-vos-ás	desmelhorar+V.vós.AD.2.PL+FUT+2+SG
desmelhorar-vos	desmelhorar+V.vós.AD.2.PL+INF
desmelhorar-vos	desmelhorar+V.vós.AD.2.PL+INF+1+SG
desmelhorar-vos	desmelhorar+V.vós.AD.2.PL+INF+3+SG
desmelhorar-vos	desmelhorar+V.vós.AD.2.PL+SBJF+1+SG
desmelhorar-vos	desmelhorar+V.vós.AD.2.PL+SBJF+3+SG
desmelhorar-vos-ei	desmelhorar+V.vós.AD.2.PL+FUT+1+SG
desmelhorar-vos-eis	desmelhorar+V.vós.AD.2.PL+FUT+2+PL
desmelhorar-vos-emos	desmelhorar+V.vós.AD.2.PL+FUT+1+PL
desmelhorar-vos-ia	desmelhorar+V.vós.AD.2.PL+COND+1+SG
desmelhorar-vos-ia	desmelhorar+V.vós.AD.2.PL+COND+3+SG
desmelhorar-vos-iam	desmelhorar+V.vós.AD.2.PL+COND+3+PL
desmelhorar-vos-íamos	desmelhorar+V.vós.AD.2.PL+COND+1+PL
desmelhorar-vos-ias	desmelhorar+V.vós.AD.2.PL+COND+2+SG
desmelhorar-vos-íeis	desmelhorar+V.vós.AD.2.PL+COND+2+PL
desmelhora-se	desmelhorar+V.ele.REFL+PRS+3+SG
desmelhoras-lhe	desmelhorar+V.ele.DAT.3.SG+PRS+2+SG
desmelhoras-lhes	desmelhorar+V.ele.DAT.3.PL+PRS+2+SG
desmelhoras-me	desmelhorar+V.eu.AD.1.SG+PRS+2+SG
desmelhoraste-a	desmelhorar+V.ele.ACC.3.F.SG+PRF+2+SG
desmelhoraste-as	desmelhorar+V.ele.ACC.3.F.PL+PRF+2+SG
desmelhoras-te	desmelhorar+V.tu.AD.2.SG+PRS+2+SG
desmelhoraste-la	desmelhorar+V.ele.ACC.3.F.SG+PRF+2+PL
desmelhoraste-las	desmelhorar+V.ele.ACC.3.F.PL+PRF+2+PL
desmelhoraste-lhe	desmelhorar+V.ele.DAT.3.SG+PRF+2+SG
desmelhoraste-lhes	desmelhorar+V.ele.DAT.3.PL+PRF+2+SG
desmelhoraste-lo	desmelhorar+V.ele.ACC.3.M.SG+PRF+2+PL
desmelhoraste-los	desmelhorar+V.ele.ACC.3.M.PL+PRF+2+PL
desmelhoraste-me	desmelhorar+V.eu.AD.1.SG+PRF+2+SG
desmelhoraste-nos	desmelhorar+nós.AD.1.PL+PRF+2+PL
desmelhoraste-nos	desmelhorar+nós.AD.1.PL+PRF+2+SG
desmelhoraste-o	desmelhorar+V.ele.ACC.3.M.SG+PRF+2+SG
desmelhoraste-os	desmelhorar+V.ele.ACC.3.M.PL+PRF+2+SG
desmelhorastes-lhe	desmelhorar+V.ele.DAT.3.SG+PRF+2+PL
desmelhorastes-lhes	desmelhorar+V.ele.DAT.3.PL+PRF+2+PL
desmelhorastes-me	desmelhorar+V.eu.AD.1.SG+PRF+2+PL
desmelhorastes-te	desmelhorar+V.tu.AD.2.SG+PRF+2+PL
desmelhorastes-vos	desmelhorar+V.vós.AD.2.PL+PRF+2+PL
desmelhoraste-te	desmelhorar+V.tu.AD.2.SG+PRF+2+SG
desmelhoraste-vos	desmelhorar+V.vós.AD.2.PL+PRF+2+SG
desmelhoras-vos	desmelhorar+V.vós.AD.2.PL+PRS+2+SG
desmelhora-te	desmelhorar+V.tu.AD.2.SG+PRS+3+SG
desmelhorava-a	desmelhorar+V.ele.ACC.3.F.SG+IMPF+1+SG
desmelhorava-a	desmelhorar+V.ele.ACC.3.F.SG+IMPF+3+SG
desmelhorava-as	desmelhorar+V.ele.ACC.3.F.PL+IMPF+1+SG
desmelhorava-as	desmelhorar+V.ele.ACC.3.F.PL+IMPF+3+SG
desmelhorava-la	desmelhorar+V.ele.ACC.3.F.SG+IMPF+2+SG
desmelhorava-las	desmelhorar+V.ele.ACC.3.F.PL+IMPF+2+SG
desmelhorava-lhe	desmelhorar+V.ele.DAT.3.SG+IMPF+1+SG
desmelhorava-lhe	desmelhorar+V.ele.DAT.3.SG+IMPF+3+SG
desmelhorava-lhes	desmelhorar+V.ele.DAT.3.PL+IMPF+1+SG
desmelhorava-lhes	desmelhorar+V.ele.DAT.3.PL+IMPF+3+SG
desmelhorava-lo	desmelhorar+V.ele.ACC.3.M.SG+IMPF+2+SG
desmelhorava-los	desmelhorar+V.ele.ACC.3.M.PL+IMPF+2+SG
desmelhorava-me	desmelhorar+V.eu.AD.1.SG+IMPF+1+SG
desmelhorava-me	desmelhorar+V.eu.AD.1.SG+IMPF+3+SG
desmelhoravam-lhe	desmelhorar+V.ele.DAT.3.SG+IMPF+3+PL
desmelhoravam-lhes	desmelhorar+V.ele.DAT.3.PL+IMPF+3+PL
desmelhoravam-me	desmelhorar+V.eu.AD.1.SG+IMPF+3+PL
desmelhoravam-na	desmelhorar+V.ele.ACC.3.F.SG+IMPF+3+PL
desmelhoravam-nas	desmelhorar+V.ele.ACC.3.F.PL+IMPF+3+PL
desmelhoravam-no	desmelhorar+V.ele.ACC.3.M.SG+IMPF+3+PL
desmelhoravam-nos	desmelhorar+V.ele.ACC.3.M.PL+IMPF+3+PL
desmelhoravam-nos	desmelhorar+V.nós.AD.1.PL+IMPF+3+PL
desmelhorávamo-la	desmelhorar+V.ele.ACC.3.F.SG+IMPF+1+PL
desmelhorávamo-las	desmelhorar+V.ele.ACC.3.F.PL+IMPF+1+PL
desmelhorávamo-lo	desmelhorar+V.ele.ACC.3.M.SG+IMPF+1+PL
desmelhorávamo-los	desmelhorar+V.ele.ACC.3.M.PL+IMPF+1+PL
desmelhorávamo-nos	desmelhorar+nós.AD.1.PL+IMPF+1+PL
desmelhorávamos-lhe	desmelhorar+V.ele.DAT.3.SG+IMPF+1+PL
desmelhorávamos-lhes	desmelhorar+V.ele.DAT.3.PL+IMPF+1+PL
desmelhorávamos-me	desmelhorar+V.eu.AD.1.SG+IMPF+1+PL
desmelhorávamos-te	desmelhorar+V.tu.AD.2.SG+IMPF+1+PL
desmelhorávamos-vos	desmelhorar+V.vós.AD.2.PL+IMPF+1+PL
desmelhoravam-se	desmelhorar+V.ele.REFL+IMPF+3+PL
desmelhoravam-te	desmelhorar+V.tu.AD.2.SG+IMPF+3+PL
desmelhoravam-vos	desmelhorar+V.vós.AD.2.PL+IMPF+3+PL
desmelhorava-nos	desmelhorar+nós.AD.1.PL+IMPF+1+SG
desmelhorava-nos	desmelhorar+nós.AD.1.PL+IMPF+2+SG
desmelhorava-nos	desmelhorar+nós.AD.1.PL+IMPF+3+SG
desmelhorava-o	desmelhorar+V.ele.ACC.3.M.SG+IMPF+1+SG
desmelhorava-o	desmelhorar+V.ele.ACC.3.M.SG+IMPF+3+SG
desmelhorava-os	desmelhorar+V.ele.ACC.3.M.PL+IMPF+1+SG
desmelhorava-os	desmelhorar+V.ele.ACC.3.M.PL+IMPF+3+SG
desmelhorava-se	desmelhorar+V.ele.REFL+IMPF+1+SG
desmelhorava-se	desmelhorar+V.ele.REFL+IMPF+3+SG
desmelhoravas-lhe	desmelhorar+V.ele.DAT.3.SG+IMPF+2+SG
desmelhoravas-lhes	desmelhorar+V.ele.DAT.3.PL+IMPF+2+SG
desmelhoravas-me	desmelhorar+V.eu.AD.1.SG+IMPF+2+SG
desmelhoravas-te	desmelhorar+V.tu.AD.2.SG+IMPF+2+SG
desmelhoravas-vos	desmelhorar+V.vós.AD.2.PL+IMPF+2+SG
desmelhorava-te	desmelhorar+V.tu.AD.2.SG+IMPF+1+SG
desmelhorava-te	desmelhorar+V.tu.AD.2.SG+IMPF+3+SG
desmelhorava-vos	desmelhorar+V.vós.AD.2.PL+IMPF+1+SG
desmelhorava-vos	desmelhorar+V.vós.AD.2.PL+IMPF+3+SG
desmelhorávei-la	desmelhorar+V.ele.ACC.3.F.SG+IMPF+2+PL
desmelhorávei-las	desmelhorar+V.ele.ACC.3.F.PL+IMPF+2+PL
desmelhorávei-lo	desmelhorar+V.ele.ACC.3.M.SG+IMPF+2+PL
desmelhorávei-los	desmelhorar+V.ele.ACC.3.M.PL+IMPF+2+PL
desmelhorávei-nos	desmelhorar+nós.AD.1.PL+IMPF+2+PL
desmelhoráveis-lhe	desmelhorar+V.ele.DAT.3.SG+IMPF+2+PL
desmelhoráveis-lhes	desmelhorar+V.ele.DAT.3.PL+IMPF+2+PL
desmelhoráveis-me	desmelhorar+V.eu.AD.1.SG+IMPF+2+PL
desmelhoráveis-te	desmelhorar+V.tu.AD.2.SG+IMPF+2+PL
desmelhoráveis-vos	desmelhorar+V.vós.AD.2.PL+IMPF+2+PL
desmelhora-vos	desmelhorar+V.vós.AD.2.PL+PRS+3+SG
desmelhore-a	desmelhorar+V.ele.ACC.3.F.SG+IMP+3+SG
desmelhore-as	desmelhorar+V.ele.ACC.3.F.PL+IMP+3+SG
desmelhorei-a	desmelhorar+V.ele.ACC.3.F.SG+PRF+1+SG
desmelhorei-as	desmelhorar+V.ele.ACC.3.F.PL+PRF+1+SG
desmelhorei-lhe	desmelhorar+V.ele.DAT.3.SG+PRF+1+SG
desmelhorei-lhes	desmelhorar+V.ele.DAT.3.PL+PRF+1+SG
desmelhorei-me	desmelhorar+V.eu.AD.1.SG+PRF+1+SG
desmelhorei-nos	desmelhorar+nós.AD.1.PL+PRF+1+SG
desmelhorei-o	desmelhorar+V.ele.ACC.3.M.SG+PRF+1+SG
desmelhorei-os	desmelhorar+V.ele.ACC.3.M.PL+PRF+1+SG
desmelhorei-te	desmelhorar+V.tu.AD.2.SG+PRF+1+SG
desmelhorei-vos	desmelhorar+V.vós.AD.2.PL+PRF+1+SG
desmelhore-lhe	desmelhorar+V.ele.DAT.3.SG+IMP+3+SG
desmelhore-lhes	desmelhorar+V.ele.DAT.3.PL+IMP+3+SG
desmelhore-me	desmelhorar+V.eu.AD.1.SG+IMP+3+SG
desmelhorem-lhe	desmelhorar+V.ele.DAT.3.SG+IMP+3+PL
desmelhorem-lhes	desmelhorar+V.ele.DAT.3.PL+IMP+3+PL
desmelhorem-me	desmelhorar+V.eu.AD.1.SG+IMP+3+PL
desmelhorem-na	desmelhorar+V.ele.ACC.3.F.SG+IMP+3+PL
desmelhorem-nas	desmelhorar+V.ele.ACC.3.F.PL+IMP+3+PL
desmelhorem-no	desmelhorar+V.ele.ACC.3.M.SG+IMP+3+PL
desmelhorem-nos	desmelhorar+V.ele.ACC.3.M.PL+IMP+3+PL
desmelhorem-nos	desmelhorar+V.nós.AD.1.PL+IMP+3+PL
desmelhoremo-la	desmelhorar+V.ele.ACC.3.F.SG+IMP+1+PL
desmelhoremo-las	desmelhorar+V.ele.ACC.3.F.PL+IMP+1+PL
desmelhoremo-lo	desmelhorar+V.ele.ACC.3.M.SG+IMP+1+PL
desmelhoremo-los	desmelhorar+V.ele.ACC.3.M.PL+IMP+1+PL
desmelhoremo-nos	desmelhorar+nós.AD.1.PL+IMP+1+PL
desmelhoremos-lhe	desmelhorar+V.ele.DAT.3.SG+IMP+1+PL
desmelhoremos-lhes	desmelhorar+V.ele.DAT.3.PL+IMP+1+PL
desmelhoremos-me	desmelhorar+V.eu.AD.1.SG+IMP+1+PL
desmelhoremos-te	desmelhorar+V.tu.AD.2.SG+IMP+1+PL
desmelhoremos-vos	desmelhorar+V.vós.AD.2.PL+IMP+1+PL
desmelhorem-se	desmelhorar+V.ele.REFL+IMP+3+PL
desmelhorem-te	desmelhorar+V.tu.AD.2.SG+IMP+3+PL
desmelhorem-vos	desmelhorar+V.vós.AD.2.PL+IMP+3+PL
desmelhore-nos	desmelhorar+nós.AD.1.PL+IMP+3+SG
desmelhore-o	desmelhorar+V.ele.ACC.3.M.SG+IMP+3+SG
desmelhore-os	desmelhorar+V.ele.ACC.3.M.PL+IMP+3+SG
desmelhore-se	desmelhorar+V.ele.REFL+IMP+3+SG
desmelhore-te	desmelhorar+V.tu.AD.2.SG+IMP+3+SG
desmelhore-vos	desmelhorar+V.vós.AD.2.PL+IMP+3+SG
desmelhoro-a	desmelhorar+V.ele.ACC.3.F.SG+PRS+1+SG
desmelhoro-as	desmelhorar+V.ele.ACC.3.F.PL+PRS+1+SG
desmelhoro-lhe	desmelhorar+V.ele.DAT.3.SG+PRS+1+SG
desmelhoro-lhes	desmelhorar+V.ele.DAT.3.PL+PRS+1+SG
desmelhoro-me	desmelhorar+V.eu.AD.1.SG+PRS+1+SG
desmelhoro-nos	desmelhorar+nós.AD.1.PL+PRS+1+SG
desmelhoro-o	desmelhorar+V.ele.ACC.3.M.SG+PRS+1+SG
desmelhoro-os	desmelhorar+V.ele.ACC.3.M.PL+PRS+1+SG
desmelhoro-te	desmelhorar+V.tu.AD.2.SG+PRS+1+SG
desmelhorou-a	desmelhorar+V.ele.ACC.3.F.SG+PRF+3+SG
desmelhorou-as	desmelhorar+V.ele.ACC.3.F.PL+PRF+3+SG
desmelhorou-lhe	desmelhorar+V.ele.DAT.3.SG+PRF+3+SG
desmelhorou-lhes	desmelhorar+V.ele.DAT.3.PL+PRF+3+SG
desmelhorou-me	desmelhorar+V.eu.AD.1.SG+PRF+3+SG
desmelhorou-nos	desmelhorar+nós.AD.1.PL+PRF+3+SG
desmelhorou-o	desmelhorar+V.ele.ACC.3.M.SG+PRF+3+SG
desmelhorou-os	desmelhorar+V.ele.ACC.3.M.PL+PRF+3+SG
desmelhorou-se	desmelhorar+V.ele.REFL+PRF+3+SG
desmelhorou-te	desmelhorar+V.tu.AD.2.SG+PRF+3+SG
desmelhorou-vos	desmelhorar+V.vós.AD.2.PL+PRF+3+SG
desmelhoro-vos	desmelhorar+V.vós.AD.2.PL+PRS+1+SG
desmelindra-a	desmelindrar+V.ele.ACC.3.F.SG+PRS+3+SG
desmelindra-as	desmelindrar+V.ele.ACC.3.F.PL+PRS+3+SG
desmelindrai-la	desmelindrar+V.ele.ACC.3.F.SG+PRS+2+PL
desmelindrai-las	desmelindrar+V.ele.ACC.3.F.PL+PRS+2+PL
desmelindrai-lo	desmelindrar+V.ele.ACC.3.M.SG+PRS+2+PL
desmelindrai-los	desmelindrar+V.ele.ACC.3.M.PL+PRS+2+PL
desmelindrai-nos	desmelindrar+nós.AD.1.PL+PRS+2+PL
desmelindrais-lhe	desmelindrar+V.ele.DAT.3.SG+PRS+2+PL
desmelindrais-lhes	desmelindrar+V.ele.DAT.3.PL+PRS+2+PL
desmelindrais-me	desmelindrar+V.eu.AD.1.SG+PRS+2+PL
desmelindrais-te	desmelindrar+V.tu.AD.2.SG+PRS+2+PL
desmelindrais-vos	desmelindrar+V.vós.AD.2.PL+PRS+2+PL
desmelindrá-la-á	desmelindrar+V.ele.ACC.3.F.SG+FUT+3+SG
desmelindrá-la-ão	desmelindrar+V.ele.ACC.3.F.SG+FUT+3+PL
desmelindrá-la-ás	desmelindrar+V.ele.ACC.3.F.SG+FUT+2+SG
desmelindrá-la	desmelindrar+V.ele.ACC.3.F.SG+INF+1+SG
desmelindrá-la	desmelindrar+V.ele.ACC.3.F.SG+INF+3+SG
desmelindra-la	desmelindrar+V.ele.ACC.3.F.SG+PRS+2+SG
desmelindrá-la	desmelindrar+V.ele.ACC.3.F.SG+SBJF+1+SG
desmelindrá-la	desmelindrar+V.ele.ACC.3.F.SG+SBJF+3+SG
desmelindrá-la-ei	desmelindrar+V.ele.ACC.3.F.SG+FUT+1+SG
desmelindrá-la-eis	desmelindrar+V.ele.ACC.3.F.SG+FUT+2+PL
desmelindrá-la-emos	desmelindrar+V.ele.ACC.3.F.SG+FUT+1+PL
desmelindrá-la-ia	desmelindrar+V.ele.ACC.3.F.SG+COND+1+SG
desmelindrá-la-ia	desmelindrar+V.ele.ACC.3.F.SG+COND+3+SG
desmelindrá-la-iam	desmelindrar+V.ele.ACC.3.F.SG+COND+3+PL
desmelindrá-la-íamos	desmelindrar+V.ele.ACC.3.F.SG+COND+1+PL
desmelindrá-la-ias	desmelindrar+V.ele.ACC.3.F.SG+COND+2+SG
desmelindrá-la-íeis	desmelindrar+V.ele.ACC.3.F.SG+COND+2+PL
desmelindrá-las-á	desmelindrar+V.ele.ACC.3.F.PL+FUT+3+SG
desmelindrá-las-ão	desmelindrar+V.ele.ACC.3.F.PL+FUT+3+PL
desmelindrá-las-ás	desmelindrar+V.ele.ACC.3.F.PL+FUT+2+SG
desmelindrá-las	desmelindrar+V.ele.ACC.3.F.PL+INF+1+SG
desmelindrá-las	desmelindrar+V.ele.ACC.3.F.PL+INF+3+SG
desmelindra-las	desmelindrar+V.ele.ACC.3.F.PL+PRS+2+SG
desmelindrá-las	desmelindrar+V.ele.ACC.3.F.PL+SBJF+1+SG
desmelindrá-las	desmelindrar+V.ele.ACC.3.F.PL+SBJF+3+SG
desmelindrá-las-ei	desmelindrar+V.ele.ACC.3.F.PL+FUT+1+SG
desmelindrá-las-eis	desmelindrar+V.ele.ACC.3.F.PL+FUT+2+PL
desmelindrá-las-emos	desmelindrar+V.ele.ACC.3.F.PL+FUT+1+PL
desmelindrá-las-ia	desmelindrar+V.ele.ACC.3.F.PL+COND+1+SG
desmelindrá-las-ia	desmelindrar+V.ele.ACC.3.F.PL+COND+3+SG
desmelindrá-las-iam	desmelindrar+V.ele.ACC.3.F.PL+COND+3+PL
desmelindrá-las-íamos	desmelindrar+V.ele.ACC.3.F.PL+COND+1+PL
desmelindrá-las-ias	desmelindrar+V.ele.ACC.3.F.PL+COND+2+SG
desmelindrá-las-íeis	desmelindrar+V.ele.ACC.3.F.PL+COND+2+PL
desmelindra-lhe	desmelindrar+V.ele.DAT.3.SG+PRS+3+SG
desmelindra-lhes	desmelindrar+V.ele.DAT.3.PL+PRS+3+SG
desmelindrá-lo-á	desmelindrar+V.ele.ACC.3.M.SG+FUT+3+SG
desmelindrá-lo-ão	desmelindrar+V.ele.ACC.3.M.SG+FUT+3+PL
desmelindrá-lo-ás	desmelindrar+V.ele.ACC.3.M.SG+FUT+2+SG
desmelindrá-lo	desmelindrar+V.ele.ACC.3.M.SG+INF+1+SG
desmelindrá-lo	desmelindrar+V.ele.ACC.3.M.SG+INF+3+SG
desmelindra-lo	desmelindrar+V.ele.ACC.3.M.SG+PRS+2+SG
desmelindrá-lo	desmelindrar+V.ele.ACC.3.M.SG+SBJF+1+SG
desmelindrá-lo	desmelindrar+V.ele.ACC.3.M.SG+SBJF+3+SG
desmelindrá-lo-ei	desmelindrar+V.ele.ACC.3.M.SG+FUT+1+SG
desmelindrá-lo-eis	desmelindrar+V.ele.ACC.3.M.SG+FUT+2+PL
desmelindrá-lo-emos	desmelindrar+V.ele.ACC.3.M.SG+FUT+1+PL
desmelindrá-lo-ia	desmelindrar+V.ele.ACC.3.M.SG+COND+1+SG
desmelindrá-lo-ia	desmelindrar+V.ele.ACC.3.M.SG+COND+3+SG
desmelindrá-lo-iam	desmelindrar+V.ele.ACC.3.M.SG+COND+3+PL
desmelindrá-lo-íamos	desmelindrar+V.ele.ACC.3.M.SG+COND+1+PL
desmelindrá-lo-ias	desmelindrar+V.ele.ACC.3.M.SG+COND+2+SG
desmelindrá-lo-íeis	desmelindrar+V.ele.ACC.3.M.SG+COND+2+PL
desmelindrá-los-á	desmelindrar+V.ele.ACC.3.M.PL+FUT+3+SG
desmelindrá-los-ão	desmelindrar+V.ele.ACC.3.M.PL+FUT+3+PL
desmelindrá-los-ás	desmelindrar+V.ele.ACC.3.M.PL+FUT+2+SG
desmelindrá-los	desmelindrar+V.ele.ACC.3.M.PL+INF+1+SG
desmelindrá-los	desmelindrar+V.ele.ACC.3.M.PL+INF+3+SG
desmelindra-los	desmelindrar+V.ele.ACC.3.M.PL+PRS+2+SG
desmelindrá-los	desmelindrar+V.ele.ACC.3.M.PL+SBJF+1+SG
desmelindrá-los	desmelindrar+V.ele.ACC.3.M.PL+SBJF+3+SG
desmelindrá-los-ei	desmelindrar+V.ele.ACC.3.M.PL+FUT+1+SG
desmelindrá-los-eis	desmelindrar+V.ele.ACC.3.M.PL+FUT+2+PL
desmelindrá-los-emos	desmelindrar+V.ele.ACC.3.M.PL+FUT+1+PL
desmelindrá-los-ia	desmelindrar+V.ele.ACC.3.M.PL+COND+1+SG
desmelindrá-los-ia	desmelindrar+V.ele.ACC.3.M.PL+COND+3+SG
desmelindrá-los-iam	desmelindrar+V.ele.ACC.3.M.PL+COND+3+PL
desmelindrá-los-íamos	desmelindrar+V.ele.ACC.3.M.PL+COND+1+PL
desmelindrá-los-ias	desmelindrar+V.ele.ACC.3.M.PL+COND+2+SG
desmelindrá-los-íeis	desmelindrar+V.ele.ACC.3.M.PL+COND+2+PL
desmelindra-me	desmelindrar+V.eu.AD.1.SG+PRS+3+SG
desmelindram-lhe	desmelindrar+V.ele.DAT.3.SG+PRS+3+PL
desmelindram-lhes	desmelindrar+V.ele.DAT.3.PL+PRS+3+PL
desmelindram-me	desmelindrar+V.eu.AD.1.SG+PRS+3+PL
desmelindram-na	desmelindrar+V.ele.ACC.3.F.SG+PRS+3+PL
desmelindram-nas	desmelindrar+V.ele.ACC.3.F.PL+PRS+3+PL
desmelindram-no	desmelindrar+V.ele.ACC.3.M.SG+PRS+3+PL
desmelindram-nos	desmelindrar+V.ele.ACC.3.M.PL+PRS+3+PL
desmelindram-nos	desmelindrar+V.nós.AD.1.PL+PRS+3+PL
desmelindramo-la	desmelindrar+V.ele.ACC.3.F.SG+PRF+1+PL
desmelindramo-la	desmelindrar+V.ele.ACC.3.F.SG+PRS+1+PL
desmelindramo-las	desmelindrar+V.ele.ACC.3.F.PL+PRF+1+PL
desmelindramo-las	desmelindrar+V.ele.ACC.3.F.PL+PRS+1+PL
desmelindramo-lo	desmelindrar+V.ele.ACC.3.M.SG+PRF+1+PL
desmelindramo-lo	desmelindrar+V.ele.ACC.3.M.SG+PRS+1+PL
desmelindramo-los	desmelindrar+V.ele.ACC.3.M.PL+PRF+1+PL
desmelindramo-los	desmelindrar+V.ele.ACC.3.M.PL+PRS+1+PL
desmelindramo-nos	desmelindrar+nós.AD.1.PL+PRF+1+PL
desmelindramo-nos	desmelindrar+nós.AD.1.PL+PRS+1+PL
desmelindramos-lhe	desmelindrar+V.ele.DAT.3.SG+PRF+1+PL
desmelindramos-lhe	desmelindrar+V.ele.DAT.3.SG+PRS+1+PL
desmelindramos-lhes	desmelindrar+V.ele.DAT.3.PL+PRF+1+PL
desmelindramos-lhes	desmelindrar+V.ele.DAT.3.PL+PRS+1+PL
desmelindramos-me	desmelindrar+V.eu.AD.1.SG+PRF+1+PL
desmelindramos-me	desmelindrar+V.eu.AD.1.SG+PRS+1+PL
desmelindramos-te	desmelindrar+V.tu.AD.2.SG+PRF+1+PL
desmelindramos-te	desmelindrar+V.tu.AD.2.SG+PRS+1+PL
desmelindramos-vos	desmelindrar+V.vós.AD.2.PL+PRF+1+PL
desmelindramos-vos	desmelindrar+V.vós.AD.2.PL+PRS+1+PL
desmelindram-se	desmelindrar+V.ele.REFL+PRS+3+PL
desmelindram-te	desmelindrar+V.tu.AD.2.SG+PRS+3+PL
desmelindram-vos	desmelindrar+V.vós.AD.2.PL+PRS+3+PL
desmelindrando-a	desmelindrar+V.ele.ACC.3.F.SG+GRD
desmelindrando-as	desmelindrar+V.ele.ACC.3.F.PL+GRD
desmelindrando-lhe	desmelindrar+V.ele.DAT.3.SG+GRD
desmelindrando-lhes	desmelindrar+V.ele.DAT.3.PL+GRD
desmelindrando-me	desmelindrar+V.eu.AD.1.SG+GRD
desmelindrando-nos	desmelindrar+nós.AD.1.PL+GRD
desmelindrando-o	desmelindrar+V.ele.ACC.3.M.SG+GRD
desmelindrando-os	desmelindrar+V.ele.ACC.3.M.PL+GRD
desmelindrando-se	desmelindrar+V.ele.REFL+GRD
desmelindrando-te	desmelindrar+V.tu.AD.2.SG+GRD
desmelindrando-vos	desmelindrar+V.vós.AD.2.PL+GRD
desmelindra-nos	desmelindrar+nós.AD.1.PL+PRS+2+SG
desmelindra-nos	desmelindrar+nós.AD.1.PL+PRS+3+SG
desmelindra-o	desmelindrar+V.ele.ACC.3.M.SG+PRS+3+SG
desmelindra-os	desmelindrar+V.ele.ACC.3.M.PL+PRS+3+SG
desmelindrara-a	desmelindrar+V.ele.ACC.3.F.SG+PQP+1+SG
desmelindrara-a	desmelindrar+V.ele.ACC.3.F.SG+PQP+3+SG
desmelindrara-as	desmelindrar+V.ele.ACC.3.F.PL+PQP+1+SG
desmelindrara-as	desmelindrar+V.ele.ACC.3.F.PL+PQP+3+SG
desmelindrara-la	desmelindrar+V.ele.ACC.3.F.SG+PQP+2+SG
desmelindrara-las	desmelindrar+V.ele.ACC.3.F.PL+PQP+2+SG
desmelindrara-lhe	desmelindrar+V.ele.DAT.3.SG+PQP+1+SG
desmelindrara-lhe	desmelindrar+V.ele.DAT.3.SG+PQP+3+SG
desmelindrara-lhes	desmelindrar+V.ele.DAT.3.PL+PQP+1+SG
desmelindrara-lhes	desmelindrar+V.ele.DAT.3.PL+PQP+3+SG
desmelindrara-lo	desmelindrar+V.ele.ACC.3.M.SG+PQP+2+SG
desmelindrara-los	desmelindrar+V.ele.ACC.3.M.PL+PQP+2+SG
desmelindrara-me	desmelindrar+V.eu.AD.1.SG+PQP+1+SG
desmelindrara-me	desmelindrar+V.eu.AD.1.SG+PQP+3+SG
desmelindraram-lhe	desmelindrar+V.ele.DAT.3.SG+PQP+3+PL
desmelindraram-lhe	desmelindrar+V.ele.DAT.3.SG+PRF+3+PL
desmelindraram-lhes	desmelindrar+V.ele.DAT.3.PL+PQP+3+PL
desmelindraram-lhes	desmelindrar+V.ele.DAT.3.PL+PRF+3+PL
desmelindraram-me	desmelindrar+V.eu.AD.1.SG+PQP+3+PL
desmelindraram-me	desmelindrar+V.eu.AD.1.SG+PRF+3+PL
desmelindraram-na	desmelindrar+V.ele.ACC.3.F.SG+PQP+3+PL
desmelindraram-na	desmelindrar+V.ele.ACC.3.F.SG+PRF+3+PL
desmelindraram-nas	desmelindrar+V.ele.ACC.3.F.PL+PQP+3+PL
desmelindraram-nas	desmelindrar+V.ele.ACC.3.F.PL+PRF+3+PL
desmelindraram-no	desmelindrar+V.ele.ACC.3.M.SG+PQP+3+PL
desmelindraram-no	desmelindrar+V.ele.ACC.3.M.SG+PRF+3+PL
desmelindraram-nos	desmelindrar+V.ele.ACC.3.M.PL+PQP+3+PL
desmelindraram-nos	desmelindrar+V.ele.ACC.3.M.PL+PRF+3+PL
desmelindraram-nos	desmelindrar+V.nós.AD.1.PL+PQP+3+PL
desmelindraram-nos	desmelindrar+V.nós.AD.1.PL+PRF+3+PL
desmelindráramo-la	desmelindrar+V.ele.ACC.3.F.SG+PQP+1+PL
desmelindráramo-las	desmelindrar+V.ele.ACC.3.F.PL+PQP+1+PL
desmelindráramo-lo	desmelindrar+V.ele.ACC.3.M.SG+PQP+1+PL
desmelindráramo-los	desmelindrar+V.ele.ACC.3.M.PL+PQP+1+PL
desmelindráramo-nos	desmelindrar+nós.AD.1.PL+PQP+1+PL
desmelindráramos-lhe	desmelindrar+V.ele.DAT.3.SG+PQP+1+PL
desmelindráramos-lhes	desmelindrar+V.ele.DAT.3.PL+PQP+1+PL
desmelindráramos-me	desmelindrar+V.eu.AD.1.SG+PQP+1+PL
desmelindráramos-te	desmelindrar+V.tu.AD.2.SG+PQP+1+PL
desmelindráramos-vos	desmelindrar+V.vós.AD.2.PL+PQP+1+PL
desmelindraram-se	desmelindrar+V.ele.REFL+PQP+3+PL
desmelindraram-se	desmelindrar+V.ele.REFL+PRF+3+PL
desmelindraram-te	desmelindrar+V.tu.AD.2.SG+PQP+3+PL
desmelindraram-te	desmelindrar+V.tu.AD.2.SG+PRF+3+PL
desmelindraram-vos	desmelindrar+V.vós.AD.2.PL+PQP+3+PL
desmelindraram-vos	desmelindrar+V.vós.AD.2.PL+PRF+3+PL
desmelindrara-nos	desmelindrar+nós.AD.1.PL+PQP+1+SG
desmelindrara-nos	desmelindrar+nós.AD.1.PL+PQP+2+SG
desmelindrara-nos	desmelindrar+nós.AD.1.PL+PQP+3+SG
desmelindrara-o	desmelindrar+V.ele.ACC.3.M.SG+PQP+1+SG
desmelindrara-o	desmelindrar+V.ele.ACC.3.M.SG+PQP+3+SG
desmelindrara-os	desmelindrar+V.ele.ACC.3.M.PL+PQP+1+SG
desmelindrara-os	desmelindrar+V.ele.ACC.3.M.PL+PQP+3+SG
desmelindrara-se	desmelindrar+V.ele.REFL+PQP+1+SG
desmelindrara-se	desmelindrar+V.ele.REFL+PQP+3+SG
desmelindraras-lhe	desmelindrar+V.ele.DAT.3.SG+PQP+2+SG
desmelindraras-lhes	desmelindrar+V.ele.DAT.3.PL+PQP+2+SG
desmelindraras-me	desmelindrar+V.eu.AD.1.SG+PQP+2+SG
desmelindraras-te	desmelindrar+V.tu.AD.2.SG+PQP+2+SG
desmelindraras-vos	desmelindrar+V.vós.AD.2.PL+PQP+2+SG
desmelindrara-te	desmelindrar+V.tu.AD.2.SG+PQP+1+SG
desmelindrara-te	desmelindrar+V.tu.AD.2.SG+PQP+3+SG
desmelindrara-vos	desmelindrar+V.vós.AD.2.PL+PQP+1+SG
desmelindrara-vos	desmelindrar+V.vós.AD.2.PL+PQP+3+SG
desmelindrarde-la	desmelindrar+V.ele.ACC.3.F.SG+INF+2+PL
desmelindrarde-la	desmelindrar+V.ele.ACC.3.F.SG+SBJF+2+PL
desmelindrarde-las	desmelindrar+V.ele.ACC.3.F.PL+INF+2+PL
desmelindrarde-las	desmelindrar+V.ele.ACC.3.F.PL+SBJF+2+PL
desmelindrarde-lo	desmelindrar+V.ele.ACC.3.M.SG+INF+2+PL
desmelindrarde-lo	desmelindrar+V.ele.ACC.3.M.SG+SBJF+2+PL
desmelindrarde-los	desmelindrar+V.ele.ACC.3.M.PL+INF+2+PL
desmelindrarde-los	desmelindrar+V.ele.ACC.3.M.PL+SBJF+2+PL
desmelindrarde-nos	desmelindrar+nós.AD.1.PL+INF+2+PL
desmelindrarde-nos	desmelindrar+nós.AD.1.PL+SBJF+2+PL
desmelindrardes-lhe	desmelindrar+V.ele.DAT.3.SG+INF+2+PL
desmelindrardes-lhe	desmelindrar+V.ele.DAT.3.SG+SBJF+2+PL
desmelindrardes-lhes	desmelindrar+V.ele.DAT.3.PL+INF+2+PL
desmelindrardes-lhes	desmelindrar+V.ele.DAT.3.PL+SBJF+2+PL
desmelindrardes-me	desmelindrar+V.eu.AD.1.SG+INF+2+PL
desmelindrardes-me	desmelindrar+V.eu.AD.1.SG+SBJF+2+PL
desmelindrardes-te	desmelindrar+V.tu.AD.2.SG+INF+2+PL
desmelindrardes-te	desmelindrar+V.tu.AD.2.SG+SBJF+2+PL
desmelindrardes-vos	desmelindrar+V.vós.AD.2.PL+INF+2+PL
desmelindrardes-vos	desmelindrar+V.vós.AD.2.PL+SBJF+2+PL
desmelindrárei-la	desmelindrar+V.ele.ACC.3.F.SG+PQP+2+PL
desmelindrárei-las	desmelindrar+V.ele.ACC.3.F.PL+PQP+2+PL
desmelindrárei-lo	desmelindrar+V.ele.ACC.3.M.SG+PQP+2+PL
desmelindrárei-los	desmelindrar+V.ele.ACC.3.M.PL+PQP+2+PL
desmelindrárei-nos	desmelindrar+nós.AD.1.PL+PQP+2+PL
desmelindráreis-lhe	desmelindrar+V.ele.DAT.3.SG+PQP+2+PL
desmelindráreis-lhes	desmelindrar+V.ele.DAT.3.PL+PQP+2+PL
desmelindráreis-me	desmelindrar+V.eu.AD.1.SG+PQP+2+PL
desmelindráreis-te	desmelindrar+V.tu.AD.2.SG+PQP+2+PL
desmelindráreis-vos	desmelindrar+V.vós.AD.2.PL+PQP+2+PL
desmelindrare-la	desmelindrar+V.ele.ACC.3.F.SG+INF+2+SG
desmelindrare-la	desmelindrar+V.ele.ACC.3.F.SG+SBJF+2+SG
desmelindrare-las	desmelindrar+V.ele.ACC.3.F.PL+INF+2+SG
desmelindrare-las	desmelindrar+V.ele.ACC.3.F.PL+SBJF+2+SG
desmelindrare-lo	desmelindrar+V.ele.ACC.3.M.SG+INF+2+SG
desmelindrare-lo	desmelindrar+V.ele.ACC.3.M.SG+SBJF+2+SG
desmelindrare-los	desmelindrar+V.ele.ACC.3.M.PL+INF+2+SG
desmelindrare-los	desmelindrar+V.ele.ACC.3.M.PL+SBJF+2+SG
desmelindrarem-lhe	desmelindrar+V.ele.DAT.3.SG+INF+3+PL
desmelindrarem-lhe	desmelindrar+V.ele.DAT.3.SG+SBJF+3+PL
desmelindrarem-lhes	desmelindrar+V.ele.DAT.3.PL+INF+3+PL
desmelindrarem-lhes	desmelindrar+V.ele.DAT.3.PL+SBJF+3+PL
desmelindrarem-me	desmelindrar+V.eu.AD.1.SG+INF+3+PL
desmelindrarem-me	desmelindrar+V.eu.AD.1.SG+SBJF+3+PL
desmelindrarem-na	desmelindrar+V.ele.ACC.3.F.SG+INF+3+PL
desmelindrarem-na	desmelindrar+V.ele.ACC.3.F.SG+SBJF+3+PL
desmelindrarem-nas	desmelindrar+V.ele.ACC.3.F.PL+INF+3+PL
desmelindrarem-nas	desmelindrar+V.ele.ACC.3.F.PL+SBJF+3+PL
desmelindrarem-no	desmelindrar+V.ele.ACC.3.M.SG+INF+3+PL
desmelindrarem-no	desmelindrar+V.ele.ACC.3.M.SG+SBJF+3+PL
