desnudarem-me	desnudar+V.eu.AD.1.SG+SBJF+3+PL
desnudarem-na	desnudar+V.ele.ACC.3.F.SG+INF+3+PL
desnudarem-na	desnudar+V.ele.ACC.3.F.SG+SBJF+3+PL
desnudarem-nas	desnudar+V.ele.ACC.3.F.PL+INF+3+PL
desnudarem-nas	desnudar+V.ele.ACC.3.F.PL+SBJF+3+PL
desnudarem-no	desnudar+V.ele.ACC.3.M.SG+INF+3+PL
desnudarem-no	desnudar+V.ele.ACC.3.M.SG+SBJF+3+PL
desnudarem-nos	desnudar+V.ele.ACC.3.M.PL+INF+3+PL
desnudarem-nos	desnudar+V.ele.ACC.3.M.PL+SBJF+3+PL
desnudarem-nos	desnudar+V.nós.AD.1.PL+INF+3+PL
desnudarem-nos	desnudar+V.nós.AD.1.PL+SBJF+3+PL
desnudarem-se	desnudar+V.ele.REFL+INF+3+PL
desnudarem-se	desnudar+V.ele.REFL+SBJF+3+PL
desnudarem-te	desnudar+V.tu.AD.2.SG+INF+3+PL
desnudarem-te	desnudar+V.tu.AD.2.SG+SBJF+3+PL
desnudarem-vos	desnudar+V.vós.AD.2.PL+INF+3+PL
desnudarem-vos	desnudar+V.vós.AD.2.PL+SBJF+3+PL
desnudare-nos	desnudar+nós.AD.1.PL+INF+2+SG
desnudare-nos	desnudar+nós.AD.1.PL+SBJF+2+SG
desnudares-lhe	desnudar+V.ele.DAT.3.SG+INF+2+SG
desnudares-lhe	desnudar+V.ele.DAT.3.SG+SBJF+2+SG
desnudares-lhes	desnudar+V.ele.DAT.3.PL+INF+2+SG
desnudares-lhes	desnudar+V.ele.DAT.3.PL+SBJF+2+SG
desnudares-me	desnudar+V.eu.AD.1.SG+INF+2+SG
desnudares-me	desnudar+V.eu.AD.1.SG+SBJF+2+SG
desnudares-te	desnudar+V.tu.AD.2.SG+INF+2+SG
desnudares-te	desnudar+V.tu.AD.2.SG+SBJF+2+SG
desnudares-vos	desnudar+V.vós.AD.2.PL+INF+2+SG
desnudares-vos	desnudar+V.vós.AD.2.PL+SBJF+2+SG
desnudar-lhe-á	desnudar+V.ele.DAT.3.SG+FUT+3+SG
desnudar-lhe-ão	desnudar+V.ele.DAT.3.SG+FUT+3+PL
desnudar-lhe-ás	desnudar+V.ele.DAT.3.SG+FUT+2+SG
desnudar-lhe	desnudar+V.ele.DAT.3.SG+INF
desnudar-lhe	desnudar+V.ele.DAT.3.SG+INF+1+SG
desnudar-lhe	desnudar+V.ele.DAT.3.SG+INF+3+SG
desnudar-lhe	desnudar+V.ele.DAT.3.SG+SBJF+1+SG
desnudar-lhe	desnudar+V.ele.DAT.3.SG+SBJF+3+SG
desnudar-lhe-ei	desnudar+V.ele.DAT.3.SG+FUT+1+SG
desnudar-lhe-eis	desnudar+V.ele.DAT.3.SG+FUT+2+PL
desnudar-lhe-emos	desnudar+V.ele.DAT.3.SG+FUT+1+PL
desnudar-lhe-ia	desnudar+V.ele.DAT.3.SG+COND+1+SG
desnudar-lhe-ia	desnudar+V.ele.DAT.3.SG+COND+3+SG
desnudar-lhe-iam	desnudar+V.ele.DAT.3.SG+COND+3+PL
desnudar-lhe-íamos	desnudar+V.ele.DAT.3.SG+COND+1+PL
desnudar-lhe-ias	desnudar+V.ele.DAT.3.SG+COND+2+SG
desnudar-lhe-íeis	desnudar+V.ele.DAT.3.SG+COND+2+PL
desnudar-lhes-á	desnudar+V.ele.DAT.3.PL+FUT+3+SG
desnudar-lhes-ão	desnudar+V.ele.DAT.3.PL+FUT+3+PL
desnudar-lhes-ás	desnudar+V.ele.DAT.3.PL+FUT+2+SG
desnudar-lhes	desnudar+V.ele.DAT.3.PL+INF
desnudar-lhes	desnudar+V.ele.DAT.3.PL+INF+1+SG
desnudar-lhes	desnudar+V.ele.DAT.3.PL+INF+3+SG
desnudar-lhes	desnudar+V.ele.DAT.3.PL+SBJF+1+SG
desnudar-lhes	desnudar+V.ele.DAT.3.PL+SBJF+3+SG
desnudar-lhes-ei	desnudar+V.ele.DAT.3.PL+FUT+1+SG
desnudar-lhes-eis	desnudar+V.ele.DAT.3.PL+FUT+2+PL
desnudar-lhes-emos	desnudar+V.ele.DAT.3.PL+FUT+1+PL
desnudar-lhes-ia	desnudar+V.ele.DAT.3.PL+COND+1+SG
desnudar-lhes-ia	desnudar+V.ele.DAT.3.PL+COND+3+SG
desnudar-lhes-iam	desnudar+V.ele.DAT.3.PL+COND+3+PL
desnudar-lhes-íamos	desnudar+V.ele.DAT.3.PL+COND+1+PL
desnudar-lhes-ias	desnudar+V.ele.DAT.3.PL+COND+2+SG
desnudar-lhes-íeis	desnudar+V.ele.DAT.3.PL+COND+2+PL
desnudar-me-á	desnudar+V.eu.AD.1.SG+FUT+3+SG
desnudar-me-ão	desnudar+V.eu.AD.1.SG+FUT+3+PL
desnudar-me-ás	desnudar+V.eu.AD.1.SG+FUT+2+SG
desnudar-me	desnudar+V.eu.AD.1.SG+INF
desnudar-me	desnudar+V.eu.AD.1.SG+INF+1+SG
desnudar-me	desnudar+V.eu.AD.1.SG+INF+3+SG
desnudar-me	desnudar+V.eu.AD.1.SG+SBJF+1+SG
desnudar-me	desnudar+V.eu.AD.1.SG+SBJF+3+SG
desnudar-me-ei	desnudar+V.eu.AD.1.SG+FUT+1+SG
desnudar-me-eis	desnudar+V.eu.AD.1.SG+FUT+2+PL
desnudar-me-emos	desnudar+V.eu.AD.1.SG+FUT+1+PL
desnudar-me-ia	desnudar+V.eu.AD.1.SG+COND+1+SG
desnudar-me-ia	desnudar+V.eu.AD.1.SG+COND+3+SG
desnudar-me-iam	desnudar+V.eu.AD.1.SG+COND+3+PL
desnudar-me-íamos	desnudar+V.eu.AD.1.SG+COND+1+PL
desnudar-me-ias	desnudar+V.eu.AD.1.SG+COND+2+SG
desnudar-me-íeis	desnudar+V.eu.AD.1.SG+COND+2+PL
desnudarmo-la	desnudar+V.ele.ACC.3.F.SG+INF+1+PL
desnudarmo-la	desnudar+V.ele.ACC.3.F.SG+SBJF+1+PL
desnudarmo-las	desnudar+V.ele.ACC.3.F.PL+INF+1+PL
desnudarmo-las	desnudar+V.ele.ACC.3.F.PL+SBJF+1+PL
desnudarmo-lo	desnudar+V.ele.ACC.3.M.SG+INF+1+PL
desnudarmo-lo	desnudar+V.ele.ACC.3.M.SG+SBJF+1+PL
desnudarmo-los	desnudar+V.ele.ACC.3.M.PL+INF+1+PL
desnudarmo-los	desnudar+V.ele.ACC.3.M.PL+SBJF+1+PL
desnudarmo-nos	desnudar+nós.AD.1.PL+INF+1+PL
desnudarmo-nos	desnudar+nós.AD.1.PL+SBJF+1+PL
desnudarmos-lhe	desnudar+V.ele.DAT.3.SG+INF+1+PL
desnudarmos-lhe	desnudar+V.ele.DAT.3.SG+SBJF+1+PL
desnudarmos-lhes	desnudar+V.ele.DAT.3.PL+INF+1+PL
desnudarmos-lhes	desnudar+V.ele.DAT.3.PL+SBJF+1+PL
desnudarmos-me	desnudar+V.eu.AD.1.SG+INF+1+PL
desnudarmos-me	desnudar+V.eu.AD.1.SG+SBJF+1+PL
desnudarmos-te	desnudar+V.tu.AD.2.SG+INF+1+PL
desnudarmos-te	desnudar+V.tu.AD.2.SG+SBJF+1+PL
desnudarmos-vos	desnudar+V.vós.AD.2.PL+INF+1+PL
desnudarmos-vos	desnudar+V.vós.AD.2.PL+SBJF+1+PL
desnudar-nos-á	desnudar+nós.AD.1.PL+FUT+3+SG
desnudar-nos-ão	desnudar+nós.AD.1.PL+FUT+3+PL
desnudar-nos-ás	desnudar+nós.AD.1.PL+FUT+2+SG
desnudar-nos	desnudar+nós.AD.1.PL+INF
desnudar-nos	desnudar+nós.AD.1.PL+INF+1+SG
desnudar-nos	desnudar+nós.AD.1.PL+INF+3+SG
desnudar-nos	desnudar+nós.AD.1.PL+SBJF+1+SG
desnudar-nos	desnudar+nós.AD.1.PL+SBJF+3+SG
desnudar-nos-ei	desnudar+nós.AD.1.PL+FUT+1+SG
desnudar-nos-eis	desnudar+nós.AD.1.PL+FUT+2+PL
desnudar-nos-emos	desnudar+nós.AD.1.PL+FUT+1+PL
desnudar-nos-ia	desnudar+nós.AD.1.PL+COND+1+SG
desnudar-nos-ia	desnudar+nós.AD.1.PL+COND+3+SG
desnudar-nos-iam	desnudar+nós.AD.1.PL+COND+3+PL
desnudar-nos-íamos	desnudar+nós.AD.1.PL+COND+1+PL
desnudar-nos-ias	desnudar+nós.AD.1.PL+COND+2+SG
desnudar-nos-íeis	desnudar+nós.AD.1.PL+COND+2+PL
desnudar-se-á	desnudar+V.ele.REFL+FUT+3+SG
desnudar-se-ão	desnudar+V.ele.REFL+FUT+3+PL
desnudar-se	desnudar+V.ele.REFL+INF
desnudar-se	desnudar+V.ele.REFL+INF+3+SG
desnudar-se	desnudar+V.ele.REFL+SBJF+3+SG
desnudar-se-ia	desnudar+V.ele.REFL+COND+3+SG
desnudar-se-iam	desnudar+V.ele.REFL+COND+3+PL
desnudar-te-á	desnudar+V.tu.AD.2.SG+FUT+3+SG
desnudar-te-ão	desnudar+V.tu.AD.2.SG+FUT+3+PL
desnudar-te-ás	desnudar+V.tu.AD.2.SG+FUT+2+SG
desnudar-te	desnudar+V.tu.AD.2.SG+INF
desnudar-te	desnudar+V.tu.AD.2.SG+INF+1+SG
desnudar-te	desnudar+V.tu.AD.2.SG+INF+3+SG
desnudar-te	desnudar+V.tu.AD.2.SG+SBJF+1+SG
desnudar-te	desnudar+V.tu.AD.2.SG+SBJF+3+SG
desnudar-te-ei	desnudar+V.tu.AD.2.SG+FUT+1+SG
desnudar-te-eis	desnudar+V.tu.AD.2.SG+FUT+2+PL
desnudar-te-emos	desnudar+V.tu.AD.2.SG+FUT+1+PL
desnudar-te-ia	desnudar+V.tu.AD.2.SG+COND+1+SG
desnudar-te-ia	desnudar+V.tu.AD.2.SG+COND+3+SG
desnudar-te-iam	desnudar+V.tu.AD.2.SG+COND+3+PL
desnudar-te-íamos	desnudar+V.tu.AD.2.SG+COND+1+PL
desnudar-te-ias	desnudar+V.tu.AD.2.SG+COND+2+SG
desnudar-te-íeis	desnudar+V.tu.AD.2.SG+COND+2+PL
desnudar-vos-á	desnudar+V.vós.AD.2.PL+FUT+3+SG
desnudar-vos-ão	desnudar+V.vós.AD.2.PL+FUT+3+PL
desnudar-vos-ás	desnudar+V.vós.AD.2.PL+FUT+2+SG
desnudar-vos	desnudar+V.vós.AD.2.PL+INF
desnudar-vos	desnudar+V.vós.AD.2.PL+INF+1+SG
desnudar-vos	desnudar+V.vós.AD.2.PL+INF+3+SG
desnudar-vos	desnudar+V.vós.AD.2.PL+SBJF+1+SG
desnudar-vos	desnudar+V.vós.AD.2.PL+SBJF+3+SG
desnudar-vos-ei	desnudar+V.vós.AD.2.PL+FUT+1+SG
desnudar-vos-eis	desnudar+V.vós.AD.2.PL+FUT+2+PL
desnudar-vos-emos	desnudar+V.vós.AD.2.PL+FUT+1+PL
desnudar-vos-ia	desnudar+V.vós.AD.2.PL+COND+1+SG
desnudar-vos-ia	desnudar+V.vós.AD.2.PL+COND+3+SG
desnudar-vos-iam	desnudar+V.vós.AD.2.PL+COND+3+PL
desnudar-vos-íamos	desnudar+V.vós.AD.2.PL+COND+1+PL
desnudar-vos-ias	desnudar+V.vós.AD.2.PL+COND+2+SG
desnudar-vos-íeis	desnudar+V.vós.AD.2.PL+COND+2+PL
desnuda-se	desnudar+V.ele.REFL+PRS+3+SG
desnudas-lhe	desnudar+V.ele.DAT.3.SG+PRS+2+SG
desnudas-lhes	desnudar+V.ele.DAT.3.PL+PRS+2+SG
desnudas-me	desnudar+V.eu.AD.1.SG+PRS+2+SG
desnudaste-a	desnudar+V.ele.ACC.3.F.SG+PRF+2+SG
desnudaste-as	desnudar+V.ele.ACC.3.F.PL+PRF+2+SG
desnudas-te	desnudar+V.tu.AD.2.SG+PRS+2+SG
desnudaste-la	desnudar+V.ele.ACC.3.F.SG+PRF+2+PL
desnudaste-las	desnudar+V.ele.ACC.3.F.PL+PRF+2+PL
desnudaste-lhe	desnudar+V.ele.DAT.3.SG+PRF+2+SG
desnudaste-lhes	desnudar+V.ele.DAT.3.PL+PRF+2+SG
desnudaste-lo	desnudar+V.ele.ACC.3.M.SG+PRF+2+PL
desnudaste-los	desnudar+V.ele.ACC.3.M.PL+PRF+2+PL
desnudaste-me	desnudar+V.eu.AD.1.SG+PRF+2+SG
desnudaste-nos	desnudar+nós.AD.1.PL+PRF+2+PL
desnudaste-nos	desnudar+nós.AD.1.PL+PRF+2+SG
desnudaste-o	desnudar+V.ele.ACC.3.M.SG+PRF+2+SG
desnudaste-os	desnudar+V.ele.ACC.3.M.PL+PRF+2+SG
desnudastes-lhe	desnudar+V.ele.DAT.3.SG+PRF+2+PL
desnudastes-lhes	desnudar+V.ele.DAT.3.PL+PRF+2+PL
desnudastes-me	desnudar+V.eu.AD.1.SG+PRF+2+PL
desnudastes-te	desnudar+V.tu.AD.2.SG+PRF+2+PL
desnudastes-vos	desnudar+V.vós.AD.2.PL+PRF+2+PL
desnudaste-te	desnudar+V.tu.AD.2.SG+PRF+2+SG
desnudaste-vos	desnudar+V.vós.AD.2.PL+PRF+2+SG
desnudas-vos	desnudar+V.vós.AD.2.PL+PRS+2+SG
desnuda-te	desnudar+V.tu.AD.2.SG+PRS+3+SG
desnudava-a	desnudar+V.ele.ACC.3.F.SG+IMPF+1+SG
desnudava-a	desnudar+V.ele.ACC.3.F.SG+IMPF+3+SG
desnudava-as	desnudar+V.ele.ACC.3.F.PL+IMPF+1+SG
desnudava-as	desnudar+V.ele.ACC.3.F.PL+IMPF+3+SG
desnudava-la	desnudar+V.ele.ACC.3.F.SG+IMPF+2+SG
desnudava-las	desnudar+V.ele.ACC.3.F.PL+IMPF+2+SG
desnudava-lhe	desnudar+V.ele.DAT.3.SG+IMPF+1+SG
desnudava-lhe	desnudar+V.ele.DAT.3.SG+IMPF+3+SG
desnudava-lhes	desnudar+V.ele.DAT.3.PL+IMPF+1+SG
desnudava-lhes	desnudar+V.ele.DAT.3.PL+IMPF+3+SG
desnudava-lo	desnudar+V.ele.ACC.3.M.SG+IMPF+2+SG
desnudava-los	desnudar+V.ele.ACC.3.M.PL+IMPF+2+SG
desnudava-me	desnudar+V.eu.AD.1.SG+IMPF+1+SG
desnudava-me	desnudar+V.eu.AD.1.SG+IMPF+3+SG
desnudavam-lhe	desnudar+V.ele.DAT.3.SG+IMPF+3+PL
desnudavam-lhes	desnudar+V.ele.DAT.3.PL+IMPF+3+PL
desnudavam-me	desnudar+V.eu.AD.1.SG+IMPF+3+PL
desnudavam-na	desnudar+V.ele.ACC.3.F.SG+IMPF+3+PL
desnudavam-nas	desnudar+V.ele.ACC.3.F.PL+IMPF+3+PL
desnudavam-no	desnudar+V.ele.ACC.3.M.SG+IMPF+3+PL
desnudavam-nos	desnudar+V.ele.ACC.3.M.PL+IMPF+3+PL
desnudavam-nos	desnudar+V.nós.AD.1.PL+IMPF+3+PL
desnudávamo-la	desnudar+V.ele.ACC.3.F.SG+IMPF+1+PL
desnudávamo-las	desnudar+V.ele.ACC.3.F.PL+IMPF+1+PL
desnudávamo-lo	desnudar+V.ele.ACC.3.M.SG+IMPF+1+PL
desnudávamo-los	desnudar+V.ele.ACC.3.M.PL+IMPF+1+PL
desnudávamo-nos	desnudar+nós.AD.1.PL+IMPF+1+PL
desnudávamos-lhe	desnudar+V.ele.DAT.3.SG+IMPF+1+PL
desnudávamos-lhes	desnudar+V.ele.DAT.3.PL+IMPF+1+PL
desnudávamos-me	desnudar+V.eu.AD.1.SG+IMPF+1+PL
desnudávamos-te	desnudar+V.tu.AD.2.SG+IMPF+1+PL
desnudávamos-vos	desnudar+V.vós.AD.2.PL+IMPF+1+PL
desnudavam-se	desnudar+V.ele.REFL+IMPF+3+PL
desnudavam-te	desnudar+V.tu.AD.2.SG+IMPF+3+PL
desnudavam-vos	desnudar+V.vós.AD.2.PL+IMPF+3+PL
desnudava-nos	desnudar+nós.AD.1.PL+IMPF+1+SG
desnudava-nos	desnudar+nós.AD.1.PL+IMPF+2+SG
desnudava-nos	desnudar+nós.AD.1.PL+IMPF+3+SG
desnudava-o	desnudar+V.ele.ACC.3.M.SG+IMPF+1+SG
desnudava-o	desnudar+V.ele.ACC.3.M.SG+IMPF+3+SG
desnudava-os	desnudar+V.ele.ACC.3.M.PL+IMPF+1+SG
desnudava-os	desnudar+V.ele.ACC.3.M.PL+IMPF+3+SG
desnudava-se	desnudar+V.ele.REFL+IMPF+1+SG
desnudava-se	desnudar+V.ele.REFL+IMPF+3+SG
desnudavas-lhe	desnudar+V.ele.DAT.3.SG+IMPF+2+SG
desnudavas-lhes	desnudar+V.ele.DAT.3.PL+IMPF+2+SG
desnudavas-me	desnudar+V.eu.AD.1.SG+IMPF+2+SG
desnudavas-te	desnudar+V.tu.AD.2.SG+IMPF+2+SG
desnudavas-vos	desnudar+V.vós.AD.2.PL+IMPF+2+SG
desnudava-te	desnudar+V.tu.AD.2.SG+IMPF+1+SG
desnudava-te	desnudar+V.tu.AD.2.SG+IMPF+3+SG
desnudava-vos	desnudar+V.vós.AD.2.PL+IMPF+1+SG
desnudava-vos	desnudar+V.vós.AD.2.PL+IMPF+3+SG
desnudávei-la	desnudar+V.ele.ACC.3.F.SG+IMPF+2+PL
desnudávei-las	desnudar+V.ele.ACC.3.F.PL+IMPF+2+PL
desnudávei-lo	desnudar+V.ele.ACC.3.M.SG+IMPF+2+PL
desnudávei-los	desnudar+V.ele.ACC.3.M.PL+IMPF+2+PL
desnudávei-nos	desnudar+nós.AD.1.PL+IMPF+2+PL
desnudáveis-lhe	desnudar+V.ele.DAT.3.SG+IMPF+2+PL
desnudáveis-lhes	desnudar+V.ele.DAT.3.PL+IMPF+2+PL
desnudáveis-me	desnudar+V.eu.AD.1.SG+IMPF+2+PL
desnudáveis-te	desnudar+V.tu.AD.2.SG+IMPF+2+PL
desnudáveis-vos	desnudar+V.vós.AD.2.PL+IMPF+2+PL
desnuda-vos	desnudar+V.vós.AD.2.PL+PRS+3+SG
desnude-a	desnudar+V.ele.ACC.3.F.SG+IMP+3+SG
desnude-as	desnudar+V.ele.ACC.3.F.PL+IMP+3+SG
desnudei-a	desnudar+V.ele.ACC.3.F.SG+PRF+1+SG
desnudei-as	desnudar+V.ele.ACC.3.F.PL+PRF+1+SG
desnudei-lhe	desnudar+V.ele.DAT.3.SG+PRF+1+SG
desnudei-lhes	desnudar+V.ele.DAT.3.PL+PRF+1+SG
desnudei-me	desnudar+V.eu.AD.1.SG+PRF+1+SG
desnudei-nos	desnudar+nós.AD.1.PL+PRF+1+SG
desnudei-o	desnudar+V.ele.ACC.3.M.SG+PRF+1+SG
desnudei-os	desnudar+V.ele.ACC.3.M.PL+PRF+1+SG
desnudei-te	desnudar+V.tu.AD.2.SG+PRF+1+SG
desnudei-vos	desnudar+V.vós.AD.2.PL+PRF+1+SG
desnude-lhe	desnudar+V.ele.DAT.3.SG+IMP+3+SG
desnude-lhes	desnudar+V.ele.DAT.3.PL+IMP+3+SG
desnude-me	desnudar+V.eu.AD.1.SG+IMP+3+SG
desnudem-lhe	desnudar+V.ele.DAT.3.SG+IMP+3+PL
desnudem-lhes	desnudar+V.ele.DAT.3.PL+IMP+3+PL
desnudem-me	desnudar+V.eu.AD.1.SG+IMP+3+PL
desnudem-na	desnudar+V.ele.ACC.3.F.SG+IMP+3+PL
desnudem-nas	desnudar+V.ele.ACC.3.F.PL+IMP+3+PL
desnudem-no	desnudar+V.ele.ACC.3.M.SG+IMP+3+PL
desnudem-nos	desnudar+V.ele.ACC.3.M.PL+IMP+3+PL
desnudem-nos	desnudar+V.nós.AD.1.PL+IMP+3+PL
desnudemo-la	desnudar+V.ele.ACC.3.F.SG+IMP+1+PL
desnudemo-las	desnudar+V.ele.ACC.3.F.PL+IMP+1+PL
desnudemo-lo	desnudar+V.ele.ACC.3.M.SG+IMP+1+PL
desnudemo-los	desnudar+V.ele.ACC.3.M.PL+IMP+1+PL
desnudemo-nos	desnudar+nós.AD.1.PL+IMP+1+PL
desnudemos-lhe	desnudar+V.ele.DAT.3.SG+IMP+1+PL
desnudemos-lhes	desnudar+V.ele.DAT.3.PL+IMP+1+PL
desnudemos-me	desnudar+V.eu.AD.1.SG+IMP+1+PL
desnudemos-te	desnudar+V.tu.AD.2.SG+IMP+1+PL
desnudemos-vos	desnudar+V.vós.AD.2.PL+IMP+1+PL
desnudem-se	desnudar+V.ele.REFL+IMP+3+PL
desnudem-te	desnudar+V.tu.AD.2.SG+IMP+3+PL
desnudem-vos	desnudar+V.vós.AD.2.PL+IMP+3+PL
desnude-nos	desnudar+nós.AD.1.PL+IMP+3+SG
desnude-o	desnudar+V.ele.ACC.3.M.SG+IMP+3+SG
desnude-os	desnudar+V.ele.ACC.3.M.PL+IMP+3+SG
desnude-se	desnudar+V.ele.REFL+IMP+3+SG
desnude-te	desnudar+V.tu.AD.2.SG+IMP+3+SG
desnude-vos	desnudar+V.vós.AD.2.PL+IMP+3+SG
desnudo-a	desnudar+V.ele.ACC.3.F.SG+PRS+1+SG
desnudo-as	desnudar+V.ele.ACC.3.F.PL+PRS+1+SG
desnudo-lhe	desnudar+V.ele.DAT.3.SG+PRS+1+SG
desnudo-lhes	desnudar+V.ele.DAT.3.PL+PRS+1+SG
desnudo-me	desnudar+V.eu.AD.1.SG+PRS+1+SG
desnudo-nos	desnudar+nós.AD.1.PL+PRS+1+SG
desnudo-o	desnudar+V.ele.ACC.3.M.SG+PRS+1+SG
desnudo-os	desnudar+V.ele.ACC.3.M.PL+PRS+1+SG
desnudo-te	desnudar+V.tu.AD.2.SG+PRS+1+SG
desnudou-a	desnudar+V.ele.ACC.3.F.SG+PRF+3+SG
desnudou-as	desnudar+V.ele.ACC.3.F.PL+PRF+3+SG
desnudou-lhe	desnudar+V.ele.DAT.3.SG+PRF+3+SG
desnudou-lhes	desnudar+V.ele.DAT.3.PL+PRF+3+SG
desnudou-me	desnudar+V.eu.AD.1.SG+PRF+3+SG
desnudou-nos	desnudar+nós.AD.1.PL+PRF+3+SG
desnudou-o	desnudar+V.ele.ACC.3.M.SG+PRF+3+SG
desnudou-os	desnudar+V.ele.ACC.3.M.PL+PRF+3+SG
desnudou-se	desnudar+V.ele.REFL+PRF+3+SG
desnudou-te	desnudar+V.tu.AD.2.SG+PRF+3+SG
desnudou-vos	desnudar+V.vós.AD.2.PL+PRF+3+SG
desnudo-vos	desnudar+V.vós.AD.2.PL+PRS+1+SG
desnue-a	desnuar+V.ele.ACC.3.F.SG+IMP+3+SG
desnue-as	desnuar+V.ele.ACC.3.F.PL+IMP+3+SG
desnuei-a	desnuar+V.ele.ACC.3.F.SG+PRF+1+SG
desnuei-as	desnuar+V.ele.ACC.3.F.PL+PRF+1+SG
desnuei-lhe	desnuar+V.ele.DAT.3.SG+PRF+1+SG
desnuei-lhes	desnuar+V.ele.DAT.3.PL+PRF+1+SG
desnuei-me	desnuar+V.eu.AD.1.SG+PRF+1+SG
desnuei-nos	desnuar+nós.AD.1.PL+PRF+1+SG
desnuei-o	desnuar+V.ele.ACC.3.M.SG+PRF+1+SG
desnuei-os	desnuar+V.ele.ACC.3.M.PL+PRF+1+SG
desnuei-te	desnuar+V.tu.AD.2.SG+PRF+1+SG
desnuei-vos	desnuar+V.vós.AD.2.PL+PRF+1+SG
desnue-lhe	desnuar+V.ele.DAT.3.SG+IMP+3+SG
desnue-lhes	desnuar+V.ele.DAT.3.PL+IMP+3+SG
desnue-me	desnuar+V.eu.AD.1.SG+IMP+3+SG
desnuem-lhe	desnuar+V.ele.DAT.3.SG+IMP+3+PL
desnuem-lhes	desnuar+V.ele.DAT.3.PL+IMP+3+PL
desnuem-me	desnuar+V.eu.AD.1.SG+IMP+3+PL
desnuem-na	desnuar+V.ele.ACC.3.F.SG+IMP+3+PL
desnuem-nas	desnuar+V.ele.ACC.3.F.PL+IMP+3+PL
desnuem-no	desnuar+V.ele.ACC.3.M.SG+IMP+3+PL
desnuem-nos	desnuar+V.ele.ACC.3.M.PL+IMP+3+PL
desnuem-nos	desnuar+V.nós.AD.1.PL+IMP+3+PL
desnuemo-la	desnuar+V.ele.ACC.3.F.SG+IMP+1+PL
desnuemo-las	desnuar+V.ele.ACC.3.F.PL+IMP+1+PL
desnuemo-lo	desnuar+V.ele.ACC.3.M.SG+IMP+1+PL
desnuemo-los	desnuar+V.ele.ACC.3.M.PL+IMP+1+PL
desnuemo-nos	desnuar+nós.AD.1.PL+IMP+1+PL
desnuemos-lhe	desnuar+V.ele.DAT.3.SG+IMP+1+PL
desnuemos-lhes	desnuar+V.ele.DAT.3.PL+IMP+1+PL
desnuemos-me	desnuar+V.eu.AD.1.SG+IMP+1+PL
desnuemos-te	desnuar+V.tu.AD.2.SG+IMP+1+PL
desnuemos-vos	desnuar+V.vós.AD.2.PL+IMP+1+PL
desnuem-se	desnuar+V.ele.REFL+IMP+3+PL
desnuem-te	desnuar+V.tu.AD.2.SG+IMP+3+PL
desnuem-vos	desnuar+V.vós.AD.2.PL+IMP+3+PL
desnue-nos	desnuar+nós.AD.1.PL+IMP+3+SG
desnue-o	desnuar+V.ele.ACC.3.M.SG+IMP+3+SG
desnue-os	desnuar+V.ele.ACC.3.M.PL+IMP+3+SG
desnue-se	desnuar+V.ele.REFL+IMP+3+SG
desnue-te	desnuar+V.tu.AD.2.SG+IMP+3+SG
desnue-vos	desnuar+V.vós.AD.2.PL+IMP+3+SG
desnuo-a	desnuar+V.ele.ACC.3.F.SG+PRS+1+SG
desnuo-as	desnuar+V.ele.ACC.3.F.PL+PRS+1+SG
desnuo-lhe	desnuar+V.ele.DAT.3.SG+PRS+1+SG
desnuo-lhes	desnuar+V.ele.DAT.3.PL+PRS+1+SG
desnuo-me	desnuar+V.eu.AD.1.SG+PRS+1+SG
desnuo-nos	desnuar+nós.AD.1.PL+PRS+1+SG
desnuo-o	desnuar+V.ele.ACC.3.M.SG+PRS+1+SG
desnuo-os	desnuar+V.ele.ACC.3.M.PL+PRS+1+SG
desnuo-te	desnuar+V.tu.AD.2.SG+PRS+1+SG
desnuou-a	desnuar+V.ele.ACC.3.F.SG+PRF+3+SG
desnuou-as	desnuar+V.ele.ACC.3.F.PL+PRF+3+SG
desnuou-lhe	desnuar+V.ele.DAT.3.SG+PRF+3+SG
desnuou-lhes	desnuar+V.ele.DAT.3.PL+PRF+3+SG
desnuou-me	desnuar+V.eu.AD.1.SG+PRF+3+SG
desnuou-nos	desnuar+nós.AD.1.PL+PRF+3+SG
desnuou-o	desnuar+V.ele.ACC.3.M.SG+PRF+3+SG
desnuou-os	desnuar+V.ele.ACC.3.M.PL+PRF+3+SG
desnuou-se	desnuar+V.ele.REFL+PRF+3+SG
desnuou-te	desnuar+V.tu.AD.2.SG+PRF+3+SG
desnuou-vos	desnuar+V.vós.AD.2.PL+PRF+3+SG
desnuo-vos	desnuar+V.vós.AD.2.PL+PRS+1+SG
desnuque-a	desnucar+V.ele.ACC.3.F.SG+IMP+3+SG
desnuque-as	desnucar+V.ele.ACC.3.F.PL+IMP+3+SG
desnuquei-a	desnucar+V.ele.ACC.3.F.SG+PRF+1+SG
desnuquei-as	desnucar+V.ele.ACC.3.F.PL+PRF+1+SG
desnuquei-lhe	desnucar+V.ele.DAT.3.SG+PRF+1+SG
desnuquei-lhes	desnucar+V.ele.DAT.3.PL+PRF+1+SG
desnuquei-me	desnucar+V.eu.AD.1.SG+PRF+1+SG
desnuquei-nos	desnucar+nós.AD.1.PL+PRF+1+SG
desnuquei-o	desnucar+V.ele.ACC.3.M.SG+PRF+1+SG
desnuquei-os	desnucar+V.ele.ACC.3.M.PL+PRF+1+SG
desnuquei-te	desnucar+V.tu.AD.2.SG+PRF+1+SG
desnuquei-vos	desnucar+V.vós.AD.2.PL+PRF+1+SG
desnuque-lhe	desnucar+V.ele.DAT.3.SG+IMP+3+SG
desnuque-lhes	desnucar+V.ele.DAT.3.PL+IMP+3+SG
desnuque-me	desnucar+V.eu.AD.1.SG+IMP+3+SG
desnuquem-lhe	desnucar+V.ele.DAT.3.SG+IMP+3+PL
desnuquem-lhes	desnucar+V.ele.DAT.3.PL+IMP+3+PL
desnuquem-me	desnucar+V.eu.AD.1.SG+IMP+3+PL
desnuquem-na	desnucar+V.ele.ACC.3.F.SG+IMP+3+PL
desnuquem-nas	desnucar+V.ele.ACC.3.F.PL+IMP+3+PL
desnuquem-no	desnucar+V.ele.ACC.3.M.SG+IMP+3+PL
desnuquem-nos	desnucar+V.ele.ACC.3.M.PL+IMP+3+PL
desnuquem-nos	desnucar+V.nós.AD.1.PL+IMP+3+PL
desnuquemo-la	desnucar+V.ele.ACC.3.F.SG+IMP+1+PL
desnuquemo-las	desnucar+V.ele.ACC.3.F.PL+IMP+1+PL
desnuquemo-lo	desnucar+V.ele.ACC.3.M.SG+IMP+1+PL
desnuquemo-los	desnucar+V.ele.ACC.3.M.PL+IMP+1+PL
desnuquemo-nos	desnucar+nós.AD.1.PL+IMP+1+PL
desnuquemos-lhe	desnucar+V.ele.DAT.3.SG+IMP+1+PL
desnuquemos-lhes	desnucar+V.ele.DAT.3.PL+IMP+1+PL
desnuquemos-me	desnucar+V.eu.AD.1.SG+IMP+1+PL
desnuquemos-te	desnucar+V.tu.AD.2.SG+IMP+1+PL
desnuquemos-vos	desnucar+V.vós.AD.2.PL+IMP+1+PL
desnuquem-se	desnucar+V.ele.REFL+IMP+3+PL
desnuquem-te	desnucar+V.tu.AD.2.SG+IMP+3+PL
desnuquem-vos	desnucar+V.vós.AD.2.PL+IMP+3+PL
desnuque-nos	desnucar+nós.AD.1.PL+IMP+3+SG
desnuque-o	desnucar+V.ele.ACC.3.M.SG+IMP+3+SG
desnuque-os	desnucar+V.ele.ACC.3.M.PL+IMP+3+SG
desnuque-se	desnucar+V.ele.REFL+IMP+3+SG
desnuque-te	desnucar+V.tu.AD.2.SG+IMP+3+SG
desnuque-vos	desnucar+V.vós.AD.2.PL+IMP+3+SG
desnutra-a	desnutrir+V.ele.ACC.3.F.SG+IMP+3+SG
desnutra-as	desnutrir+V.ele.ACC.3.F.PL+IMP+3+SG
desnutra-lhe	desnutrir+V.ele.DAT.3.SG+IMP+3+SG
desnutra-lhes	desnutrir+V.ele.DAT.3.PL+IMP+3+SG
desnutra-me	desnutrir+V.eu.AD.1.SG+IMP+3+SG
desnutram-lhe	desnutrir+V.ele.DAT.3.SG+IMP+3+PL
desnutram-lhes	desnutrir+V.ele.DAT.3.PL+IMP+3+PL
desnutram-me	desnutrir+V.eu.AD.1.SG+IMP+3+PL
desnutram-na	desnutrir+V.ele.ACC.3.F.SG+IMP+3+PL
desnutram-nas	desnutrir+V.ele.ACC.3.F.PL+IMP+3+PL
desnutram-no	desnutrir+V.ele.ACC.3.M.SG+IMP+3+PL
desnutram-nos	desnutrir+V.ele.ACC.3.M.PL+IMP+3+PL
desnutram-nos	desnutrir+V.nós.AD.1.PL+IMP+3+PL
desnutramo-la	desnutrir+V.ele.ACC.3.F.SG+IMP+1+PL
desnutramo-las	desnutrir+V.ele.ACC.3.F.PL+IMP+1+PL
desnutramo-lo	desnutrir+V.ele.ACC.3.M.SG+IMP+1+PL
desnutramo-los	desnutrir+V.ele.ACC.3.M.PL+IMP+1+PL
desnutramo-nos	desnutrir+nós.AD.1.PL+IMP+1+PL
desnutramos-lhe	desnutrir+V.ele.DAT.3.SG+IMP+1+PL
desnutramos-lhes	desnutrir+V.ele.DAT.3.PL+IMP+1+PL
desnutramos-me	desnutrir+V.eu.AD.1.SG+IMP+1+PL
desnutramos-te	desnutrir+V.tu.AD.2.SG+IMP+1+PL
desnutramos-vos	desnutrir+V.vós.AD.2.PL+IMP+1+PL
desnutram-se	desnutrir+V.ele.REFL+IMP+3+PL
desnutram-te	desnutrir+V.tu.AD.2.SG+IMP+3+PL
desnutram-vos	desnutrir+V.vós.AD.2.PL+IMP+3+PL
desnutra-nos	desnutrir+nós.AD.1.PL+IMP+3+SG
desnutra-o	desnutrir+V.ele.ACC.3.M.SG+IMP+3+SG
desnutra-os	desnutrir+V.ele.ACC.3.M.PL+IMP+3+SG
desnutra-se	desnutrir+V.ele.REFL+IMP+3+SG
desnutra-te	desnutrir+V.tu.AD.2.SG+IMP+3+SG
desnutra-vos	desnutrir+V.vós.AD.2.PL+IMP+3+SG
desnutria-a	desnutrir+V.ele.ACC.3.F.SG+IMPF+1+SG
desnutria-a	desnutrir+V.ele.ACC.3.F.SG+IMPF+3+SG
desnutria-as	desnutrir+V.ele.ACC.3.F.PL+IMPF+1+SG
desnutria-as	desnutrir+V.ele.ACC.3.F.PL+IMPF+3+SG
desnutri-a	desnutrir+V.ele.ACC.3.F.SG+PRF+1+SG
desnutria-la	desnutrir+V.ele.ACC.3.F.SG+IMPF+2+SG
desnutria-las	desnutrir+V.ele.ACC.3.F.PL+IMPF+2+SG
desnutria-lhe	desnutrir+V.ele.DAT.3.SG+IMPF+1+SG
desnutria-lhe	desnutrir+V.ele.DAT.3.SG+IMPF+3+SG
desnutria-lhes	desnutrir+V.ele.DAT.3.PL+IMPF+1+SG
desnutria-lhes	desnutrir+V.ele.DAT.3.PL+IMPF+3+SG
desnutria-lo	desnutrir+V.ele.ACC.3.M.SG+IMPF+2+SG
desnutria-los	desnutrir+V.ele.ACC.3.M.PL+IMPF+2+SG
desnutria-me	desnutrir+V.eu.AD.1.SG+IMPF+1+SG
desnutria-me	desnutrir+V.eu.AD.1.SG+IMPF+3+SG
desnutriam-lhe	desnutrir+V.ele.DAT.3.SG+IMPF+3+PL
desnutriam-lhes	desnutrir+V.ele.DAT.3.PL+IMPF+3+PL
desnutriam-me	desnutrir+V.eu.AD.1.SG+IMPF+3+PL
desnutriam-na	desnutrir+V.ele.ACC.3.F.SG+IMPF+3+PL
desnutriam-nas	desnutrir+V.ele.ACC.3.F.PL+IMPF+3+PL
desnutriam-no	desnutrir+V.ele.ACC.3.M.SG+IMPF+3+PL
desnutriam-nos	desnutrir+V.ele.ACC.3.M.PL+IMPF+3+PL
desnutriam-nos	desnutrir+V.nós.AD.1.PL+IMPF+3+PL
desnutríamo-la	desnutrir+V.ele.ACC.3.F.SG+IMPF+1+PL
desnutríamo-las	desnutrir+V.ele.ACC.3.F.PL+IMPF+1+PL
desnutríamo-lo	desnutrir+V.ele.ACC.3.M.SG+IMPF+1+PL
desnutríamo-los	desnutrir+V.ele.ACC.3.M.PL+IMPF+1+PL
desnutríamo-nos	desnutrir+nós.AD.1.PL+IMPF+1+PL
desnutríamos-lhe	desnutrir+V.ele.DAT.3.SG+IMPF+1+PL
desnutríamos-lhes	desnutrir+V.ele.DAT.3.PL+IMPF+1+PL
desnutríamos-me	desnutrir+V.eu.AD.1.SG+IMPF+1+PL
desnutríamos-te	desnutrir+V.tu.AD.2.SG+IMPF+1+PL
desnutríamos-vos	desnutrir+V.vós.AD.2.PL+IMPF+1+PL
desnutriam-se	desnutrir+V.ele.REFL+IMPF+3+PL
desnutriam-te	desnutrir+V.tu.AD.2.SG+IMPF+3+PL
desnutriam-vos	desnutrir+V.vós.AD.2.PL+IMPF+3+PL
desnutria-nos	desnutrir+nós.AD.1.PL+IMPF+1+SG
desnutria-nos	desnutrir+nós.AD.1.PL+IMPF+2+SG
desnutria-nos	desnutrir+nós.AD.1.PL+IMPF+3+SG
desnutria-o	desnutrir+V.ele.ACC.3.M.SG+IMPF+1+SG
desnutria-o	desnutrir+V.ele.ACC.3.M.SG+IMPF+3+SG
desnutria-os	desnutrir+V.ele.ACC.3.M.PL+IMPF+1+SG
desnutria-os	desnutrir+V.ele.ACC.3.M.PL+IMPF+3+SG
desnutri-as	desnutrir+V.ele.ACC.3.F.PL+PRF+1+SG
desnutria-se	desnutrir+V.ele.REFL+IMPF+3+SG
desnutrias-lhe	desnutrir+V.ele.DAT.3.SG+IMPF+2+SG
desnutrias-lhes	desnutrir+V.ele.DAT.3.PL+IMPF+2+SG
desnutrias-me	desnutrir+V.eu.AD.1.SG+IMPF+2+SG
desnutrias-te	desnutrir+V.tu.AD.2.SG+IMPF+2+SG
desnutrias-vos	desnutrir+V.vós.AD.2.PL+IMPF+2+SG
desnutria-te	desnutrir+V.tu.AD.2.SG+IMPF+1+SG
desnutria-te	desnutrir+V.tu.AD.2.SG+IMPF+3+SG
desnutria-vos	desnutrir+V.vós.AD.2.PL+IMPF+1+SG
desnutria-vos	desnutrir+V.vós.AD.2.PL+IMPF+3+SG
desnutríei-la	desnutrir+V.ele.ACC.3.F.SG+IMPF+2+PL
desnutríei-las	desnutrir+V.ele.ACC.3.F.PL+IMPF+2+PL
desnutríei-lo	desnutrir+V.ele.ACC.3.M.SG+IMPF+2+PL
desnutríei-los	desnutrir+V.ele.ACC.3.M.PL+IMPF+2+PL
desnutríei-nos	desnutrir+nós.AD.1.PL+IMPF+2+PL
desnutríeis-lhe	desnutrir+V.ele.DAT.3.SG+IMPF+2+PL
desnutríeis-lhes	desnutrir+V.ele.DAT.3.PL+IMPF+2+PL
desnutríeis-me	desnutrir+V.eu.AD.1.SG+IMPF+2+PL
desnutríeis-te	desnutrir+V.tu.AD.2.SG+IMPF+2+PL
desnutríeis-vos	desnutrir+V.vós.AD.2.PL+IMPF+2+PL
desnutri-la-á	desnutrir+V.ele.ACC.3.F.SG+FUT+3+SG
desnutri-la-ão	desnutrir+V.ele.ACC.3.F.SG+FUT+3+PL
desnutri-la-ás	desnutrir+V.ele.ACC.3.F.SG+FUT+2+SG
desnutri-la	desnutrir+V.ele.ACC.3.F.SG+INF+1+SG
desnutri-la	desnutrir+V.ele.ACC.3.F.SG+INF+3+SG
desnutri-la	desnutrir+V.ele.ACC.3.F.SG+SBJF+1+SG
desnutri-la	desnutrir+V.ele.ACC.3.F.SG+SBJF+3+SG
desnutri-la-ei	desnutrir+V.ele.ACC.3.F.SG+FUT+1+SG
desnutri-la-eis	desnutrir+V.ele.ACC.3.F.SG+FUT+2+PL
desnutri-la-emos	desnutrir+V.ele.ACC.3.F.SG+FUT+1+PL
desnutri-la-ia	desnutrir+V.ele.ACC.3.F.SG+COND+1+SG
desnutri-la-ia	desnutrir+V.ele.ACC.3.F.SG+COND+3+SG
desnutri-la-iam	desnutrir+V.ele.ACC.3.F.SG+COND+3+PL
desnutri-la-íamos	desnutrir+V.ele.ACC.3.F.SG+COND+1+PL
desnutri-la-ias	desnutrir+V.ele.ACC.3.F.SG+COND+2+SG
desnutri-la-íeis	desnutrir+V.ele.ACC.3.F.SG+COND+2+PL
desnutri-las-á	desnutrir+V.ele.ACC.3.F.PL+FUT+3+SG
desnutri-las-ão	desnutrir+V.ele.ACC.3.F.PL+FUT+3+PL
desnutri-las-ás	desnutrir+V.ele.ACC.3.F.PL+FUT+2+SG
desnutri-las	desnutrir+V.ele.ACC.3.F.PL+INF+1+SG
desnutri-las	desnutrir+V.ele.ACC.3.F.PL+INF+3+SG
desnutri-las	desnutrir+V.ele.ACC.3.F.PL+SBJF+1+SG
desnutri-las	desnutrir+V.ele.ACC.3.F.PL+SBJF+3+SG
desnutri-las-ei	desnutrir+V.ele.ACC.3.F.PL+FUT+1+SG
desnutri-las-eis	desnutrir+V.ele.ACC.3.F.PL+FUT+2+PL
desnutri-las-emos	desnutrir+V.ele.ACC.3.F.PL+FUT+1+PL
desnutri-las-ia	desnutrir+V.ele.ACC.3.F.PL+COND+1+SG
desnutri-las-ia	desnutrir+V.ele.ACC.3.F.PL+COND+3+SG
desnutri-las-iam	desnutrir+V.ele.ACC.3.F.PL+COND+3+PL
desnutri-las-íamos	desnutrir+V.ele.ACC.3.F.PL+COND+1+PL
desnutri-las-ias	desnutrir+V.ele.ACC.3.F.PL+COND+2+SG
desnutri-las-íeis	desnutrir+V.ele.ACC.3.F.PL+COND+2+PL
desnutri-lhe	desnutrir+V.ele.DAT.3.SG+PRF+1+SG
desnutri-lhes	desnutrir+V.ele.DAT.3.PL+PRF+1+SG
desnutri-lo-á	desnutrir+V.ele.ACC.3.M.SG+FUT+3+SG
desnutri-lo-ão	desnutrir+V.ele.ACC.3.M.SG+FUT+3+PL
desnutri-lo-ás	desnutrir+V.ele.ACC.3.M.SG+FUT+2+SG
desnutri-lo	desnutrir+V.ele.ACC.3.M.SG+INF+1+SG
desnutri-lo	desnutrir+V.ele.ACC.3.M.SG+INF+3+SG
desnutri-lo	desnutrir+V.ele.ACC.3.M.SG+SBJF+1+SG
desnutri-lo	desnutrir+V.ele.ACC.3.M.SG+SBJF+3+SG
desnutri-lo-ei	desnutrir+V.ele.ACC.3.M.SG+FUT+1+SG
desnutri-lo-eis	desnutrir+V.ele.ACC.3.M.SG+FUT+2+PL
desnutri-lo-emos	desnutrir+V.ele.ACC.3.M.SG+FUT+1+PL
desnutri-lo-ia	desnutrir+V.ele.ACC.3.M.SG+COND+1+SG
desnutri-lo-ia	desnutrir+V.ele.ACC.3.M.SG+COND+3+SG
desnutri-lo-iam	desnutrir+V.ele.ACC.3.M.SG+COND+3+PL
desnutri-lo-íamos	desnutrir+V.ele.ACC.3.M.SG+COND+1+PL
desnutri-lo-ias	desnutrir+V.ele.ACC.3.M.SG+COND+2+SG
desnutri-lo-íeis	desnutrir+V.ele.ACC.3.M.SG+COND+2+PL
desnutri-los-á	desnutrir+V.ele.ACC.3.M.PL+FUT+3+SG
desnutri-los-ão	desnutrir+V.ele.ACC.3.M.PL+FUT+3+PL
desnutri-los-ás	desnutrir+V.ele.ACC.3.M.PL+FUT+2+SG
desnutri-los	desnutrir+V.ele.ACC.3.M.PL+INF+1+SG
desnutri-los	desnutrir+V.ele.ACC.3.M.PL+INF+3+SG
desnutri-los	desnutrir+V.ele.ACC.3.M.PL+SBJF+1+SG
desnutri-los	desnutrir+V.ele.ACC.3.M.PL+SBJF+3+SG
desnutri-los-ei	desnutrir+V.ele.ACC.3.M.PL+FUT+1+SG
desnutri-los-eis	desnutrir+V.ele.ACC.3.M.PL+FUT+2+PL
desnutri-los-emos	desnutrir+V.ele.ACC.3.M.PL+FUT+1+PL
desnutri-los-ia	desnutrir+V.ele.ACC.3.M.PL+COND+1+SG
desnutri-los-ia	desnutrir+V.ele.ACC.3.M.PL+COND+3+SG
desnutri-los-iam	desnutrir+V.ele.ACC.3.M.PL+COND+3+PL
desnutri-los-íamos	desnutrir+V.ele.ACC.3.M.PL+COND+1+PL
desnutri-los-ias	desnutrir+V.ele.ACC.3.M.PL+COND+2+SG
desnutri-los-íeis	desnutrir+V.ele.ACC.3.M.PL+COND+2+PL
desnutri-me	desnutrir+V.eu.AD.1.SG+PRF+1+SG
desnutrimo-la	desnutrir+V.ele.ACC.3.F.SG+PRF+1+PL
desnutrimo-las	desnutrir+V.ele.ACC.3.F.PL+PRF+1+PL
desnutrimo-lo	desnutrir+V.ele.ACC.3.M.SG+PRF+1+PL
desnutrimo-los	desnutrir+V.ele.ACC.3.M.PL+PRF+1+PL
desnutrimo-nos	desnutrir+nós.AD.1.PL+PRF+1+PL
desnutrimos-lhe	desnutrir+V.ele.DAT.3.SG+PRF+1+PL
desnutrimos-lhes	desnutrir+V.ele.DAT.3.PL+PRF+1+PL
desnutrimos-me	desnutrir+V.eu.AD.1.SG+PRF+1+PL
desnutrimos-te	desnutrir+V.tu.AD.2.SG+PRF+1+PL
desnutrimos-vos	desnutrir+V.vós.AD.2.PL+PRF+1+PL
desnutrindo-a	desnutrir+V.ele.ACC.3.F.SG+GRD
desnutrindo-as	desnutrir+V.ele.ACC.3.F.PL+GRD
desnutrindo-lhe	desnutrir+V.ele.DAT.3.SG+GRD
desnutrindo-lhes	desnutrir+V.ele.DAT.3.PL+GRD
desnutrindo-me	desnutrir+V.eu.AD.1.SG+GRD
desnutrindo-nos	desnutrir+nós.AD.1.PL+GRD
desnutrindo-o	desnutrir+V.ele.ACC.3.M.SG+GRD
desnutrindo-os	desnutrir+V.ele.ACC.3.M.PL+GRD
desnutrindo-se	desnutrir+V.ele.REFL+GRD
desnutrindo-te	desnutrir+V.tu.AD.2.SG+GRD
desnutrindo-vos	desnutrir+V.vós.AD.2.PL+GRD
desnutri-nos	desnutrir+nós.AD.1.PL+PRF+1+SG
desnutri-o	desnutrir+V.ele.ACC.3.M.SG+PRF+1+SG
desnutri-os	desnutrir+V.ele.ACC.3.M.PL+PRF+1+SG
desnutriram-lhe	desnutrir+V.ele.DAT.3.SG+PRF+3+PL
desnutriram-lhes	desnutrir+V.ele.DAT.3.PL+PRF+3+PL
desnutriram-me	desnutrir+V.eu.AD.1.SG+PRF+3+PL
desnutriram-na	desnutrir+V.ele.ACC.3.F.SG+PRF+3+PL
desnutriram-nas	desnutrir+V.ele.ACC.3.F.PL+PRF+3+PL
desnutriram-no	desnutrir+V.ele.ACC.3.M.SG+PRF+3+PL
desnutriram-nos	desnutrir+V.ele.ACC.3.M.PL+PRF+3+PL
desnutriram-nos	desnutrir+V.nós.AD.1.PL+PRF+3+PL
desnutriram-se	desnutrir+V.ele.REFL+PRF+3+PL
desnutriram-te	desnutrir+V.tu.AD.2.SG+PRF+3+PL
desnutriram-vos	desnutrir+V.vós.AD.2.PL+PRF+3+PL
desnutrirde-la	desnutrir+V.ele.ACC.3.F.SG+INF+2+PL
desnutrirde-la	desnutrir+V.ele.ACC.3.F.SG+SBJF+2+PL
desnutrirde-las	desnutrir+V.ele.ACC.3.F.PL+INF+2+PL
desnutrirde-las	desnutrir+V.ele.ACC.3.F.PL+SBJF+2+PL
desnutrirde-lo	desnutrir+V.ele.ACC.3.M.SG+INF+2+PL
desnutrirde-lo	desnutrir+V.ele.ACC.3.M.SG+SBJF+2+PL
desnutrirde-los	desnutrir+V.ele.ACC.3.M.PL+INF+2+PL
desnutrirde-los	desnutrir+V.ele.ACC.3.M.PL+SBJF+2+PL
desnutrirde-nos	desnutrir+nós.AD.1.PL+INF+2+PL
desnutrirde-nos	desnutrir+nós.AD.1.PL+SBJF+2+PL
desnutrirdes-lhe	desnutrir+V.ele.DAT.3.SG+INF+2+PL
desnutrirdes-lhe	desnutrir+V.ele.DAT.3.SG+SBJF+2+PL
desnutrirdes-lhes	desnutrir+V.ele.DAT.3.PL+INF+2+PL
desnutrirdes-lhes	desnutrir+V.ele.DAT.3.PL+SBJF+2+PL
desnutrirdes-me	desnutrir+V.eu.AD.1.SG+INF+2+PL
desnutrirdes-me	desnutrir+V.eu.AD.1.SG+SBJF+2+PL
desnutrirdes-te	desnutrir+V.tu.AD.2.SG+INF+2+PL
desnutrirdes-te	desnutrir+V.tu.AD.2.SG+SBJF+2+PL
desnutrirdes-vos	desnutrir+V.vós.AD.2.PL+INF+2+PL
desnutrirdes-vos	desnutrir+V.vós.AD.2.PL+SBJF+2+PL
desnutrire-la	desnutrir+V.ele.ACC.3.F.SG+INF+2+SG
desnutrire-la	desnutrir+V.ele.ACC.3.F.SG+SBJF+2+SG
desnutrire-las	desnutrir+V.ele.ACC.3.F.PL+INF+2+SG
desnutrire-las	desnutrir+V.ele.ACC.3.F.PL+SBJF+2+SG
desnutrire-lo	desnutrir+V.ele.ACC.3.M.SG+INF+2+SG
desnutrire-lo	desnutrir+V.ele.ACC.3.M.SG+SBJF+2+SG
desnutrire-los	desnutrir+V.ele.ACC.3.M.PL+INF+2+SG
desnutrire-los	desnutrir+V.ele.ACC.3.M.PL+SBJF+2+SG
desnutrirem-lhe	desnutrir+V.ele.DAT.3.SG+INF+3+PL
desnutrirem-lhe	desnutrir+V.ele.DAT.3.SG+SBJF+3+PL
desnutrirem-lhes	desnutrir+V.ele.DAT.3.PL+INF+3+PL
desnutrirem-lhes	desnutrir+V.ele.DAT.3.PL+SBJF+3+PL
desnutrirem-me	desnutrir+V.eu.AD.1.SG+INF+3+PL
desnutrirem-me	desnutrir+V.eu.AD.1.SG+SBJF+3+PL
desnutrirem-na	desnutrir+V.ele.ACC.3.F.SG+INF+3+PL
desnutrirem-na	desnutrir+V.ele.ACC.3.F.SG+SBJF+3+PL
desnutrirem-nas	desnutrir+V.ele.ACC.3.F.PL+INF+3+PL
desnutrirem-nas	desnutrir+V.ele.ACC.3.F.PL+SBJF+3+PL
desnutrirem-no	desnutrir+V.ele.ACC.3.M.SG+INF+3+PL
desnutrirem-no	desnutrir+V.ele.ACC.3.M.SG+SBJF+3+PL
desnutrirem-nos	desnutrir+V.ele.ACC.3.M.PL+INF+3+PL
desnutrirem-nos	desnutrir+V.ele.ACC.3.M.PL+SBJF+3+PL
desnutrirem-nos	desnutrir+V.nós.AD.1.PL+INF+3+PL
desnutrirem-nos	desnutrir+V.nós.AD.1.PL+SBJF+3+PL
desnutrirem-se	desnutrir+V.ele.REFL+INF+3+PL
desnutrirem-se	desnutrir+V.ele.REFL+SBJF+3+PL
desnutrirem-te	desnutrir+V.tu.AD.2.SG+INF+3+PL
desnutrirem-te	desnutrir+V.tu.AD.2.SG+SBJF+3+PL
desnutrirem-vos	desnutrir+V.vós.AD.2.PL+INF+3+PL
desnutrirem-vos	desnutrir+V.vós.AD.2.PL+SBJF+3+PL
desnutrire-nos	desnutrir+nós.AD.1.PL+INF+2+SG
desnutrire-nos	desnutrir+nós.AD.1.PL+SBJF+2+SG
desnutrires-lhe	desnutrir+V.ele.DAT.3.SG+INF+2+SG
desnutrires-lhe	desnutrir+V.ele.DAT.3.SG+SBJF+2+SG
desnutrires-lhes	desnutrir+V.ele.DAT.3.PL+INF+2+SG
desnutrires-lhes	desnutrir+V.ele.DAT.3.PL+SBJF+2+SG
desnutrires-me	desnutrir+V.eu.AD.1.SG+INF+2+SG
desnutrires-me	desnutrir+V.eu.AD.1.SG+SBJF+2+SG
desnutrires-te	desnutrir+V.tu.AD.2.SG+INF+2+SG
desnutrires-te	desnutrir+V.tu.AD.2.SG+SBJF+2+SG
desnutrires-vos	desnutrir+V.vós.AD.2.PL+INF+2+SG
desnutrires-vos	desnutrir+V.vós.AD.2.PL+SBJF+2+SG
desnutrir-lhe-á	desnutrir+V.ele.DAT.3.SG+FUT+3+SG
desnutrir-lhe-ão	desnutrir+V.ele.DAT.3.SG+FUT+3+PL
desnutrir-lhe-ás	desnutrir+V.ele.DAT.3.SG+FUT+2+SG
desnutrir-lhe	desnutrir+V.ele.DAT.3.SG+INF
desnutrir-lhe	desnutrir+V.ele.DAT.3.SG+INF+1+SG
desnutrir-lhe	desnutrir+V.ele.DAT.3.SG+INF+3+SG
desnutrir-lhe	desnutrir+V.ele.DAT.3.SG+SBJF+1+SG
desnutrir-lhe	desnutrir+V.ele.DAT.3.SG+SBJF+3+SG
desnutrir-lhe-ei	desnutrir+V.ele.DAT.3.SG+FUT+1+SG
desnutrir-lhe-eis	desnutrir+V.ele.DAT.3.SG+FUT+2+PL
desnutrir-lhe-emos	desnutrir+V.ele.DAT.3.SG+FUT+1+PL
desnutrir-lhe-ia	desnutrir+V.ele.DAT.3.SG+COND+1+SG
desnutrir-lhe-ia	desnutrir+V.ele.DAT.3.SG+COND+3+SG
desnutrir-lhe-iam	desnutrir+V.ele.DAT.3.SG+COND+3+PL
desnutrir-lhe-íamos	desnutrir+V.ele.DAT.3.SG+COND+1+PL
desnutrir-lhe-ias	desnutrir+V.ele.DAT.3.SG+COND+2+SG
desnutrir-lhe-íeis	desnutrir+V.ele.DAT.3.SG+COND+2+PL
desnutrir-lhes-á	desnutrir+V.ele.DAT.3.PL+FUT+3+SG
desnutrir-lhes-ão	desnutrir+V.ele.DAT.3.PL+FUT+3+PL
desnutrir-lhes-ás	desnutrir+V.ele.DAT.3.PL+FUT+2+SG
desnutrir-lhes	desnutrir+V.ele.DAT.3.PL+INF
desnutrir-lhes	desnutrir+V.ele.DAT.3.PL+INF+1+SG
desnutrir-lhes	desnutrir+V.ele.DAT.3.PL+INF+3+SG
desnutrir-lhes	desnutrir+V.ele.DAT.3.PL+SBJF+1+SG
desnutrir-lhes	desnutrir+V.ele.DAT.3.PL+SBJF+3+SG
desnutrir-lhes-ei	desnutrir+V.ele.DAT.3.PL+FUT+1+SG
desnutrir-lhes-eis	desnutrir+V.ele.DAT.3.PL+FUT+2+PL
desnutrir-lhes-emos	desnutrir+V.ele.DAT.3.PL+FUT+1+PL
desnutrir-lhes-ia	desnutrir+V.ele.DAT.3.PL+COND+1+SG
desnutrir-lhes-ia	desnutrir+V.ele.DAT.3.PL+COND+3+SG
desnutrir-lhes-iam	desnutrir+V.ele.DAT.3.PL+COND+3+PL
desnutrir-lhes-íamos	desnutrir+V.ele.DAT.3.PL+COND+1+PL
desnutrir-lhes-ias	desnutrir+V.ele.DAT.3.PL+COND+2+SG
desnutrir-lhes-íeis	desnutrir+V.ele.DAT.3.PL+COND+2+PL
desnutrir-me-á	desnutrir+V.eu.AD.1.SG+FUT+3+SG
desnutrir-me-ão	desnutrir+V.eu.AD.1.SG+FUT+3+PL
desnutrir-me-ás	desnutrir+V.eu.AD.1.SG+FUT+2+SG
desnutrir-me	desnutrir+V.eu.AD.1.SG+INF
desnutrir-me	desnutrir+V.eu.AD.1.SG+INF+1+SG
desnutrir-me	desnutrir+V.eu.AD.1.SG+INF+3+SG
desnutrir-me	desnutrir+V.eu.AD.1.SG+SBJF+1+SG
desnutrir-me	desnutrir+V.eu.AD.1.SG+SBJF+3+SG
desnutrir-me-ei	desnutrir+V.eu.AD.1.SG+FUT+1+SG
desnutrir-me-eis	desnutrir+V.eu.AD.1.SG+FUT+2+PL
desnutrir-me-emos	desnutrir+V.eu.AD.1.SG+FUT+1+PL
desnutrir-me-ia	desnutrir+V.eu.AD.1.SG+COND+1+SG
desnutrir-me-ia	desnutrir+V.eu.AD.1.SG+COND+3+SG
desnutrir-me-iam	desnutrir+V.eu.AD.1.SG+COND+3+PL
desnutrir-me-íamos	desnutrir+V.eu.AD.1.SG+COND+1+PL
desnutrir-me-ias	desnutrir+V.eu.AD.1.SG+COND+2+SG
desnutrir-me-íeis	desnutrir+V.eu.AD.1.SG+COND+2+PL
desnutrirmo-la	desnutrir+V.ele.ACC.3.F.SG+INF+1+PL
desnutrirmo-la	desnutrir+V.ele.ACC.3.F.SG+SBJF+1+PL
desnutrirmo-las	desnutrir+V.ele.ACC.3.F.PL+INF+1+PL
desnutrirmo-las	desnutrir+V.ele.ACC.3.F.PL+SBJF+1+PL
desnutrirmo-lo	desnutrir+V.ele.ACC.3.M.SG+INF+1+PL
desnutrirmo-lo	desnutrir+V.ele.ACC.3.M.SG+SBJF+1+PL
desnutrirmo-los	desnutrir+V.ele.ACC.3.M.PL+INF+1+PL
desnutrirmo-los	desnutrir+V.ele.ACC.3.M.PL+SBJF+1+PL
desnutrirmo-nos	desnutrir+nós.AD.1.PL+INF+1+PL
desnutrirmo-nos	desnutrir+nós.AD.1.PL+SBJF+1+PL
desnutrirmos-lhe	desnutrir+V.ele.DAT.3.SG+INF+1+PL
desnutrirmos-lhe	desnutrir+V.ele.DAT.3.SG+SBJF+1+PL
desnutrirmos-lhes	desnutrir+V.ele.DAT.3.PL+INF+1+PL
desnutrirmos-lhes	desnutrir+V.ele.DAT.3.PL+SBJF+1+PL
desnutrirmos-me	desnutrir+V.eu.AD.1.SG+INF+1+PL
desnutrirmos-me	desnutrir+V.eu.AD.1.SG+SBJF+1+PL
desnutrirmos-te	desnutrir+V.tu.AD.2.SG+INF+1+PL
desnutrirmos-te	desnutrir+V.tu.AD.2.SG+SBJF+1+PL
desnutrirmos-vos	desnutrir+V.vós.AD.2.PL+INF+1+PL
desnutrirmos-vos	desnutrir+V.vós.AD.2.PL+SBJF+1+PL
desnutrir-nos-á	desnutrir+nós.AD.1.PL+FUT+3+SG
desnutrir-nos-ão	desnutrir+nós.AD.1.PL+FUT+3+PL
desnutrir-nos-ás	desnutrir+nós.AD.1.PL+FUT+2+SG
desnutrir-nos	desnutrir+nós.AD.1.PL+INF
desnutrir-nos	desnutrir+nós.AD.1.PL+INF+1+SG
desnutrir-nos	desnutrir+nós.AD.1.PL+INF+3+SG
desnutrir-nos	desnutrir+nós.AD.1.PL+SBJF+1+SG
desnutrir-nos	desnutrir+nós.AD.1.PL+SBJF+3+SG
desnutrir-nos-ei	desnutrir+nós.AD.1.PL+FUT+1+SG
desnutrir-nos-eis	desnutrir+nós.AD.1.PL+FUT+2+PL
desnutrir-nos-emos	desnutrir+nós.AD.1.PL+FUT+1+PL
desnutrir-nos-ia	desnutrir+nós.AD.1.PL+COND+1+SG
desnutrir-nos-ia	desnutrir+nós.AD.1.PL+COND+3+SG
desnutrir-nos-iam	desnutrir+nós.AD.1.PL+COND+3+PL
desnutrir-nos-íamos	desnutrir+nós.AD.1.PL+COND+1+PL
desnutrir-nos-ias	desnutrir+nós.AD.1.PL+COND+2+SG
desnutrir-nos-íeis	desnutrir+nós.AD.1.PL+COND+2+PL
desnutrir-se-á	desnutrir+V.ele.REFL+FUT+3+SG
desnutrir-se-ão	desnutrir+V.ele.REFL+FUT+3+PL
desnutrir-se	desnutrir+V.ele.REFL+INF
desnutrir-se	desnutrir+V.ele.REFL+INF+3+SG
desnutrir-se	desnutrir+V.ele.REFL+SBJF+3+SG
desnutrir-se-ia	desnutrir+V.ele.REFL+COND+3+SG
desnutrir-se-iam	desnutrir+V.ele.REFL+COND+3+PL
desnutrir-te-á	desnutrir+V.tu.AD.2.SG+FUT+3+SG
desnutrir-te-ão	desnutrir+V.tu.AD.2.SG+FUT+3+PL
desnutrir-te-ás	desnutrir+V.tu.AD.2.SG+FUT+2+SG
desnutrir-te	desnutrir+V.tu.AD.2.SG+INF
desnutrir-te	desnutrir+V.tu.AD.2.SG+INF+1+SG
desnutrir-te	desnutrir+V.tu.AD.2.SG+INF+3+SG
desnutrir-te	desnutrir+V.tu.AD.2.SG+SBJF+1+SG
desnutrir-te	desnutrir+V.tu.AD.2.SG+SBJF+3+SG
desnutrir-te-ei	desnutrir+V.tu.AD.2.SG+FUT+1+SG
desnutrir-te-eis	desnutrir+V.tu.AD.2.SG+FUT+2+PL
desnutrir-te-emos	desnutrir+V.tu.AD.2.SG+FUT+1+PL
desnutrir-te-ia	desnutrir+V.tu.AD.2.SG+COND+1+SG
desnutrir-te-ia	desnutrir+V.tu.AD.2.SG+COND+3+SG
desnutrir-te-iam	desnutrir+V.tu.AD.2.SG+COND+3+PL
desnutrir-te-íamos	desnutrir+V.tu.AD.2.SG+COND+1+PL
desnutrir-te-ias	desnutrir+V.tu.AD.2.SG+COND+2+SG
desnutrir-te-íeis	desnutrir+V.tu.AD.2.SG+COND+2+PL
desnutrir-vos-á	desnutrir+V.vós.AD.2.PL+FUT+3+SG
desnutrir-vos-ão	desnutrir+V.vós.AD.2.PL+FUT+3+PL
desnutrir-vos-ás	desnutrir+V.vós.AD.2.PL+FUT+2+SG
desnutrir-vos	desnutrir+V.vós.AD.2.PL+INF
desnutrir-vos	desnutrir+V.vós.AD.2.PL+INF+1+SG
desnutrir-vos	desnutrir+V.vós.AD.2.PL+INF+3+SG
desnutrir-vos	desnutrir+V.vós.AD.2.PL+SBJF+1+SG
desnutrir-vos	desnutrir+V.vós.AD.2.PL+SBJF+3+SG
desnutrir-vos-ei	desnutrir+V.vós.AD.2.PL+FUT+1+SG
desnutrir-vos-eis	desnutrir+V.vós.AD.2.PL+FUT+2+PL
desnutrir-vos-emos	desnutrir+V.vós.AD.2.PL+FUT+1+PL
desnutrir-vos-ia	desnutrir+V.vós.AD.2.PL+COND+1+SG
desnutrir-vos-ia	desnutrir+V.vós.AD.2.PL+COND+3+SG
desnutrir-vos-iam	desnutrir+V.vós.AD.2.PL+COND+3+PL
desnutrir-vos-íamos	desnutrir+V.vós.AD.2.PL+COND+1+PL
desnutrir-vos-ias	desnutrir+V.vós.AD.2.PL+COND+2+SG
desnutrir-vos-íeis	desnutrir+V.vós.AD.2.PL+COND+2+PL
desnutriste-a	desnutrir+V.ele.ACC.3.F.SG+PRF+2+SG
desnutriste-as	desnutrir+V.ele.ACC.3.F.PL+PRF+2+SG
desnutriste-la	desnutrir+V.ele.ACC.3.F.SG+PRF+2+PL
desnutriste-las	desnutrir+V.ele.ACC.3.F.PL+PRF+2+PL
desnutriste-lhe	desnutrir+V.ele.DAT.3.SG+PRF+2+SG
desnutriste-lhes	desnutrir+V.ele.DAT.3.PL+PRF+2+SG
desnutriste-lo	desnutrir+V.ele.ACC.3.M.SG+PRF+2+PL
desnutriste-los	desnutrir+V.ele.ACC.3.M.PL+PRF+2+PL
desnutriste-me	desnutrir+V.eu.AD.1.SG+PRF+2+SG
desnutriste-nos	desnutrir+nós.AD.1.PL+PRF+2+PL
desnutriste-nos	desnutrir+nós.AD.1.PL+PRF+2+SG
desnutriste-o	desnutrir+V.ele.ACC.3.M.SG+PRF+2+SG
desnutriste-os	desnutrir+V.ele.ACC.3.M.PL+PRF+2+SG
desnutristes-lhe	desnutrir+V.ele.DAT.3.SG+PRF+2+PL
desnutristes-lhes	desnutrir+V.ele.DAT.3.PL+PRF+2+PL
desnutristes-me	desnutrir+V.eu.AD.1.SG+PRF+2+PL
desnutristes-te	desnutrir+V.tu.AD.2.SG+PRF+2+PL
desnutristes-vos	desnutrir+V.vós.AD.2.PL+PRF+2+PL
desnutriste-te	desnutrir+V.tu.AD.2.SG+PRF+2+SG
desnutriste-vos	desnutrir+V.vós.AD.2.PL+PRF+2+SG
desnutri-te	desnutrir+V.tu.AD.2.SG+PRF+1+SG
desnutriu-a	desnutrir+V.ele.ACC.3.F.SG+PRF+3+SG
desnutriu-as	desnutrir+V.ele.ACC.3.F.PL+PRF+3+SG
desnutriu-lhe	desnutrir+V.ele.DAT.3.SG+PRF+3+SG
desnutriu-lhes	desnutrir+V.ele.DAT.3.PL+PRF+3+SG
desnutriu-me	desnutrir+V.eu.AD.1.SG+PRF+3+SG
desnutriu-nos	desnutrir+nós.AD.1.PL+PRF+3+SG
desnutriu-o	desnutrir+V.ele.ACC.3.M.SG+PRF+3+SG
desnutriu-os	desnutrir+V.ele.ACC.3.M.PL+PRF+3+SG
desnutriu-se	desnutrir+V.ele.REFL+PRF+3+SG
desnutriu-te	desnutrir+V.tu.AD.2.SG+PRF+3+SG
desnutriu-vos	desnutrir+V.vós.AD.2.PL+PRF+3+SG
desnutri-vos	desnutrir+V.vós.AD.2.PL+PRF+1+SG
desnuvia-a	desnuviar+V.ele.ACC.3.F.SG+PRS+3+SG
desnuvia-as	desnuviar+V.ele.ACC.3.F.PL+PRS+3+SG
desnuviai-la	desnuviar+V.ele.ACC.3.F.SG+PRS+2+PL
desnuviai-las	desnuviar+V.ele.ACC.3.F.PL+PRS+2+PL
desnuviai-lo	desnuviar+V.ele.ACC.3.M.SG+PRS+2+PL
desnuviai-los	desnuviar+V.ele.ACC.3.M.PL+PRS+2+PL
desnuviai-nos	desnuviar+nós.AD.1.PL+PRS+2+PL
desnuviais-lhe	desnuviar+V.ele.DAT.3.SG+PRS+2+PL
desnuviais-lhes	desnuviar+V.ele.DAT.3.PL+PRS+2+PL
desnuviais-me	desnuviar+V.eu.AD.1.SG+PRS+2+PL
desnuviais-te	desnuviar+V.tu.AD.2.SG+PRS+2+PL
desnuviais-vos	desnuviar+V.vós.AD.2.PL+PRS+2+PL
desnuviá-la-á	desnuviar+V.ele.ACC.3.F.SG+FUT+3+SG
desnuviá-la-ão	desnuviar+V.ele.ACC.3.F.SG+FUT+3+PL
desnuviá-la-ás	desnuviar+V.ele.ACC.3.F.SG+FUT+2+SG
desnuviá-la	desnuviar+V.ele.ACC.3.F.SG+INF+1+SG
desnuviá-la	desnuviar+V.ele.ACC.3.F.SG+INF+3+SG
desnuvia-la	desnuviar+V.ele.ACC.3.F.SG+PRS+2+SG
desnuviá-la	desnuviar+V.ele.ACC.3.F.SG+SBJF+1+SG
desnuviá-la	desnuviar+V.ele.ACC.3.F.SG+SBJF+3+SG
desnuviá-la-ei	desnuviar+V.ele.ACC.3.F.SG+FUT+1+SG
desnuviá-la-eis	desnuviar+V.ele.ACC.3.F.SG+FUT+2+PL
desnuviá-la-emos	desnuviar+V.ele.ACC.3.F.SG+FUT+1+PL
desnuviá-la-ia	desnuviar+V.ele.ACC.3.F.SG+COND+1+SG
desnuviá-la-ia	desnuviar+V.ele.ACC.3.F.SG+COND+3+SG
desnuviá-la-iam	desnuviar+V.ele.ACC.3.F.SG+COND+3+PL
desnuviá-la-íamos	desnuviar+V.ele.ACC.3.F.SG+COND+1+PL
desnuviá-la-ias	desnuviar+V.ele.ACC.3.F.SG+COND+2+SG
desnuviá-la-íeis	desnuviar+V.ele.ACC.3.F.SG+COND+2+PL
desnuviá-las-á	desnuviar+V.ele.ACC.3.F.PL+FUT+3+SG
desnuviá-las-ão	desnuviar+V.ele.ACC.3.F.PL+FUT+3+PL
desnuviá-las-ás	desnuviar+V.ele.ACC.3.F.PL+FUT+2+SG
desnuviá-las	desnuviar+V.ele.ACC.3.F.PL+INF+1+SG
desnuviá-las	desnuviar+V.ele.ACC.3.F.PL+INF+3+SG
desnuvia-las	desnuviar+V.ele.ACC.3.F.PL+PRS+2+SG
desnuviá-las	desnuviar+V.ele.ACC.3.F.PL+SBJF+1+SG
desnuviá-las	desnuviar+V.ele.ACC.3.F.PL+SBJF+3+SG
desnuviá-las-ei	desnuviar+V.ele.ACC.3.F.PL+FUT+1+SG
desnuviá-las-eis	desnuviar+V.ele.ACC.3.F.PL+FUT+2+PL
desnuviá-las-emos	desnuviar+V.ele.ACC.3.F.PL+FUT+1+PL
desnuviá-las-ia	desnuviar+V.ele.ACC.3.F.PL+COND+1+SG
desnuviá-las-ia	desnuviar+V.ele.ACC.3.F.PL+COND+3+SG
desnuviá-las-iam	desnuviar+V.ele.ACC.3.F.PL+COND+3+PL
desnuviá-las-íamos	desnuviar+V.ele.ACC.3.F.PL+COND+1+PL
desnuviá-las-ias	desnuviar+V.ele.ACC.3.F.PL+COND+2+SG
desnuviá-las-íeis	desnuviar+V.ele.ACC.3.F.PL+COND+2+PL
desnuvia-lhe	desnuviar+V.ele.DAT.3.SG+PRS+3+SG
desnuvia-lhes	desnuviar+V.ele.DAT.3.PL+PRS+3+SG
desnuviá-lo-á	desnuviar+V.ele.ACC.3.M.SG+FUT+3+SG
desnuviá-lo-ão	desnuviar+V.ele.ACC.3.M.SG+FUT+3+PL
desnuviá-lo-ás	desnuviar+V.ele.ACC.3.M.SG+FUT+2+SG
desnuviá-lo	desnuviar+V.ele.ACC.3.M.SG+INF+1+SG
desnuviá-lo	desnuviar+V.ele.ACC.3.M.SG+INF+3+SG
desnuvia-lo	desnuviar+V.ele.ACC.3.M.SG+PRS+2+SG
desnuviá-lo	desnuviar+V.ele.ACC.3.M.SG+SBJF+1+SG
desnuviá-lo	desnuviar+V.ele.ACC.3.M.SG+SBJF+3+SG
desnuviá-lo-ei	desnuviar+V.ele.ACC.3.M.SG+FUT+1+SG
desnuviá-lo-eis	desnuviar+V.ele.ACC.3.M.SG+FUT+2+PL
desnuviá-lo-emos	desnuviar+V.ele.ACC.3.M.SG+FUT+1+PL
desnuviá-lo-ia	desnuviar+V.ele.ACC.3.M.SG+COND+1+SG
desnuviá-lo-ia	desnuviar+V.ele.ACC.3.M.SG+COND+3+SG
desnuviá-lo-iam	desnuviar+V.ele.ACC.3.M.SG+COND+3+PL
desnuviá-lo-íamos	desnuviar+V.ele.ACC.3.M.SG+COND+1+PL
desnuviá-lo-ias	desnuviar+V.ele.ACC.3.M.SG+COND+2+SG
desnuviá-lo-íeis	desnuviar+V.ele.ACC.3.M.SG+COND+2+PL
desnuviá-los-á	desnuviar+V.ele.ACC.3.M.PL+FUT+3+SG
desnuviá-los-ão	desnuviar+V.ele.ACC.3.M.PL+FUT+3+PL
desnuviá-los-ás	desnuviar+V.ele.ACC.3.M.PL+FUT+2+SG
desnuviá-los	desnuviar+V.ele.ACC.3.M.PL+INF+1+SG
desnuviá-los	desnuviar+V.ele.ACC.3.M.PL+INF+3+SG
desnuvia-los	desnuviar+V.ele.ACC.3.M.PL+PRS+2+SG
desnuviá-los	desnuviar+V.ele.ACC.3.M.PL+SBJF+1+SG
desnuviá-los	desnuviar+V.ele.ACC.3.M.PL+SBJF+3+SG
desnuviá-los-ei	desnuviar+V.ele.ACC.3.M.PL+FUT+1+SG
desnuviá-los-eis	desnuviar+V.ele.ACC.3.M.PL+FUT+2+PL
desnuviá-los-emos	desnuviar+V.ele.ACC.3.M.PL+FUT+1+PL
desnuviá-los-ia	desnuviar+V.ele.ACC.3.M.PL+COND+1+SG
desnuviá-los-ia	desnuviar+V.ele.ACC.3.M.PL+COND+3+SG
desnuviá-los-iam	desnuviar+V.ele.ACC.3.M.PL+COND+3+PL
desnuviá-los-íamos	desnuviar+V.ele.ACC.3.M.PL+COND+1+PL
desnuviá-los-ias	desnuviar+V.ele.ACC.3.M.PL+COND+2+SG
desnuviá-los-íeis	desnuviar+V.ele.ACC.3.M.PL+COND+2+PL
desnuvia-me	desnuviar+V.eu.AD.1.SG+PRS+3+SG
desnuviam-lhe	desnuviar+V.ele.DAT.3.SG+PRS+3+PL
desnuviam-lhes	desnuviar+V.ele.DAT.3.PL+PRS+3+PL
desnuviam-me	desnuviar+V.eu.AD.1.SG+PRS+3+PL
desnuviam-na	desnuviar+V.ele.ACC.3.F.SG+PRS+3+PL
desnuviam-nas	desnuviar+V.ele.ACC.3.F.PL+PRS+3+PL
desnuviam-no	desnuviar+V.ele.ACC.3.M.SG+PRS+3+PL
desnuviam-nos	desnuviar+V.ele.ACC.3.M.PL+PRS+3+PL
desnuviam-nos	desnuviar+V.nós.AD.1.PL+PRS+3+PL
desnuviamo-la	desnuviar+V.ele.ACC.3.F.SG+PRF+1+PL
desnuviamo-la	desnuviar+V.ele.ACC.3.F.SG+PRS+1+PL
desnuviamo-las	desnuviar+V.ele.ACC.3.F.PL+PRF+1+PL
desnuviamo-las	desnuviar+V.ele.ACC.3.F.PL+PRS+1+PL
desnuviamo-lo	desnuviar+V.ele.ACC.3.M.SG+PRF+1+PL
desnuviamo-lo	desnuviar+V.ele.ACC.3.M.SG+PRS+1+PL
desnuviamo-los	desnuviar+V.ele.ACC.3.M.PL+PRF+1+PL
desnuviamo-los	desnuviar+V.ele.ACC.3.M.PL+PRS+1+PL
desnuviamo-nos	desnuviar+nós.AD.1.PL+PRF+1+PL
desnuviamo-nos	desnuviar+nós.AD.1.PL+PRS+1+PL
desnuviamos-lhe	desnuviar+V.ele.DAT.3.SG+PRF+1+PL
desnuviamos-lhe	desnuviar+V.ele.DAT.3.SG+PRS+1+PL
desnuviamos-lhes	desnuviar+V.ele.DAT.3.PL+PRF+1+PL
desnuviamos-lhes	desnuviar+V.ele.DAT.3.PL+PRS+1+PL
desnuviamos-me	desnuviar+V.eu.AD.1.SG+PRF+1+PL
desnuviamos-me	desnuviar+V.eu.AD.1.SG+PRS+1+PL
desnuviamos-te	desnuviar+V.tu.AD.2.SG+PRF+1+PL
desnuviamos-te	desnuviar+V.tu.AD.2.SG+PRS+1+PL
desnuviamos-vos	desnuviar+V.vós.AD.2.PL+PRF+1+PL
desnuviamos-vos	desnuviar+V.vós.AD.2.PL+PRS+1+PL
desnuviam-se	desnuviar+V.ele.REFL+PRS+3+PL
desnuviam-te	desnuviar+V.tu.AD.2.SG+PRS+3+PL
desnuviam-vos	desnuviar+V.vós.AD.2.PL+PRS+3+PL
desnuviando-a	desnuviar+V.ele.ACC.3.F.SG+GRD
desnuviando-as	desnuviar+V.ele.ACC.3.F.PL+GRD
desnuviando-lhe	desnuviar+V.ele.DAT.3.SG+GRD
desnuviando-lhes	desnuviar+V.ele.DAT.3.PL+GRD
desnuviando-me	desnuviar+V.eu.AD.1.SG+GRD
desnuviando-nos	desnuviar+nós.AD.1.PL+GRD
desnuviando-o	desnuviar+V.ele.ACC.3.M.SG+GRD
desnuviando-os	desnuviar+V.ele.ACC.3.M.PL+GRD
desnuviando-se	desnuviar+V.ele.REFL+GRD
desnuviando-te	desnuviar+V.tu.AD.2.SG+GRD
desnuviando-vos	desnuviar+V.vós.AD.2.PL+GRD
desnuvia-nos	desnuviar+nós.AD.1.PL+PRS+2+SG
desnuvia-nos	desnuviar+nós.AD.1.PL+PRS+3+SG
desnuvia-o	desnuviar+V.ele.ACC.3.M.SG+PRS+3+SG
desnuvia-os	desnuviar+V.ele.ACC.3.M.PL+PRS+3+SG
desnuviara-a	desnuviar+V.ele.ACC.3.F.SG+PQP+1+SG
desnuviara-a	desnuviar+V.ele.ACC.3.F.SG+PQP+3+SG
desnuviara-as	desnuviar+V.ele.ACC.3.F.PL+PQP+1+SG
desnuviara-as	desnuviar+V.ele.ACC.3.F.PL+PQP+3+SG
desnuviara-la	desnuviar+V.ele.ACC.3.F.SG+PQP+2+SG
desnuviara-las	desnuviar+V.ele.ACC.3.F.PL+PQP+2+SG
desnuviara-lhe	desnuviar+V.ele.DAT.3.SG+PQP+1+SG
desnuviara-lhe	desnuviar+V.ele.DAT.3.SG+PQP+3+SG
desnuviara-lhes	desnuviar+V.ele.DAT.3.PL+PQP+1+SG
desnuviara-lhes	desnuviar+V.ele.DAT.3.PL+PQP+3+SG
desnuviara-lo	desnuviar+V.ele.ACC.3.M.SG+PQP+2+SG
desnuviara-los	desnuviar+V.ele.ACC.3.M.PL+PQP+2+SG
desnuviara-me	desnuviar+V.eu.AD.1.SG+PQP+1+SG
desnuviara-me	desnuviar+V.eu.AD.1.SG+PQP+3+SG
desnuviaram-lhe	desnuviar+V.ele.DAT.3.SG+PQP+3+PL
desnuviaram-lhe	desnuviar+V.ele.DAT.3.SG+PRF+3+PL
desnuviaram-lhes	desnuviar+V.ele.DAT.3.PL+PQP+3+PL
desnuviaram-lhes	desnuviar+V.ele.DAT.3.PL+PRF+3+PL
desnuviaram-me	desnuviar+V.eu.AD.1.SG+PQP+3+PL
desnuviaram-me	desnuviar+V.eu.AD.1.SG+PRF+3+PL
desnuviaram-na	desnuviar+V.ele.ACC.3.F.SG+PQP+3+PL
desnuviaram-na	desnuviar+V.ele.ACC.3.F.SG+PRF+3+PL
desnuviaram-nas	desnuviar+V.ele.ACC.3.F.PL+PQP+3+PL
desnuviaram-nas	desnuviar+V.ele.ACC.3.F.PL+PRF+3+PL
desnuviaram-no	desnuviar+V.ele.ACC.3.M.SG+PQP+3+PL
desnuviaram-no	desnuviar+V.ele.ACC.3.M.SG+PRF+3+PL
desnuviaram-nos	desnuviar+V.ele.ACC.3.M.PL+PQP+3+PL
desnuviaram-nos	desnuviar+V.ele.ACC.3.M.PL+PRF+3+PL
desnuviaram-nos	desnuviar+V.nós.AD.1.PL+PQP+3+PL
desnuviaram-nos	desnuviar+V.nós.AD.1.PL+PRF+3+PL
desnuviáramo-la	desnuviar+V.ele.ACC.3.F.SG+PQP+1+PL
desnuviáramo-las	desnuviar+V.ele.ACC.3.F.PL+PQP+1+PL
