despetrechar-vos	despetrechar+V.vós.AD.2.PL+INF
despetrechar-vos	despetrechar+V.vós.AD.2.PL+INF+1+SG
despetrechar-vos	despetrechar+V.vós.AD.2.PL+INF+3+SG
despetrechar-vos	despetrechar+V.vós.AD.2.PL+SBJF+1+SG
despetrechar-vos	despetrechar+V.vós.AD.2.PL+SBJF+3+SG
despetrechar-vos-ei	despetrechar+V.vós.AD.2.PL+FUT+1+SG
despetrechar-vos-eis	despetrechar+V.vós.AD.2.PL+FUT+2+PL
despetrechar-vos-emos	despetrechar+V.vós.AD.2.PL+FUT+1+PL
despetrechar-vos-ia	despetrechar+V.vós.AD.2.PL+COND+1+SG
despetrechar-vos-ia	despetrechar+V.vós.AD.2.PL+COND+3+SG
despetrechar-vos-iam	despetrechar+V.vós.AD.2.PL+COND+3+PL
despetrechar-vos-íamos	despetrechar+V.vós.AD.2.PL+COND+1+PL
despetrechar-vos-ias	despetrechar+V.vós.AD.2.PL+COND+2+SG
despetrechar-vos-íeis	despetrechar+V.vós.AD.2.PL+COND+2+PL
despetrecha-se	despetrechar+V.ele.REFL+PRS+3+SG
despetrechas-lhe	despetrechar+V.ele.DAT.3.SG+PRS+2+SG
despetrechas-lhes	despetrechar+V.ele.DAT.3.PL+PRS+2+SG
despetrechas-me	despetrechar+V.eu.AD.1.SG+PRS+2+SG
despetrechaste-a	despetrechar+V.ele.ACC.3.F.SG+PRF+2+SG
despetrechaste-as	despetrechar+V.ele.ACC.3.F.PL+PRF+2+SG
despetrechas-te	despetrechar+V.tu.AD.2.SG+PRS+2+SG
despetrechaste-la	despetrechar+V.ele.ACC.3.F.SG+PRF+2+PL
despetrechaste-las	despetrechar+V.ele.ACC.3.F.PL+PRF+2+PL
despetrechaste-lhe	despetrechar+V.ele.DAT.3.SG+PRF+2+SG
despetrechaste-lhes	despetrechar+V.ele.DAT.3.PL+PRF+2+SG
despetrechaste-lo	despetrechar+V.ele.ACC.3.M.SG+PRF+2+PL
despetrechaste-los	despetrechar+V.ele.ACC.3.M.PL+PRF+2+PL
despetrechaste-me	despetrechar+V.eu.AD.1.SG+PRF+2+SG
despetrechaste-nos	despetrechar+nós.AD.1.PL+PRF+2+PL
despetrechaste-nos	despetrechar+nós.AD.1.PL+PRF+2+SG
despetrechaste-o	despetrechar+V.ele.ACC.3.M.SG+PRF+2+SG
despetrechaste-os	despetrechar+V.ele.ACC.3.M.PL+PRF+2+SG
despetrechastes-lhe	despetrechar+V.ele.DAT.3.SG+PRF+2+PL
despetrechastes-lhes	despetrechar+V.ele.DAT.3.PL+PRF+2+PL
despetrechastes-me	despetrechar+V.eu.AD.1.SG+PRF+2+PL
despetrechastes-te	despetrechar+V.tu.AD.2.SG+PRF+2+PL
despetrechastes-vos	despetrechar+V.vós.AD.2.PL+PRF+2+PL
despetrechaste-te	despetrechar+V.tu.AD.2.SG+PRF+2+SG
despetrechaste-vos	despetrechar+V.vós.AD.2.PL+PRF+2+SG
despetrechas-vos	despetrechar+V.vós.AD.2.PL+PRS+2+SG
despetrecha-te	despetrechar+V.tu.AD.2.SG+PRS+3+SG
despetrechava-a	despetrechar+V.ele.ACC.3.F.SG+IMPF+1+SG
despetrechava-a	despetrechar+V.ele.ACC.3.F.SG+IMPF+3+SG
despetrechava-as	despetrechar+V.ele.ACC.3.F.PL+IMPF+1+SG
despetrechava-as	despetrechar+V.ele.ACC.3.F.PL+IMPF+3+SG
despetrechava-la	despetrechar+V.ele.ACC.3.F.SG+IMPF+2+SG
despetrechava-las	despetrechar+V.ele.ACC.3.F.PL+IMPF+2+SG
despetrechava-lhe	despetrechar+V.ele.DAT.3.SG+IMPF+1+SG
despetrechava-lhe	despetrechar+V.ele.DAT.3.SG+IMPF+3+SG
despetrechava-lhes	despetrechar+V.ele.DAT.3.PL+IMPF+1+SG
despetrechava-lhes	despetrechar+V.ele.DAT.3.PL+IMPF+3+SG
despetrechava-lo	despetrechar+V.ele.ACC.3.M.SG+IMPF+2+SG
despetrechava-los	despetrechar+V.ele.ACC.3.M.PL+IMPF+2+SG
despetrechava-me	despetrechar+V.eu.AD.1.SG+IMPF+1+SG
despetrechava-me	despetrechar+V.eu.AD.1.SG+IMPF+3+SG
despetrechavam-lhe	despetrechar+V.ele.DAT.3.SG+IMPF+3+PL
despetrechavam-lhes	despetrechar+V.ele.DAT.3.PL+IMPF+3+PL
despetrechavam-me	despetrechar+V.eu.AD.1.SG+IMPF+3+PL
despetrechavam-na	despetrechar+V.ele.ACC.3.F.SG+IMPF+3+PL
despetrechavam-nas	despetrechar+V.ele.ACC.3.F.PL+IMPF+3+PL
despetrechavam-no	despetrechar+V.ele.ACC.3.M.SG+IMPF+3+PL
despetrechavam-nos	despetrechar+V.ele.ACC.3.M.PL+IMPF+3+PL
despetrechavam-nos	despetrechar+V.nós.AD.1.PL+IMPF+3+PL
despetrechávamo-la	despetrechar+V.ele.ACC.3.F.SG+IMPF+1+PL
despetrechávamo-las	despetrechar+V.ele.ACC.3.F.PL+IMPF+1+PL
despetrechávamo-lo	despetrechar+V.ele.ACC.3.M.SG+IMPF+1+PL
despetrechávamo-los	despetrechar+V.ele.ACC.3.M.PL+IMPF+1+PL
despetrechávamo-nos	despetrechar+nós.AD.1.PL+IMPF+1+PL
despetrechávamos-lhe	despetrechar+V.ele.DAT.3.SG+IMPF+1+PL
despetrechávamos-lhes	despetrechar+V.ele.DAT.3.PL+IMPF+1+PL
despetrechávamos-me	despetrechar+V.eu.AD.1.SG+IMPF+1+PL
despetrechávamos-te	despetrechar+V.tu.AD.2.SG+IMPF+1+PL
despetrechávamos-vos	despetrechar+V.vós.AD.2.PL+IMPF+1+PL
despetrechavam-se	despetrechar+V.ele.REFL+IMPF+3+PL
despetrechavam-te	despetrechar+V.tu.AD.2.SG+IMPF+3+PL
despetrechavam-vos	despetrechar+V.vós.AD.2.PL+IMPF+3+PL
despetrechava-nos	despetrechar+nós.AD.1.PL+IMPF+1+SG
despetrechava-nos	despetrechar+nós.AD.1.PL+IMPF+2+SG
despetrechava-nos	despetrechar+nós.AD.1.PL+IMPF+3+SG
despetrechava-o	despetrechar+V.ele.ACC.3.M.SG+IMPF+1+SG
despetrechava-o	despetrechar+V.ele.ACC.3.M.SG+IMPF+3+SG
despetrechava-os	despetrechar+V.ele.ACC.3.M.PL+IMPF+1+SG
despetrechava-os	despetrechar+V.ele.ACC.3.M.PL+IMPF+3+SG
despetrechava-se	despetrechar+V.ele.REFL+IMPF+1+SG
despetrechava-se	despetrechar+V.ele.REFL+IMPF+3+SG
despetrechavas-lhe	despetrechar+V.ele.DAT.3.SG+IMPF+2+SG
despetrechavas-lhes	despetrechar+V.ele.DAT.3.PL+IMPF+2+SG
despetrechavas-me	despetrechar+V.eu.AD.1.SG+IMPF+2+SG
despetrechavas-te	despetrechar+V.tu.AD.2.SG+IMPF+2+SG
despetrechavas-vos	despetrechar+V.vós.AD.2.PL+IMPF+2+SG
despetrechava-te	despetrechar+V.tu.AD.2.SG+IMPF+1+SG
despetrechava-te	despetrechar+V.tu.AD.2.SG+IMPF+3+SG
despetrechava-vos	despetrechar+V.vós.AD.2.PL+IMPF+1+SG
despetrechava-vos	despetrechar+V.vós.AD.2.PL+IMPF+3+SG
despetrechávei-la	despetrechar+V.ele.ACC.3.F.SG+IMPF+2+PL
despetrechávei-las	despetrechar+V.ele.ACC.3.F.PL+IMPF+2+PL
despetrechávei-lo	despetrechar+V.ele.ACC.3.M.SG+IMPF+2+PL
despetrechávei-los	despetrechar+V.ele.ACC.3.M.PL+IMPF+2+PL
despetrechávei-nos	despetrechar+nós.AD.1.PL+IMPF+2+PL
despetrecháveis-lhe	despetrechar+V.ele.DAT.3.SG+IMPF+2+PL
despetrecháveis-lhes	despetrechar+V.ele.DAT.3.PL+IMPF+2+PL
despetrecháveis-me	despetrechar+V.eu.AD.1.SG+IMPF+2+PL
despetrecháveis-te	despetrechar+V.tu.AD.2.SG+IMPF+2+PL
despetrecháveis-vos	despetrechar+V.vós.AD.2.PL+IMPF+2+PL
despetrecha-vos	despetrechar+V.vós.AD.2.PL+PRS+3+SG
despetreche-a	despetrechar+V.ele.ACC.3.F.SG+IMP+3+SG
despetreche-as	despetrechar+V.ele.ACC.3.F.PL+IMP+3+SG
despetrechei-a	despetrechar+V.ele.ACC.3.F.SG+PRF+1+SG
despetrechei-as	despetrechar+V.ele.ACC.3.F.PL+PRF+1+SG
despetrechei-lhe	despetrechar+V.ele.DAT.3.SG+PRF+1+SG
despetrechei-lhes	despetrechar+V.ele.DAT.3.PL+PRF+1+SG
despetrechei-me	despetrechar+V.eu.AD.1.SG+PRF+1+SG
despetrechei-nos	despetrechar+nós.AD.1.PL+PRF+1+SG
despetrechei-o	despetrechar+V.ele.ACC.3.M.SG+PRF+1+SG
despetrechei-os	despetrechar+V.ele.ACC.3.M.PL+PRF+1+SG
despetrechei-te	despetrechar+V.tu.AD.2.SG+PRF+1+SG
despetrechei-vos	despetrechar+V.vós.AD.2.PL+PRF+1+SG
despetreche-lhe	despetrechar+V.ele.DAT.3.SG+IMP+3+SG
despetreche-lhes	despetrechar+V.ele.DAT.3.PL+IMP+3+SG
despetreche-me	despetrechar+V.eu.AD.1.SG+IMP+3+SG
despetrechem-lhe	despetrechar+V.ele.DAT.3.SG+IMP+3+PL
despetrechem-lhes	despetrechar+V.ele.DAT.3.PL+IMP+3+PL
despetrechem-me	despetrechar+V.eu.AD.1.SG+IMP+3+PL
despetrechem-na	despetrechar+V.ele.ACC.3.F.SG+IMP+3+PL
despetrechem-nas	despetrechar+V.ele.ACC.3.F.PL+IMP+3+PL
despetrechem-no	despetrechar+V.ele.ACC.3.M.SG+IMP+3+PL
despetrechem-nos	despetrechar+V.ele.ACC.3.M.PL+IMP+3+PL
despetrechem-nos	despetrechar+V.nós.AD.1.PL+IMP+3+PL
despetrechemo-la	despetrechar+V.ele.ACC.3.F.SG+IMP+1+PL
despetrechemo-las	despetrechar+V.ele.ACC.3.F.PL+IMP+1+PL
despetrechemo-lo	despetrechar+V.ele.ACC.3.M.SG+IMP+1+PL
despetrechemo-los	despetrechar+V.ele.ACC.3.M.PL+IMP+1+PL
despetrechemo-nos	despetrechar+nós.AD.1.PL+IMP+1+PL
despetrechemos-lhe	despetrechar+V.ele.DAT.3.SG+IMP+1+PL
despetrechemos-lhes	despetrechar+V.ele.DAT.3.PL+IMP+1+PL
despetrechemos-me	despetrechar+V.eu.AD.1.SG+IMP+1+PL
despetrechemos-te	despetrechar+V.tu.AD.2.SG+IMP+1+PL
despetrechemos-vos	despetrechar+V.vós.AD.2.PL+IMP+1+PL
despetrechem-se	despetrechar+V.ele.REFL+IMP+3+PL
despetrechem-te	despetrechar+V.tu.AD.2.SG+IMP+3+PL
despetrechem-vos	despetrechar+V.vós.AD.2.PL+IMP+3+PL
despetreche-nos	despetrechar+nós.AD.1.PL+IMP+3+SG
despetreche-o	despetrechar+V.ele.ACC.3.M.SG+IMP+3+SG
despetreche-os	despetrechar+V.ele.ACC.3.M.PL+IMP+3+SG
despetreche-se	despetrechar+V.ele.REFL+IMP+3+SG
despetreche-te	despetrechar+V.tu.AD.2.SG+IMP+3+SG
despetreche-vos	despetrechar+V.vós.AD.2.PL+IMP+3+SG
despetrecho-a	despetrechar+V.ele.ACC.3.F.SG+PRS+1+SG
despetrecho-as	despetrechar+V.ele.ACC.3.F.PL+PRS+1+SG
despetrecho-lhe	despetrechar+V.ele.DAT.3.SG+PRS+1+SG
despetrecho-lhes	despetrechar+V.ele.DAT.3.PL+PRS+1+SG
despetrecho-me	despetrechar+V.eu.AD.1.SG+PRS+1+SG
despetrecho-nos	despetrechar+nós.AD.1.PL+PRS+1+SG
despetrecho-o	despetrechar+V.ele.ACC.3.M.SG+PRS+1+SG
despetrecho-os	despetrechar+V.ele.ACC.3.M.PL+PRS+1+SG
despetrecho-te	despetrechar+V.tu.AD.2.SG+PRS+1+SG
despetrechou-a	despetrechar+V.ele.ACC.3.F.SG+PRF+3+SG
despetrechou-as	despetrechar+V.ele.ACC.3.F.PL+PRF+3+SG
despetrechou-lhe	despetrechar+V.ele.DAT.3.SG+PRF+3+SG
despetrechou-lhes	despetrechar+V.ele.DAT.3.PL+PRF+3+SG
despetrechou-me	despetrechar+V.eu.AD.1.SG+PRF+3+SG
despetrechou-nos	despetrechar+nós.AD.1.PL+PRF+3+SG
despetrechou-o	despetrechar+V.ele.ACC.3.M.SG+PRF+3+SG
despetrechou-os	despetrechar+V.ele.ACC.3.M.PL+PRF+3+SG
despetrechou-se	despetrechar+V.ele.REFL+PRF+3+SG
despetrechou-te	despetrechar+V.tu.AD.2.SG+PRF+3+SG
despetrechou-vos	despetrechar+V.vós.AD.2.PL+PRF+3+SG
despetrecho-vos	despetrechar+V.vós.AD.2.PL+PRS+1+SG
despe-vos	despir+V.vós.AD.2.PL+PRS+3+SG
despia-a	despir+V.ele.ACC.3.F.SG+IMPF+1+SG
despia-a	despir+V.ele.ACC.3.F.SG+IMPF+3+SG
despia-as	despir+V.ele.ACC.3.F.PL+IMPF+1+SG
despia-as	despir+V.ele.ACC.3.F.PL+IMPF+3+SG
despi-a	despir+V.ele.ACC.3.F.SG+PRF+1+SG
despia-la	despir+V.ele.ACC.3.F.SG+IMPF+2+SG
despia-las	despir+V.ele.ACC.3.F.PL+IMPF+2+SG
despia-lhe	despir+V.ele.DAT.3.SG+IMPF+1+SG
despia-lhe	despir+V.ele.DAT.3.SG+IMPF+3+SG
despia-lhes	despir+V.ele.DAT.3.PL+IMPF+1+SG
despia-lhes	despir+V.ele.DAT.3.PL+IMPF+3+SG
despia-lo	despir+V.ele.ACC.3.M.SG+IMPF+2+SG
despia-los	despir+V.ele.ACC.3.M.PL+IMPF+2+SG
despia-me	despir+V.eu.AD.1.SG+IMPF+1+SG
despia-me	despir+V.eu.AD.1.SG+IMPF+3+SG
despiam-lhe	despir+V.ele.DAT.3.SG+IMPF+3+PL
despiam-lhes	despir+V.ele.DAT.3.PL+IMPF+3+PL
despiam-me	despir+V.eu.AD.1.SG+IMPF+3+PL
despiam-na	despir+V.ele.ACC.3.F.SG+IMPF+3+PL
despiam-nas	despir+V.ele.ACC.3.F.PL+IMPF+3+PL
despiam-no	despir+V.ele.ACC.3.M.SG+IMPF+3+PL
despiam-nos	despir+V.ele.ACC.3.M.PL+IMPF+3+PL
despiam-nos	despir+V.nós.AD.1.PL+IMPF+3+PL
despíamo-la	despir+V.ele.ACC.3.F.SG+IMPF+1+PL
despíamo-las	despir+V.ele.ACC.3.F.PL+IMPF+1+PL
despíamo-lo	despir+V.ele.ACC.3.M.SG+IMPF+1+PL
despíamo-los	despir+V.ele.ACC.3.M.PL+IMPF+1+PL
despíamo-nos	despir+nós.AD.1.PL+IMPF+1+PL
despíamos-lhe	despir+V.ele.DAT.3.SG+IMPF+1+PL
despíamos-lhes	despir+V.ele.DAT.3.PL+IMPF+1+PL
despíamos-me	despir+V.eu.AD.1.SG+IMPF+1+PL
despíamos-te	despir+V.tu.AD.2.SG+IMPF+1+PL
despíamos-vos	despir+V.vós.AD.2.PL+IMPF+1+PL
despiam-se	despir+V.ele.REFL+IMPF+3+PL
despiam-te	despir+V.tu.AD.2.SG+IMPF+3+PL
despiam-vos	despir+V.vós.AD.2.PL+IMPF+3+PL
despia-nos	despir+nós.AD.1.PL+IMPF+1+SG
despia-nos	despir+nós.AD.1.PL+IMPF+2+SG
despia-nos	despir+nós.AD.1.PL+IMPF+3+SG
despia-o	despir+V.ele.ACC.3.M.SG+IMPF+1+SG
despia-o	despir+V.ele.ACC.3.M.SG+IMPF+3+SG
despia-os	despir+V.ele.ACC.3.M.PL+IMPF+1+SG
despia-os	despir+V.ele.ACC.3.M.PL+IMPF+3+SG
despi-as	despir+V.ele.ACC.3.F.PL+PRF+1+SG
despia-se	despir+V.ele.REFL+IMPF+3+SG
despias-lhe	despir+V.ele.DAT.3.SG+IMPF+2+SG
despias-lhes	despir+V.ele.DAT.3.PL+IMPF+2+SG
despias-me	despir+V.eu.AD.1.SG+IMPF+2+SG
despias-te	despir+V.tu.AD.2.SG+IMPF+2+SG
despias-vos	despir+V.vós.AD.2.PL+IMPF+2+SG
despia-te	despir+V.tu.AD.2.SG+IMPF+1+SG
despia-te	despir+V.tu.AD.2.SG+IMPF+3+SG
despia-vos	despir+V.vós.AD.2.PL+IMPF+1+SG
despia-vos	despir+V.vós.AD.2.PL+IMPF+3+SG
despica-a	despicar+V.ele.ACC.3.F.SG+PRS+3+SG
despica-as	despicar+V.ele.ACC.3.F.PL+PRS+3+SG
despicai-la	despicar+V.ele.ACC.3.F.SG+PRS+2+PL
despicai-las	despicar+V.ele.ACC.3.F.PL+PRS+2+PL
despicai-lo	despicar+V.ele.ACC.3.M.SG+PRS+2+PL
despicai-los	despicar+V.ele.ACC.3.M.PL+PRS+2+PL
despicai-nos	despicar+nós.AD.1.PL+PRS+2+PL
despicais-lhe	despicar+V.ele.DAT.3.SG+PRS+2+PL
despicais-lhes	despicar+V.ele.DAT.3.PL+PRS+2+PL
despicais-me	despicar+V.eu.AD.1.SG+PRS+2+PL
despicais-te	despicar+V.tu.AD.2.SG+PRS+2+PL
despicais-vos	despicar+V.vós.AD.2.PL+PRS+2+PL
despicá-la-á	despicar+V.ele.ACC.3.F.SG+FUT+3+SG
despicá-la-ão	despicar+V.ele.ACC.3.F.SG+FUT+3+PL
despicá-la-ás	despicar+V.ele.ACC.3.F.SG+FUT+2+SG
despicá-la	despicar+V.ele.ACC.3.F.SG+INF+1+SG
despicá-la	despicar+V.ele.ACC.3.F.SG+INF+3+SG
despica-la	despicar+V.ele.ACC.3.F.SG+PRS+2+SG
despicá-la	despicar+V.ele.ACC.3.F.SG+SBJF+1+SG
despicá-la	despicar+V.ele.ACC.3.F.SG+SBJF+3+SG
despicá-la-ei	despicar+V.ele.ACC.3.F.SG+FUT+1+SG
despicá-la-eis	despicar+V.ele.ACC.3.F.SG+FUT+2+PL
despicá-la-emos	despicar+V.ele.ACC.3.F.SG+FUT+1+PL
despicá-la-ia	despicar+V.ele.ACC.3.F.SG+COND+1+SG
despicá-la-ia	despicar+V.ele.ACC.3.F.SG+COND+3+SG
despicá-la-iam	despicar+V.ele.ACC.3.F.SG+COND+3+PL
despicá-la-íamos	despicar+V.ele.ACC.3.F.SG+COND+1+PL
despicá-la-ias	despicar+V.ele.ACC.3.F.SG+COND+2+SG
despicá-la-íeis	despicar+V.ele.ACC.3.F.SG+COND+2+PL
despicá-las-á	despicar+V.ele.ACC.3.F.PL+FUT+3+SG
despicá-las-ão	despicar+V.ele.ACC.3.F.PL+FUT+3+PL
despicá-las-ás	despicar+V.ele.ACC.3.F.PL+FUT+2+SG
despicá-las	despicar+V.ele.ACC.3.F.PL+INF+1+SG
despicá-las	despicar+V.ele.ACC.3.F.PL+INF+3+SG
despica-las	despicar+V.ele.ACC.3.F.PL+PRS+2+SG
despicá-las	despicar+V.ele.ACC.3.F.PL+SBJF+1+SG
despicá-las	despicar+V.ele.ACC.3.F.PL+SBJF+3+SG
despicá-las-ei	despicar+V.ele.ACC.3.F.PL+FUT+1+SG
despicá-las-eis	despicar+V.ele.ACC.3.F.PL+FUT+2+PL
despicá-las-emos	despicar+V.ele.ACC.3.F.PL+FUT+1+PL
despicá-las-ia	despicar+V.ele.ACC.3.F.PL+COND+1+SG
despicá-las-ia	despicar+V.ele.ACC.3.F.PL+COND+3+SG
despicá-las-iam	despicar+V.ele.ACC.3.F.PL+COND+3+PL
despicá-las-íamos	despicar+V.ele.ACC.3.F.PL+COND+1+PL
despicá-las-ias	despicar+V.ele.ACC.3.F.PL+COND+2+SG
despicá-las-íeis	despicar+V.ele.ACC.3.F.PL+COND+2+PL
despica-lhe	despicar+V.ele.DAT.3.SG+PRS+3+SG
despica-lhes	despicar+V.ele.DAT.3.PL+PRS+3+SG
despicá-lo-á	despicar+V.ele.ACC.3.M.SG+FUT+3+SG
despicá-lo-ão	despicar+V.ele.ACC.3.M.SG+FUT+3+PL
despicá-lo-ás	despicar+V.ele.ACC.3.M.SG+FUT+2+SG
despicá-lo	despicar+V.ele.ACC.3.M.SG+INF+1+SG
despicá-lo	despicar+V.ele.ACC.3.M.SG+INF+3+SG
despica-lo	despicar+V.ele.ACC.3.M.SG+PRS+2+SG
despicá-lo	despicar+V.ele.ACC.3.M.SG+SBJF+1+SG
despicá-lo	despicar+V.ele.ACC.3.M.SG+SBJF+3+SG
despicá-lo-ei	despicar+V.ele.ACC.3.M.SG+FUT+1+SG
despicá-lo-eis	despicar+V.ele.ACC.3.M.SG+FUT+2+PL
despicá-lo-emos	despicar+V.ele.ACC.3.M.SG+FUT+1+PL
despicá-lo-ia	despicar+V.ele.ACC.3.M.SG+COND+1+SG
despicá-lo-ia	despicar+V.ele.ACC.3.M.SG+COND+3+SG
despicá-lo-iam	despicar+V.ele.ACC.3.M.SG+COND+3+PL
despicá-lo-íamos	despicar+V.ele.ACC.3.M.SG+COND+1+PL
despicá-lo-ias	despicar+V.ele.ACC.3.M.SG+COND+2+SG
despicá-lo-íeis	despicar+V.ele.ACC.3.M.SG+COND+2+PL
despicá-los-á	despicar+V.ele.ACC.3.M.PL+FUT+3+SG
despicá-los-ão	despicar+V.ele.ACC.3.M.PL+FUT+3+PL
despicá-los-ás	despicar+V.ele.ACC.3.M.PL+FUT+2+SG
despicá-los	despicar+V.ele.ACC.3.M.PL+INF+1+SG
despicá-los	despicar+V.ele.ACC.3.M.PL+INF+3+SG
despica-los	despicar+V.ele.ACC.3.M.PL+PRS+2+SG
despicá-los	despicar+V.ele.ACC.3.M.PL+SBJF+1+SG
despicá-los	despicar+V.ele.ACC.3.M.PL+SBJF+3+SG
despicá-los-ei	despicar+V.ele.ACC.3.M.PL+FUT+1+SG
despicá-los-eis	despicar+V.ele.ACC.3.M.PL+FUT+2+PL
despicá-los-emos	despicar+V.ele.ACC.3.M.PL+FUT+1+PL
despicá-los-ia	despicar+V.ele.ACC.3.M.PL+COND+1+SG
despicá-los-ia	despicar+V.ele.ACC.3.M.PL+COND+3+SG
despicá-los-iam	despicar+V.ele.ACC.3.M.PL+COND+3+PL
despicá-los-íamos	despicar+V.ele.ACC.3.M.PL+COND+1+PL
despicá-los-ias	despicar+V.ele.ACC.3.M.PL+COND+2+SG
despicá-los-íeis	despicar+V.ele.ACC.3.M.PL+COND+2+PL
despica-me	despicar+V.eu.AD.1.SG+PRS+3+SG
despicam-lhe	despicar+V.ele.DAT.3.SG+PRS+3+PL
despicam-lhes	despicar+V.ele.DAT.3.PL+PRS+3+PL
despicam-me	despicar+V.eu.AD.1.SG+PRS+3+PL
despicam-na	despicar+V.ele.ACC.3.F.SG+PRS+3+PL
despicam-nas	despicar+V.ele.ACC.3.F.PL+PRS+3+PL
despicam-no	despicar+V.ele.ACC.3.M.SG+PRS+3+PL
despicam-nos	despicar+V.ele.ACC.3.M.PL+PRS+3+PL
despicam-nos	despicar+V.nós.AD.1.PL+PRS+3+PL
despicamo-la	despicar+V.ele.ACC.3.F.SG+PRF+1+PL
despicamo-la	despicar+V.ele.ACC.3.F.SG+PRS+1+PL
despicamo-las	despicar+V.ele.ACC.3.F.PL+PRF+1+PL
despicamo-las	despicar+V.ele.ACC.3.F.PL+PRS+1+PL
despicamo-lo	despicar+V.ele.ACC.3.M.SG+PRF+1+PL
despicamo-lo	despicar+V.ele.ACC.3.M.SG+PRS+1+PL
despicamo-los	despicar+V.ele.ACC.3.M.PL+PRF+1+PL
despicamo-los	despicar+V.ele.ACC.3.M.PL+PRS+1+PL
despicamo-nos	despicar+nós.AD.1.PL+PRF+1+PL
despicamo-nos	despicar+nós.AD.1.PL+PRS+1+PL
despicamos-lhe	despicar+V.ele.DAT.3.SG+PRF+1+PL
despicamos-lhe	despicar+V.ele.DAT.3.SG+PRS+1+PL
despicamos-lhes	despicar+V.ele.DAT.3.PL+PRF+1+PL
despicamos-lhes	despicar+V.ele.DAT.3.PL+PRS+1+PL
despicamos-me	despicar+V.eu.AD.1.SG+PRF+1+PL
despicamos-me	despicar+V.eu.AD.1.SG+PRS+1+PL
despicamos-te	despicar+V.tu.AD.2.SG+PRF+1+PL
despicamos-te	despicar+V.tu.AD.2.SG+PRS+1+PL
despicamos-vos	despicar+V.vós.AD.2.PL+PRF+1+PL
despicamos-vos	despicar+V.vós.AD.2.PL+PRS+1+PL
despicam-se	despicar+V.ele.REFL+PRS+3+PL
despicam-te	despicar+V.tu.AD.2.SG+PRS+3+PL
despicam-vos	despicar+V.vós.AD.2.PL+PRS+3+PL
despicando-a	despicar+V.ele.ACC.3.F.SG+GRD
despicando-as	despicar+V.ele.ACC.3.F.PL+GRD
despicando-lhe	despicar+V.ele.DAT.3.SG+GRD
despicando-lhes	despicar+V.ele.DAT.3.PL+GRD
despicando-me	despicar+V.eu.AD.1.SG+GRD
despicando-nos	despicar+nós.AD.1.PL+GRD
despicando-o	despicar+V.ele.ACC.3.M.SG+GRD
despicando-os	despicar+V.ele.ACC.3.M.PL+GRD
despicando-se	despicar+V.ele.REFL+GRD
despicando-te	despicar+V.tu.AD.2.SG+GRD
despicando-vos	despicar+V.vós.AD.2.PL+GRD
despica-nos	despicar+nós.AD.1.PL+PRS+2+SG
despica-nos	despicar+nós.AD.1.PL+PRS+3+SG
despica-o	despicar+V.ele.ACC.3.M.SG+PRS+3+SG
despica-os	despicar+V.ele.ACC.3.M.PL+PRS+3+SG
despicara-a	despicar+V.ele.ACC.3.F.SG+PQP+1+SG
despicara-a	despicar+V.ele.ACC.3.F.SG+PQP+3+SG
despicara-as	despicar+V.ele.ACC.3.F.PL+PQP+1+SG
despicara-as	despicar+V.ele.ACC.3.F.PL+PQP+3+SG
despicara-la	despicar+V.ele.ACC.3.F.SG+PQP+2+SG
despicara-las	despicar+V.ele.ACC.3.F.PL+PQP+2+SG
despicara-lhe	despicar+V.ele.DAT.3.SG+PQP+1+SG
despicara-lhe	despicar+V.ele.DAT.3.SG+PQP+3+SG
despicara-lhes	despicar+V.ele.DAT.3.PL+PQP+1+SG
despicara-lhes	despicar+V.ele.DAT.3.PL+PQP+3+SG
despicara-lo	despicar+V.ele.ACC.3.M.SG+PQP+2+SG
despicara-los	despicar+V.ele.ACC.3.M.PL+PQP+2+SG
despicara-me	despicar+V.eu.AD.1.SG+PQP+1+SG
despicara-me	despicar+V.eu.AD.1.SG+PQP+3+SG
despicaram-lhe	despicar+V.ele.DAT.3.SG+PQP+3+PL
despicaram-lhe	despicar+V.ele.DAT.3.SG+PRF+3+PL
despicaram-lhes	despicar+V.ele.DAT.3.PL+PQP+3+PL
despicaram-lhes	despicar+V.ele.DAT.3.PL+PRF+3+PL
despicaram-me	despicar+V.eu.AD.1.SG+PQP+3+PL
despicaram-me	despicar+V.eu.AD.1.SG+PRF+3+PL
despicaram-na	despicar+V.ele.ACC.3.F.SG+PQP+3+PL
despicaram-na	despicar+V.ele.ACC.3.F.SG+PRF+3+PL
despicaram-nas	despicar+V.ele.ACC.3.F.PL+PQP+3+PL
despicaram-nas	despicar+V.ele.ACC.3.F.PL+PRF+3+PL
despicaram-no	despicar+V.ele.ACC.3.M.SG+PQP+3+PL
despicaram-no	despicar+V.ele.ACC.3.M.SG+PRF+3+PL
despicaram-nos	despicar+V.ele.ACC.3.M.PL+PQP+3+PL
despicaram-nos	despicar+V.ele.ACC.3.M.PL+PRF+3+PL
despicaram-nos	despicar+V.nós.AD.1.PL+PQP+3+PL
despicaram-nos	despicar+V.nós.AD.1.PL+PRF+3+PL
despicáramo-la	despicar+V.ele.ACC.3.F.SG+PQP+1+PL
despicáramo-las	despicar+V.ele.ACC.3.F.PL+PQP+1+PL
despicáramo-lo	despicar+V.ele.ACC.3.M.SG+PQP+1+PL
despicáramo-los	despicar+V.ele.ACC.3.M.PL+PQP+1+PL
despicáramo-nos	despicar+nós.AD.1.PL+PQP+1+PL
despicáramos-lhe	despicar+V.ele.DAT.3.SG+PQP+1+PL
despicáramos-lhes	despicar+V.ele.DAT.3.PL+PQP+1+PL
despicáramos-me	despicar+V.eu.AD.1.SG+PQP+1+PL
despicáramos-te	despicar+V.tu.AD.2.SG+PQP+1+PL
despicáramos-vos	despicar+V.vós.AD.2.PL+PQP+1+PL
despicaram-se	despicar+V.ele.REFL+PQP+3+PL
despicaram-se	despicar+V.ele.REFL+PRF+3+PL
despicaram-te	despicar+V.tu.AD.2.SG+PQP+3+PL
despicaram-te	despicar+V.tu.AD.2.SG+PRF+3+PL
despicaram-vos	despicar+V.vós.AD.2.PL+PQP+3+PL
despicaram-vos	despicar+V.vós.AD.2.PL+PRF+3+PL
despicara-nos	despicar+nós.AD.1.PL+PQP+1+SG
despicara-nos	despicar+nós.AD.1.PL+PQP+2+SG
despicara-nos	despicar+nós.AD.1.PL+PQP+3+SG
despicara-o	despicar+V.ele.ACC.3.M.SG+PQP+1+SG
despicara-o	despicar+V.ele.ACC.3.M.SG+PQP+3+SG
despicara-os	despicar+V.ele.ACC.3.M.PL+PQP+1+SG
despicara-os	despicar+V.ele.ACC.3.M.PL+PQP+3+SG
despicara-se	despicar+V.ele.REFL+PQP+1+SG
despicara-se	despicar+V.ele.REFL+PQP+3+SG
despicaras-lhe	despicar+V.ele.DAT.3.SG+PQP+2+SG
despicaras-lhes	despicar+V.ele.DAT.3.PL+PQP+2+SG
despicaras-me	despicar+V.eu.AD.1.SG+PQP+2+SG
despicaras-te	despicar+V.tu.AD.2.SG+PQP+2+SG
despicaras-vos	despicar+V.vós.AD.2.PL+PQP+2+SG
despicara-te	despicar+V.tu.AD.2.SG+PQP+1+SG
despicara-te	despicar+V.tu.AD.2.SG+PQP+3+SG
despicara-vos	despicar+V.vós.AD.2.PL+PQP+1+SG
despicara-vos	despicar+V.vós.AD.2.PL+PQP+3+SG
despicarde-la	despicar+V.ele.ACC.3.F.SG+INF+2+PL
despicarde-la	despicar+V.ele.ACC.3.F.SG+SBJF+2+PL
despicarde-las	despicar+V.ele.ACC.3.F.PL+INF+2+PL
despicarde-las	despicar+V.ele.ACC.3.F.PL+SBJF+2+PL
despicarde-lo	despicar+V.ele.ACC.3.M.SG+INF+2+PL
despicarde-lo	despicar+V.ele.ACC.3.M.SG+SBJF+2+PL
despicarde-los	despicar+V.ele.ACC.3.M.PL+INF+2+PL
despicarde-los	despicar+V.ele.ACC.3.M.PL+SBJF+2+PL
despicarde-nos	despicar+nós.AD.1.PL+INF+2+PL
despicarde-nos	despicar+nós.AD.1.PL+SBJF+2+PL
despicardes-lhe	despicar+V.ele.DAT.3.SG+INF+2+PL
despicardes-lhe	despicar+V.ele.DAT.3.SG+SBJF+2+PL
despicardes-lhes	despicar+V.ele.DAT.3.PL+INF+2+PL
despicardes-lhes	despicar+V.ele.DAT.3.PL+SBJF+2+PL
despicardes-me	despicar+V.eu.AD.1.SG+INF+2+PL
despicardes-me	despicar+V.eu.AD.1.SG+SBJF+2+PL
despicardes-te	despicar+V.tu.AD.2.SG+INF+2+PL
despicardes-te	despicar+V.tu.AD.2.SG+SBJF+2+PL
despicardes-vos	despicar+V.vós.AD.2.PL+INF+2+PL
despicardes-vos	despicar+V.vós.AD.2.PL+SBJF+2+PL
despicárei-la	despicar+V.ele.ACC.3.F.SG+PQP+2+PL
despicárei-las	despicar+V.ele.ACC.3.F.PL+PQP+2+PL
despicárei-lo	despicar+V.ele.ACC.3.M.SG+PQP+2+PL
despicárei-los	despicar+V.ele.ACC.3.M.PL+PQP+2+PL
despicárei-nos	despicar+nós.AD.1.PL+PQP+2+PL
despicáreis-lhe	despicar+V.ele.DAT.3.SG+PQP+2+PL
despicáreis-lhes	despicar+V.ele.DAT.3.PL+PQP+2+PL
despicáreis-me	despicar+V.eu.AD.1.SG+PQP+2+PL
despicáreis-te	despicar+V.tu.AD.2.SG+PQP+2+PL
despicáreis-vos	despicar+V.vós.AD.2.PL+PQP+2+PL
despicare-la	despicar+V.ele.ACC.3.F.SG+INF+2+SG
despicare-la	despicar+V.ele.ACC.3.F.SG+SBJF+2+SG
despicare-las	despicar+V.ele.ACC.3.F.PL+INF+2+SG
despicare-las	despicar+V.ele.ACC.3.F.PL+SBJF+2+SG
despicare-lo	despicar+V.ele.ACC.3.M.SG+INF+2+SG
despicare-lo	despicar+V.ele.ACC.3.M.SG+SBJF+2+SG
despicare-los	despicar+V.ele.ACC.3.M.PL+INF+2+SG
despicare-los	despicar+V.ele.ACC.3.M.PL+SBJF+2+SG
despicarem-lhe	despicar+V.ele.DAT.3.SG+INF+3+PL
despicarem-lhe	despicar+V.ele.DAT.3.SG+SBJF+3+PL
despicarem-lhes	despicar+V.ele.DAT.3.PL+INF+3+PL
despicarem-lhes	despicar+V.ele.DAT.3.PL+SBJF+3+PL
despicarem-me	despicar+V.eu.AD.1.SG+INF+3+PL
despicarem-me	despicar+V.eu.AD.1.SG+SBJF+3+PL
despicarem-na	despicar+V.ele.ACC.3.F.SG+INF+3+PL
despicarem-na	despicar+V.ele.ACC.3.F.SG+SBJF+3+PL
despicarem-nas	despicar+V.ele.ACC.3.F.PL+INF+3+PL
despicarem-nas	despicar+V.ele.ACC.3.F.PL+SBJF+3+PL
despicarem-no	despicar+V.ele.ACC.3.M.SG+INF+3+PL
despicarem-no	despicar+V.ele.ACC.3.M.SG+SBJF+3+PL
despicarem-nos	despicar+V.ele.ACC.3.M.PL+INF+3+PL
despicarem-nos	despicar+V.ele.ACC.3.M.PL+SBJF+3+PL
despicarem-nos	despicar+V.nós.AD.1.PL+INF+3+PL
despicarem-nos	despicar+V.nós.AD.1.PL+SBJF+3+PL
despicarem-se	despicar+V.ele.REFL+INF+3+PL
despicarem-se	despicar+V.ele.REFL+SBJF+3+PL
despicarem-te	despicar+V.tu.AD.2.SG+INF+3+PL
despicarem-te	despicar+V.tu.AD.2.SG+SBJF+3+PL
despicarem-vos	despicar+V.vós.AD.2.PL+INF+3+PL
despicarem-vos	despicar+V.vós.AD.2.PL+SBJF+3+PL
despicare-nos	despicar+nós.AD.1.PL+INF+2+SG
despicare-nos	despicar+nós.AD.1.PL+SBJF+2+SG
despicares-lhe	despicar+V.ele.DAT.3.SG+INF+2+SG
despicares-lhe	despicar+V.ele.DAT.3.SG+SBJF+2+SG
despicares-lhes	despicar+V.ele.DAT.3.PL+INF+2+SG
despicares-lhes	despicar+V.ele.DAT.3.PL+SBJF+2+SG
despicares-me	despicar+V.eu.AD.1.SG+INF+2+SG
despicares-me	despicar+V.eu.AD.1.SG+SBJF+2+SG
despicares-te	despicar+V.tu.AD.2.SG+INF+2+SG
despicares-te	despicar+V.tu.AD.2.SG+SBJF+2+SG
despicares-vos	despicar+V.vós.AD.2.PL+INF+2+SG
despicares-vos	despicar+V.vós.AD.2.PL+SBJF+2+SG
despicar-lhe-á	despicar+V.ele.DAT.3.SG+FUT+3+SG
despicar-lhe-ão	despicar+V.ele.DAT.3.SG+FUT+3+PL
despicar-lhe-ás	despicar+V.ele.DAT.3.SG+FUT+2+SG
despicar-lhe	despicar+V.ele.DAT.3.SG+INF
despicar-lhe	despicar+V.ele.DAT.3.SG+INF+1+SG
despicar-lhe	despicar+V.ele.DAT.3.SG+INF+3+SG
despicar-lhe	despicar+V.ele.DAT.3.SG+SBJF+1+SG
despicar-lhe	despicar+V.ele.DAT.3.SG+SBJF+3+SG
despicar-lhe-ei	despicar+V.ele.DAT.3.SG+FUT+1+SG
despicar-lhe-eis	despicar+V.ele.DAT.3.SG+FUT+2+PL
despicar-lhe-emos	despicar+V.ele.DAT.3.SG+FUT+1+PL
despicar-lhe-ia	despicar+V.ele.DAT.3.SG+COND+1+SG
despicar-lhe-ia	despicar+V.ele.DAT.3.SG+COND+3+SG
despicar-lhe-iam	despicar+V.ele.DAT.3.SG+COND+3+PL
despicar-lhe-íamos	despicar+V.ele.DAT.3.SG+COND+1+PL
despicar-lhe-ias	despicar+V.ele.DAT.3.SG+COND+2+SG
despicar-lhe-íeis	despicar+V.ele.DAT.3.SG+COND+2+PL
despicar-lhes-á	despicar+V.ele.DAT.3.PL+FUT+3+SG
despicar-lhes-ão	despicar+V.ele.DAT.3.PL+FUT+3+PL
despicar-lhes-ás	despicar+V.ele.DAT.3.PL+FUT+2+SG
despicar-lhes	despicar+V.ele.DAT.3.PL+INF
despicar-lhes	despicar+V.ele.DAT.3.PL+INF+1+SG
despicar-lhes	despicar+V.ele.DAT.3.PL+INF+3+SG
despicar-lhes	despicar+V.ele.DAT.3.PL+SBJF+1+SG
despicar-lhes	despicar+V.ele.DAT.3.PL+SBJF+3+SG
despicar-lhes-ei	despicar+V.ele.DAT.3.PL+FUT+1+SG
despicar-lhes-eis	despicar+V.ele.DAT.3.PL+FUT+2+PL
despicar-lhes-emos	despicar+V.ele.DAT.3.PL+FUT+1+PL
despicar-lhes-ia	despicar+V.ele.DAT.3.PL+COND+1+SG
despicar-lhes-ia	despicar+V.ele.DAT.3.PL+COND+3+SG
despicar-lhes-iam	despicar+V.ele.DAT.3.PL+COND+3+PL
despicar-lhes-íamos	despicar+V.ele.DAT.3.PL+COND+1+PL
despicar-lhes-ias	despicar+V.ele.DAT.3.PL+COND+2+SG
despicar-lhes-íeis	despicar+V.ele.DAT.3.PL+COND+2+PL
despicar-me-á	despicar+V.eu.AD.1.SG+FUT+3+SG
despicar-me-ão	despicar+V.eu.AD.1.SG+FUT+3+PL
despicar-me-ás	despicar+V.eu.AD.1.SG+FUT+2+SG
despicar-me	despicar+V.eu.AD.1.SG+INF
despicar-me	despicar+V.eu.AD.1.SG+INF+1+SG
despicar-me	despicar+V.eu.AD.1.SG+INF+3+SG
despicar-me	despicar+V.eu.AD.1.SG+SBJF+1+SG
despicar-me	despicar+V.eu.AD.1.SG+SBJF+3+SG
despicar-me-ei	despicar+V.eu.AD.1.SG+FUT+1+SG
despicar-me-eis	despicar+V.eu.AD.1.SG+FUT+2+PL
despicar-me-emos	despicar+V.eu.AD.1.SG+FUT+1+PL
despicar-me-ia	despicar+V.eu.AD.1.SG+COND+1+SG
despicar-me-ia	despicar+V.eu.AD.1.SG+COND+3+SG
despicar-me-iam	despicar+V.eu.AD.1.SG+COND+3+PL
despicar-me-íamos	despicar+V.eu.AD.1.SG+COND+1+PL
despicar-me-ias	despicar+V.eu.AD.1.SG+COND+2+SG
despicar-me-íeis	despicar+V.eu.AD.1.SG+COND+2+PL
despicarmo-la	despicar+V.ele.ACC.3.F.SG+INF+1+PL
despicarmo-la	despicar+V.ele.ACC.3.F.SG+SBJF+1+PL
despicarmo-las	despicar+V.ele.ACC.3.F.PL+INF+1+PL
despicarmo-las	despicar+V.ele.ACC.3.F.PL+SBJF+1+PL
despicarmo-lo	despicar+V.ele.ACC.3.M.SG+INF+1+PL
despicarmo-lo	despicar+V.ele.ACC.3.M.SG+SBJF+1+PL
despicarmo-los	despicar+V.ele.ACC.3.M.PL+INF+1+PL
despicarmo-los	despicar+V.ele.ACC.3.M.PL+SBJF+1+PL
despicarmo-nos	despicar+nós.AD.1.PL+INF+1+PL
despicarmo-nos	despicar+nós.AD.1.PL+SBJF+1+PL
despicarmos-lhe	despicar+V.ele.DAT.3.SG+INF+1+PL
despicarmos-lhe	despicar+V.ele.DAT.3.SG+SBJF+1+PL
despicarmos-lhes	despicar+V.ele.DAT.3.PL+INF+1+PL
despicarmos-lhes	despicar+V.ele.DAT.3.PL+SBJF+1+PL
despicarmos-me	despicar+V.eu.AD.1.SG+INF+1+PL
despicarmos-me	despicar+V.eu.AD.1.SG+SBJF+1+PL
despicarmos-te	despicar+V.tu.AD.2.SG+INF+1+PL
despicarmos-te	despicar+V.tu.AD.2.SG+SBJF+1+PL
despicarmos-vos	despicar+V.vós.AD.2.PL+INF+1+PL
despicarmos-vos	despicar+V.vós.AD.2.PL+SBJF+1+PL
despicar-nos-á	despicar+nós.AD.1.PL+FUT+3+SG
despicar-nos-ão	despicar+nós.AD.1.PL+FUT+3+PL
despicar-nos-ás	despicar+nós.AD.1.PL+FUT+2+SG
despicar-nos	despicar+nós.AD.1.PL+INF
despicar-nos	despicar+nós.AD.1.PL+INF+1+SG
despicar-nos	despicar+nós.AD.1.PL+INF+3+SG
despicar-nos	despicar+nós.AD.1.PL+SBJF+1+SG
despicar-nos	despicar+nós.AD.1.PL+SBJF+3+SG
despicar-nos-ei	despicar+nós.AD.1.PL+FUT+1+SG
despicar-nos-eis	despicar+nós.AD.1.PL+FUT+2+PL
despicar-nos-emos	despicar+nós.AD.1.PL+FUT+1+PL
despicar-nos-ia	despicar+nós.AD.1.PL+COND+1+SG
despicar-nos-ia	despicar+nós.AD.1.PL+COND+3+SG
despicar-nos-iam	despicar+nós.AD.1.PL+COND+3+PL
despicar-nos-íamos	despicar+nós.AD.1.PL+COND+1+PL
despicar-nos-ias	despicar+nós.AD.1.PL+COND+2+SG
despicar-nos-íeis	despicar+nós.AD.1.PL+COND+2+PL
despicar-se-á	despicar+V.ele.REFL+FUT+3+SG
despicar-se-ão	despicar+V.ele.REFL+FUT+3+PL
despicar-se	despicar+V.ele.REFL+INF
despicar-se	despicar+V.ele.REFL+INF+3+SG
despicar-se	despicar+V.ele.REFL+SBJF+3+SG
despicar-se-ia	despicar+V.ele.REFL+COND+3+SG
despicar-se-iam	despicar+V.ele.REFL+COND+3+PL
despicar-te-á	despicar+V.tu.AD.2.SG+FUT+3+SG
despicar-te-ão	despicar+V.tu.AD.2.SG+FUT+3+PL
despicar-te-ás	despicar+V.tu.AD.2.SG+FUT+2+SG
despicar-te	despicar+V.tu.AD.2.SG+INF
despicar-te	despicar+V.tu.AD.2.SG+INF+1+SG
despicar-te	despicar+V.tu.AD.2.SG+INF+3+SG
despicar-te	despicar+V.tu.AD.2.SG+SBJF+1+SG
despicar-te	despicar+V.tu.AD.2.SG+SBJF+3+SG
despicar-te-ei	despicar+V.tu.AD.2.SG+FUT+1+SG
despicar-te-eis	despicar+V.tu.AD.2.SG+FUT+2+PL
despicar-te-emos	despicar+V.tu.AD.2.SG+FUT+1+PL
despicar-te-ia	despicar+V.tu.AD.2.SG+COND+1+SG
despicar-te-ia	despicar+V.tu.AD.2.SG+COND+3+SG
despicar-te-iam	despicar+V.tu.AD.2.SG+COND+3+PL
despicar-te-íamos	despicar+V.tu.AD.2.SG+COND+1+PL
despicar-te-ias	despicar+V.tu.AD.2.SG+COND+2+SG
despicar-te-íeis	despicar+V.tu.AD.2.SG+COND+2+PL
despicar-vos-á	despicar+V.vós.AD.2.PL+FUT+3+SG
despicar-vos-ão	despicar+V.vós.AD.2.PL+FUT+3+PL
despicar-vos-ás	despicar+V.vós.AD.2.PL+FUT+2+SG
despicar-vos	despicar+V.vós.AD.2.PL+INF
despicar-vos	despicar+V.vós.AD.2.PL+INF+1+SG
despicar-vos	despicar+V.vós.AD.2.PL+INF+3+SG
despicar-vos	despicar+V.vós.AD.2.PL+SBJF+1+SG
despicar-vos	despicar+V.vós.AD.2.PL+SBJF+3+SG
despicar-vos-ei	despicar+V.vós.AD.2.PL+FUT+1+SG
despicar-vos-eis	despicar+V.vós.AD.2.PL+FUT+2+PL
despicar-vos-emos	despicar+V.vós.AD.2.PL+FUT+1+PL
despicar-vos-ia	despicar+V.vós.AD.2.PL+COND+1+SG
despicar-vos-ia	despicar+V.vós.AD.2.PL+COND+3+SG
despicar-vos-iam	despicar+V.vós.AD.2.PL+COND+3+PL
despicar-vos-íamos	despicar+V.vós.AD.2.PL+COND+1+PL
despicar-vos-ias	despicar+V.vós.AD.2.PL+COND+2+SG
despicar-vos-íeis	despicar+V.vós.AD.2.PL+COND+2+PL
despica-se	despicar+V.ele.REFL+PRS+3+SG
despicas-lhe	despicar+V.ele.DAT.3.SG+PRS+2+SG
despicas-lhes	despicar+V.ele.DAT.3.PL+PRS+2+SG
despicas-me	despicar+V.eu.AD.1.SG+PRS+2+SG
despicas-te	despicar+V.tu.AD.2.SG+PRS+2+SG
despicaste-la	despicar+V.ele.ACC.3.F.SG+PRF+2+PL
despicaste-las	despicar+V.ele.ACC.3.F.PL+PRF+2+PL
despicaste-lo	despicar+V.ele.ACC.3.M.SG+PRF+2+PL
despicaste-los	despicar+V.ele.ACC.3.M.PL+PRF+2+PL
despicaste-nos	despicar+nós.AD.1.PL+PRF+2+PL
despicastes-lhe	despicar+V.ele.DAT.3.SG+PRF+2+PL
despicastes-lhes	despicar+V.ele.DAT.3.PL+PRF+2+PL
despicastes-me	despicar+V.eu.AD.1.SG+PRF+2+PL
despicastes-te	despicar+V.tu.AD.2.SG+PRF+2+PL
despicastes-vos	despicar+V.vós.AD.2.PL+PRF+2+PL
despicas-vos	despicar+V.vós.AD.2.PL+PRS+2+SG
despica-te	despicar+V.tu.AD.2.SG+PRS+3+SG
despicava-a	despicar+V.ele.ACC.3.F.SG+IMPF+1+SG
despicava-a	despicar+V.ele.ACC.3.F.SG+IMPF+3+SG
despicava-as	despicar+V.ele.ACC.3.F.PL+IMPF+1+SG
despicava-as	despicar+V.ele.ACC.3.F.PL+IMPF+3+SG
despicava-la	despicar+V.ele.ACC.3.F.SG+IMPF+2+SG
despicava-las	despicar+V.ele.ACC.3.F.PL+IMPF+2+SG
despicava-lhe	despicar+V.ele.DAT.3.SG+IMPF+1+SG
despicava-lhe	despicar+V.ele.DAT.3.SG+IMPF+3+SG
despicava-lhes	despicar+V.ele.DAT.3.PL+IMPF+1+SG
despicava-lhes	despicar+V.ele.DAT.3.PL+IMPF+3+SG
despicava-lo	despicar+V.ele.ACC.3.M.SG+IMPF+2+SG
despicava-los	despicar+V.ele.ACC.3.M.PL+IMPF+2+SG
despicava-me	despicar+V.eu.AD.1.SG+IMPF+1+SG
despicava-me	despicar+V.eu.AD.1.SG+IMPF+3+SG
despicavam-lhe	despicar+V.ele.DAT.3.SG+IMPF+3+PL
despicavam-lhes	despicar+V.ele.DAT.3.PL+IMPF+3+PL
despicavam-me	despicar+V.eu.AD.1.SG+IMPF+3+PL
despicavam-na	despicar+V.ele.ACC.3.F.SG+IMPF+3+PL
despicavam-nas	despicar+V.ele.ACC.3.F.PL+IMPF+3+PL
despicavam-no	despicar+V.ele.ACC.3.M.SG+IMPF+3+PL
despicavam-nos	despicar+V.ele.ACC.3.M.PL+IMPF+3+PL
despicavam-nos	despicar+V.nós.AD.1.PL+IMPF+3+PL
despicávamo-la	despicar+V.ele.ACC.3.F.SG+IMPF+1+PL
despicávamo-las	despicar+V.ele.ACC.3.F.PL+IMPF+1+PL
despicávamo-lo	despicar+V.ele.ACC.3.M.SG+IMPF+1+PL
despicávamo-los	despicar+V.ele.ACC.3.M.PL+IMPF+1+PL
despicávamo-nos	despicar+nós.AD.1.PL+IMPF+1+PL
despicávamos-lhe	despicar+V.ele.DAT.3.SG+IMPF+1+PL
despicávamos-lhes	despicar+V.ele.DAT.3.PL+IMPF+1+PL
despicávamos-me	despicar+V.eu.AD.1.SG+IMPF+1+PL
despicávamos-te	despicar+V.tu.AD.2.SG+IMPF+1+PL
despicávamos-vos	despicar+V.vós.AD.2.PL+IMPF+1+PL
despicavam-se	despicar+V.ele.REFL+IMPF+3+PL
despicavam-te	despicar+V.tu.AD.2.SG+IMPF+3+PL
despicavam-vos	despicar+V.vós.AD.2.PL+IMPF+3+PL
despicava-nos	despicar+nós.AD.1.PL+IMPF+1+SG
despicava-nos	despicar+nós.AD.1.PL+IMPF+2+SG
despicava-nos	despicar+nós.AD.1.PL+IMPF+3+SG
despicava-o	despicar+V.ele.ACC.3.M.SG+IMPF+1+SG
despicava-o	despicar+V.ele.ACC.3.M.SG+IMPF+3+SG
despicava-os	despicar+V.ele.ACC.3.M.PL+IMPF+1+SG
despicava-os	despicar+V.ele.ACC.3.M.PL+IMPF+3+SG
despicava-se	despicar+V.ele.REFL+IMPF+1+SG
despicava-se	despicar+V.ele.REFL+IMPF+3+SG
despicavas-lhe	despicar+V.ele.DAT.3.SG+IMPF+2+SG
despicavas-lhes	despicar+V.ele.DAT.3.PL+IMPF+2+SG
despicavas-me	despicar+V.eu.AD.1.SG+IMPF+2+SG
despicavas-te	despicar+V.tu.AD.2.SG+IMPF+2+SG
despicavas-vos	despicar+V.vós.AD.2.PL+IMPF+2+SG
despicava-te	despicar+V.tu.AD.2.SG+IMPF+1+SG
despicava-te	despicar+V.tu.AD.2.SG+IMPF+3+SG
despicava-vos	despicar+V.vós.AD.2.PL+IMPF+1+SG
despicava-vos	despicar+V.vós.AD.2.PL+IMPF+3+SG
despicávei-la	despicar+V.ele.ACC.3.F.SG+IMPF+2+PL
despicávei-las	despicar+V.ele.ACC.3.F.PL+IMPF+2+PL
despicávei-lo	despicar+V.ele.ACC.3.M.SG+IMPF+2+PL
despicávei-los	despicar+V.ele.ACC.3.M.PL+IMPF+2+PL
despicávei-nos	despicar+nós.AD.1.PL+IMPF+2+PL
despicáveis-lhe	despicar+V.ele.DAT.3.SG+IMPF+2+PL
despicáveis-lhes	despicar+V.ele.DAT.3.PL+IMPF+2+PL
despicáveis-me	despicar+V.eu.AD.1.SG+IMPF+2+PL
despicáveis-te	despicar+V.tu.AD.2.SG+IMPF+2+PL
despicáveis-vos	despicar+V.vós.AD.2.PL+IMPF+2+PL
despica-vos	despicar+V.vós.AD.2.PL+PRS+3+SG
despico-a	despicar+V.ele.ACC.3.F.SG+PRS+1+SG
despico-as	despicar+V.ele.ACC.3.F.PL+PRS+1+SG
despico-lhe	despicar+V.ele.DAT.3.SG+PRS+1+SG
despico-lhes	despicar+V.ele.DAT.3.PL+PRS+1+SG
despico-me	despicar+V.eu.AD.1.SG+PRS+1+SG
despico-nos	despicar+nós.AD.1.PL+PRS+1+SG
despico-o	despicar+V.ele.ACC.3.M.SG+PRS+1+SG
despico-os	despicar+V.ele.ACC.3.M.PL+PRS+1+SG
despico-te	despicar+V.tu.AD.2.SG+PRS+1+SG
despicou-a	despicar+V.ele.ACC.3.F.SG+PRF+3+SG
despicou-as	despicar+V.ele.ACC.3.F.PL+PRF+3+SG
despicou-lhe	despicar+V.ele.DAT.3.SG+PRF+3+SG
despicou-lhes	despicar+V.ele.DAT.3.PL+PRF+3+SG
despicou-me	despicar+V.eu.AD.1.SG+PRF+3+SG
despicou-nos	despicar+nós.AD.1.PL+PRF+3+SG
despicou-o	despicar+V.ele.ACC.3.M.SG+PRF+3+SG
despicou-os	despicar+V.ele.ACC.3.M.PL+PRF+3+SG
despicou-se	despicar+V.ele.REFL+PRF+3+SG
despicou-te	despicar+V.tu.AD.2.SG+PRF+3+SG
despicou-vos	despicar+V.vós.AD.2.PL+PRF+3+SG
despico-vos	despicar+V.vós.AD.2.PL+PRS+1+SG
despieda-a	despiedar+V.ele.ACC.3.F.SG+PRS+3+SG
despieda-as	despiedar+V.ele.ACC.3.F.PL+PRS+3+SG
despiedai-la	despiedar+V.ele.ACC.3.F.SG+PRS+2+PL
despiedai-las	despiedar+V.ele.ACC.3.F.PL+PRS+2+PL
despiedai-lo	despiedar+V.ele.ACC.3.M.SG+PRS+2+PL
despiedai-los	despiedar+V.ele.ACC.3.M.PL+PRS+2+PL
despiedai-nos	despiedar+nós.AD.1.PL+PRS+2+PL
despiedais-lhe	despiedar+V.ele.DAT.3.SG+PRS+2+PL
despiedais-lhes	despiedar+V.ele.DAT.3.PL+PRS+2+PL
despiedais-me	despiedar+V.eu.AD.1.SG+PRS+2+PL
despiedais-te	despiedar+V.tu.AD.2.SG+PRS+2+PL
despiedais-vos	despiedar+V.vós.AD.2.PL+PRS+2+PL
despiedá-la-á	despiedar+V.ele.ACC.3.F.SG+FUT+3+SG
despiedá-la-ão	despiedar+V.ele.ACC.3.F.SG+FUT+3+PL
despiedá-la-ás	despiedar+V.ele.ACC.3.F.SG+FUT+2+SG
despiedá-la	despiedar+V.ele.ACC.3.F.SG+INF+1+SG
despiedá-la	despiedar+V.ele.ACC.3.F.SG+INF+3+SG
despieda-la	despiedar+V.ele.ACC.3.F.SG+PRS+2+SG
despiedá-la	despiedar+V.ele.ACC.3.F.SG+SBJF+1+SG
despiedá-la	despiedar+V.ele.ACC.3.F.SG+SBJF+3+SG
despiedá-la-ei	despiedar+V.ele.ACC.3.F.SG+FUT+1+SG
despiedá-la-eis	despiedar+V.ele.ACC.3.F.SG+FUT+2+PL
despiedá-la-emos	despiedar+V.ele.ACC.3.F.SG+FUT+1+PL
despiedá-la-ia	despiedar+V.ele.ACC.3.F.SG+COND+1+SG
despiedá-la-ia	despiedar+V.ele.ACC.3.F.SG+COND+3+SG
despiedá-la-iam	despiedar+V.ele.ACC.3.F.SG+COND+3+PL
despiedá-la-íamos	despiedar+V.ele.ACC.3.F.SG+COND+1+PL
despiedá-la-ias	despiedar+V.ele.ACC.3.F.SG+COND+2+SG
despiedá-la-íeis	despiedar+V.ele.ACC.3.F.SG+COND+2+PL
despiedá-las-á	despiedar+V.ele.ACC.3.F.PL+FUT+3+SG
despiedá-las-ão	despiedar+V.ele.ACC.3.F.PL+FUT+3+PL
despiedá-las-ás	despiedar+V.ele.ACC.3.F.PL+FUT+2+SG
despiedá-las	despiedar+V.ele.ACC.3.F.PL+INF+1+SG
despiedá-las	despiedar+V.ele.ACC.3.F.PL+INF+3+SG
despieda-las	despiedar+V.ele.ACC.3.F.PL+PRS+2+SG
despiedá-las	despiedar+V.ele.ACC.3.F.PL+SBJF+1+SG
despiedá-las	despiedar+V.ele.ACC.3.F.PL+SBJF+3+SG
despiedá-las-ei	despiedar+V.ele.ACC.3.F.PL+FUT+1+SG
despiedá-las-eis	despiedar+V.ele.ACC.3.F.PL+FUT+2+PL
despiedá-las-emos	despiedar+V.ele.ACC.3.F.PL+FUT+1+PL
despiedá-las-ia	despiedar+V.ele.ACC.3.F.PL+COND+1+SG
despiedá-las-ia	despiedar+V.ele.ACC.3.F.PL+COND+3+SG
despiedá-las-iam	despiedar+V.ele.ACC.3.F.PL+COND+3+PL
despiedá-las-íamos	despiedar+V.ele.ACC.3.F.PL+COND+1+PL
despiedá-las-ias	despiedar+V.ele.ACC.3.F.PL+COND+2+SG
despiedá-las-íeis	despiedar+V.ele.ACC.3.F.PL+COND+2+PL
despieda-lhe	despiedar+V.ele.DAT.3.SG+PRS+3+SG
despieda-lhes	despiedar+V.ele.DAT.3.PL+PRS+3+SG
despiedá-lo-á	despiedar+V.ele.ACC.3.M.SG+FUT+3+SG
despiedá-lo-ão	despiedar+V.ele.ACC.3.M.SG+FUT+3+PL
despiedá-lo-ás	despiedar+V.ele.ACC.3.M.SG+FUT+2+SG
despiedá-lo	despiedar+V.ele.ACC.3.M.SG+INF+1+SG
despiedá-lo	despiedar+V.ele.ACC.3.M.SG+INF+3+SG
despieda-lo	despiedar+V.ele.ACC.3.M.SG+PRS+2+SG
despiedá-lo	despiedar+V.ele.ACC.3.M.SG+SBJF+1+SG
despiedá-lo	despiedar+V.ele.ACC.3.M.SG+SBJF+3+SG
despiedá-lo-ei	despiedar+V.ele.ACC.3.M.SG+FUT+1+SG
despiedá-lo-eis	despiedar+V.ele.ACC.3.M.SG+FUT+2+PL
despiedá-lo-emos	despiedar+V.ele.ACC.3.M.SG+FUT+1+PL
despiedá-lo-ia	despiedar+V.ele.ACC.3.M.SG+COND+1+SG
despiedá-lo-ia	despiedar+V.ele.ACC.3.M.SG+COND+3+SG
despiedá-lo-iam	despiedar+V.ele.ACC.3.M.SG+COND+3+PL
despiedá-lo-íamos	despiedar+V.ele.ACC.3.M.SG+COND+1+PL
despiedá-lo-ias	despiedar+V.ele.ACC.3.M.SG+COND+2+SG
despiedá-lo-íeis	despiedar+V.ele.ACC.3.M.SG+COND+2+PL
despiedá-los-á	despiedar+V.ele.ACC.3.M.PL+FUT+3+SG
despiedá-los-ão	despiedar+V.ele.ACC.3.M.PL+FUT+3+PL
despiedá-los-ás	despiedar+V.ele.ACC.3.M.PL+FUT+2+SG
despiedá-los	despiedar+V.ele.ACC.3.M.PL+INF+1+SG
despiedá-los	despiedar+V.ele.ACC.3.M.PL+INF+3+SG
despieda-los	despiedar+V.ele.ACC.3.M.PL+PRS+2+SG
despiedá-los	despiedar+V.ele.ACC.3.M.PL+SBJF+1+SG
despiedá-los	despiedar+V.ele.ACC.3.M.PL+SBJF+3+SG
despiedá-los-ei	despiedar+V.ele.ACC.3.M.PL+FUT+1+SG
despiedá-los-eis	despiedar+V.ele.ACC.3.M.PL+FUT+2+PL
despiedá-los-emos	despiedar+V.ele.ACC.3.M.PL+FUT+1+PL
despiedá-los-ia	despiedar+V.ele.ACC.3.M.PL+COND+1+SG
despiedá-los-ia	despiedar+V.ele.ACC.3.M.PL+COND+3+SG
despiedá-los-iam	despiedar+V.ele.ACC.3.M.PL+COND+3+PL
despiedá-los-íamos	despiedar+V.ele.ACC.3.M.PL+COND+1+PL
despiedá-los-ias	despiedar+V.ele.ACC.3.M.PL+COND+2+SG
despiedá-los-íeis	despiedar+V.ele.ACC.3.M.PL+COND+2+PL
despieda-me	despiedar+V.eu.AD.1.SG+PRS+3+SG
despiedam-lhe	despiedar+V.ele.DAT.3.SG+PRS+3+PL
despiedam-lhes	despiedar+V.ele.DAT.3.PL+PRS+3+PL
despiedam-me	despiedar+V.eu.AD.1.SG+PRS+3+PL
despiedam-na	despiedar+V.ele.ACC.3.F.SG+PRS+3+PL
despiedam-nas	despiedar+V.ele.ACC.3.F.PL+PRS+3+PL
despiedam-no	despiedar+V.ele.ACC.3.M.SG+PRS+3+PL
despiedam-nos	despiedar+V.ele.ACC.3.M.PL+PRS+3+PL
despiedam-nos	despiedar+V.nós.AD.1.PL+PRS+3+PL
despiedamo-la	despiedar+V.ele.ACC.3.F.SG+PRF+1+PL
despiedamo-la	despiedar+V.ele.ACC.3.F.SG+PRS+1+PL
despiedamo-las	despiedar+V.ele.ACC.3.F.PL+PRF+1+PL
despiedamo-las	despiedar+V.ele.ACC.3.F.PL+PRS+1+PL
despiedamo-lo	despiedar+V.ele.ACC.3.M.SG+PRF+1+PL
despiedamo-lo	despiedar+V.ele.ACC.3.M.SG+PRS+1+PL
despiedamo-los	despiedar+V.ele.ACC.3.M.PL+PRF+1+PL
despiedamo-los	despiedar+V.ele.ACC.3.M.PL+PRS+1+PL
despiedamo-nos	despiedar+nós.AD.1.PL+PRF+1+PL
despiedamo-nos	despiedar+nós.AD.1.PL+PRS+1+PL
despiedamos-lhe	despiedar+V.ele.DAT.3.SG+PRF+1+PL
despiedamos-lhe	despiedar+V.ele.DAT.3.SG+PRS+1+PL
despiedamos-lhes	despiedar+V.ele.DAT.3.PL+PRF+1+PL
despiedamos-lhes	despiedar+V.ele.DAT.3.PL+PRS+1+PL
despiedamos-me	despiedar+V.eu.AD.1.SG+PRF+1+PL
despiedamos-me	despiedar+V.eu.AD.1.SG+PRS+1+PL
despiedamos-te	despiedar+V.tu.AD.2.SG+PRF+1+PL
despiedamos-te	despiedar+V.tu.AD.2.SG+PRS+1+PL
despiedamos-vos	despiedar+V.vós.AD.2.PL+PRF+1+PL
despiedamos-vos	despiedar+V.vós.AD.2.PL+PRS+1+PL
despiedam-se	despiedar+V.ele.REFL+PRS+3+PL
despiedam-te	despiedar+V.tu.AD.2.SG+PRS+3+PL
despiedam-vos	despiedar+V.vós.AD.2.PL+PRS+3+PL
despiedando-a	despiedar+V.ele.ACC.3.F.SG+GRD
despiedando-as	despiedar+V.ele.ACC.3.F.PL+GRD
despiedando-lhe	despiedar+V.ele.DAT.3.SG+GRD
despiedando-lhes	despiedar+V.ele.DAT.3.PL+GRD
despiedando-me	despiedar+V.eu.AD.1.SG+GRD
despiedando-nos	despiedar+nós.AD.1.PL+GRD
despiedando-o	despiedar+V.ele.ACC.3.M.SG+GRD
despiedando-os	despiedar+V.ele.ACC.3.M.PL+GRD
despiedando-se	despiedar+V.ele.REFL+GRD
despiedando-te	despiedar+V.tu.AD.2.SG+GRD
despiedando-vos	despiedar+V.vós.AD.2.PL+GRD
despieda-nos	despiedar+nós.AD.1.PL+PRS+2+SG
despieda-nos	despiedar+nós.AD.1.PL+PRS+3+SG
despieda-o	despiedar+V.ele.ACC.3.M.SG+PRS+3+SG
despieda-os	despiedar+V.ele.ACC.3.M.PL+PRS+3+SG
despiedara-a	despiedar+V.ele.ACC.3.F.SG+PQP+1+SG
despiedara-a	despiedar+V.ele.ACC.3.F.SG+PQP+3+SG
despiedara-as	despiedar+V.ele.ACC.3.F.PL+PQP+1+SG
despiedara-as	despiedar+V.ele.ACC.3.F.PL+PQP+3+SG
despiedara-la	despiedar+V.ele.ACC.3.F.SG+PQP+2+SG
despiedara-las	despiedar+V.ele.ACC.3.F.PL+PQP+2+SG
despiedara-lhe	despiedar+V.ele.DAT.3.SG+PQP+1+SG
despiedara-lhe	despiedar+V.ele.DAT.3.SG+PQP+3+SG
despiedara-lhes	despiedar+V.ele.DAT.3.PL+PQP+1+SG
despiedara-lhes	despiedar+V.ele.DAT.3.PL+PQP+3+SG
despiedara-lo	despiedar+V.ele.ACC.3.M.SG+PQP+2+SG
despiedara-los	despiedar+V.ele.ACC.3.M.PL+PQP+2+SG
despiedara-me	despiedar+V.eu.AD.1.SG+PQP+1+SG
despiedara-me	despiedar+V.eu.AD.1.SG+PQP+3+SG
despiedaram-lhe	despiedar+V.ele.DAT.3.SG+PQP+3+PL
despiedaram-lhe	despiedar+V.ele.DAT.3.SG+PRF+3+PL
despiedaram-lhes	despiedar+V.ele.DAT.3.PL+PQP+3+PL
despiedaram-lhes	despiedar+V.ele.DAT.3.PL+PRF+3+PL
despiedaram-me	despiedar+V.eu.AD.1.SG+PQP+3+PL
despiedaram-me	despiedar+V.eu.AD.1.SG+PRF+3+PL
despiedaram-na	despiedar+V.ele.ACC.3.F.SG+PQP+3+PL
despiedaram-na	despiedar+V.ele.ACC.3.F.SG+PRF+3+PL
despiedaram-nas	despiedar+V.ele.ACC.3.F.PL+PQP+3+PL
despiedaram-nas	despiedar+V.ele.ACC.3.F.PL+PRF+3+PL
despiedaram-no	despiedar+V.ele.ACC.3.M.SG+PQP+3+PL
despiedaram-no	despiedar+V.ele.ACC.3.M.SG+PRF+3+PL
despiedaram-nos	despiedar+V.ele.ACC.3.M.PL+PQP+3+PL
despiedaram-nos	despiedar+V.ele.ACC.3.M.PL+PRF+3+PL
despiedaram-nos	despiedar+V.nós.AD.1.PL+PQP+3+PL
despiedaram-nos	despiedar+V.nós.AD.1.PL+PRF+3+PL
despiedáramo-la	despiedar+V.ele.ACC.3.F.SG+PQP+1+PL
despiedáramo-las	despiedar+V.ele.ACC.3.F.PL+PQP+1+PL
despiedáramo-lo	despiedar+V.ele.ACC.3.M.SG+PQP+1+PL
despiedáramo-los	despiedar+V.ele.ACC.3.M.PL+PQP+1+PL
despiedáramo-nos	despiedar+nós.AD.1.PL+PQP+1+PL
despiedáramos-lhe	despiedar+V.ele.DAT.3.SG+PQP+1+PL
despiedáramos-lhes	despiedar+V.ele.DAT.3.PL+PQP+1+PL
despiedáramos-me	despiedar+V.eu.AD.1.SG+PQP+1+PL
despiedáramos-te	despiedar+V.tu.AD.2.SG+PQP+1+PL
despiedáramos-vos	despiedar+V.vós.AD.2.PL+PQP+1+PL
despiedaram-se	despiedar+V.ele.REFL+PQP+3+PL
despiedaram-se	despiedar+V.ele.REFL+PRF+3+PL
despiedaram-te	despiedar+V.tu.AD.2.SG+PQP+3+PL
despiedaram-te	despiedar+V.tu.AD.2.SG+PRF+3+PL
despiedaram-vos	despiedar+V.vós.AD.2.PL+PQP+3+PL
despiedaram-vos	despiedar+V.vós.AD.2.PL+PRF+3+PL
despiedara-nos	despiedar+nós.AD.1.PL+PQP+1+SG
despiedara-nos	despiedar+nós.AD.1.PL+PQP+2+SG
despiedara-nos	despiedar+nós.AD.1.PL+PQP+3+SG
despiedara-o	despiedar+V.ele.ACC.3.M.SG+PQP+1+SG
despiedara-o	despiedar+V.ele.ACC.3.M.SG+PQP+3+SG
despiedara-os	despiedar+V.ele.ACC.3.M.PL+PQP+1+SG
despiedara-os	despiedar+V.ele.ACC.3.M.PL+PQP+3+SG
despiedara-se	despiedar+V.ele.REFL+PQP+1+SG
despiedara-se	despiedar+V.ele.REFL+PQP+3+SG
despiedaras-lhe	despiedar+V.ele.DAT.3.SG+PQP+2+SG
despiedaras-lhes	despiedar+V.ele.DAT.3.PL+PQP+2+SG
despiedaras-me	despiedar+V.eu.AD.1.SG+PQP+2+SG
despiedaras-te	despiedar+V.tu.AD.2.SG+PQP+2+SG
despiedaras-vos	despiedar+V.vós.AD.2.PL+PQP+2+SG
despiedara-te	despiedar+V.tu.AD.2.SG+PQP+1+SG
despiedara-te	despiedar+V.tu.AD.2.SG+PQP+3+SG
despiedara-vos	despiedar+V.vós.AD.2.PL+PQP+1+SG
despiedara-vos	despiedar+V.vós.AD.2.PL+PQP+3+SG
despiedarde-la	despiedar+V.ele.ACC.3.F.SG+INF+2+PL
despiedarde-la	despiedar+V.ele.ACC.3.F.SG+SBJF+2+PL
despiedarde-las	despiedar+V.ele.ACC.3.F.PL+INF+2+PL
despiedarde-las	despiedar+V.ele.ACC.3.F.PL+SBJF+2+PL
despiedarde-lo	despiedar+V.ele.ACC.3.M.SG+INF+2+PL
despiedarde-lo	despiedar+V.ele.ACC.3.M.SG+SBJF+2+PL
despiedarde-los	despiedar+V.ele.ACC.3.M.PL+INF+2+PL
despiedarde-los	despiedar+V.ele.ACC.3.M.PL+SBJF+2+PL
despiedarde-nos	despiedar+nós.AD.1.PL+INF+2+PL
despiedarde-nos	despiedar+nós.AD.1.PL+SBJF+2+PL
despiedardes-lhe	despiedar+V.ele.DAT.3.SG+INF+2+PL
despiedardes-lhe	despiedar+V.ele.DAT.3.SG+SBJF+2+PL
despiedardes-lhes	despiedar+V.ele.DAT.3.PL+INF+2+PL
despiedardes-lhes	despiedar+V.ele.DAT.3.PL+SBJF+2+PL
despiedardes-me	despiedar+V.eu.AD.1.SG+INF+2+PL
despiedardes-me	despiedar+V.eu.AD.1.SG+SBJF+2+PL
despiedardes-te	despiedar+V.tu.AD.2.SG+INF+2+PL
despiedardes-te	despiedar+V.tu.AD.2.SG+SBJF+2+PL
despiedardes-vos	despiedar+V.vós.AD.2.PL+INF+2+PL
despiedardes-vos	despiedar+V.vós.AD.2.PL+SBJF+2+PL
despiedárei-la	despiedar+V.ele.ACC.3.F.SG+PQP+2+PL
despiedárei-las	despiedar+V.ele.ACC.3.F.PL+PQP+2+PL
despiedárei-lo	despiedar+V.ele.ACC.3.M.SG+PQP+2+PL
despiedárei-los	despiedar+V.ele.ACC.3.M.PL+PQP+2+PL
despiedárei-nos	despiedar+nós.AD.1.PL+PQP+2+PL
despiedáreis-lhe	despiedar+V.ele.DAT.3.SG+PQP+2+PL
despiedáreis-lhes	despiedar+V.ele.DAT.3.PL+PQP+2+PL
despiedáreis-me	despiedar+V.eu.AD.1.SG+PQP+2+PL
despiedáreis-te	despiedar+V.tu.AD.2.SG+PQP+2+PL
despiedáreis-vos	despiedar+V.vós.AD.2.PL+PQP+2+PL
despiedare-la	despiedar+V.ele.ACC.3.F.SG+INF+2+SG
despiedare-la	despiedar+V.ele.ACC.3.F.SG+SBJF+2+SG
despiedare-las	despiedar+V.ele.ACC.3.F.PL+INF+2+SG
despiedare-las	despiedar+V.ele.ACC.3.F.PL+SBJF+2+SG
despiedare-lo	despiedar+V.ele.ACC.3.M.SG+INF+2+SG
despiedare-lo	despiedar+V.ele.ACC.3.M.SG+SBJF+2+SG
despiedare-los	despiedar+V.ele.ACC.3.M.PL+INF+2+SG
despiedare-los	despiedar+V.ele.ACC.3.M.PL+SBJF+2+SG
despiedarem-lhe	despiedar+V.ele.DAT.3.SG+INF+3+PL
despiedarem-lhe	despiedar+V.ele.DAT.3.SG+SBJF+3+PL
despiedarem-lhes	despiedar+V.ele.DAT.3.PL+INF+3+PL
despiedarem-lhes	despiedar+V.ele.DAT.3.PL+SBJF+3+PL
despiedarem-me	despiedar+V.eu.AD.1.SG+INF+3+PL
despiedarem-me	despiedar+V.eu.AD.1.SG+SBJF+3+PL
despiedarem-na	despiedar+V.ele.ACC.3.F.SG+INF+3+PL
despiedarem-na	despiedar+V.ele.ACC.3.F.SG+SBJF+3+PL
despiedarem-nas	despiedar+V.ele.ACC.3.F.PL+INF+3+PL
despiedarem-nas	despiedar+V.ele.ACC.3.F.PL+SBJF+3+PL
despiedarem-no	despiedar+V.ele.ACC.3.M.SG+INF+3+PL
despiedarem-no	despiedar+V.ele.ACC.3.M.SG+SBJF+3+PL
despiedarem-nos	despiedar+V.ele.ACC.3.M.PL+INF+3+PL
despiedarem-nos	despiedar+V.ele.ACC.3.M.PL+SBJF+3+PL
despiedarem-nos	despiedar+V.nós.AD.1.PL+INF+3+PL
despiedarem-nos	despiedar+V.nós.AD.1.PL+SBJF+3+PL
despiedarem-se	despiedar+V.ele.REFL+INF+3+PL
despiedarem-se	despiedar+V.ele.REFL+SBJF+3+PL
despiedarem-te	despiedar+V.tu.AD.2.SG+INF+3+PL
despiedarem-te	despiedar+V.tu.AD.2.SG+SBJF+3+PL
despiedarem-vos	despiedar+V.vós.AD.2.PL+INF+3+PL
despiedarem-vos	despiedar+V.vós.AD.2.PL+SBJF+3+PL
despiedare-nos	despiedar+nós.AD.1.PL+INF+2+SG
despiedare-nos	despiedar+nós.AD.1.PL+SBJF+2+SG
despiedares-lhe	despiedar+V.ele.DAT.3.SG+INF+2+SG
despiedares-lhe	despiedar+V.ele.DAT.3.SG+SBJF+2+SG
despiedares-lhes	despiedar+V.ele.DAT.3.PL+INF+2+SG
despiedares-lhes	despiedar+V.ele.DAT.3.PL+SBJF+2+SG
despiedares-me	despiedar+V.eu.AD.1.SG+INF+2+SG
despiedares-me	despiedar+V.eu.AD.1.SG+SBJF+2+SG
despiedares-te	despiedar+V.tu.AD.2.SG+INF+2+SG
despiedares-te	despiedar+V.tu.AD.2.SG+SBJF+2+SG
despiedares-vos	despiedar+V.vós.AD.2.PL+INF+2+SG
despiedares-vos	despiedar+V.vós.AD.2.PL+SBJF+2+SG
despiedar-lhe-á	despiedar+V.ele.DAT.3.SG+FUT+3+SG
despiedar-lhe-ão	despiedar+V.ele.DAT.3.SG+FUT+3+PL
despiedar-lhe-ás	despiedar+V.ele.DAT.3.SG+FUT+2+SG
despiedar-lhe	despiedar+V.ele.DAT.3.SG+INF
despiedar-lhe	despiedar+V.ele.DAT.3.SG+INF+1+SG
despiedar-lhe	despiedar+V.ele.DAT.3.SG+INF+3+SG
despiedar-lhe	despiedar+V.ele.DAT.3.SG+SBJF+1+SG
despiedar-lhe	despiedar+V.ele.DAT.3.SG+SBJF+3+SG
despiedar-lhe-ei	despiedar+V.ele.DAT.3.SG+FUT+1+SG
despiedar-lhe-eis	despiedar+V.ele.DAT.3.SG+FUT+2+PL
despiedar-lhe-emos	despiedar+V.ele.DAT.3.SG+FUT+1+PL
despiedar-lhe-ia	despiedar+V.ele.DAT.3.SG+COND+1+SG
despiedar-lhe-ia	despiedar+V.ele.DAT.3.SG+COND+3+SG
despiedar-lhe-iam	despiedar+V.ele.DAT.3.SG+COND+3+PL
despiedar-lhe-íamos	despiedar+V.ele.DAT.3.SG+COND+1+PL
despiedar-lhe-ias	despiedar+V.ele.DAT.3.SG+COND+2+SG
