desquartinar-me-ás	desquartinar+V.eu.AD.1.SG+FUT+2+SG
desquartinar-me	desquartinar+V.eu.AD.1.SG+INF
desquartinar-me	desquartinar+V.eu.AD.1.SG+INF+1+SG
desquartinar-me	desquartinar+V.eu.AD.1.SG+INF+3+SG
desquartinar-me	desquartinar+V.eu.AD.1.SG+SBJF+1+SG
desquartinar-me	desquartinar+V.eu.AD.1.SG+SBJF+3+SG
desquartinar-me-ei	desquartinar+V.eu.AD.1.SG+FUT+1+SG
desquartinar-me-eis	desquartinar+V.eu.AD.1.SG+FUT+2+PL
desquartinar-me-emos	desquartinar+V.eu.AD.1.SG+FUT+1+PL
desquartinar-me-ia	desquartinar+V.eu.AD.1.SG+COND+1+SG
desquartinar-me-ia	desquartinar+V.eu.AD.1.SG+COND+3+SG
desquartinar-me-iam	desquartinar+V.eu.AD.1.SG+COND+3+PL
desquartinar-me-íamos	desquartinar+V.eu.AD.1.SG+COND+1+PL
desquartinar-me-ias	desquartinar+V.eu.AD.1.SG+COND+2+SG
desquartinar-me-íeis	desquartinar+V.eu.AD.1.SG+COND+2+PL
desquartinarmo-la	desquartinar+V.ele.ACC.3.F.SG+INF+1+PL
desquartinarmo-la	desquartinar+V.ele.ACC.3.F.SG+SBJF+1+PL
desquartinarmo-las	desquartinar+V.ele.ACC.3.F.PL+INF+1+PL
desquartinarmo-las	desquartinar+V.ele.ACC.3.F.PL+SBJF+1+PL
desquartinarmo-lo	desquartinar+V.ele.ACC.3.M.SG+INF+1+PL
desquartinarmo-lo	desquartinar+V.ele.ACC.3.M.SG+SBJF+1+PL
desquartinarmo-los	desquartinar+V.ele.ACC.3.M.PL+INF+1+PL
desquartinarmo-los	desquartinar+V.ele.ACC.3.M.PL+SBJF+1+PL
desquartinarmo-nos	desquartinar+nós.AD.1.PL+INF+1+PL
desquartinarmo-nos	desquartinar+nós.AD.1.PL+SBJF+1+PL
desquartinarmos-lhe	desquartinar+V.ele.DAT.3.SG+INF+1+PL
desquartinarmos-lhe	desquartinar+V.ele.DAT.3.SG+SBJF+1+PL
desquartinarmos-lhes	desquartinar+V.ele.DAT.3.PL+INF+1+PL
desquartinarmos-lhes	desquartinar+V.ele.DAT.3.PL+SBJF+1+PL
desquartinarmos-me	desquartinar+V.eu.AD.1.SG+INF+1+PL
desquartinarmos-me	desquartinar+V.eu.AD.1.SG+SBJF+1+PL
desquartinarmos-te	desquartinar+V.tu.AD.2.SG+INF+1+PL
desquartinarmos-te	desquartinar+V.tu.AD.2.SG+SBJF+1+PL
desquartinarmos-vos	desquartinar+V.vós.AD.2.PL+INF+1+PL
desquartinarmos-vos	desquartinar+V.vós.AD.2.PL+SBJF+1+PL
desquartinar-nos-á	desquartinar+nós.AD.1.PL+FUT+3+SG
desquartinar-nos-ão	desquartinar+nós.AD.1.PL+FUT+3+PL
desquartinar-nos-ás	desquartinar+nós.AD.1.PL+FUT+2+SG
desquartinar-nos	desquartinar+nós.AD.1.PL+INF
desquartinar-nos	desquartinar+nós.AD.1.PL+INF+1+SG
desquartinar-nos	desquartinar+nós.AD.1.PL+INF+3+SG
desquartinar-nos	desquartinar+nós.AD.1.PL+SBJF+1+SG
desquartinar-nos	desquartinar+nós.AD.1.PL+SBJF+3+SG
desquartinar-nos-ei	desquartinar+nós.AD.1.PL+FUT+1+SG
desquartinar-nos-eis	desquartinar+nós.AD.1.PL+FUT+2+PL
desquartinar-nos-emos	desquartinar+nós.AD.1.PL+FUT+1+PL
desquartinar-nos-ia	desquartinar+nós.AD.1.PL+COND+1+SG
desquartinar-nos-ia	desquartinar+nós.AD.1.PL+COND+3+SG
desquartinar-nos-iam	desquartinar+nós.AD.1.PL+COND+3+PL
desquartinar-nos-íamos	desquartinar+nós.AD.1.PL+COND+1+PL
desquartinar-nos-ias	desquartinar+nós.AD.1.PL+COND+2+SG
desquartinar-nos-íeis	desquartinar+nós.AD.1.PL+COND+2+PL
desquartinar-se-á	desquartinar+V.ele.REFL+FUT+3+SG
desquartinar-se-ão	desquartinar+V.ele.REFL+FUT+3+PL
desquartinar-se	desquartinar+V.ele.REFL+INF
desquartinar-se	desquartinar+V.ele.REFL+INF+3+SG
desquartinar-se	desquartinar+V.ele.REFL+SBJF+3+SG
desquartinar-se-ia	desquartinar+V.ele.REFL+COND+3+SG
desquartinar-se-iam	desquartinar+V.ele.REFL+COND+3+PL
desquartinar-te-á	desquartinar+V.tu.AD.2.SG+FUT+3+SG
desquartinar-te-ão	desquartinar+V.tu.AD.2.SG+FUT+3+PL
desquartinar-te-ás	desquartinar+V.tu.AD.2.SG+FUT+2+SG
desquartinar-te	desquartinar+V.tu.AD.2.SG+INF
desquartinar-te	desquartinar+V.tu.AD.2.SG+INF+1+SG
desquartinar-te	desquartinar+V.tu.AD.2.SG+INF+3+SG
desquartinar-te	desquartinar+V.tu.AD.2.SG+SBJF+1+SG
desquartinar-te	desquartinar+V.tu.AD.2.SG+SBJF+3+SG
desquartinar-te-ei	desquartinar+V.tu.AD.2.SG+FUT+1+SG
desquartinar-te-eis	desquartinar+V.tu.AD.2.SG+FUT+2+PL
desquartinar-te-emos	desquartinar+V.tu.AD.2.SG+FUT+1+PL
desquartinar-te-ia	desquartinar+V.tu.AD.2.SG+COND+1+SG
desquartinar-te-ia	desquartinar+V.tu.AD.2.SG+COND+3+SG
desquartinar-te-iam	desquartinar+V.tu.AD.2.SG+COND+3+PL
desquartinar-te-íamos	desquartinar+V.tu.AD.2.SG+COND+1+PL
desquartinar-te-ias	desquartinar+V.tu.AD.2.SG+COND+2+SG
desquartinar-te-íeis	desquartinar+V.tu.AD.2.SG+COND+2+PL
desquartinar-vos-á	desquartinar+V.vós.AD.2.PL+FUT+3+SG
desquartinar-vos-ão	desquartinar+V.vós.AD.2.PL+FUT+3+PL
desquartinar-vos-ás	desquartinar+V.vós.AD.2.PL+FUT+2+SG
desquartinar-vos	desquartinar+V.vós.AD.2.PL+INF
desquartinar-vos	desquartinar+V.vós.AD.2.PL+INF+1+SG
desquartinar-vos	desquartinar+V.vós.AD.2.PL+INF+3+SG
desquartinar-vos	desquartinar+V.vós.AD.2.PL+SBJF+1+SG
desquartinar-vos	desquartinar+V.vós.AD.2.PL+SBJF+3+SG
desquartinar-vos-ei	desquartinar+V.vós.AD.2.PL+FUT+1+SG
desquartinar-vos-eis	desquartinar+V.vós.AD.2.PL+FUT+2+PL
desquartinar-vos-emos	desquartinar+V.vós.AD.2.PL+FUT+1+PL
desquartinar-vos-ia	desquartinar+V.vós.AD.2.PL+COND+1+SG
desquartinar-vos-ia	desquartinar+V.vós.AD.2.PL+COND+3+SG
desquartinar-vos-iam	desquartinar+V.vós.AD.2.PL+COND+3+PL
desquartinar-vos-íamos	desquartinar+V.vós.AD.2.PL+COND+1+PL
desquartinar-vos-ias	desquartinar+V.vós.AD.2.PL+COND+2+SG
desquartinar-vos-íeis	desquartinar+V.vós.AD.2.PL+COND+2+PL
desquartina-se	desquartinar+V.ele.REFL+PRS+3+SG
desquartinas-lhe	desquartinar+V.ele.DAT.3.SG+PRS+2+SG
desquartinas-lhes	desquartinar+V.ele.DAT.3.PL+PRS+2+SG
desquartinas-me	desquartinar+V.eu.AD.1.SG+PRS+2+SG
desquartinaste-a	desquartinar+V.ele.ACC.3.F.SG+PRF+2+SG
desquartinaste-as	desquartinar+V.ele.ACC.3.F.PL+PRF+2+SG
desquartinas-te	desquartinar+V.tu.AD.2.SG+PRS+2+SG
desquartinaste-la	desquartinar+V.ele.ACC.3.F.SG+PRF+2+PL
desquartinaste-las	desquartinar+V.ele.ACC.3.F.PL+PRF+2+PL
desquartinaste-lhe	desquartinar+V.ele.DAT.3.SG+PRF+2+SG
desquartinaste-lhes	desquartinar+V.ele.DAT.3.PL+PRF+2+SG
desquartinaste-lo	desquartinar+V.ele.ACC.3.M.SG+PRF+2+PL
desquartinaste-los	desquartinar+V.ele.ACC.3.M.PL+PRF+2+PL
desquartinaste-me	desquartinar+V.eu.AD.1.SG+PRF+2+SG
desquartinaste-nos	desquartinar+nós.AD.1.PL+PRF+2+PL
desquartinaste-nos	desquartinar+nós.AD.1.PL+PRF+2+SG
desquartinaste-o	desquartinar+V.ele.ACC.3.M.SG+PRF+2+SG
desquartinaste-os	desquartinar+V.ele.ACC.3.M.PL+PRF+2+SG
desquartinastes-lhe	desquartinar+V.ele.DAT.3.SG+PRF+2+PL
desquartinastes-lhes	desquartinar+V.ele.DAT.3.PL+PRF+2+PL
desquartinastes-me	desquartinar+V.eu.AD.1.SG+PRF+2+PL
desquartinastes-te	desquartinar+V.tu.AD.2.SG+PRF+2+PL
desquartinastes-vos	desquartinar+V.vós.AD.2.PL+PRF+2+PL
desquartinaste-te	desquartinar+V.tu.AD.2.SG+PRF+2+SG
desquartinaste-vos	desquartinar+V.vós.AD.2.PL+PRF+2+SG
desquartinas-vos	desquartinar+V.vós.AD.2.PL+PRS+2+SG
desquartina-te	desquartinar+V.tu.AD.2.SG+PRS+3+SG
desquartinava-a	desquartinar+V.ele.ACC.3.F.SG+IMPF+1+SG
desquartinava-a	desquartinar+V.ele.ACC.3.F.SG+IMPF+3+SG
desquartinava-as	desquartinar+V.ele.ACC.3.F.PL+IMPF+1+SG
desquartinava-as	desquartinar+V.ele.ACC.3.F.PL+IMPF+3+SG
desquartinava-la	desquartinar+V.ele.ACC.3.F.SG+IMPF+2+SG
desquartinava-las	desquartinar+V.ele.ACC.3.F.PL+IMPF+2+SG
desquartinava-lhe	desquartinar+V.ele.DAT.3.SG+IMPF+1+SG
desquartinava-lhe	desquartinar+V.ele.DAT.3.SG+IMPF+3+SG
desquartinava-lhes	desquartinar+V.ele.DAT.3.PL+IMPF+1+SG
desquartinava-lhes	desquartinar+V.ele.DAT.3.PL+IMPF+3+SG
desquartinava-lo	desquartinar+V.ele.ACC.3.M.SG+IMPF+2+SG
desquartinava-los	desquartinar+V.ele.ACC.3.M.PL+IMPF+2+SG
desquartinava-me	desquartinar+V.eu.AD.1.SG+IMPF+1+SG
desquartinava-me	desquartinar+V.eu.AD.1.SG+IMPF+3+SG
desquartinavam-lhe	desquartinar+V.ele.DAT.3.SG+IMPF+3+PL
desquartinavam-lhes	desquartinar+V.ele.DAT.3.PL+IMPF+3+PL
desquartinavam-me	desquartinar+V.eu.AD.1.SG+IMPF+3+PL
desquartinavam-na	desquartinar+V.ele.ACC.3.F.SG+IMPF+3+PL
desquartinavam-nas	desquartinar+V.ele.ACC.3.F.PL+IMPF+3+PL
desquartinavam-no	desquartinar+V.ele.ACC.3.M.SG+IMPF+3+PL
desquartinavam-nos	desquartinar+V.ele.ACC.3.M.PL+IMPF+3+PL
desquartinavam-nos	desquartinar+V.nós.AD.1.PL+IMPF+3+PL
desquartinávamo-la	desquartinar+V.ele.ACC.3.F.SG+IMPF+1+PL
desquartinávamo-las	desquartinar+V.ele.ACC.3.F.PL+IMPF+1+PL
desquartinávamo-lo	desquartinar+V.ele.ACC.3.M.SG+IMPF+1+PL
desquartinávamo-los	desquartinar+V.ele.ACC.3.M.PL+IMPF+1+PL
desquartinávamo-nos	desquartinar+nós.AD.1.PL+IMPF+1+PL
desquartinávamos-lhe	desquartinar+V.ele.DAT.3.SG+IMPF+1+PL
desquartinávamos-lhes	desquartinar+V.ele.DAT.3.PL+IMPF+1+PL
desquartinávamos-me	desquartinar+V.eu.AD.1.SG+IMPF+1+PL
desquartinávamos-te	desquartinar+V.tu.AD.2.SG+IMPF+1+PL
desquartinávamos-vos	desquartinar+V.vós.AD.2.PL+IMPF+1+PL
desquartinavam-se	desquartinar+V.ele.REFL+IMPF+3+PL
desquartinavam-te	desquartinar+V.tu.AD.2.SG+IMPF+3+PL
desquartinavam-vos	desquartinar+V.vós.AD.2.PL+IMPF+3+PL
desquartinava-nos	desquartinar+nós.AD.1.PL+IMPF+1+SG
desquartinava-nos	desquartinar+nós.AD.1.PL+IMPF+2+SG
desquartinava-nos	desquartinar+nós.AD.1.PL+IMPF+3+SG
desquartinava-o	desquartinar+V.ele.ACC.3.M.SG+IMPF+1+SG
desquartinava-o	desquartinar+V.ele.ACC.3.M.SG+IMPF+3+SG
desquartinava-os	desquartinar+V.ele.ACC.3.M.PL+IMPF+1+SG
desquartinava-os	desquartinar+V.ele.ACC.3.M.PL+IMPF+3+SG
desquartinava-se	desquartinar+V.ele.REFL+IMPF+1+SG
desquartinava-se	desquartinar+V.ele.REFL+IMPF+3+SG
desquartinavas-lhe	desquartinar+V.ele.DAT.3.SG+IMPF+2+SG
desquartinavas-lhes	desquartinar+V.ele.DAT.3.PL+IMPF+2+SG
desquartinavas-me	desquartinar+V.eu.AD.1.SG+IMPF+2+SG
desquartinavas-te	desquartinar+V.tu.AD.2.SG+IMPF+2+SG
desquartinavas-vos	desquartinar+V.vós.AD.2.PL+IMPF+2+SG
desquartinava-te	desquartinar+V.tu.AD.2.SG+IMPF+1+SG
desquartinava-te	desquartinar+V.tu.AD.2.SG+IMPF+3+SG
desquartinava-vos	desquartinar+V.vós.AD.2.PL+IMPF+1+SG
desquartinava-vos	desquartinar+V.vós.AD.2.PL+IMPF+3+SG
desquartinávei-la	desquartinar+V.ele.ACC.3.F.SG+IMPF+2+PL
desquartinávei-las	desquartinar+V.ele.ACC.3.F.PL+IMPF+2+PL
desquartinávei-lo	desquartinar+V.ele.ACC.3.M.SG+IMPF+2+PL
desquartinávei-los	desquartinar+V.ele.ACC.3.M.PL+IMPF+2+PL
desquartinávei-nos	desquartinar+nós.AD.1.PL+IMPF+2+PL
desquartináveis-lhe	desquartinar+V.ele.DAT.3.SG+IMPF+2+PL
desquartináveis-lhes	desquartinar+V.ele.DAT.3.PL+IMPF+2+PL
desquartináveis-me	desquartinar+V.eu.AD.1.SG+IMPF+2+PL
desquartináveis-te	desquartinar+V.tu.AD.2.SG+IMPF+2+PL
desquartináveis-vos	desquartinar+V.vós.AD.2.PL+IMPF+2+PL
desquartina-vos	desquartinar+V.vós.AD.2.PL+PRS+3+SG
desquartine-a	desquartinar+V.ele.ACC.3.F.SG+IMP+3+SG
desquartine-as	desquartinar+V.ele.ACC.3.F.PL+IMP+3+SG
desquartinei-a	desquartinar+V.ele.ACC.3.F.SG+PRF+1+SG
desquartinei-as	desquartinar+V.ele.ACC.3.F.PL+PRF+1+SG
desquartinei-lhe	desquartinar+V.ele.DAT.3.SG+PRF+1+SG
desquartinei-lhes	desquartinar+V.ele.DAT.3.PL+PRF+1+SG
desquartinei-me	desquartinar+V.eu.AD.1.SG+PRF+1+SG
desquartinei-nos	desquartinar+nós.AD.1.PL+PRF+1+SG
desquartinei-o	desquartinar+V.ele.ACC.3.M.SG+PRF+1+SG
desquartinei-os	desquartinar+V.ele.ACC.3.M.PL+PRF+1+SG
desquartinei-te	desquartinar+V.tu.AD.2.SG+PRF+1+SG
desquartinei-vos	desquartinar+V.vós.AD.2.PL+PRF+1+SG
desquartine-lhe	desquartinar+V.ele.DAT.3.SG+IMP+3+SG
desquartine-lhes	desquartinar+V.ele.DAT.3.PL+IMP+3+SG
desquartine-me	desquartinar+V.eu.AD.1.SG+IMP+3+SG
desquartinem-lhe	desquartinar+V.ele.DAT.3.SG+IMP+3+PL
desquartinem-lhes	desquartinar+V.ele.DAT.3.PL+IMP+3+PL
desquartinem-me	desquartinar+V.eu.AD.1.SG+IMP+3+PL
desquartinem-na	desquartinar+V.ele.ACC.3.F.SG+IMP+3+PL
desquartinem-nas	desquartinar+V.ele.ACC.3.F.PL+IMP+3+PL
desquartinem-no	desquartinar+V.ele.ACC.3.M.SG+IMP+3+PL
desquartinem-nos	desquartinar+V.ele.ACC.3.M.PL+IMP+3+PL
desquartinem-nos	desquartinar+V.nós.AD.1.PL+IMP+3+PL
desquartinemo-la	desquartinar+V.ele.ACC.3.F.SG+IMP+1+PL
desquartinemo-las	desquartinar+V.ele.ACC.3.F.PL+IMP+1+PL
desquartinemo-lo	desquartinar+V.ele.ACC.3.M.SG+IMP+1+PL
desquartinemo-los	desquartinar+V.ele.ACC.3.M.PL+IMP+1+PL
desquartinemo-nos	desquartinar+nós.AD.1.PL+IMP+1+PL
desquartinemos-lhe	desquartinar+V.ele.DAT.3.SG+IMP+1+PL
desquartinemos-lhes	desquartinar+V.ele.DAT.3.PL+IMP+1+PL
desquartinemos-me	desquartinar+V.eu.AD.1.SG+IMP+1+PL
desquartinemos-te	desquartinar+V.tu.AD.2.SG+IMP+1+PL
desquartinemos-vos	desquartinar+V.vós.AD.2.PL+IMP+1+PL
desquartinem-se	desquartinar+V.ele.REFL+IMP+3+PL
desquartinem-te	desquartinar+V.tu.AD.2.SG+IMP+3+PL
desquartinem-vos	desquartinar+V.vós.AD.2.PL+IMP+3+PL
desquartine-nos	desquartinar+nós.AD.1.PL+IMP+3+SG
desquartine-o	desquartinar+V.ele.ACC.3.M.SG+IMP+3+SG
desquartine-os	desquartinar+V.ele.ACC.3.M.PL+IMP+3+SG
desquartine-se	desquartinar+V.ele.REFL+IMP+3+SG
desquartine-te	desquartinar+V.tu.AD.2.SG+IMP+3+SG
desquartine-vos	desquartinar+V.vós.AD.2.PL+IMP+3+SG
desquartino-a	desquartinar+V.ele.ACC.3.F.SG+PRS+1+SG
desquartino-as	desquartinar+V.ele.ACC.3.F.PL+PRS+1+SG
desquartino-lhe	desquartinar+V.ele.DAT.3.SG+PRS+1+SG
desquartino-lhes	desquartinar+V.ele.DAT.3.PL+PRS+1+SG
desquartino-me	desquartinar+V.eu.AD.1.SG+PRS+1+SG
desquartino-nos	desquartinar+nós.AD.1.PL+PRS+1+SG
desquartino-o	desquartinar+V.ele.ACC.3.M.SG+PRS+1+SG
desquartino-os	desquartinar+V.ele.ACC.3.M.PL+PRS+1+SG
desquartino-te	desquartinar+V.tu.AD.2.SG+PRS+1+SG
desquartinou-a	desquartinar+V.ele.ACC.3.F.SG+PRF+3+SG
desquartinou-as	desquartinar+V.ele.ACC.3.F.PL+PRF+3+SG
desquartinou-lhe	desquartinar+V.ele.DAT.3.SG+PRF+3+SG
desquartinou-lhes	desquartinar+V.ele.DAT.3.PL+PRF+3+SG
desquartinou-me	desquartinar+V.eu.AD.1.SG+PRF+3+SG
desquartinou-nos	desquartinar+nós.AD.1.PL+PRF+3+SG
desquartinou-o	desquartinar+V.ele.ACC.3.M.SG+PRF+3+SG
desquartinou-os	desquartinar+V.ele.ACC.3.M.PL+PRF+3+SG
desquartinou-se	desquartinar+V.ele.REFL+PRF+3+SG
desquartinou-te	desquartinar+V.tu.AD.2.SG+PRF+3+SG
desquartinou-vos	desquartinar+V.vós.AD.2.PL+PRF+3+SG
desquartino-vos	desquartinar+V.vós.AD.2.PL+PRS+1+SG
desquarto-a	desquartar+V.ele.ACC.3.F.SG+PRS+1+SG
desquarto-as	desquartar+V.ele.ACC.3.F.PL+PRS+1+SG
desquarto-lhe	desquartar+V.ele.DAT.3.SG+PRS+1+SG
desquarto-lhes	desquartar+V.ele.DAT.3.PL+PRS+1+SG
desquarto-me	desquartar+V.eu.AD.1.SG+PRS+1+SG
desquarto-nos	desquartar+nós.AD.1.PL+PRS+1+SG
desquarto-o	desquartar+V.ele.ACC.3.M.SG+PRS+1+SG
desquarto-os	desquartar+V.ele.ACC.3.M.PL+PRS+1+SG
desquarto-te	desquartar+V.tu.AD.2.SG+PRS+1+SG
desquartou-a	desquartar+V.ele.ACC.3.F.SG+PRF+3+SG
desquartou-as	desquartar+V.ele.ACC.3.F.PL+PRF+3+SG
desquartou-lhe	desquartar+V.ele.DAT.3.SG+PRF+3+SG
desquartou-lhes	desquartar+V.ele.DAT.3.PL+PRF+3+SG
desquartou-me	desquartar+V.eu.AD.1.SG+PRF+3+SG
desquartou-nos	desquartar+nós.AD.1.PL+PRF+3+SG
desquartou-o	desquartar+V.ele.ACC.3.M.SG+PRF+3+SG
desquartou-os	desquartar+V.ele.ACC.3.M.PL+PRF+3+SG
desquartou-se	desquartar+V.ele.REFL+PRF+3+SG
desquartou-te	desquartar+V.tu.AD.2.SG+PRF+3+SG
desquartou-vos	desquartar+V.vós.AD.2.PL+PRF+3+SG
desquarto-vos	desquartar+V.vós.AD.2.PL+PRS+1+SG
desquebra-a	desquebrar+V.ele.ACC.3.F.SG+PRS+3+SG
desquebra-as	desquebrar+V.ele.ACC.3.F.PL+PRS+3+SG
desquebrai-la	desquebrar+V.ele.ACC.3.F.SG+PRS+2+PL
desquebrai-las	desquebrar+V.ele.ACC.3.F.PL+PRS+2+PL
desquebrai-lo	desquebrar+V.ele.ACC.3.M.SG+PRS+2+PL
desquebrai-los	desquebrar+V.ele.ACC.3.M.PL+PRS+2+PL
desquebrai-nos	desquebrar+nós.AD.1.PL+PRS+2+PL
desquebrais-lhe	desquebrar+V.ele.DAT.3.SG+PRS+2+PL
desquebrais-lhes	desquebrar+V.ele.DAT.3.PL+PRS+2+PL
desquebrais-me	desquebrar+V.eu.AD.1.SG+PRS+2+PL
desquebrais-te	desquebrar+V.tu.AD.2.SG+PRS+2+PL
desquebrais-vos	desquebrar+V.vós.AD.2.PL+PRS+2+PL
desquebrá-la-á	desquebrar+V.ele.ACC.3.F.SG+FUT+3+SG
desquebrá-la-ão	desquebrar+V.ele.ACC.3.F.SG+FUT+3+PL
desquebrá-la-ás	desquebrar+V.ele.ACC.3.F.SG+FUT+2+SG
desquebrá-la	desquebrar+V.ele.ACC.3.F.SG+INF+1+SG
desquebrá-la	desquebrar+V.ele.ACC.3.F.SG+INF+3+SG
desquebra-la	desquebrar+V.ele.ACC.3.F.SG+PRS+2+SG
desquebrá-la	desquebrar+V.ele.ACC.3.F.SG+SBJF+1+SG
desquebrá-la	desquebrar+V.ele.ACC.3.F.SG+SBJF+3+SG
desquebrá-la-ei	desquebrar+V.ele.ACC.3.F.SG+FUT+1+SG
desquebrá-la-eis	desquebrar+V.ele.ACC.3.F.SG+FUT+2+PL
desquebrá-la-emos	desquebrar+V.ele.ACC.3.F.SG+FUT+1+PL
desquebrá-la-ia	desquebrar+V.ele.ACC.3.F.SG+COND+1+SG
desquebrá-la-ia	desquebrar+V.ele.ACC.3.F.SG+COND+3+SG
desquebrá-la-iam	desquebrar+V.ele.ACC.3.F.SG+COND+3+PL
desquebrá-la-íamos	desquebrar+V.ele.ACC.3.F.SG+COND+1+PL
desquebrá-la-ias	desquebrar+V.ele.ACC.3.F.SG+COND+2+SG
desquebrá-la-íeis	desquebrar+V.ele.ACC.3.F.SG+COND+2+PL
desquebrá-las-á	desquebrar+V.ele.ACC.3.F.PL+FUT+3+SG
desquebrá-las-ão	desquebrar+V.ele.ACC.3.F.PL+FUT+3+PL
desquebrá-las-ás	desquebrar+V.ele.ACC.3.F.PL+FUT+2+SG
desquebrá-las	desquebrar+V.ele.ACC.3.F.PL+INF+1+SG
desquebrá-las	desquebrar+V.ele.ACC.3.F.PL+INF+3+SG
desquebra-las	desquebrar+V.ele.ACC.3.F.PL+PRS+2+SG
desquebrá-las	desquebrar+V.ele.ACC.3.F.PL+SBJF+1+SG
desquebrá-las	desquebrar+V.ele.ACC.3.F.PL+SBJF+3+SG
desquebrá-las-ei	desquebrar+V.ele.ACC.3.F.PL+FUT+1+SG
desquebrá-las-eis	desquebrar+V.ele.ACC.3.F.PL+FUT+2+PL
desquebrá-las-emos	desquebrar+V.ele.ACC.3.F.PL+FUT+1+PL
desquebrá-las-ia	desquebrar+V.ele.ACC.3.F.PL+COND+1+SG
desquebrá-las-ia	desquebrar+V.ele.ACC.3.F.PL+COND+3+SG
desquebrá-las-iam	desquebrar+V.ele.ACC.3.F.PL+COND+3+PL
desquebrá-las-íamos	desquebrar+V.ele.ACC.3.F.PL+COND+1+PL
desquebrá-las-ias	desquebrar+V.ele.ACC.3.F.PL+COND+2+SG
desquebrá-las-íeis	desquebrar+V.ele.ACC.3.F.PL+COND+2+PL
desquebra-lhe	desquebrar+V.ele.DAT.3.SG+PRS+3+SG
desquebra-lhes	desquebrar+V.ele.DAT.3.PL+PRS+3+SG
desquebrá-lo-á	desquebrar+V.ele.ACC.3.M.SG+FUT+3+SG
desquebrá-lo-ão	desquebrar+V.ele.ACC.3.M.SG+FUT+3+PL
desquebrá-lo-ás	desquebrar+V.ele.ACC.3.M.SG+FUT+2+SG
desquebrá-lo	desquebrar+V.ele.ACC.3.M.SG+INF+1+SG
desquebrá-lo	desquebrar+V.ele.ACC.3.M.SG+INF+3+SG
desquebra-lo	desquebrar+V.ele.ACC.3.M.SG+PRS+2+SG
desquebrá-lo	desquebrar+V.ele.ACC.3.M.SG+SBJF+1+SG
desquebrá-lo	desquebrar+V.ele.ACC.3.M.SG+SBJF+3+SG
desquebrá-lo-ei	desquebrar+V.ele.ACC.3.M.SG+FUT+1+SG
desquebrá-lo-eis	desquebrar+V.ele.ACC.3.M.SG+FUT+2+PL
desquebrá-lo-emos	desquebrar+V.ele.ACC.3.M.SG+FUT+1+PL
desquebrá-lo-ia	desquebrar+V.ele.ACC.3.M.SG+COND+1+SG
desquebrá-lo-ia	desquebrar+V.ele.ACC.3.M.SG+COND+3+SG
desquebrá-lo-iam	desquebrar+V.ele.ACC.3.M.SG+COND+3+PL
desquebrá-lo-íamos	desquebrar+V.ele.ACC.3.M.SG+COND+1+PL
desquebrá-lo-ias	desquebrar+V.ele.ACC.3.M.SG+COND+2+SG
desquebrá-lo-íeis	desquebrar+V.ele.ACC.3.M.SG+COND+2+PL
desquebrá-los-á	desquebrar+V.ele.ACC.3.M.PL+FUT+3+SG
desquebrá-los-ão	desquebrar+V.ele.ACC.3.M.PL+FUT+3+PL
desquebrá-los-ás	desquebrar+V.ele.ACC.3.M.PL+FUT+2+SG
desquebrá-los	desquebrar+V.ele.ACC.3.M.PL+INF+1+SG
desquebrá-los	desquebrar+V.ele.ACC.3.M.PL+INF+3+SG
desquebra-los	desquebrar+V.ele.ACC.3.M.PL+PRS+2+SG
desquebrá-los	desquebrar+V.ele.ACC.3.M.PL+SBJF+1+SG
desquebrá-los	desquebrar+V.ele.ACC.3.M.PL+SBJF+3+SG
desquebrá-los-ei	desquebrar+V.ele.ACC.3.M.PL+FUT+1+SG
desquebrá-los-eis	desquebrar+V.ele.ACC.3.M.PL+FUT+2+PL
desquebrá-los-emos	desquebrar+V.ele.ACC.3.M.PL+FUT+1+PL
desquebrá-los-ia	desquebrar+V.ele.ACC.3.M.PL+COND+1+SG
desquebrá-los-ia	desquebrar+V.ele.ACC.3.M.PL+COND+3+SG
desquebrá-los-iam	desquebrar+V.ele.ACC.3.M.PL+COND+3+PL
desquebrá-los-íamos	desquebrar+V.ele.ACC.3.M.PL+COND+1+PL
desquebrá-los-ias	desquebrar+V.ele.ACC.3.M.PL+COND+2+SG
desquebrá-los-íeis	desquebrar+V.ele.ACC.3.M.PL+COND+2+PL
desquebra-me	desquebrar+V.eu.AD.1.SG+PRS+3+SG
desquebram-lhe	desquebrar+V.ele.DAT.3.SG+PRS+3+PL
desquebram-lhes	desquebrar+V.ele.DAT.3.PL+PRS+3+PL
desquebram-me	desquebrar+V.eu.AD.1.SG+PRS+3+PL
desquebram-na	desquebrar+V.ele.ACC.3.F.SG+PRS+3+PL
desquebram-nas	desquebrar+V.ele.ACC.3.F.PL+PRS+3+PL
desquebram-no	desquebrar+V.ele.ACC.3.M.SG+PRS+3+PL
desquebram-nos	desquebrar+V.ele.ACC.3.M.PL+PRS+3+PL
desquebram-nos	desquebrar+V.nós.AD.1.PL+PRS+3+PL
desquebramo-la	desquebrar+V.ele.ACC.3.F.SG+PRF+1+PL
desquebramo-la	desquebrar+V.ele.ACC.3.F.SG+PRS+1+PL
desquebramo-las	desquebrar+V.ele.ACC.3.F.PL+PRF+1+PL
desquebramo-las	desquebrar+V.ele.ACC.3.F.PL+PRS+1+PL
desquebramo-lo	desquebrar+V.ele.ACC.3.M.SG+PRF+1+PL
desquebramo-lo	desquebrar+V.ele.ACC.3.M.SG+PRS+1+PL
desquebramo-los	desquebrar+V.ele.ACC.3.M.PL+PRF+1+PL
desquebramo-los	desquebrar+V.ele.ACC.3.M.PL+PRS+1+PL
desquebramo-nos	desquebrar+nós.AD.1.PL+PRF+1+PL
desquebramo-nos	desquebrar+nós.AD.1.PL+PRS+1+PL
desquebramos-lhe	desquebrar+V.ele.DAT.3.SG+PRF+1+PL
desquebramos-lhe	desquebrar+V.ele.DAT.3.SG+PRS+1+PL
desquebramos-lhes	desquebrar+V.ele.DAT.3.PL+PRF+1+PL
desquebramos-lhes	desquebrar+V.ele.DAT.3.PL+PRS+1+PL
desquebramos-me	desquebrar+V.eu.AD.1.SG+PRF+1+PL
desquebramos-me	desquebrar+V.eu.AD.1.SG+PRS+1+PL
desquebramos-te	desquebrar+V.tu.AD.2.SG+PRF+1+PL
desquebramos-te	desquebrar+V.tu.AD.2.SG+PRS+1+PL
desquebramos-vos	desquebrar+V.vós.AD.2.PL+PRF+1+PL
desquebramos-vos	desquebrar+V.vós.AD.2.PL+PRS+1+PL
desquebram-se	desquebrar+V.ele.REFL+PRS+3+PL
desquebram-te	desquebrar+V.tu.AD.2.SG+PRS+3+PL
desquebram-vos	desquebrar+V.vós.AD.2.PL+PRS+3+PL
desquebrando-a	desquebrar+V.ele.ACC.3.F.SG+GRD
desquebrando-as	desquebrar+V.ele.ACC.3.F.PL+GRD
desquebrando-lhe	desquebrar+V.ele.DAT.3.SG+GRD
desquebrando-lhes	desquebrar+V.ele.DAT.3.PL+GRD
desquebrando-me	desquebrar+V.eu.AD.1.SG+GRD
desquebrando-nos	desquebrar+nós.AD.1.PL+GRD
desquebrando-o	desquebrar+V.ele.ACC.3.M.SG+GRD
desquebrando-os	desquebrar+V.ele.ACC.3.M.PL+GRD
desquebrando-se	desquebrar+V.ele.REFL+GRD
desquebrando-te	desquebrar+V.tu.AD.2.SG+GRD
desquebrando-vos	desquebrar+V.vós.AD.2.PL+GRD
desquebra-nos	desquebrar+nós.AD.1.PL+PRS+2+SG
desquebra-nos	desquebrar+nós.AD.1.PL+PRS+3+SG
desquebra-o	desquebrar+V.ele.ACC.3.M.SG+PRS+3+SG
desquebra-os	desquebrar+V.ele.ACC.3.M.PL+PRS+3+SG
desquebrara-a	desquebrar+V.ele.ACC.3.F.SG+PQP+1+SG
desquebrara-a	desquebrar+V.ele.ACC.3.F.SG+PQP+3+SG
desquebrara-as	desquebrar+V.ele.ACC.3.F.PL+PQP+1+SG
desquebrara-as	desquebrar+V.ele.ACC.3.F.PL+PQP+3+SG
desquebrara-la	desquebrar+V.ele.ACC.3.F.SG+PQP+2+SG
desquebrara-las	desquebrar+V.ele.ACC.3.F.PL+PQP+2+SG
desquebrara-lhe	desquebrar+V.ele.DAT.3.SG+PQP+1+SG
desquebrara-lhe	desquebrar+V.ele.DAT.3.SG+PQP+3+SG
desquebrara-lhes	desquebrar+V.ele.DAT.3.PL+PQP+1+SG
desquebrara-lhes	desquebrar+V.ele.DAT.3.PL+PQP+3+SG
desquebrara-lo	desquebrar+V.ele.ACC.3.M.SG+PQP+2+SG
desquebrara-los	desquebrar+V.ele.ACC.3.M.PL+PQP+2+SG
desquebrara-me	desquebrar+V.eu.AD.1.SG+PQP+1+SG
desquebrara-me	desquebrar+V.eu.AD.1.SG+PQP+3+SG
desquebraram-lhe	desquebrar+V.ele.DAT.3.SG+PQP+3+PL
desquebraram-lhe	desquebrar+V.ele.DAT.3.SG+PRF+3+PL
desquebraram-lhes	desquebrar+V.ele.DAT.3.PL+PQP+3+PL
desquebraram-lhes	desquebrar+V.ele.DAT.3.PL+PRF+3+PL
desquebraram-me	desquebrar+V.eu.AD.1.SG+PQP+3+PL
desquebraram-me	desquebrar+V.eu.AD.1.SG+PRF+3+PL
desquebraram-na	desquebrar+V.ele.ACC.3.F.SG+PQP+3+PL
desquebraram-na	desquebrar+V.ele.ACC.3.F.SG+PRF+3+PL
desquebraram-nas	desquebrar+V.ele.ACC.3.F.PL+PQP+3+PL
desquebraram-nas	desquebrar+V.ele.ACC.3.F.PL+PRF+3+PL
desquebraram-no	desquebrar+V.ele.ACC.3.M.SG+PQP+3+PL
desquebraram-no	desquebrar+V.ele.ACC.3.M.SG+PRF+3+PL
desquebraram-nos	desquebrar+V.ele.ACC.3.M.PL+PQP+3+PL
desquebraram-nos	desquebrar+V.ele.ACC.3.M.PL+PRF+3+PL
desquebraram-nos	desquebrar+V.nós.AD.1.PL+PQP+3+PL
desquebraram-nos	desquebrar+V.nós.AD.1.PL+PRF+3+PL
desquebráramo-la	desquebrar+V.ele.ACC.3.F.SG+PQP+1+PL
desquebráramo-las	desquebrar+V.ele.ACC.3.F.PL+PQP+1+PL
desquebráramo-lo	desquebrar+V.ele.ACC.3.M.SG+PQP+1+PL
desquebráramo-los	desquebrar+V.ele.ACC.3.M.PL+PQP+1+PL
desquebráramo-nos	desquebrar+nós.AD.1.PL+PQP+1+PL
desquebráramos-lhe	desquebrar+V.ele.DAT.3.SG+PQP+1+PL
desquebráramos-lhes	desquebrar+V.ele.DAT.3.PL+PQP+1+PL
desquebráramos-me	desquebrar+V.eu.AD.1.SG+PQP+1+PL
desquebráramos-te	desquebrar+V.tu.AD.2.SG+PQP+1+PL
desquebráramos-vos	desquebrar+V.vós.AD.2.PL+PQP+1+PL
desquebraram-se	desquebrar+V.ele.REFL+PQP+3+PL
desquebraram-se	desquebrar+V.ele.REFL+PRF+3+PL
desquebraram-te	desquebrar+V.tu.AD.2.SG+PQP+3+PL
desquebraram-te	desquebrar+V.tu.AD.2.SG+PRF+3+PL
desquebraram-vos	desquebrar+V.vós.AD.2.PL+PQP+3+PL
desquebraram-vos	desquebrar+V.vós.AD.2.PL+PRF+3+PL
desquebrara-nos	desquebrar+nós.AD.1.PL+PQP+1+SG
desquebrara-nos	desquebrar+nós.AD.1.PL+PQP+2+SG
desquebrara-nos	desquebrar+nós.AD.1.PL+PQP+3+SG
desquebrara-o	desquebrar+V.ele.ACC.3.M.SG+PQP+1+SG
desquebrara-o	desquebrar+V.ele.ACC.3.M.SG+PQP+3+SG
desquebrara-os	desquebrar+V.ele.ACC.3.M.PL+PQP+1+SG
desquebrara-os	desquebrar+V.ele.ACC.3.M.PL+PQP+3+SG
desquebrara-se	desquebrar+V.ele.REFL+PQP+1+SG
desquebrara-se	desquebrar+V.ele.REFL+PQP+3+SG
desquebraras-lhe	desquebrar+V.ele.DAT.3.SG+PQP+2+SG
desquebraras-lhes	desquebrar+V.ele.DAT.3.PL+PQP+2+SG
desquebraras-me	desquebrar+V.eu.AD.1.SG+PQP+2+SG
desquebraras-te	desquebrar+V.tu.AD.2.SG+PQP+2+SG
desquebraras-vos	desquebrar+V.vós.AD.2.PL+PQP+2+SG
desquebrara-te	desquebrar+V.tu.AD.2.SG+PQP+1+SG
desquebrara-te	desquebrar+V.tu.AD.2.SG+PQP+3+SG
desquebrara-vos	desquebrar+V.vós.AD.2.PL+PQP+1+SG
desquebrara-vos	desquebrar+V.vós.AD.2.PL+PQP+3+SG
desquebrarde-la	desquebrar+V.ele.ACC.3.F.SG+INF+2+PL
desquebrarde-la	desquebrar+V.ele.ACC.3.F.SG+SBJF+2+PL
desquebrarde-las	desquebrar+V.ele.ACC.3.F.PL+INF+2+PL
desquebrarde-las	desquebrar+V.ele.ACC.3.F.PL+SBJF+2+PL
desquebrarde-lo	desquebrar+V.ele.ACC.3.M.SG+INF+2+PL
desquebrarde-lo	desquebrar+V.ele.ACC.3.M.SG+SBJF+2+PL
desquebrarde-los	desquebrar+V.ele.ACC.3.M.PL+INF+2+PL
desquebrarde-los	desquebrar+V.ele.ACC.3.M.PL+SBJF+2+PL
desquebrarde-nos	desquebrar+nós.AD.1.PL+INF+2+PL
desquebrarde-nos	desquebrar+nós.AD.1.PL+SBJF+2+PL
desquebrardes-lhe	desquebrar+V.ele.DAT.3.SG+INF+2+PL
desquebrardes-lhe	desquebrar+V.ele.DAT.3.SG+SBJF+2+PL
desquebrardes-lhes	desquebrar+V.ele.DAT.3.PL+INF+2+PL
desquebrardes-lhes	desquebrar+V.ele.DAT.3.PL+SBJF+2+PL
desquebrardes-me	desquebrar+V.eu.AD.1.SG+INF+2+PL
desquebrardes-me	desquebrar+V.eu.AD.1.SG+SBJF+2+PL
desquebrardes-te	desquebrar+V.tu.AD.2.SG+INF+2+PL
desquebrardes-te	desquebrar+V.tu.AD.2.SG+SBJF+2+PL
desquebrardes-vos	desquebrar+V.vós.AD.2.PL+INF+2+PL
desquebrardes-vos	desquebrar+V.vós.AD.2.PL+SBJF+2+PL
desquebrárei-la	desquebrar+V.ele.ACC.3.F.SG+PQP+2+PL
desquebrárei-las	desquebrar+V.ele.ACC.3.F.PL+PQP+2+PL
desquebrárei-lo	desquebrar+V.ele.ACC.3.M.SG+PQP+2+PL
desquebrárei-los	desquebrar+V.ele.ACC.3.M.PL+PQP+2+PL
desquebrárei-nos	desquebrar+nós.AD.1.PL+PQP+2+PL
desquebráreis-lhe	desquebrar+V.ele.DAT.3.SG+PQP+2+PL
desquebráreis-lhes	desquebrar+V.ele.DAT.3.PL+PQP+2+PL
desquebráreis-me	desquebrar+V.eu.AD.1.SG+PQP+2+PL
desquebráreis-te	desquebrar+V.tu.AD.2.SG+PQP+2+PL
desquebráreis-vos	desquebrar+V.vós.AD.2.PL+PQP+2+PL
desquebrare-la	desquebrar+V.ele.ACC.3.F.SG+INF+2+SG
desquebrare-la	desquebrar+V.ele.ACC.3.F.SG+SBJF+2+SG
desquebrare-las	desquebrar+V.ele.ACC.3.F.PL+INF+2+SG
desquebrare-las	desquebrar+V.ele.ACC.3.F.PL+SBJF+2+SG
desquebrare-lo	desquebrar+V.ele.ACC.3.M.SG+INF+2+SG
desquebrare-lo	desquebrar+V.ele.ACC.3.M.SG+SBJF+2+SG
desquebrare-los	desquebrar+V.ele.ACC.3.M.PL+INF+2+SG
desquebrare-los	desquebrar+V.ele.ACC.3.M.PL+SBJF+2+SG
desquebrarem-lhe	desquebrar+V.ele.DAT.3.SG+INF+3+PL
desquebrarem-lhe	desquebrar+V.ele.DAT.3.SG+SBJF+3+PL
desquebrarem-lhes	desquebrar+V.ele.DAT.3.PL+INF+3+PL
desquebrarem-lhes	desquebrar+V.ele.DAT.3.PL+SBJF+3+PL
desquebrarem-me	desquebrar+V.eu.AD.1.SG+INF+3+PL
desquebrarem-me	desquebrar+V.eu.AD.1.SG+SBJF+3+PL
desquebrarem-na	desquebrar+V.ele.ACC.3.F.SG+INF+3+PL
desquebrarem-na	desquebrar+V.ele.ACC.3.F.SG+SBJF+3+PL
desquebrarem-nas	desquebrar+V.ele.ACC.3.F.PL+INF+3+PL
desquebrarem-nas	desquebrar+V.ele.ACC.3.F.PL+SBJF+3+PL
desquebrarem-no	desquebrar+V.ele.ACC.3.M.SG+INF+3+PL
desquebrarem-no	desquebrar+V.ele.ACC.3.M.SG+SBJF+3+PL
desquebrarem-nos	desquebrar+V.ele.ACC.3.M.PL+INF+3+PL
desquebrarem-nos	desquebrar+V.ele.ACC.3.M.PL+SBJF+3+PL
desquebrarem-nos	desquebrar+V.nós.AD.1.PL+INF+3+PL
desquebrarem-nos	desquebrar+V.nós.AD.1.PL+SBJF+3+PL
desquebrarem-se	desquebrar+V.ele.REFL+INF+3+PL
desquebrarem-se	desquebrar+V.ele.REFL+SBJF+3+PL
desquebrarem-te	desquebrar+V.tu.AD.2.SG+INF+3+PL
desquebrarem-te	desquebrar+V.tu.AD.2.SG+SBJF+3+PL
desquebrarem-vos	desquebrar+V.vós.AD.2.PL+INF+3+PL
desquebrarem-vos	desquebrar+V.vós.AD.2.PL+SBJF+3+PL
desquebrare-nos	desquebrar+nós.AD.1.PL+INF+2+SG
desquebrare-nos	desquebrar+nós.AD.1.PL+SBJF+2+SG
desquebrares-lhe	desquebrar+V.ele.DAT.3.SG+INF+2+SG
desquebrares-lhe	desquebrar+V.ele.DAT.3.SG+SBJF+2+SG
desquebrares-lhes	desquebrar+V.ele.DAT.3.PL+INF+2+SG
desquebrares-lhes	desquebrar+V.ele.DAT.3.PL+SBJF+2+SG
desquebrares-me	desquebrar+V.eu.AD.1.SG+INF+2+SG
desquebrares-me	desquebrar+V.eu.AD.1.SG+SBJF+2+SG
desquebrares-te	desquebrar+V.tu.AD.2.SG+INF+2+SG
desquebrares-te	desquebrar+V.tu.AD.2.SG+SBJF+2+SG
desquebrares-vos	desquebrar+V.vós.AD.2.PL+INF+2+SG
desquebrares-vos	desquebrar+V.vós.AD.2.PL+SBJF+2+SG
desquebrar-lhe-á	desquebrar+V.ele.DAT.3.SG+FUT+3+SG
desquebrar-lhe-ão	desquebrar+V.ele.DAT.3.SG+FUT+3+PL
desquebrar-lhe-ás	desquebrar+V.ele.DAT.3.SG+FUT+2+SG
desquebrar-lhe	desquebrar+V.ele.DAT.3.SG+INF
desquebrar-lhe	desquebrar+V.ele.DAT.3.SG+INF+1+SG
desquebrar-lhe	desquebrar+V.ele.DAT.3.SG+INF+3+SG
desquebrar-lhe	desquebrar+V.ele.DAT.3.SG+SBJF+1+SG
desquebrar-lhe	desquebrar+V.ele.DAT.3.SG+SBJF+3+SG
desquebrar-lhe-ei	desquebrar+V.ele.DAT.3.SG+FUT+1+SG
desquebrar-lhe-eis	desquebrar+V.ele.DAT.3.SG+FUT+2+PL
desquebrar-lhe-emos	desquebrar+V.ele.DAT.3.SG+FUT+1+PL
desquebrar-lhe-ia	desquebrar+V.ele.DAT.3.SG+COND+1+SG
desquebrar-lhe-ia	desquebrar+V.ele.DAT.3.SG+COND+3+SG
desquebrar-lhe-iam	desquebrar+V.ele.DAT.3.SG+COND+3+PL
desquebrar-lhe-íamos	desquebrar+V.ele.DAT.3.SG+COND+1+PL
desquebrar-lhe-ias	desquebrar+V.ele.DAT.3.SG+COND+2+SG
desquebrar-lhe-íeis	desquebrar+V.ele.DAT.3.SG+COND+2+PL
desquebrar-lhes-á	desquebrar+V.ele.DAT.3.PL+FUT+3+SG
desquebrar-lhes-ão	desquebrar+V.ele.DAT.3.PL+FUT+3+PL
desquebrar-lhes-ás	desquebrar+V.ele.DAT.3.PL+FUT+2+SG
desquebrar-lhes	desquebrar+V.ele.DAT.3.PL+INF
desquebrar-lhes	desquebrar+V.ele.DAT.3.PL+INF+1+SG
desquebrar-lhes	desquebrar+V.ele.DAT.3.PL+INF+3+SG
desquebrar-lhes	desquebrar+V.ele.DAT.3.PL+SBJF+1+SG
desquebrar-lhes	desquebrar+V.ele.DAT.3.PL+SBJF+3+SG
desquebrar-lhes-ei	desquebrar+V.ele.DAT.3.PL+FUT+1+SG
desquebrar-lhes-eis	desquebrar+V.ele.DAT.3.PL+FUT+2+PL
desquebrar-lhes-emos	desquebrar+V.ele.DAT.3.PL+FUT+1+PL
desquebrar-lhes-ia	desquebrar+V.ele.DAT.3.PL+COND+1+SG
desquebrar-lhes-ia	desquebrar+V.ele.DAT.3.PL+COND+3+SG
desquebrar-lhes-iam	desquebrar+V.ele.DAT.3.PL+COND+3+PL
desquebrar-lhes-íamos	desquebrar+V.ele.DAT.3.PL+COND+1+PL
desquebrar-lhes-ias	desquebrar+V.ele.DAT.3.PL+COND+2+SG
desquebrar-lhes-íeis	desquebrar+V.ele.DAT.3.PL+COND+2+PL
desquebrar-me-á	desquebrar+V.eu.AD.1.SG+FUT+3+SG
desquebrar-me-ão	desquebrar+V.eu.AD.1.SG+FUT+3+PL
desquebrar-me-ás	desquebrar+V.eu.AD.1.SG+FUT+2+SG
desquebrar-me	desquebrar+V.eu.AD.1.SG+INF
desquebrar-me	desquebrar+V.eu.AD.1.SG+INF+1+SG
desquebrar-me	desquebrar+V.eu.AD.1.SG+INF+3+SG
desquebrar-me	desquebrar+V.eu.AD.1.SG+SBJF+1+SG
desquebrar-me	desquebrar+V.eu.AD.1.SG+SBJF+3+SG
desquebrar-me-ei	desquebrar+V.eu.AD.1.SG+FUT+1+SG
desquebrar-me-eis	desquebrar+V.eu.AD.1.SG+FUT+2+PL
desquebrar-me-emos	desquebrar+V.eu.AD.1.SG+FUT+1+PL
desquebrar-me-ia	desquebrar+V.eu.AD.1.SG+COND+1+SG
desquebrar-me-ia	desquebrar+V.eu.AD.1.SG+COND+3+SG
desquebrar-me-iam	desquebrar+V.eu.AD.1.SG+COND+3+PL
desquebrar-me-íamos	desquebrar+V.eu.AD.1.SG+COND+1+PL
desquebrar-me-ias	desquebrar+V.eu.AD.1.SG+COND+2+SG
desquebrar-me-íeis	desquebrar+V.eu.AD.1.SG+COND+2+PL
desquebrarmo-la	desquebrar+V.ele.ACC.3.F.SG+INF+1+PL
desquebrarmo-la	desquebrar+V.ele.ACC.3.F.SG+SBJF+1+PL
desquebrarmo-las	desquebrar+V.ele.ACC.3.F.PL+INF+1+PL
desquebrarmo-las	desquebrar+V.ele.ACC.3.F.PL+SBJF+1+PL
desquebrarmo-lo	desquebrar+V.ele.ACC.3.M.SG+INF+1+PL
desquebrarmo-lo	desquebrar+V.ele.ACC.3.M.SG+SBJF+1+PL
desquebrarmo-los	desquebrar+V.ele.ACC.3.M.PL+INF+1+PL
desquebrarmo-los	desquebrar+V.ele.ACC.3.M.PL+SBJF+1+PL
desquebrarmo-nos	desquebrar+nós.AD.1.PL+INF+1+PL
desquebrarmo-nos	desquebrar+nós.AD.1.PL+SBJF+1+PL
desquebrarmos-lhe	desquebrar+V.ele.DAT.3.SG+INF+1+PL
desquebrarmos-lhe	desquebrar+V.ele.DAT.3.SG+SBJF+1+PL
desquebrarmos-lhes	desquebrar+V.ele.DAT.3.PL+INF+1+PL
desquebrarmos-lhes	desquebrar+V.ele.DAT.3.PL+SBJF+1+PL
desquebrarmos-me	desquebrar+V.eu.AD.1.SG+INF+1+PL
desquebrarmos-me	desquebrar+V.eu.AD.1.SG+SBJF+1+PL
desquebrarmos-te	desquebrar+V.tu.AD.2.SG+INF+1+PL
desquebrarmos-te	desquebrar+V.tu.AD.2.SG+SBJF+1+PL
desquebrarmos-vos	desquebrar+V.vós.AD.2.PL+INF+1+PL
desquebrarmos-vos	desquebrar+V.vós.AD.2.PL+SBJF+1+PL
desquebrar-nos-á	desquebrar+nós.AD.1.PL+FUT+3+SG
desquebrar-nos-ão	desquebrar+nós.AD.1.PL+FUT+3+PL
desquebrar-nos-ás	desquebrar+nós.AD.1.PL+FUT+2+SG
desquebrar-nos	desquebrar+nós.AD.1.PL+INF
desquebrar-nos	desquebrar+nós.AD.1.PL+INF+1+SG
desquebrar-nos	desquebrar+nós.AD.1.PL+INF+3+SG
desquebrar-nos	desquebrar+nós.AD.1.PL+SBJF+1+SG
desquebrar-nos	desquebrar+nós.AD.1.PL+SBJF+3+SG
desquebrar-nos-ei	desquebrar+nós.AD.1.PL+FUT+1+SG
desquebrar-nos-eis	desquebrar+nós.AD.1.PL+FUT+2+PL
desquebrar-nos-emos	desquebrar+nós.AD.1.PL+FUT+1+PL
desquebrar-nos-ia	desquebrar+nós.AD.1.PL+COND+1+SG
desquebrar-nos-ia	desquebrar+nós.AD.1.PL+COND+3+SG
desquebrar-nos-iam	desquebrar+nós.AD.1.PL+COND+3+PL
desquebrar-nos-íamos	desquebrar+nós.AD.1.PL+COND+1+PL
desquebrar-nos-ias	desquebrar+nós.AD.1.PL+COND+2+SG
desquebrar-nos-íeis	desquebrar+nós.AD.1.PL+COND+2+PL
desquebrar-se-á	desquebrar+V.ele.REFL+FUT+3+SG
desquebrar-se-ão	desquebrar+V.ele.REFL+FUT+3+PL
desquebrar-se	desquebrar+V.ele.REFL+INF
desquebrar-se	desquebrar+V.ele.REFL+INF+3+SG
desquebrar-se	desquebrar+V.ele.REFL+SBJF+3+SG
desquebrar-se-ia	desquebrar+V.ele.REFL+COND+3+SG
desquebrar-se-iam	desquebrar+V.ele.REFL+COND+3+PL
desquebrar-te-á	desquebrar+V.tu.AD.2.SG+FUT+3+SG
desquebrar-te-ão	desquebrar+V.tu.AD.2.SG+FUT+3+PL
desquebrar-te-ás	desquebrar+V.tu.AD.2.SG+FUT+2+SG
desquebrar-te	desquebrar+V.tu.AD.2.SG+INF
desquebrar-te	desquebrar+V.tu.AD.2.SG+INF+1+SG
desquebrar-te	desquebrar+V.tu.AD.2.SG+INF+3+SG
desquebrar-te	desquebrar+V.tu.AD.2.SG+SBJF+1+SG
desquebrar-te	desquebrar+V.tu.AD.2.SG+SBJF+3+SG
desquebrar-te-ei	desquebrar+V.tu.AD.2.SG+FUT+1+SG
desquebrar-te-eis	desquebrar+V.tu.AD.2.SG+FUT+2+PL
desquebrar-te-emos	desquebrar+V.tu.AD.2.SG+FUT+1+PL
desquebrar-te-ia	desquebrar+V.tu.AD.2.SG+COND+1+SG
desquebrar-te-ia	desquebrar+V.tu.AD.2.SG+COND+3+SG
desquebrar-te-iam	desquebrar+V.tu.AD.2.SG+COND+3+PL
desquebrar-te-íamos	desquebrar+V.tu.AD.2.SG+COND+1+PL
desquebrar-te-ias	desquebrar+V.tu.AD.2.SG+COND+2+SG
desquebrar-te-íeis	desquebrar+V.tu.AD.2.SG+COND+2+PL
desquebrar-vos-á	desquebrar+V.vós.AD.2.PL+FUT+3+SG
desquebrar-vos-ão	desquebrar+V.vós.AD.2.PL+FUT+3+PL
desquebrar-vos-ás	desquebrar+V.vós.AD.2.PL+FUT+2+SG
desquebrar-vos	desquebrar+V.vós.AD.2.PL+INF
desquebrar-vos	desquebrar+V.vós.AD.2.PL+INF+1+SG
desquebrar-vos	desquebrar+V.vós.AD.2.PL+INF+3+SG
desquebrar-vos	desquebrar+V.vós.AD.2.PL+SBJF+1+SG
desquebrar-vos	desquebrar+V.vós.AD.2.PL+SBJF+3+SG
desquebrar-vos-ei	desquebrar+V.vós.AD.2.PL+FUT+1+SG
desquebrar-vos-eis	desquebrar+V.vós.AD.2.PL+FUT+2+PL
desquebrar-vos-emos	desquebrar+V.vós.AD.2.PL+FUT+1+PL
desquebrar-vos-ia	desquebrar+V.vós.AD.2.PL+COND+1+SG
desquebrar-vos-ia	desquebrar+V.vós.AD.2.PL+COND+3+SG
desquebrar-vos-iam	desquebrar+V.vós.AD.2.PL+COND+3+PL
desquebrar-vos-íamos	desquebrar+V.vós.AD.2.PL+COND+1+PL
desquebrar-vos-ias	desquebrar+V.vós.AD.2.PL+COND+2+SG
desquebrar-vos-íeis	desquebrar+V.vós.AD.2.PL+COND+2+PL
desquebra-se	desquebrar+V.ele.REFL+PRS+3+SG
desquebras-lhe	desquebrar+V.ele.DAT.3.SG+PRS+2+SG
desquebras-lhes	desquebrar+V.ele.DAT.3.PL+PRS+2+SG
desquebras-me	desquebrar+V.eu.AD.1.SG+PRS+2+SG
desquebraste-a	desquebrar+V.ele.ACC.3.F.SG+PRF+2+SG
desquebraste-as	desquebrar+V.ele.ACC.3.F.PL+PRF+2+SG
desquebras-te	desquebrar+V.tu.AD.2.SG+PRS+2+SG
desquebraste-la	desquebrar+V.ele.ACC.3.F.SG+PRF+2+PL
desquebraste-las	desquebrar+V.ele.ACC.3.F.PL+PRF+2+PL
desquebraste-lhe	desquebrar+V.ele.DAT.3.SG+PRF+2+SG
desquebraste-lhes	desquebrar+V.ele.DAT.3.PL+PRF+2+SG
desquebraste-lo	desquebrar+V.ele.ACC.3.M.SG+PRF+2+PL
desquebraste-los	desquebrar+V.ele.ACC.3.M.PL+PRF+2+PL
desquebraste-me	desquebrar+V.eu.AD.1.SG+PRF+2+SG
desquebraste-nos	desquebrar+nós.AD.1.PL+PRF+2+PL
desquebraste-nos	desquebrar+nós.AD.1.PL+PRF+2+SG
desquebraste-o	desquebrar+V.ele.ACC.3.M.SG+PRF+2+SG
desquebraste-os	desquebrar+V.ele.ACC.3.M.PL+PRF+2+SG
desquebrastes-lhe	desquebrar+V.ele.DAT.3.SG+PRF+2+PL
desquebrastes-lhes	desquebrar+V.ele.DAT.3.PL+PRF+2+PL
desquebrastes-me	desquebrar+V.eu.AD.1.SG+PRF+2+PL
desquebrastes-te	desquebrar+V.tu.AD.2.SG+PRF+2+PL
desquebrastes-vos	desquebrar+V.vós.AD.2.PL+PRF+2+PL
desquebraste-te	desquebrar+V.tu.AD.2.SG+PRF+2+SG
desquebraste-vos	desquebrar+V.vós.AD.2.PL+PRF+2+SG
desquebras-vos	desquebrar+V.vós.AD.2.PL+PRS+2+SG
desquebra-te	desquebrar+V.tu.AD.2.SG+PRS+3+SG
desquebrava-a	desquebrar+V.ele.ACC.3.F.SG+IMPF+1+SG
desquebrava-a	desquebrar+V.ele.ACC.3.F.SG+IMPF+3+SG
desquebrava-as	desquebrar+V.ele.ACC.3.F.PL+IMPF+1+SG
desquebrava-as	desquebrar+V.ele.ACC.3.F.PL+IMPF+3+SG
desquebrava-la	desquebrar+V.ele.ACC.3.F.SG+IMPF+2+SG
desquebrava-las	desquebrar+V.ele.ACC.3.F.PL+IMPF+2+SG
desquebrava-lhe	desquebrar+V.ele.DAT.3.SG+IMPF+1+SG
desquebrava-lhe	desquebrar+V.ele.DAT.3.SG+IMPF+3+SG
desquebrava-lhes	desquebrar+V.ele.DAT.3.PL+IMPF+1+SG
desquebrava-lhes	desquebrar+V.ele.DAT.3.PL+IMPF+3+SG
desquebrava-lo	desquebrar+V.ele.ACC.3.M.SG+IMPF+2+SG
desquebrava-los	desquebrar+V.ele.ACC.3.M.PL+IMPF+2+SG
desquebrava-me	desquebrar+V.eu.AD.1.SG+IMPF+1+SG
desquebrava-me	desquebrar+V.eu.AD.1.SG+IMPF+3+SG
desquebravam-lhe	desquebrar+V.ele.DAT.3.SG+IMPF+3+PL
desquebravam-lhes	desquebrar+V.ele.DAT.3.PL+IMPF+3+PL
desquebravam-me	desquebrar+V.eu.AD.1.SG+IMPF+3+PL
desquebravam-na	desquebrar+V.ele.ACC.3.F.SG+IMPF+3+PL
desquebravam-nas	desquebrar+V.ele.ACC.3.F.PL+IMPF+3+PL
desquebravam-no	desquebrar+V.ele.ACC.3.M.SG+IMPF+3+PL
desquebravam-nos	desquebrar+V.ele.ACC.3.M.PL+IMPF+3+PL
desquebravam-nos	desquebrar+V.nós.AD.1.PL+IMPF+3+PL
desquebrávamo-la	desquebrar+V.ele.ACC.3.F.SG+IMPF+1+PL
desquebrávamo-las	desquebrar+V.ele.ACC.3.F.PL+IMPF+1+PL
desquebrávamo-lo	desquebrar+V.ele.ACC.3.M.SG+IMPF+1+PL
desquebrávamo-los	desquebrar+V.ele.ACC.3.M.PL+IMPF+1+PL
desquebrávamo-nos	desquebrar+nós.AD.1.PL+IMPF+1+PL
desquebrávamos-lhe	desquebrar+V.ele.DAT.3.SG+IMPF+1+PL
desquebrávamos-lhes	desquebrar+V.ele.DAT.3.PL+IMPF+1+PL
desquebrávamos-me	desquebrar+V.eu.AD.1.SG+IMPF+1+PL
desquebrávamos-te	desquebrar+V.tu.AD.2.SG+IMPF+1+PL
desquebrávamos-vos	desquebrar+V.vós.AD.2.PL+IMPF+1+PL
desquebravam-se	desquebrar+V.ele.REFL+IMPF+3+PL
desquebravam-te	desquebrar+V.tu.AD.2.SG+IMPF+3+PL
desquebravam-vos	desquebrar+V.vós.AD.2.PL+IMPF+3+PL
desquebrava-nos	desquebrar+nós.AD.1.PL+IMPF+1+SG
desquebrava-nos	desquebrar+nós.AD.1.PL+IMPF+2+SG
desquebrava-nos	desquebrar+nós.AD.1.PL+IMPF+3+SG
desquebrava-o	desquebrar+V.ele.ACC.3.M.SG+IMPF+1+SG
desquebrava-o	desquebrar+V.ele.ACC.3.M.SG+IMPF+3+SG
desquebrava-os	desquebrar+V.ele.ACC.3.M.PL+IMPF+1+SG
desquebrava-os	desquebrar+V.ele.ACC.3.M.PL+IMPF+3+SG
desquebrava-se	desquebrar+V.ele.REFL+IMPF+1+SG
desquebrava-se	desquebrar+V.ele.REFL+IMPF+3+SG
desquebravas-lhe	desquebrar+V.ele.DAT.3.SG+IMPF+2+SG
desquebravas-lhes	desquebrar+V.ele.DAT.3.PL+IMPF+2+SG
desquebravas-me	desquebrar+V.eu.AD.1.SG+IMPF+2+SG
desquebravas-te	desquebrar+V.tu.AD.2.SG+IMPF+2+SG
desquebravas-vos	desquebrar+V.vós.AD.2.PL+IMPF+2+SG
desquebrava-te	desquebrar+V.tu.AD.2.SG+IMPF+1+SG
desquebrava-te	desquebrar+V.tu.AD.2.SG+IMPF+3+SG
desquebrava-vos	desquebrar+V.vós.AD.2.PL+IMPF+1+SG
desquebrava-vos	desquebrar+V.vós.AD.2.PL+IMPF+3+SG
desquebrávei-la	desquebrar+V.ele.ACC.3.F.SG+IMPF+2+PL
desquebrávei-las	desquebrar+V.ele.ACC.3.F.PL+IMPF+2+PL
desquebrávei-lo	desquebrar+V.ele.ACC.3.M.SG+IMPF+2+PL
desquebrávei-los	desquebrar+V.ele.ACC.3.M.PL+IMPF+2+PL
desquebrávei-nos	desquebrar+nós.AD.1.PL+IMPF+2+PL
desquebráveis-lhe	desquebrar+V.ele.DAT.3.SG+IMPF+2+PL
desquebráveis-lhes	desquebrar+V.ele.DAT.3.PL+IMPF+2+PL
desquebráveis-me	desquebrar+V.eu.AD.1.SG+IMPF+2+PL
desquebráveis-te	desquebrar+V.tu.AD.2.SG+IMPF+2+PL
desquebráveis-vos	desquebrar+V.vós.AD.2.PL+IMPF+2+PL
desquebra-vos	desquebrar+V.vós.AD.2.PL+PRS+3+SG
desquebre-a	desquebrar+V.ele.ACC.3.F.SG+IMP+3+SG
desquebre-as	desquebrar+V.ele.ACC.3.F.PL+IMP+3+SG
desquebrei-a	desquebrar+V.ele.ACC.3.F.SG+PRF+1+SG
desquebrei-as	desquebrar+V.ele.ACC.3.F.PL+PRF+1+SG
desquebrei-lhe	desquebrar+V.ele.DAT.3.SG+PRF+1+SG
desquebrei-lhes	desquebrar+V.ele.DAT.3.PL+PRF+1+SG
desquebrei-me	desquebrar+V.eu.AD.1.SG+PRF+1+SG
desquebrei-nos	desquebrar+nós.AD.1.PL+PRF+1+SG
desquebrei-o	desquebrar+V.ele.ACC.3.M.SG+PRF+1+SG
desquebrei-os	desquebrar+V.ele.ACC.3.M.PL+PRF+1+SG
desquebrei-te	desquebrar+V.tu.AD.2.SG+PRF+1+SG
desquebrei-vos	desquebrar+V.vós.AD.2.PL+PRF+1+SG
desquebre-lhe	desquebrar+V.ele.DAT.3.SG+IMP+3+SG
desquebre-lhes	desquebrar+V.ele.DAT.3.PL+IMP+3+SG
desquebre-me	desquebrar+V.eu.AD.1.SG+IMP+3+SG
desquebrem-lhe	desquebrar+V.ele.DAT.3.SG+IMP+3+PL
desquebrem-lhes	desquebrar+V.ele.DAT.3.PL+IMP+3+PL
desquebrem-me	desquebrar+V.eu.AD.1.SG+IMP+3+PL
desquebrem-na	desquebrar+V.ele.ACC.3.F.SG+IMP+3+PL
desquebrem-nas	desquebrar+V.ele.ACC.3.F.PL+IMP+3+PL
desquebrem-no	desquebrar+V.ele.ACC.3.M.SG+IMP+3+PL
desquebrem-nos	desquebrar+V.ele.ACC.3.M.PL+IMP+3+PL
desquebrem-nos	desquebrar+V.nós.AD.1.PL+IMP+3+PL
desquebremo-la	desquebrar+V.ele.ACC.3.F.SG+IMP+1+PL
desquebremo-las	desquebrar+V.ele.ACC.3.F.PL+IMP+1+PL
desquebremo-lo	desquebrar+V.ele.ACC.3.M.SG+IMP+1+PL
desquebremo-los	desquebrar+V.ele.ACC.3.M.PL+IMP+1+PL
desquebremo-nos	desquebrar+nós.AD.1.PL+IMP+1+PL
desquebremos-lhe	desquebrar+V.ele.DAT.3.SG+IMP+1+PL
desquebremos-lhes	desquebrar+V.ele.DAT.3.PL+IMP+1+PL
desquebremos-me	desquebrar+V.eu.AD.1.SG+IMP+1+PL
desquebremos-te	desquebrar+V.tu.AD.2.SG+IMP+1+PL
desquebremos-vos	desquebrar+V.vós.AD.2.PL+IMP+1+PL
desquebrem-se	desquebrar+V.ele.REFL+IMP+3+PL
desquebrem-te	desquebrar+V.tu.AD.2.SG+IMP+3+PL
desquebrem-vos	desquebrar+V.vós.AD.2.PL+IMP+3+PL
desquebre-nos	desquebrar+nós.AD.1.PL+IMP+3+SG
desquebre-o	desquebrar+V.ele.ACC.3.M.SG+IMP+3+SG
desquebre-os	desquebrar+V.ele.ACC.3.M.PL+IMP+3+SG
desquebre-se	desquebrar+V.ele.REFL+IMP+3+SG
desquebre-te	desquebrar+V.tu.AD.2.SG+IMP+3+SG
desquebre-vos	desquebrar+V.vós.AD.2.PL+IMP+3+SG
desquebro-a	desquebrar+V.ele.ACC.3.F.SG+PRS+1+SG
desquebro-as	desquebrar+V.ele.ACC.3.F.PL+PRS+1+SG
desquebro-lhe	desquebrar+V.ele.DAT.3.SG+PRS+1+SG
desquebro-lhes	desquebrar+V.ele.DAT.3.PL+PRS+1+SG
desquebro-me	desquebrar+V.eu.AD.1.SG+PRS+1+SG
desquebro-nos	desquebrar+nós.AD.1.PL+PRS+1+SG
desquebro-o	desquebrar+V.ele.ACC.3.M.SG+PRS+1+SG
desquebro-os	desquebrar+V.ele.ACC.3.M.PL+PRS+1+SG
desquebro-te	desquebrar+V.tu.AD.2.SG+PRS+1+SG
desquebrou-a	desquebrar+V.ele.ACC.3.F.SG+PRF+3+SG
desquebrou-as	desquebrar+V.ele.ACC.3.F.PL+PRF+3+SG
desquebrou-lhe	desquebrar+V.ele.DAT.3.SG+PRF+3+SG
desquebrou-lhes	desquebrar+V.ele.DAT.3.PL+PRF+3+SG
desquebrou-me	desquebrar+V.eu.AD.1.SG+PRF+3+SG
desquebrou-nos	desquebrar+nós.AD.1.PL+PRF+3+SG
desquebrou-o	desquebrar+V.ele.ACC.3.M.SG+PRF+3+SG
desquebrou-os	desquebrar+V.ele.ACC.3.M.PL+PRF+3+SG
desquebrou-se	desquebrar+V.ele.REFL+PRF+3+SG
desquebrou-te	desquebrar+V.tu.AD.2.SG+PRF+3+SG
desquebrou-vos	desquebrar+V.vós.AD.2.PL+PRF+3+SG
desquebro-vos	desquebrar+V.vós.AD.2.PL+PRS+1+SG
desqueé-la	desquerer+V.ele.ACC.3.F.SG+PRS+3+SG
desqueé-las	desquerer+V.ele.ACC.3.F.PL+PRS+3+SG
desqueé-lo	desquerer+V.ele.ACC.3.M.SG+PRS+3+SG
desqueé-los	desquerer+V.ele.ACC.3.M.PL+PRS+3+SG
desqueira-a	desquerer+V.ele.ACC.3.F.SG+IMP+3+SG
desqueira-as	desquerer+V.ele.ACC.3.F.PL+IMP+3+SG
desqueira-lhe	desquerer+V.ele.DAT.3.SG+IMP+3+SG
desqueira-lhes	desquerer+V.ele.DAT.3.PL+IMP+3+SG
desqueira-me	desquerer+V.eu.AD.1.SG+IMP+3+SG
desqueiram-lhe	desquerer+V.ele.DAT.3.SG+IMP+3+PL
desqueiram-lhes	desquerer+V.ele.DAT.3.PL+IMP+3+PL
desqueiram-me	desquerer+V.eu.AD.1.SG+IMP+3+PL
desqueiram-na	desquerer+V.ele.ACC.3.F.SG+IMP+3+PL
desqueiram-nas	desquerer+V.ele.ACC.3.F.PL+IMP+3+PL
desqueiram-no	desquerer+V.ele.ACC.3.M.SG+IMP+3+PL
desqueiram-nos	desquerer+V.ele.ACC.3.M.PL+IMP+3+PL
desqueiram-nos	desquerer+V.nós.AD.1.PL+IMP+3+PL
desqueiramo-la	desquerer+V.ele.ACC.3.F.SG+IMP+1+PL
desqueiramo-las	desquerer+V.ele.ACC.3.F.PL+IMP+1+PL
desqueiramo-lo	desquerer+V.ele.ACC.3.M.SG+IMP+1+PL
desqueiramo-los	desquerer+V.ele.ACC.3.M.PL+IMP+1+PL
desqueiramo-nos	desquerer+nós.AD.1.PL+IMP+1+PL
desqueiramos-lhe	desquerer+V.ele.DAT.3.SG+IMP+1+PL
desqueiramos-lhes	desquerer+V.ele.DAT.3.PL+IMP+1+PL
desqueiramos-me	desquerer+V.eu.AD.1.SG+IMP+1+PL
desqueiramos-te	desquerer+V.tu.AD.2.SG+IMP+1+PL
desqueiramos-vos	desquerer+V.vós.AD.2.PL+IMP+1+PL
desqueiram-se	desquerer+V.ele.REFL+IMP+3+PL
desqueiram-te	desquerer+V.tu.AD.2.SG+IMP+3+PL
desqueiram-vos	desquerer+V.vós.AD.2.PL+IMP+3+PL
desqueira-nos	desquerer+nós.AD.1.PL+IMP+3+SG
desqueira-o	desquerer+V.ele.ACC.3.M.SG+IMP+3+SG
desqueira-os	desquerer+V.ele.ACC.3.M.PL+IMP+3+SG
desqueira-se	desquerer+V.ele.REFL+IMP+3+SG
desqueira-te	desquerer+V.tu.AD.2.SG+IMP+3+SG
desqueira-vos	desquerer+V.vós.AD.2.PL+IMP+3+SG
desqueixa-a	desqueixar+V.ele.ACC.3.F.SG+PRS+3+SG
desqueixa-as	desqueixar+V.ele.ACC.3.F.PL+PRS+3+SG
desqueixai-la	desqueixar+V.ele.ACC.3.F.SG+PRS+2+PL
desqueixai-las	desqueixar+V.ele.ACC.3.F.PL+PRS+2+PL
desqueixai-lo	desqueixar+V.ele.ACC.3.M.SG+PRS+2+PL
desqueixai-los	desqueixar+V.ele.ACC.3.M.PL+PRS+2+PL
desqueixai-nos	desqueixar+nós.AD.1.PL+PRS+2+PL
desqueixais-lhe	desqueixar+V.ele.DAT.3.SG+PRS+2+PL
desqueixais-lhes	desqueixar+V.ele.DAT.3.PL+PRS+2+PL
desqueixais-me	desqueixar+V.eu.AD.1.SG+PRS+2+PL
desqueixais-te	desqueixar+V.tu.AD.2.SG+PRS+2+PL
desqueixais-vos	desqueixar+V.vós.AD.2.PL+PRS+2+PL
desqueixá-la-á	desqueixar+V.ele.ACC.3.F.SG+FUT+3+SG
desqueixá-la-ão	desqueixar+V.ele.ACC.3.F.SG+FUT+3+PL
desqueixá-la-ás	desqueixar+V.ele.ACC.3.F.SG+FUT+2+SG
desqueixá-la	desqueixar+V.ele.ACC.3.F.SG+INF+1+SG
desqueixá-la	desqueixar+V.ele.ACC.3.F.SG+INF+3+SG
desqueixa-la	desqueixar+V.ele.ACC.3.F.SG+PRS+2+SG
desqueixá-la	desqueixar+V.ele.ACC.3.F.SG+SBJF+1+SG
desqueixá-la	desqueixar+V.ele.ACC.3.F.SG+SBJF+3+SG
desqueixá-la-ei	desqueixar+V.ele.ACC.3.F.SG+FUT+1+SG
desqueixá-la-eis	desqueixar+V.ele.ACC.3.F.SG+FUT+2+PL
desqueixá-la-emos	desqueixar+V.ele.ACC.3.F.SG+FUT+1+PL
desqueixá-la-ia	desqueixar+V.ele.ACC.3.F.SG+COND+1+SG
desqueixá-la-ia	desqueixar+V.ele.ACC.3.F.SG+COND+3+SG
desqueixá-la-iam	desqueixar+V.ele.ACC.3.F.SG+COND+3+PL
desqueixá-la-íamos	desqueixar+V.ele.ACC.3.F.SG+COND+1+PL
desqueixá-la-ias	desqueixar+V.ele.ACC.3.F.SG+COND+2+SG
desqueixá-la-íeis	desqueixar+V.ele.ACC.3.F.SG+COND+2+PL
desqueixá-las-á	desqueixar+V.ele.ACC.3.F.PL+FUT+3+SG
desqueixá-las-ão	desqueixar+V.ele.ACC.3.F.PL+FUT+3+PL
desqueixá-las-ás	desqueixar+V.ele.ACC.3.F.PL+FUT+2+SG
desqueixá-las	desqueixar+V.ele.ACC.3.F.PL+INF+1+SG
desqueixá-las	desqueixar+V.ele.ACC.3.F.PL+INF+3+SG
desqueixa-las	desqueixar+V.ele.ACC.3.F.PL+PRS+2+SG
desqueixá-las	desqueixar+V.ele.ACC.3.F.PL+SBJF+1+SG
desqueixá-las	desqueixar+V.ele.ACC.3.F.PL+SBJF+3+SG
desqueixá-las-ei	desqueixar+V.ele.ACC.3.F.PL+FUT+1+SG
desqueixá-las-eis	desqueixar+V.ele.ACC.3.F.PL+FUT+2+PL
desqueixá-las-emos	desqueixar+V.ele.ACC.3.F.PL+FUT+1+PL
desqueixá-las-ia	desqueixar+V.ele.ACC.3.F.PL+COND+1+SG
desqueixá-las-ia	desqueixar+V.ele.ACC.3.F.PL+COND+3+SG
desqueixá-las-iam	desqueixar+V.ele.ACC.3.F.PL+COND+3+PL
desqueixá-las-íamos	desqueixar+V.ele.ACC.3.F.PL+COND+1+PL
desqueixá-las-ias	desqueixar+V.ele.ACC.3.F.PL+COND+2+SG
desqueixá-las-íeis	desqueixar+V.ele.ACC.3.F.PL+COND+2+PL
desqueixa-lhe	desqueixar+V.ele.DAT.3.SG+PRS+3+SG
desqueixa-lhes	desqueixar+V.ele.DAT.3.PL+PRS+3+SG
desqueixá-lo-á	desqueixar+V.ele.ACC.3.M.SG+FUT+3+SG
desqueixá-lo-ão	desqueixar+V.ele.ACC.3.M.SG+FUT+3+PL
desqueixá-lo-ás	desqueixar+V.ele.ACC.3.M.SG+FUT+2+SG
desqueixá-lo	desqueixar+V.ele.ACC.3.M.SG+INF+1+SG
desqueixá-lo	desqueixar+V.ele.ACC.3.M.SG+INF+3+SG
desqueixa-lo	desqueixar+V.ele.ACC.3.M.SG+PRS+2+SG
desqueixá-lo	desqueixar+V.ele.ACC.3.M.SG+SBJF+1+SG
desqueixá-lo	desqueixar+V.ele.ACC.3.M.SG+SBJF+3+SG
desqueixá-lo-ei	desqueixar+V.ele.ACC.3.M.SG+FUT+1+SG
desqueixá-lo-eis	desqueixar+V.ele.ACC.3.M.SG+FUT+2+PL
desqueixá-lo-emos	desqueixar+V.ele.ACC.3.M.SG+FUT+1+PL
desqueixá-lo-ia	desqueixar+V.ele.ACC.3.M.SG+COND+1+SG
desqueixá-lo-ia	desqueixar+V.ele.ACC.3.M.SG+COND+3+SG
desqueixá-lo-iam	desqueixar+V.ele.ACC.3.M.SG+COND+3+PL
desqueixá-lo-íamos	desqueixar+V.ele.ACC.3.M.SG+COND+1+PL
desqueixá-lo-ias	desqueixar+V.ele.ACC.3.M.SG+COND+2+SG
desqueixá-lo-íeis	desqueixar+V.ele.ACC.3.M.SG+COND+2+PL
desqueixá-los-á	desqueixar+V.ele.ACC.3.M.PL+FUT+3+SG
desqueixá-los-ão	desqueixar+V.ele.ACC.3.M.PL+FUT+3+PL
desqueixá-los-ás	desqueixar+V.ele.ACC.3.M.PL+FUT+2+SG
desqueixá-los	desqueixar+V.ele.ACC.3.M.PL+INF+1+SG
desqueixá-los	desqueixar+V.ele.ACC.3.M.PL+INF+3+SG
desqueixa-los	desqueixar+V.ele.ACC.3.M.PL+PRS+2+SG
desqueixá-los	desqueixar+V.ele.ACC.3.M.PL+SBJF+1+SG
desqueixá-los	desqueixar+V.ele.ACC.3.M.PL+SBJF+3+SG
desqueixá-los-ei	desqueixar+V.ele.ACC.3.M.PL+FUT+1+SG
desqueixá-los-eis	desqueixar+V.ele.ACC.3.M.PL+FUT+2+PL
desqueixá-los-emos	desqueixar+V.ele.ACC.3.M.PL+FUT+1+PL
desqueixá-los-ia	desqueixar+V.ele.ACC.3.M.PL+COND+1+SG
desqueixá-los-ia	desqueixar+V.ele.ACC.3.M.PL+COND+3+SG
desqueixá-los-iam	desqueixar+V.ele.ACC.3.M.PL+COND+3+PL
desqueixá-los-íamos	desqueixar+V.ele.ACC.3.M.PL+COND+1+PL
desqueixá-los-ias	desqueixar+V.ele.ACC.3.M.PL+COND+2+SG
desqueixá-los-íeis	desqueixar+V.ele.ACC.3.M.PL+COND+2+PL
desqueixa-me	desqueixar+V.eu.AD.1.SG+PRS+3+SG
desqueixam-lhe	desqueixar+V.ele.DAT.3.SG+PRS+3+PL
desqueixam-lhes	desqueixar+V.ele.DAT.3.PL+PRS+3+PL
desqueixam-me	desqueixar+V.eu.AD.1.SG+PRS+3+PL
desqueixam-na	desqueixar+V.ele.ACC.3.F.SG+PRS+3+PL
desqueixam-nas	desqueixar+V.ele.ACC.3.F.PL+PRS+3+PL
desqueixam-no	desqueixar+V.ele.ACC.3.M.SG+PRS+3+PL
desqueixam-nos	desqueixar+V.ele.ACC.3.M.PL+PRS+3+PL
desqueixam-nos	desqueixar+V.nós.AD.1.PL+PRS+3+PL
desqueixamo-la	desqueixar+V.ele.ACC.3.F.SG+PRF+1+PL
desqueixamo-la	desqueixar+V.ele.ACC.3.F.SG+PRS+1+PL
desqueixamo-las	desqueixar+V.ele.ACC.3.F.PL+PRF+1+PL
desqueixamo-las	desqueixar+V.ele.ACC.3.F.PL+PRS+1+PL
desqueixamo-lo	desqueixar+V.ele.ACC.3.M.SG+PRF+1+PL
desqueixamo-lo	desqueixar+V.ele.ACC.3.M.SG+PRS+1+PL
desqueixamo-los	desqueixar+V.ele.ACC.3.M.PL+PRF+1+PL
desqueixamo-los	desqueixar+V.ele.ACC.3.M.PL+PRS+1+PL
desqueixamo-nos	desqueixar+nós.AD.1.PL+PRF+1+PL
desqueixamo-nos	desqueixar+nós.AD.1.PL+PRS+1+PL
desqueixamos-lhe	desqueixar+V.ele.DAT.3.SG+PRF+1+PL
desqueixamos-lhe	desqueixar+V.ele.DAT.3.SG+PRS+1+PL
desqueixamos-lhes	desqueixar+V.ele.DAT.3.PL+PRF+1+PL
desqueixamos-lhes	desqueixar+V.ele.DAT.3.PL+PRS+1+PL
desqueixamos-me	desqueixar+V.eu.AD.1.SG+PRF+1+PL
desqueixamos-me	desqueixar+V.eu.AD.1.SG+PRS+1+PL
desqueixamos-te	desqueixar+V.tu.AD.2.SG+PRF+1+PL
desqueixamos-te	desqueixar+V.tu.AD.2.SG+PRS+1+PL
desqueixamos-vos	desqueixar+V.vós.AD.2.PL+PRF+1+PL
desqueixamos-vos	desqueixar+V.vós.AD.2.PL+PRS+1+PL
desqueixam-se	desqueixar+V.ele.REFL+PRS+3+PL
desqueixam-te	desqueixar+V.tu.AD.2.SG+PRS+3+PL
desqueixam-vos	desqueixar+V.vós.AD.2.PL+PRS+3+PL
desqueixando-a	desqueixar+V.ele.ACC.3.F.SG+GRD
desqueixando-as	desqueixar+V.ele.ACC.3.F.PL+GRD
desqueixando-lhe	desqueixar+V.ele.DAT.3.SG+GRD
desqueixando-lhes	desqueixar+V.ele.DAT.3.PL+GRD
desqueixando-me	desqueixar+V.eu.AD.1.SG+GRD
desqueixando-nos	desqueixar+nós.AD.1.PL+GRD
desqueixando-o	desqueixar+V.ele.ACC.3.M.SG+GRD
desqueixando-os	desqueixar+V.ele.ACC.3.M.PL+GRD
desqueixando-se	desqueixar+V.ele.REFL+GRD
desqueixando-te	desqueixar+V.tu.AD.2.SG+GRD
desqueixando-vos	desqueixar+V.vós.AD.2.PL+GRD
desqueixa-nos	desqueixar+nós.AD.1.PL+PRS+2+SG
desqueixa-nos	desqueixar+nós.AD.1.PL+PRS+3+SG
desqueixa-o	desqueixar+V.ele.ACC.3.M.SG+PRS+3+SG
desqueixa-os	desqueixar+V.ele.ACC.3.M.PL+PRS+3+SG
desqueixara-a	desqueixar+V.ele.ACC.3.F.SG+PQP+1+SG
desqueixara-a	desqueixar+V.ele.ACC.3.F.SG+PQP+3+SG
desqueixara-as	desqueixar+V.ele.ACC.3.F.PL+PQP+1+SG
desqueixara-as	desqueixar+V.ele.ACC.3.F.PL+PQP+3+SG
desqueixara-la	desqueixar+V.ele.ACC.3.F.SG+PQP+2+SG
desqueixara-las	desqueixar+V.ele.ACC.3.F.PL+PQP+2+SG
desqueixara-lhe	desqueixar+V.ele.DAT.3.SG+PQP+1+SG
desqueixara-lhe	desqueixar+V.ele.DAT.3.SG+PQP+3+SG
desqueixara-lhes	desqueixar+V.ele.DAT.3.PL+PQP+1+SG
desqueixara-lhes	desqueixar+V.ele.DAT.3.PL+PQP+3+SG
desqueixara-lo	desqueixar+V.ele.ACC.3.M.SG+PQP+2+SG
desqueixara-los	desqueixar+V.ele.ACC.3.M.PL+PQP+2+SG
desqueixara-me	desqueixar+V.eu.AD.1.SG+PQP+1+SG
desqueixara-me	desqueixar+V.eu.AD.1.SG+PQP+3+SG
desqueixaram-lhe	desqueixar+V.ele.DAT.3.SG+PQP+3+PL
desqueixaram-lhe	desqueixar+V.ele.DAT.3.SG+PRF+3+PL
desqueixaram-lhes	desqueixar+V.ele.DAT.3.PL+PQP+3+PL
desqueixaram-lhes	desqueixar+V.ele.DAT.3.PL+PRF+3+PL
desqueixaram-me	desqueixar+V.eu.AD.1.SG+PQP+3+PL
