destronizar-vos-ás	destronizar+V.vós.AD.2.PL+FUT+2+SG
destronizar-vos	destronizar+V.vós.AD.2.PL+INF
destronizar-vos	destronizar+V.vós.AD.2.PL+INF+1+SG
destronizar-vos	destronizar+V.vós.AD.2.PL+INF+3+SG
destronizar-vos	destronizar+V.vós.AD.2.PL+SBJF+1+SG
destronizar-vos	destronizar+V.vós.AD.2.PL+SBJF+3+SG
destronizar-vos-ei	destronizar+V.vós.AD.2.PL+FUT+1+SG
destronizar-vos-eis	destronizar+V.vós.AD.2.PL+FUT+2+PL
destronizar-vos-emos	destronizar+V.vós.AD.2.PL+FUT+1+PL
destronizar-vos-ia	destronizar+V.vós.AD.2.PL+COND+1+SG
destronizar-vos-ia	destronizar+V.vós.AD.2.PL+COND+3+SG
destronizar-vos-iam	destronizar+V.vós.AD.2.PL+COND+3+PL
destronizar-vos-íamos	destronizar+V.vós.AD.2.PL+COND+1+PL
destronizar-vos-ias	destronizar+V.vós.AD.2.PL+COND+2+SG
destronizar-vos-íeis	destronizar+V.vós.AD.2.PL+COND+2+PL
destroniza-se	destronizar+V.ele.REFL+PRS+3+SG
destronizas-lhe	destronizar+V.ele.DAT.3.SG+PRS+2+SG
destronizas-lhes	destronizar+V.ele.DAT.3.PL+PRS+2+SG
destronizas-me	destronizar+V.eu.AD.1.SG+PRS+2+SG
destronizaste-a	destronizar+V.ele.ACC.3.F.SG+PRF+2+SG
destronizaste-as	destronizar+V.ele.ACC.3.F.PL+PRF+2+SG
destronizas-te	destronizar+V.tu.AD.2.SG+PRS+2+SG
destronizaste-la	destronizar+V.ele.ACC.3.F.SG+PRF+2+PL
destronizaste-las	destronizar+V.ele.ACC.3.F.PL+PRF+2+PL
destronizaste-lhe	destronizar+V.ele.DAT.3.SG+PRF+2+SG
destronizaste-lhes	destronizar+V.ele.DAT.3.PL+PRF+2+SG
destronizaste-lo	destronizar+V.ele.ACC.3.M.SG+PRF+2+PL
destronizaste-los	destronizar+V.ele.ACC.3.M.PL+PRF+2+PL
destronizaste-me	destronizar+V.eu.AD.1.SG+PRF+2+SG
destronizaste-nos	destronizar+nós.AD.1.PL+PRF+2+PL
destronizaste-nos	destronizar+nós.AD.1.PL+PRF+2+SG
destronizaste-o	destronizar+V.ele.ACC.3.M.SG+PRF+2+SG
destronizaste-os	destronizar+V.ele.ACC.3.M.PL+PRF+2+SG
destronizastes-lhe	destronizar+V.ele.DAT.3.SG+PRF+2+PL
destronizastes-lhes	destronizar+V.ele.DAT.3.PL+PRF+2+PL
destronizastes-me	destronizar+V.eu.AD.1.SG+PRF+2+PL
destronizastes-te	destronizar+V.tu.AD.2.SG+PRF+2+PL
destronizastes-vos	destronizar+V.vós.AD.2.PL+PRF+2+PL
destronizaste-te	destronizar+V.tu.AD.2.SG+PRF+2+SG
destronizaste-vos	destronizar+V.vós.AD.2.PL+PRF+2+SG
destronizas-vos	destronizar+V.vós.AD.2.PL+PRS+2+SG
destroniza-te	destronizar+V.tu.AD.2.SG+PRS+3+SG
destronizava-a	destronizar+V.ele.ACC.3.F.SG+IMPF+1+SG
destronizava-a	destronizar+V.ele.ACC.3.F.SG+IMPF+3+SG
destronizava-as	destronizar+V.ele.ACC.3.F.PL+IMPF+1+SG
destronizava-as	destronizar+V.ele.ACC.3.F.PL+IMPF+3+SG
destronizava-la	destronizar+V.ele.ACC.3.F.SG+IMPF+2+SG
destronizava-las	destronizar+V.ele.ACC.3.F.PL+IMPF+2+SG
destronizava-lhe	destronizar+V.ele.DAT.3.SG+IMPF+1+SG
destronizava-lhe	destronizar+V.ele.DAT.3.SG+IMPF+3+SG
destronizava-lhes	destronizar+V.ele.DAT.3.PL+IMPF+1+SG
destronizava-lhes	destronizar+V.ele.DAT.3.PL+IMPF+3+SG
destronizava-lo	destronizar+V.ele.ACC.3.M.SG+IMPF+2+SG
destronizava-los	destronizar+V.ele.ACC.3.M.PL+IMPF+2+SG
destronizava-me	destronizar+V.eu.AD.1.SG+IMPF+1+SG
destronizava-me	destronizar+V.eu.AD.1.SG+IMPF+3+SG
destronizavam-lhe	destronizar+V.ele.DAT.3.SG+IMPF+3+PL
destronizavam-lhes	destronizar+V.ele.DAT.3.PL+IMPF+3+PL
destronizavam-me	destronizar+V.eu.AD.1.SG+IMPF+3+PL
destronizavam-na	destronizar+V.ele.ACC.3.F.SG+IMPF+3+PL
destronizavam-nas	destronizar+V.ele.ACC.3.F.PL+IMPF+3+PL
destronizavam-no	destronizar+V.ele.ACC.3.M.SG+IMPF+3+PL
destronizavam-nos	destronizar+V.ele.ACC.3.M.PL+IMPF+3+PL
destronizavam-nos	destronizar+V.nós.AD.1.PL+IMPF+3+PL
destronizávamo-la	destronizar+V.ele.ACC.3.F.SG+IMPF+1+PL
destronizávamo-las	destronizar+V.ele.ACC.3.F.PL+IMPF+1+PL
destronizávamo-lo	destronizar+V.ele.ACC.3.M.SG+IMPF+1+PL
destronizávamo-los	destronizar+V.ele.ACC.3.M.PL+IMPF+1+PL
destronizávamo-nos	destronizar+nós.AD.1.PL+IMPF+1+PL
destronizávamos-lhe	destronizar+V.ele.DAT.3.SG+IMPF+1+PL
destronizávamos-lhes	destronizar+V.ele.DAT.3.PL+IMPF+1+PL
destronizávamos-me	destronizar+V.eu.AD.1.SG+IMPF+1+PL
destronizávamos-te	destronizar+V.tu.AD.2.SG+IMPF+1+PL
destronizávamos-vos	destronizar+V.vós.AD.2.PL+IMPF+1+PL
destronizavam-se	destronizar+V.ele.REFL+IMPF+3+PL
destronizavam-te	destronizar+V.tu.AD.2.SG+IMPF+3+PL
destronizavam-vos	destronizar+V.vós.AD.2.PL+IMPF+3+PL
destronizava-nos	destronizar+nós.AD.1.PL+IMPF+1+SG
destronizava-nos	destronizar+nós.AD.1.PL+IMPF+2+SG
destronizava-nos	destronizar+nós.AD.1.PL+IMPF+3+SG
destronizava-o	destronizar+V.ele.ACC.3.M.SG+IMPF+1+SG
destronizava-o	destronizar+V.ele.ACC.3.M.SG+IMPF+3+SG
destronizava-os	destronizar+V.ele.ACC.3.M.PL+IMPF+1+SG
destronizava-os	destronizar+V.ele.ACC.3.M.PL+IMPF+3+SG
destronizava-se	destronizar+V.ele.REFL+IMPF+1+SG
destronizava-se	destronizar+V.ele.REFL+IMPF+3+SG
destronizavas-lhe	destronizar+V.ele.DAT.3.SG+IMPF+2+SG
destronizavas-lhes	destronizar+V.ele.DAT.3.PL+IMPF+2+SG
destronizavas-me	destronizar+V.eu.AD.1.SG+IMPF+2+SG
destronizavas-te	destronizar+V.tu.AD.2.SG+IMPF+2+SG
destronizavas-vos	destronizar+V.vós.AD.2.PL+IMPF+2+SG
destronizava-te	destronizar+V.tu.AD.2.SG+IMPF+1+SG
destronizava-te	destronizar+V.tu.AD.2.SG+IMPF+3+SG
destronizava-vos	destronizar+V.vós.AD.2.PL+IMPF+1+SG
destronizava-vos	destronizar+V.vós.AD.2.PL+IMPF+3+SG
destronizávei-la	destronizar+V.ele.ACC.3.F.SG+IMPF+2+PL
destronizávei-las	destronizar+V.ele.ACC.3.F.PL+IMPF+2+PL
destronizávei-lo	destronizar+V.ele.ACC.3.M.SG+IMPF+2+PL
destronizávei-los	destronizar+V.ele.ACC.3.M.PL+IMPF+2+PL
destronizávei-nos	destronizar+nós.AD.1.PL+IMPF+2+PL
destronizáveis-lhe	destronizar+V.ele.DAT.3.SG+IMPF+2+PL
destronizáveis-lhes	destronizar+V.ele.DAT.3.PL+IMPF+2+PL
destronizáveis-me	destronizar+V.eu.AD.1.SG+IMPF+2+PL
destronizáveis-te	destronizar+V.tu.AD.2.SG+IMPF+2+PL
destronizáveis-vos	destronizar+V.vós.AD.2.PL+IMPF+2+PL
destroniza-vos	destronizar+V.vós.AD.2.PL+PRS+3+SG
destronize-a	destronizar+V.ele.ACC.3.F.SG+IMP+3+SG
destronize-as	destronizar+V.ele.ACC.3.F.PL+IMP+3+SG
destronizei-a	destronizar+V.ele.ACC.3.F.SG+PRF+1+SG
destronizei-as	destronizar+V.ele.ACC.3.F.PL+PRF+1+SG
destronizei-lhe	destronizar+V.ele.DAT.3.SG+PRF+1+SG
destronizei-lhes	destronizar+V.ele.DAT.3.PL+PRF+1+SG
destronizei-me	destronizar+V.eu.AD.1.SG+PRF+1+SG
destronizei-nos	destronizar+nós.AD.1.PL+PRF+1+SG
destronizei-o	destronizar+V.ele.ACC.3.M.SG+PRF+1+SG
destronizei-os	destronizar+V.ele.ACC.3.M.PL+PRF+1+SG
destronizei-te	destronizar+V.tu.AD.2.SG+PRF+1+SG
destronizei-vos	destronizar+V.vós.AD.2.PL+PRF+1+SG
destronize-lhe	destronizar+V.ele.DAT.3.SG+IMP+3+SG
destronize-lhes	destronizar+V.ele.DAT.3.PL+IMP+3+SG
destronize-me	destronizar+V.eu.AD.1.SG+IMP+3+SG
destronizem-lhe	destronizar+V.ele.DAT.3.SG+IMP+3+PL
destronizem-lhes	destronizar+V.ele.DAT.3.PL+IMP+3+PL
destronizem-me	destronizar+V.eu.AD.1.SG+IMP+3+PL
destronizem-na	destronizar+V.ele.ACC.3.F.SG+IMP+3+PL
destronizem-nas	destronizar+V.ele.ACC.3.F.PL+IMP+3+PL
destronizem-no	destronizar+V.ele.ACC.3.M.SG+IMP+3+PL
destronizem-nos	destronizar+V.ele.ACC.3.M.PL+IMP+3+PL
destronizem-nos	destronizar+V.nós.AD.1.PL+IMP+3+PL
destronizemo-la	destronizar+V.ele.ACC.3.F.SG+IMP+1+PL
destronizemo-las	destronizar+V.ele.ACC.3.F.PL+IMP+1+PL
destronizemo-lo	destronizar+V.ele.ACC.3.M.SG+IMP+1+PL
destronizemo-los	destronizar+V.ele.ACC.3.M.PL+IMP+1+PL
destronizemo-nos	destronizar+nós.AD.1.PL+IMP+1+PL
destronizemos-lhe	destronizar+V.ele.DAT.3.SG+IMP+1+PL
destronizemos-lhes	destronizar+V.ele.DAT.3.PL+IMP+1+PL
destronizemos-me	destronizar+V.eu.AD.1.SG+IMP+1+PL
destronizemos-te	destronizar+V.tu.AD.2.SG+IMP+1+PL
destronizemos-vos	destronizar+V.vós.AD.2.PL+IMP+1+PL
destronizem-se	destronizar+V.ele.REFL+IMP+3+PL
destronizem-te	destronizar+V.tu.AD.2.SG+IMP+3+PL
destronizem-vos	destronizar+V.vós.AD.2.PL+IMP+3+PL
destronize-nos	destronizar+nós.AD.1.PL+IMP+3+SG
destronize-o	destronizar+V.ele.ACC.3.M.SG+IMP+3+SG
destronize-os	destronizar+V.ele.ACC.3.M.PL+IMP+3+SG
destronize-se	destronizar+V.ele.REFL+IMP+3+SG
destronize-te	destronizar+V.tu.AD.2.SG+IMP+3+SG
destronize-vos	destronizar+V.vós.AD.2.PL+IMP+3+SG
destronizo-a	destronizar+V.ele.ACC.3.F.SG+PRS+1+SG
destronizo-as	destronizar+V.ele.ACC.3.F.PL+PRS+1+SG
destronizo-lhe	destronizar+V.ele.DAT.3.SG+PRS+1+SG
destronizo-lhes	destronizar+V.ele.DAT.3.PL+PRS+1+SG
destronizo-me	destronizar+V.eu.AD.1.SG+PRS+1+SG
destronizo-nos	destronizar+nós.AD.1.PL+PRS+1+SG
destronizo-o	destronizar+V.ele.ACC.3.M.SG+PRS+1+SG
destronizo-os	destronizar+V.ele.ACC.3.M.PL+PRS+1+SG
destronizo-te	destronizar+V.tu.AD.2.SG+PRS+1+SG
destronizou-a	destronizar+V.ele.ACC.3.F.SG+PRF+3+SG
destronizou-as	destronizar+V.ele.ACC.3.F.PL+PRF+3+SG
destronizou-lhe	destronizar+V.ele.DAT.3.SG+PRF+3+SG
destronizou-lhes	destronizar+V.ele.DAT.3.PL+PRF+3+SG
destronizou-me	destronizar+V.eu.AD.1.SG+PRF+3+SG
destronizou-nos	destronizar+nós.AD.1.PL+PRF+3+SG
destronizou-o	destronizar+V.ele.ACC.3.M.SG+PRF+3+SG
destronizou-os	destronizar+V.ele.ACC.3.M.PL+PRF+3+SG
destronizou-se	destronizar+V.ele.REFL+PRF+3+SG
destronizou-te	destronizar+V.tu.AD.2.SG+PRF+3+SG
destronizou-vos	destronizar+V.vós.AD.2.PL+PRF+3+SG
destronizo-vos	destronizar+V.vós.AD.2.PL+PRS+1+SG
destrono-a	destronar+V.ele.ACC.3.F.SG+PRS+1+SG
destrono-as	destronar+V.ele.ACC.3.F.PL+PRS+1+SG
destrono-lhe	destronar+V.ele.DAT.3.SG+PRS+1+SG
destrono-lhes	destronar+V.ele.DAT.3.PL+PRS+1+SG
destrono-me	destronar+V.eu.AD.1.SG+PRS+1+SG
destrono-nos	destronar+nós.AD.1.PL+PRS+1+SG
destrono-o	destronar+V.ele.ACC.3.M.SG+PRS+1+SG
destrono-os	destronar+V.ele.ACC.3.M.PL+PRS+1+SG
destrono-te	destronar+V.tu.AD.2.SG+PRS+1+SG
destronou-a	destronar+V.ele.ACC.3.F.SG+PRF+3+SG
destronou-as	destronar+V.ele.ACC.3.F.PL+PRF+3+SG
destronou-lhe	destronar+V.ele.DAT.3.SG+PRF+3+SG
destronou-lhes	destronar+V.ele.DAT.3.PL+PRF+3+SG
destronou-me	destronar+V.eu.AD.1.SG+PRF+3+SG
destronou-nos	destronar+nós.AD.1.PL+PRF+3+SG
destronou-o	destronar+V.ele.ACC.3.M.SG+PRF+3+SG
destronou-os	destronar+V.ele.ACC.3.M.PL+PRF+3+SG
destronou-se	destronar+V.ele.REFL+PRF+3+SG
destronou-te	destronar+V.tu.AD.2.SG+PRF+3+SG
destronou-vos	destronar+V.vós.AD.2.PL+PRF+3+SG
destrono-vos	destronar+V.vós.AD.2.PL+PRS+1+SG
destronque-a	destroncar+V.ele.ACC.3.F.SG+IMP+3+SG
destronque-as	destroncar+V.ele.ACC.3.F.PL+IMP+3+SG
destronquei-a	destroncar+V.ele.ACC.3.F.SG+PRF+1+SG
destronquei-as	destroncar+V.ele.ACC.3.F.PL+PRF+1+SG
destronquei-lhe	destroncar+V.ele.DAT.3.SG+PRF+1+SG
destronquei-lhes	destroncar+V.ele.DAT.3.PL+PRF+1+SG
destronquei-me	destroncar+V.eu.AD.1.SG+PRF+1+SG
destronquei-nos	destroncar+nós.AD.1.PL+PRF+1+SG
destronquei-o	destroncar+V.ele.ACC.3.M.SG+PRF+1+SG
destronquei-os	destroncar+V.ele.ACC.3.M.PL+PRF+1+SG
destronquei-te	destroncar+V.tu.AD.2.SG+PRF+1+SG
destronquei-vos	destroncar+V.vós.AD.2.PL+PRF+1+SG
destronque-lhe	destroncar+V.ele.DAT.3.SG+IMP+3+SG
destronque-lhes	destroncar+V.ele.DAT.3.PL+IMP+3+SG
destronque-me	destroncar+V.eu.AD.1.SG+IMP+3+SG
destronquem-lhe	destroncar+V.ele.DAT.3.SG+IMP+3+PL
destronquem-lhes	destroncar+V.ele.DAT.3.PL+IMP+3+PL
destronquem-me	destroncar+V.eu.AD.1.SG+IMP+3+PL
destronquem-na	destroncar+V.ele.ACC.3.F.SG+IMP+3+PL
destronquem-nas	destroncar+V.ele.ACC.3.F.PL+IMP+3+PL
destronquem-no	destroncar+V.ele.ACC.3.M.SG+IMP+3+PL
destronquem-nos	destroncar+V.ele.ACC.3.M.PL+IMP+3+PL
destronquem-nos	destroncar+V.nós.AD.1.PL+IMP+3+PL
destronquemo-la	destroncar+V.ele.ACC.3.F.SG+IMP+1+PL
destronquemo-las	destroncar+V.ele.ACC.3.F.PL+IMP+1+PL
destronquemo-lo	destroncar+V.ele.ACC.3.M.SG+IMP+1+PL
destronquemo-los	destroncar+V.ele.ACC.3.M.PL+IMP+1+PL
destronquemo-nos	destroncar+nós.AD.1.PL+IMP+1+PL
destronquemos-lhe	destroncar+V.ele.DAT.3.SG+IMP+1+PL
destronquemos-lhes	destroncar+V.ele.DAT.3.PL+IMP+1+PL
destronquemos-me	destroncar+V.eu.AD.1.SG+IMP+1+PL
destronquemos-te	destroncar+V.tu.AD.2.SG+IMP+1+PL
destronquemos-vos	destroncar+V.vós.AD.2.PL+IMP+1+PL
destronquem-se	destroncar+V.ele.REFL+IMP+3+PL
destronquem-te	destroncar+V.tu.AD.2.SG+IMP+3+PL
destronquem-vos	destroncar+V.vós.AD.2.PL+IMP+3+PL
destronque-nos	destroncar+nós.AD.1.PL+IMP+3+SG
destronque-o	destroncar+V.ele.ACC.3.M.SG+IMP+3+SG
destronque-os	destroncar+V.ele.ACC.3.M.PL+IMP+3+SG
destronque-se	destroncar+V.ele.REFL+IMP+3+SG
destronque-te	destroncar+V.tu.AD.2.SG+IMP+3+SG
destronque-vos	destroncar+V.vós.AD.2.PL+IMP+3+SG
destroque-a	destrocar+V.ele.ACC.3.F.SG+IMP+3+SG
destroque-as	destrocar+V.ele.ACC.3.F.PL+IMP+3+SG
destroquei-a	destrocar+V.ele.ACC.3.F.SG+PRF+1+SG
destroquei-as	destrocar+V.ele.ACC.3.F.PL+PRF+1+SG
destroquei-lhe	destrocar+V.ele.DAT.3.SG+PRF+1+SG
destroquei-lhes	destrocar+V.ele.DAT.3.PL+PRF+1+SG
destroquei-me	destrocar+V.eu.AD.1.SG+PRF+1+SG
destroquei-nos	destrocar+nós.AD.1.PL+PRF+1+SG
destroquei-o	destrocar+V.ele.ACC.3.M.SG+PRF+1+SG
destroquei-os	destrocar+V.ele.ACC.3.M.PL+PRF+1+SG
destroquei-te	destrocar+V.tu.AD.2.SG+PRF+1+SG
destroquei-vos	destrocar+V.vós.AD.2.PL+PRF+1+SG
destroque-lhe	destrocar+V.ele.DAT.3.SG+IMP+3+SG
destroque-lhes	destrocar+V.ele.DAT.3.PL+IMP+3+SG
destroque-me	destrocar+V.eu.AD.1.SG+IMP+3+SG
destroquem-lhe	destrocar+V.ele.DAT.3.SG+IMP+3+PL
destroquem-lhes	destrocar+V.ele.DAT.3.PL+IMP+3+PL
destroquem-me	destrocar+V.eu.AD.1.SG+IMP+3+PL
destroquem-na	destrocar+V.ele.ACC.3.F.SG+IMP+3+PL
destroquem-nas	destrocar+V.ele.ACC.3.F.PL+IMP+3+PL
destroquem-no	destrocar+V.ele.ACC.3.M.SG+IMP+3+PL
destroquem-nos	destrocar+V.ele.ACC.3.M.PL+IMP+3+PL
destroquem-nos	destrocar+V.nós.AD.1.PL+IMP+3+PL
destroquemo-la	destrocar+V.ele.ACC.3.F.SG+IMP+1+PL
destroquemo-las	destrocar+V.ele.ACC.3.F.PL+IMP+1+PL
destroquemo-lo	destrocar+V.ele.ACC.3.M.SG+IMP+1+PL
destroquemo-los	destrocar+V.ele.ACC.3.M.PL+IMP+1+PL
destroquemo-nos	destrocar+nós.AD.1.PL+IMP+1+PL
destroquemos-lhe	destrocar+V.ele.DAT.3.SG+IMP+1+PL
destroquemos-lhes	destrocar+V.ele.DAT.3.PL+IMP+1+PL
destroquemos-me	destrocar+V.eu.AD.1.SG+IMP+1+PL
destroquemos-te	destrocar+V.tu.AD.2.SG+IMP+1+PL
destroquemos-vos	destrocar+V.vós.AD.2.PL+IMP+1+PL
destroquem-se	destrocar+V.ele.REFL+IMP+3+PL
destroquem-te	destrocar+V.tu.AD.2.SG+IMP+3+PL
destroquem-vos	destrocar+V.vós.AD.2.PL+IMP+3+PL
destroque-nos	destrocar+nós.AD.1.PL+IMP+3+SG
destroque-o	destrocar+V.ele.ACC.3.M.SG+IMP+3+SG
destroque-os	destrocar+V.ele.ACC.3.M.PL+IMP+3+SG
destroque-se	destrocar+V.ele.REFL+IMP+3+SG
destroque-te	destrocar+V.tu.AD.2.SG+IMP+3+SG
destroque-vos	destrocar+V.vós.AD.2.PL+IMP+3+SG
destrua-a	destruir+V.ele.ACC.3.F.SG+IMP+3+SG
destrua-as	destruir+V.ele.ACC.3.F.PL+IMP+3+SG
destrua-lhe	destruir+V.ele.DAT.3.SG+IMP+3+SG
destrua-lhes	destruir+V.ele.DAT.3.PL+IMP+3+SG
destrua-me	destruir+V.eu.AD.1.SG+IMP+3+SG
destruam-lhe	destruir+V.ele.DAT.3.SG+IMP+3+PL
destruam-lhes	destruir+V.ele.DAT.3.PL+IMP+3+PL
destruam-me	destruir+V.eu.AD.1.SG+IMP+3+PL
destruam-na	destruir+V.ele.ACC.3.F.SG+IMP+3+PL
destruam-nas	destruir+V.ele.ACC.3.F.PL+IMP+3+PL
destruam-no	destruir+V.ele.ACC.3.M.SG+IMP+3+PL
destruam-nos	destruir+V.ele.ACC.3.M.PL+IMP+3+PL
destruam-nos	destruir+V.nós.AD.1.PL+IMP+3+PL
destruamo-la	destruir+V.ele.ACC.3.F.SG+IMP+1+PL
destruamo-las	destruir+V.ele.ACC.3.F.PL+IMP+1+PL
destruamo-lo	destruir+V.ele.ACC.3.M.SG+IMP+1+PL
destruamo-los	destruir+V.ele.ACC.3.M.PL+IMP+1+PL
destruamo-nos	destruir+nós.AD.1.PL+IMP+1+PL
destruamos-lhe	destruir+V.ele.DAT.3.SG+IMP+1+PL
destruamos-lhes	destruir+V.ele.DAT.3.PL+IMP+1+PL
destruamos-me	destruir+V.eu.AD.1.SG+IMP+1+PL
destruamos-te	destruir+V.tu.AD.2.SG+IMP+1+PL
destruamos-vos	destruir+V.vós.AD.2.PL+IMP+1+PL
destruam-se	destruir+V.ele.REFL+IMP+3+PL
destruam-te	destruir+V.tu.AD.2.SG+IMP+3+PL
destruam-vos	destruir+V.vós.AD.2.PL+IMP+3+PL
destrua-nos	destruir+nós.AD.1.PL+IMP+3+SG
destrua-o	destruir+V.ele.ACC.3.M.SG+IMP+3+SG
destrua-os	destruir+V.ele.ACC.3.M.PL+IMP+3+SG
destrua-se	destruir+V.ele.REFL+IMP+3+SG
destrua-te	destruir+V.tu.AD.2.SG+IMP+3+SG
destrua-vos	destruir+V.vós.AD.2.PL+IMP+3+SG
destruem-lhe	destruir+V.ele.DAT.3.SG+PRS+3+PL
destruem-lhes	destruir+V.ele.DAT.3.PL+PRS+3+PL
destruem-me	destruir+V.eu.AD.1.SG+PRS+3+PL
destruem-na	destruir+V.ele.ACC.3.F.SG+PRS+3+PL
destruem-nas	destruir+V.ele.ACC.3.F.PL+PRS+3+PL
destruem-no	destruir+V.ele.ACC.3.M.SG+PRS+3+PL
destruem-nos	destruir+V.ele.ACC.3.M.PL+PRS+3+PL
destruem-nos	destruir+V.nós.AD.1.PL+PRS+3+PL
destruem-se	destruir+V.ele.REFL+PRS+3+PL
destruem-te	destruir+V.tu.AD.2.SG+PRS+3+PL
destruem-vos	destruir+V.vós.AD.2.PL+PRS+3+PL
destruía-a	destruir+V.ele.ACC.3.F.SG+IMPF+1+SG
destruía-a	destruir+V.ele.ACC.3.F.SG+IMPF+3+SG
destruía-as	destruir+V.ele.ACC.3.F.PL+IMPF+1+SG
destruía-as	destruir+V.ele.ACC.3.F.PL+IMPF+3+SG
destruí-a	destruir+V.ele.ACC.3.F.SG+PRF+1+SG
destrui-a	destruir+V.ele.ACC.3.F.SG+PRS+3+SG
destruía-la	destruir+V.ele.ACC.3.F.SG+IMPF+2+SG
destruía-las	destruir+V.ele.ACC.3.F.PL+IMPF+2+SG
destruía-lhe	destruir+V.ele.DAT.3.SG+IMPF+1+SG
destruía-lhe	destruir+V.ele.DAT.3.SG+IMPF+3+SG
destruía-lhes	destruir+V.ele.DAT.3.PL+IMPF+1+SG
destruía-lhes	destruir+V.ele.DAT.3.PL+IMPF+3+SG
destruía-lo	destruir+V.ele.ACC.3.M.SG+IMPF+2+SG
destruía-los	destruir+V.ele.ACC.3.M.PL+IMPF+2+SG
destruía-me	destruir+V.eu.AD.1.SG+IMPF+1+SG
destruía-me	destruir+V.eu.AD.1.SG+IMPF+3+SG
destruíam-lhe	destruir+V.ele.DAT.3.SG+IMPF+3+PL
destruíam-lhes	destruir+V.ele.DAT.3.PL+IMPF+3+PL
destruíam-me	destruir+V.eu.AD.1.SG+IMPF+3+PL
destruíam-na	destruir+V.ele.ACC.3.F.SG+IMPF+3+PL
destruíam-nas	destruir+V.ele.ACC.3.F.PL+IMPF+3+PL
destruíam-no	destruir+V.ele.ACC.3.M.SG+IMPF+3+PL
destruíam-nos	destruir+nós.AD.1.PL+IMPF+3+PL
destruíamo-la	destruir+V.ele.ACC.3.F.SG+IMPF+1+PL
destruíamo-las	destruir+V.ele.ACC.3.F.PL+IMPF+1+PL
destruíamo-lo	destruir+V.ele.ACC.3.M.SG+IMPF+1+PL
destruíamo-los	destruir+V.ele.ACC.3.M.PL+IMPF+1+PL
destruíamo-nos	destruir+nós.AD.1.PL+IMPF+1+PL
destruíamos-lhe	destruir+V.ele.DAT.3.SG+IMPF+1+PL
destruíamos-lhes	destruir+V.ele.DAT.3.PL+IMPF+1+PL
destruíamos-me	destruir+V.eu.AD.1.SG+IMPF+1+PL
destruíamos-te	destruir+V.tu.AD.2.SG+IMPF+1+PL
destruíamos-vos	destruir+V.vós.AD.2.PL+IMPF+1+PL
destruíam-se	destruir+V.ele.REFL+IMPF+3+PL
destruíam-te	destruir+V.tu.AD.2.SG+IMPF+3+PL
destruíam-vos	destruir+V.vós.AD.2.PL+IMPF+3+PL
destruía-nos	destruir+nós.AD.1.PL+IMPF+1+SG
destruía-nos	destruir+nós.AD.1.PL+IMPF+2+SG
destruía-nos	destruir+nós.AD.1.PL+IMPF+3+SG
destruía-o	destruir+V.ele.ACC.3.M.SG+IMPF+1+SG
destruía-o	destruir+V.ele.ACC.3.M.SG+IMPF+3+SG
destruía-os	destruir+V.ele.ACC.3.M.PL+IMPF+1+SG
destruía-os	destruir+V.ele.ACC.3.M.PL+IMPF+3+SG
destruí-as	destruir+V.ele.ACC.3.F.PL+PRF+1+SG
destrui-as	destruir+V.ele.ACC.3.F.PL+PRS+3+SG
destruía-se	destruir+V.ele.REFL+IMPF+3+SG
destruías-lhe	destruir+V.ele.DAT.3.SG+IMPF+2+SG
destruías-lhes	destruir+V.ele.DAT.3.PL+IMPF+2+SG
destruías-me	destruir+V.eu.AD.1.SG+IMPF+2+SG
destruías-te	destruir+V.tu.AD.2.SG+IMPF+2+SG
destruías-vos	destruir+V.vós.AD.2.PL+IMPF+2+SG
destruía-te	destruir+V.tu.AD.2.SG+IMPF+1+SG
destruía-te	destruir+V.tu.AD.2.SG+IMPF+3+SG
destruía-vos	destruir+V.vós.AD.2.PL+IMPF+1+SG
destruía-vos	destruir+V.vós.AD.2.PL+IMPF+3+SG
destruíei-la	destruir+V.ele.ACC.3.F.SG+IMPF+2+PL
destruíei-las	destruir+V.ele.ACC.3.F.PL+IMPF+2+PL
destruíei-lo	destruir+V.ele.ACC.3.M.SG+IMPF+2+PL
destruíei-los	destruir+V.ele.ACC.3.M.PL+IMPF+2+PL
destruíei-nos	destruir+nós.AD.1.PL+IMPF+2+PL
destruíeis-lhe	destruir+V.ele.DAT.3.SG+IMPF+2+PL
destruíeis-lhes	destruir+V.ele.DAT.3.PL+IMPF+2+PL
destruíeis-me	destruir+V.eu.AD.1.SG+IMPF+2+PL
destruíeis-te	destruir+V.tu.AD.2.SG+IMPF+2+PL
destruíeis-vos	destruir+V.vós.AD.2.PL+IMPF+2+PL
destrui-la-á	destruir+V.ele.ACC.3.F.SG+FUT+3+SG
destrui-la-ão	destruir+V.ele.ACC.3.F.SG+FUT+3+PL
destrui-la-ás	destruir+V.ele.ACC.3.F.SG+FUT+2+SG
destrui-la	destruir+V.ele.ACC.3.F.SG+INF+1+SG
destrui-la	destruir+V.ele.ACC.3.F.SG+INF+3+SG
destruí-la	destruir+V.ele.ACC.3.F.SG+PRS+2+PL
destrui-la	destruir+V.ele.ACC.3.F.SG+PRS+2+SG
destrui-la	destruir+V.ele.ACC.3.F.SG+SBJF+1+SG
destrui-la	destruir+V.ele.ACC.3.F.SG+SBJF+3+SG
destrui-la-ei	destruir+V.ele.ACC.3.F.SG+FUT+1+SG
destrui-la-eis	destruir+V.ele.ACC.3.F.SG+FUT+2+PL
destrui-la-emos	destruir+V.ele.ACC.3.F.SG+FUT+1+PL
destrui-la-ia	destruir+V.ele.ACC.3.F.SG+COND+1+SG
destrui-la-ia	destruir+V.ele.ACC.3.F.SG+COND+3+SG
destrui-la-iam	destruir+V.ele.ACC.3.F.SG+COND+3+PL
destrui-la-íamos	destruir+V.ele.ACC.3.F.SG+COND+1+PL
destrui-la-ias	destruir+V.ele.ACC.3.F.SG+COND+2+SG
destrui-la-íeis	destruir+V.ele.ACC.3.F.SG+COND+2+PL
destrui-las-á	destruir+V.ele.ACC.3.F.PL+FUT+3+SG
destrui-las-ão	destruir+V.ele.ACC.3.F.PL+FUT+3+PL
destrui-las-ás	destruir+V.ele.ACC.3.F.PL+FUT+2+SG
destrui-las	destruir+V.ele.ACC.3.F.PL+INF+1+SG
destrui-las	destruir+V.ele.ACC.3.F.PL+INF+3+SG
destruí-las	destruir+V.ele.ACC.3.F.PL+PRS+2+PL
destrui-las	destruir+V.ele.ACC.3.F.PL+PRS+2+SG
destrui-las	destruir+V.ele.ACC.3.F.PL+SBJF+1+SG
destrui-las	destruir+V.ele.ACC.3.F.PL+SBJF+3+SG
destrui-las-ei	destruir+V.ele.ACC.3.F.PL+FUT+1+SG
destrui-las-eis	destruir+V.ele.ACC.3.F.PL+FUT+2+PL
destrui-las-emos	destruir+V.ele.ACC.3.F.PL+FUT+1+PL
destrui-las-ia	destruir+V.ele.ACC.3.F.PL+COND+1+SG
destrui-las-ia	destruir+V.ele.ACC.3.F.PL+COND+3+SG
destrui-las-iam	destruir+V.ele.ACC.3.F.PL+COND+3+PL
destrui-las-íamos	destruir+V.ele.ACC.3.F.PL+COND+1+PL
destrui-las-ias	destruir+V.ele.ACC.3.F.PL+COND+2+SG
destrui-las-íeis	destruir+V.ele.ACC.3.F.PL+COND+2+PL
destruí-lhe	destruir+V.ele.DAT.3.SG+PRF+1+SG
destrui-lhe	destruir+V.ele.DAT.3.SG+PRS+3+SG
destruí-lhes	destruir+V.ele.DAT.3.PL+PRF+1+SG
destrui-lhes	destruir+V.ele.DAT.3.PL+PRS+3+SG
destrui-lo-á	destruir+V.ele.ACC.3.M.SG+FUT+3+SG
destrui-lo-ão	destruir+V.ele.ACC.3.M.SG+FUT+3+PL
destrui-lo-ás	destruir+V.ele.ACC.3.M.SG+FUT+2+SG
destrui-lo	destruir+V.ele.ACC.3.M.SG+INF+1+SG
destrui-lo	destruir+V.ele.ACC.3.M.SG+INF+3+SG
destruí-lo	destruir+V.ele.ACC.3.M.SG+PRS+2+PL
destrui-lo	destruir+V.ele.ACC.3.M.SG+PRS+2+SG
destrui-lo	destruir+V.ele.ACC.3.M.SG+SBJF+1+SG
destrui-lo	destruir+V.ele.ACC.3.M.SG+SBJF+3+SG
destrui-lo-ei	destruir+V.ele.ACC.3.M.SG+FUT+1+SG
destrui-lo-eis	destruir+V.ele.ACC.3.M.SG+FUT+2+PL
destrui-lo-emos	destruir+V.ele.ACC.3.M.SG+FUT+1+PL
destrui-lo-ia	destruir+V.ele.ACC.3.M.SG+COND+1+SG
destrui-lo-ia	destruir+V.ele.ACC.3.M.SG+COND+3+SG
destrui-lo-iam	destruir+V.ele.ACC.3.M.SG+COND+3+PL
destrui-lo-íamos	destruir+V.ele.ACC.3.M.SG+COND+1+PL
destrui-lo-ias	destruir+V.ele.ACC.3.M.SG+COND+2+SG
destrui-lo-íeis	destruir+V.ele.ACC.3.M.SG+COND+2+PL
destrui-los-á	destruir+V.ele.ACC.3.M.PL+FUT+3+SG
destrui-los-ão	destruir+V.ele.ACC.3.M.PL+FUT+3+PL
destrui-los-ás	destruir+V.ele.ACC.3.M.PL+FUT+2+SG
destrui-los	destruir+V.ele.ACC.3.M.PL+INF+1+SG
destrui-los	destruir+V.ele.ACC.3.M.PL+INF+3+SG
destruí-los	destruir+V.ele.ACC.3.M.PL+PRS+2+PL
destrui-los	destruir+V.ele.ACC.3.M.PL+PRS+2+SG
destrui-los	destruir+V.ele.ACC.3.M.PL+SBJF+1+SG
destrui-los	destruir+V.ele.ACC.3.M.PL+SBJF+3+SG
destrui-los-ei	destruir+V.ele.ACC.3.M.PL+FUT+1+SG
destrui-los-eis	destruir+V.ele.ACC.3.M.PL+FUT+2+PL
destrui-los-emos	destruir+V.ele.ACC.3.M.PL+FUT+1+PL
destrui-los-ia	destruir+V.ele.ACC.3.M.PL+COND+1+SG
destrui-los-ia	destruir+V.ele.ACC.3.M.PL+COND+3+SG
destrui-los-iam	destruir+V.ele.ACC.3.M.PL+COND+3+PL
destrui-los-íamos	destruir+V.ele.ACC.3.M.PL+COND+1+PL
destrui-los-ias	destruir+V.ele.ACC.3.M.PL+COND+2+SG
destrui-los-íeis	destruir+V.ele.ACC.3.M.PL+COND+2+PL
destruí-me	destruir+V.eu.AD.1.SG+PRF+1+SG
destrui-me	destruir+V.eu.AD.1.SG+PRS+3+SG
destruímo-la	destruir+V.ele.ACC.3.F.SG+PRF+1+PL
destruímo-la	destruir+V.ele.ACC.3.F.SG+PRS+1+PL
destruímo-las	destruir+V.ele.ACC.3.F.PL+PRF+1+PL
destruímo-las	destruir+V.ele.ACC.3.F.PL+PRS+1+PL
destruímo-lo	destruir+V.ele.ACC.3.M.SG+PRF+1+PL
destruímo-lo	destruir+V.ele.ACC.3.M.SG+PRS+1+PL
destruímo-los	destruir+V.ele.ACC.3.M.PL+PRF+1+PL
destruímo-los	destruir+V.ele.ACC.3.M.PL+PRS+1+PL
destruímo-nos	destruir+nós.AD.1.PL+PRF+1+PL
destruímo-nos	destruir+nós.AD.1.PL+PRS+1+PL
destruímos-lhe	destruir+V.ele.DAT.3.SG+PRF+1+PL
destruímos-lhe	destruir+V.ele.DAT.3.SG+PRS+1+PL
destruímos-lhes	destruir+V.ele.DAT.3.PL+PRF+1+PL
destruímos-lhes	destruir+V.ele.DAT.3.PL+PRS+1+PL
destruímos-me	destruir+V.eu.AD.1.SG+PRF+1+PL
destruímos-me	destruir+V.eu.AD.1.SG+PRS+1+PL
destruímos-te	destruir+V.tu.AD.2.SG+PRF+1+PL
destruímos-te	destruir+V.tu.AD.2.SG+PRS+1+PL
destruímos-vos	destruir+V.vós.AD.2.PL+PRF+1+PL
destruímos-vos	destruir+V.vós.AD.2.PL+PRS+1+PL
destruindo-a	destruir+V.ele.ACC.3.F.SG+GRD
destruindo-as	destruir+V.ele.ACC.3.F.PL+GRD
destruindo-lhe	destruir+V.ele.DAT.3.SG+GRD
destruindo-lhes	destruir+V.ele.DAT.3.PL+GRD
destruindo-me	destruir+V.eu.AD.1.SG+GRD
destruindo-nos	destruir+nós.AD.1.PL+GRD
destruindo-o	destruir+V.ele.ACC.3.M.SG+GRD
destruindo-os	destruir+V.ele.ACC.3.M.PL+GRD
destruindo-se	destruir+V.ele.REFL+GRD
destruindo-te	destruir+V.tu.AD.2.SG+GRD
destruindo-vos	destruir+V.vós.AD.2.PL+GRD
destruí-nos	destruir+nós.AD.1.PL+PRF+1+SG
destruí-nos	destruir+nós.AD.1.PL+PRS+2+PL
destrui-nos	destruir+nós.AD.1.PL+PRS+2+SG
destrui-nos	destruir+nós.AD.1.PL+PRS+3+SG
destruí-o	destruir+V.ele.ACC.3.M.SG+PRF+1+SG
destrui-o	destruir+V.ele.ACC.3.M.SG+PRS+3+SG
destruí-os	destruir+V.ele.ACC.3.M.PL+PRF+1+SG
destrui-os	destruir+V.ele.ACC.3.M.PL+PRS+3+SG
destruíra-a	destruir+V.ele.ACC.3.F.SG+PQP+1+SG
destruíra-a	destruir+V.ele.ACC.3.F.SG+PQP+3+SG
destruíra-as	destruir+V.ele.ACC.3.F.PL+PQP+1+SG
destruíra-as	destruir+V.ele.ACC.3.F.PL+PQP+3+SG
destruíra-la	destruir+V.ele.ACC.3.F.SG+PQP+2+SG
destruíra-las	destruir+V.ele.ACC.3.F.PL+PQP+2+SG
destruíra-lhe	destruir+V.ele.DAT.3.SG+PQP+1+SG
destruíra-lhe	destruir+V.ele.DAT.3.SG+PQP+3+SG
destruíra-lhes	destruir+V.ele.DAT.3.PL+PQP+1+SG
destruíra-lhes	destruir+V.ele.DAT.3.PL+PQP+3+SG
destruíra-lo	destruir+V.ele.ACC.3.M.SG+PQP+2+SG
destruíra-los	destruir+V.ele.ACC.3.M.PL+PQP+2+SG
destruíra-me	destruir+V.eu.AD.1.SG+PQP+1+SG
destruíra-me	destruir+V.eu.AD.1.SG+PQP+3+SG
destruíram-lhe	destruir+V.ele.DAT.3.SG+PQP+3+PL
destruíram-lhe	destruir+V.ele.DAT.3.SG+PRF+3+PL
destruíram-lhes	destruir+V.ele.DAT.3.PL+PQP+3+PL
destruíram-lhes	destruir+V.ele.DAT.3.PL+PRF+3+PL
destruíram-me	destruir+V.eu.AD.1.SG+PQP+3+PL
destruíram-me	destruir+V.eu.AD.1.SG+PRF+3+PL
destruíram-na	destruir+V.ele.ACC.3.F.SG+PQP+3+PL
destruíram-na	destruir+V.ele.ACC.3.F.SG+PRF+3+PL
destruíram-nas	destruir+V.ele.ACC.3.F.PL+PQP+3+PL
destruíram-nas	destruir+V.ele.ACC.3.F.PL+PRF+3+PL
destruíram-no	destruir+V.ele.ACC.3.M.SG+PQP+3+PL
destruíram-no	destruir+V.ele.ACC.3.M.SG+PRF+3+PL
destruíram-nos	destruir+nós.AD.1.PL+PQP+3+PL
destruíram-nos	destruir+nós.AD.1.PL+PRF+3+PL
destruíramo-la	destruir+V.ele.ACC.3.F.SG+PQP+1+PL
destruíramo-las	destruir+V.ele.ACC.3.F.PL+PQP+1+PL
destruíramo-lo	destruir+V.ele.ACC.3.M.SG+PQP+1+PL
destruíramo-los	destruir+V.ele.ACC.3.M.PL+PQP+1+PL
destruíramo-nos	destruir+nós.AD.1.PL+PQP+1+PL
destruíramos-lhe	destruir+V.ele.DAT.3.SG+PQP+1+PL
destruíramos-lhes	destruir+V.ele.DAT.3.PL+PQP+1+PL
destruíramos-me	destruir+V.eu.AD.1.SG+PQP+1+PL
destruíramos-te	destruir+V.tu.AD.2.SG+PQP+1+PL
destruíramos-vos	destruir+V.vós.AD.2.PL+PQP+1+PL
destruíram-se	destruir+V.ele.REFL+PQP+3+PL
destruíram-se	destruir+V.ele.REFL+PRF+3+PL
destruíram-te	destruir+V.tu.AD.2.SG+PQP+3+PL
destruíram-te	destruir+V.tu.AD.2.SG+PRF+3+PL
destruíram-vos	destruir+V.vós.AD.2.PL+PQP+3+PL
destruíram-vos	destruir+V.vós.AD.2.PL+PRF+3+PL
destruíra-nos	destruir+nós.AD.1.PL+PQP+1+SG
destruíra-nos	destruir+nós.AD.1.PL+PQP+2+SG
destruíra-nos	destruir+nós.AD.1.PL+PQP+3+SG
destruíra-o	destruir+V.ele.ACC.3.M.SG+PQP+1+SG
destruíra-o	destruir+V.ele.ACC.3.M.SG+PQP+3+SG
destruíra-os	destruir+V.ele.ACC.3.M.PL+PQP+1+SG
destruíra-os	destruir+V.ele.ACC.3.M.PL+PQP+3+SG
destruíra-se	destruir+V.ele.REFL+PQP+3+SG
destruíras-lhe	destruir+V.ele.DAT.3.SG+PQP+2+SG
destruíras-lhes	destruir+V.ele.DAT.3.PL+PQP+2+SG
destruíras-me	destruir+V.eu.AD.1.SG+PQP+2+SG
destruíras-te	destruir+V.tu.AD.2.SG+PQP+2+SG
destruíras-vos	destruir+V.vós.AD.2.PL+PQP+2+SG
destruíra-te	destruir+V.tu.AD.2.SG+PQP+1+SG
destruíra-te	destruir+V.tu.AD.2.SG+PQP+3+SG
destruíra-vos	destruir+V.vós.AD.2.PL+PQP+1+SG
destruíra-vos	destruir+V.vós.AD.2.PL+PQP+3+SG
destruirde-la	destruir+V.ele.ACC.3.F.SG+INF+2+PL
destruirde-la	destruir+V.ele.ACC.3.F.SG+SBJF+2+PL
destruirde-las	destruir+V.ele.ACC.3.F.PL+INF+2+PL
destruirde-las	destruir+V.ele.ACC.3.F.PL+SBJF+2+PL
destruirde-lo	destruir+V.ele.ACC.3.M.SG+INF+2+PL
destruirde-lo	destruir+V.ele.ACC.3.M.SG+SBJF+2+PL
destruirde-los	destruir+V.ele.ACC.3.M.PL+INF+2+PL
destruirde-los	destruir+V.ele.ACC.3.M.PL+SBJF+2+PL
destruirde-nos	destruir+nós.AD.1.PL+INF+2+PL
destruirde-nos	destruir+nós.AD.1.PL+SBJF+2+PL
destruirdes-lhe	destruir+V.ele.DAT.3.SG+INF+2+PL
destruirdes-lhe	destruir+V.ele.DAT.3.SG+SBJF+2+PL
destruirdes-lhes	destruir+V.ele.DAT.3.PL+INF+2+PL
destruirdes-lhes	destruir+V.ele.DAT.3.PL+SBJF+2+PL
destruirdes-me	destruir+V.eu.AD.1.SG+INF+2+PL
destruirdes-me	destruir+V.eu.AD.1.SG+SBJF+2+PL
destruirdes-te	destruir+V.tu.AD.2.SG+INF+2+PL
destruirdes-te	destruir+V.tu.AD.2.SG+SBJF+2+PL
destruirdes-vos	destruir+V.vós.AD.2.PL+INF+2+PL
destruirdes-vos	destruir+V.vós.AD.2.PL+SBJF+2+PL
destruírei-la	destruir+V.ele.ACC.3.F.SG+PQP+2+PL
destruírei-las	destruir+V.ele.ACC.3.F.PL+PQP+2+PL
destruírei-lo	destruir+V.ele.ACC.3.M.SG+PQP+2+PL
destruírei-los	destruir+V.ele.ACC.3.M.PL+PQP+2+PL
destruírei-nos	destruir+nós.AD.1.PL+PQP+2+PL
destruíreis-lhe	destruir+V.ele.DAT.3.SG+PQP+2+PL
destruíreis-lhes	destruir+V.ele.DAT.3.PL+PQP+2+PL
destruíreis-me	destruir+V.eu.AD.1.SG+PQP+2+PL
destruíreis-te	destruir+V.tu.AD.2.SG+PQP+2+PL
destruíreis-vos	destruir+V.vós.AD.2.PL+PQP+2+PL
destruíre-la	destruir+V.ele.ACC.3.F.SG+INF+2+SG
destruíre-la	destruir+V.ele.ACC.3.F.SG+SBJF+2+SG
destruíre-las	destruir+V.ele.ACC.3.F.PL+INF+2+SG
destruíre-las	destruir+V.ele.ACC.3.F.PL+SBJF+2+SG
destruíre-lo	destruir+V.ele.ACC.3.M.SG+INF+2+SG
destruíre-lo	destruir+V.ele.ACC.3.M.SG+SBJF+2+SG
destruíre-los	destruir+V.ele.ACC.3.M.PL+INF+2+SG
destruíre-los	destruir+V.ele.ACC.3.M.PL+SBJF+2+SG
destruírem-lhe	destruir+V.ele.DAT.3.SG+INF+3+PL
destruírem-lhe	destruir+V.ele.DAT.3.SG+SBJF+3+PL
destruírem-lhes	destruir+V.ele.DAT.3.PL+INF+3+PL
destruírem-lhes	destruir+V.ele.DAT.3.PL+SBJF+3+PL
destruírem-me	destruir+V.eu.AD.1.SG+INF+3+PL
destruírem-me	destruir+V.eu.AD.1.SG+SBJF+3+PL
destruírem-na	destruir+V.ele.ACC.3.F.SG+INF+3+PL
destruírem-na	destruir+V.ele.ACC.3.F.SG+SBJF+3+PL
destruírem-nas	destruir+V.ele.ACC.3.F.PL+INF+3+PL
destruírem-nas	destruir+V.ele.ACC.3.F.PL+SBJF+3+PL
destruírem-no	destruir+V.ele.ACC.3.M.SG+INF+3+PL
destruírem-no	destruir+V.ele.ACC.3.M.SG+SBJF+3+PL
destruírem-nos	destruir+nós.AD.1.PL+INF+3+PL
destruírem-nos	destruir+nós.AD.1.PL+SBJF+3+PL
destruírem-se	destruir+V.ele.REFL+INF+3+PL
destruírem-se	destruir+V.ele.REFL+SBJF+3+PL
destruírem-te	destruir+V.tu.AD.2.SG+INF+3+PL
destruírem-te	destruir+V.tu.AD.2.SG+SBJF+3+PL
destruírem-vos	destruir+V.vós.AD.2.PL+INF+3+PL
destruírem-vos	destruir+V.vós.AD.2.PL+SBJF+3+PL
destruíre-nos	destruir+nós.AD.1.PL+INF+2+SG
destruíre-nos	destruir+nós.AD.1.PL+SBJF+2+SG
destruíres-lhe	destruir+V.ele.DAT.3.SG+INF+2+SG
destruíres-lhe	destruir+V.ele.DAT.3.SG+SBJF+2+SG
destruíres-lhes	destruir+V.ele.DAT.3.PL+INF+2+SG
destruíres-lhes	destruir+V.ele.DAT.3.PL+SBJF+2+SG
destruíres-me	destruir+V.eu.AD.1.SG+INF+2+SG
destruíres-me	destruir+V.eu.AD.1.SG+SBJF+2+SG
destruíres-te	destruir+V.tu.AD.2.SG+INF+2+SG
destruíres-te	destruir+V.tu.AD.2.SG+SBJF+2+SG
destruíres-vos	destruir+V.vós.AD.2.PL+INF+2+SG
destruíres-vos	destruir+V.vós.AD.2.PL+SBJF+2+SG
destruir-lhe-á	destruir+V.ele.DAT.3.SG+FUT+3+SG
destruir-lhe-ão	destruir+V.ele.DAT.3.SG+FUT+3+PL
destruir-lhe-ás	destruir+V.ele.DAT.3.SG+FUT+2+SG
destruirlhe	destruir+V.None+INF
destruirlhe	destruir+V.None+INF+3+1
destruirlhe	destruir+V.None+INF+3+SG
destruirlhe	destruir+V.None+SBJF+1+SG
destruirlhe	destruir+V.None+SBJF+3+SG
destruir-lhe-ei	destruir+V.ele.DAT.3.SG+FUT+1+SG
destruir-lhe-eis	destruir+V.ele.DAT.3.SG+FUT+2+PL
destruir-lhe-emos	destruir+V.ele.DAT.3.SG+FUT+1+PL
destruir-lhe-ia	destruir+V.ele.DAT.3.SG+COND+1+SG
destruir-lhe-ia	destruir+V.ele.DAT.3.SG+COND+3+SG
destruir-lhe-iam	destruir+V.ele.DAT.3.SG+COND+3+PL
destruir-lhe-íamos	destruir+V.ele.DAT.3.SG+COND+1+PL
destruir-lhe-ias	destruir+V.ele.DAT.3.SG+COND+2+SG
destruir-lhe-íeis	destruir+V.ele.DAT.3.SG+COND+2+PL
destruir-lhes-á	destruir+V.ele.DAT.3.PL+FUT+3+SG
destruir-lhes-ão	destruir+V.ele.DAT.3.PL+FUT+3+PL
destruir-lhes-ás	destruir+V.ele.DAT.3.PL+FUT+2+SG
destruirlhes	destruir+V.None+INF
destruirlhes	destruir+V.None+INF+3+1
destruirlhes	destruir+V.None+INF+3+SG
destruirlhes	destruir+V.None+SBJF+1+SG
destruirlhes	destruir+V.None+SBJF+3+SG
destruir-lhes-ei	destruir+V.ele.DAT.3.PL+FUT+1+SG
destruir-lhes-eis	destruir+V.ele.DAT.3.PL+FUT+2+PL
destruir-lhes-emos	destruir+V.ele.DAT.3.PL+FUT+1+PL
destruir-lhes-ia	destruir+V.ele.DAT.3.PL+COND+1+SG
destruir-lhes-ia	destruir+V.ele.DAT.3.PL+COND+3+SG
destruir-lhes-iam	destruir+V.ele.DAT.3.PL+COND+3+PL
destruir-lhes-íamos	destruir+V.ele.DAT.3.PL+COND+1+PL
destruir-lhes-ias	destruir+V.ele.DAT.3.PL+COND+2+SG
destruir-lhes-íeis	destruir+V.ele.DAT.3.PL+COND+2+PL
destruir-me-á	destruir+V.eu.AD.1.SG+FUT+3+SG
destruir-me-ão	destruir+V.eu.AD.1.SG+FUT+3+PL
destruir-me-ás	destruir+V.eu.AD.1.SG+FUT+2+SG
destruirme	destruir+V.None+INF
destruirme	destruir+V.None+INF+3+1
destruirme	destruir+V.None+INF+3+SG
destruirme	destruir+V.None+SBJF+1+SG
destruirme	destruir+V.None+SBJF+3+SG
destruir-me-ei	destruir+V.eu.AD.1.SG+FUT+1+SG
destruir-me-eis	destruir+V.eu.AD.1.SG+FUT+2+PL
destruir-me-emos	destruir+V.eu.AD.1.SG+FUT+1+PL
destruir-me-ia	destruir+V.eu.AD.1.SG+COND+1+SG
destruir-me-ia	destruir+V.eu.AD.1.SG+COND+3+SG
destruir-me-iam	destruir+V.eu.AD.1.SG+COND+3+PL
destruir-me-íamos	destruir+V.eu.AD.1.SG+COND+1+PL
destruir-me-ias	destruir+V.eu.AD.1.SG+COND+2+SG
destruir-me-íeis	destruir+V.eu.AD.1.SG+COND+2+PL
destruirmo-la	destruir+V.ele.ACC.3.F.SG+INF+1+PL
destruirmo-la	destruir+V.ele.ACC.3.F.SG+SBJF+1+PL
destruirmo-las	destruir+V.ele.ACC.3.F.PL+INF+1+PL
destruirmo-las	destruir+V.ele.ACC.3.F.PL+SBJF+1+PL
destruirmo-lo	destruir+V.ele.ACC.3.M.SG+INF+1+PL
destruirmo-lo	destruir+V.ele.ACC.3.M.SG+SBJF+1+PL
destruirmo-los	destruir+V.ele.ACC.3.M.PL+INF+1+PL
destruirmo-los	destruir+V.ele.ACC.3.M.PL+SBJF+1+PL
destruirmo-nos	destruir+nós.AD.1.PL+INF+1+PL
destruirmo-nos	destruir+nós.AD.1.PL+SBJF+1+PL
destruirmos-lhe	destruir+V.ele.DAT.3.SG+INF+1+PL
destruirmos-lhe	destruir+V.ele.DAT.3.SG+SBJF+1+PL
destruirmos-lhes	destruir+V.ele.DAT.3.PL+INF+1+PL
destruirmos-lhes	destruir+V.ele.DAT.3.PL+SBJF+1+PL
destruirmos-me	destruir+V.eu.AD.1.SG+INF+1+PL
destruirmos-me	destruir+V.eu.AD.1.SG+SBJF+1+PL
destruirmos-te	destruir+V.tu.AD.2.SG+INF+1+PL
destruirmos-te	destruir+V.tu.AD.2.SG+SBJF+1+PL
destruirmos-vos	destruir+V.vós.AD.2.PL+INF+1+PL
destruirmos-vos	destruir+V.vós.AD.2.PL+SBJF+1+PL
destruir-nos-á	destruir+nós.AD.1.PL+FUT+3+SG
destruir-nos-ão	destruir+nós.AD.1.PL+FUT+3+PL
destruir-nos-ás	destruir+nós.AD.1.PL+FUT+2+SG
destruirnos	destruir+V.None+INF
destruirnos	destruir+V.None+INF+3+1
destruirnos	destruir+V.None+INF+3+SG
destruirnos	destruir+V.None+SBJF+1+SG
destruirnos	destruir+V.None+SBJF+3+SG
destruir-nos-ei	destruir+nós.AD.1.PL+FUT+1+SG
destruir-nos-eis	destruir+nós.AD.1.PL+FUT+2+PL
destruir-nos-emos	destruir+nós.AD.1.PL+FUT+1+PL
destruir-nos-ia	destruir+nós.AD.1.PL+COND+1+SG
destruir-nos-ia	destruir+nós.AD.1.PL+COND+3+SG
destruir-nos-iam	destruir+nós.AD.1.PL+COND+3+PL
destruir-nos-íamos	destruir+nós.AD.1.PL+COND+1+PL
destruir-nos-ias	destruir+nós.AD.1.PL+COND+2+SG
destruir-nos-íeis	destruir+nós.AD.1.PL+COND+2+PL
destruir-se-á	destruir+V.ele.REFL+FUT+3+SG
destruir-se-ão	destruir+V.ele.REFL+FUT+3+PL
destruir-se	destruir+V.ele.REFL+INF
destruir-se	destruir+V.ele.REFL+INF+3+SG
destruir-se	destruir+V.ele.REFL+SBJF+3+SG
destruir-se-ia	destruir+V.ele.REFL+COND+3+SG
destruir-se-iam	destruir+V.ele.REFL+COND+3+PL
destruir-te-á	destruir+V.tu.AD.2.SG+FUT+3+SG
destruir-te-ão	destruir+V.tu.AD.2.SG+FUT+3+PL
destruir-te-ás	destruir+V.tu.AD.2.SG+FUT+2+SG
destruirte	destruir+V.None+INF
destruirte	destruir+V.None+INF+3+1
destruirte	destruir+V.None+INF+3+SG
destruirte	destruir+V.None+SBJF+1+SG
destruirte	destruir+V.None+SBJF+3+SG
destruir-te-ei	destruir+V.tu.AD.2.SG+FUT+1+SG
destruir-te-eis	destruir+V.tu.AD.2.SG+FUT+2+PL
destruir-te-emos	destruir+V.tu.AD.2.SG+FUT+1+PL
destruir-te-ia	destruir+V.tu.AD.2.SG+COND+1+SG
destruir-te-ia	destruir+V.tu.AD.2.SG+COND+3+SG
destruir-te-iam	destruir+V.tu.AD.2.SG+COND+3+PL
destruir-te-íamos	destruir+V.tu.AD.2.SG+COND+1+PL
destruir-te-ias	destruir+V.tu.AD.2.SG+COND+2+SG
destruir-te-íeis	destruir+V.tu.AD.2.SG+COND+2+PL
destruir-vos-á	destruir+V.vós.AD.2.PL+FUT+3+SG
destruir-vos-ão	destruir+V.vós.AD.2.PL+FUT+3+PL
destruir-vos-ás	destruir+V.vós.AD.2.PL+FUT+2+SG
destruirvos	destruir+V.None+INF
destruirvos	destruir+V.None+INF+3+1
destruirvos	destruir+V.None+INF+3+SG
destruirvos	destruir+V.None+SBJF+1+SG
destruirvos	destruir+V.None+SBJF+3+SG
destruir-vos-ei	destruir+V.vós.AD.2.PL+FUT+1+SG
destruir-vos-eis	destruir+V.vós.AD.2.PL+FUT+2+PL
destruir-vos-emos	destruir+V.vós.AD.2.PL+FUT+1+PL
destruir-vos-ia	destruir+V.vós.AD.2.PL+COND+1+SG
destruir-vos-ia	destruir+V.vós.AD.2.PL+COND+3+SG
destruir-vos-iam	destruir+V.vós.AD.2.PL+COND+3+PL
destruir-vos-íamos	destruir+V.vós.AD.2.PL+COND+1+PL
destruir-vos-ias	destruir+V.vós.AD.2.PL+COND+2+SG
destruir-vos-íeis	destruir+V.vós.AD.2.PL+COND+2+PL
destrui-se	destruir+V.ele.REFL+PRS+3+SG
destruís-lhe	destruir+V.ele.DAT.3.SG+PRS+2+PL
destruis-lhe	destruir+V.ele.DAT.3.SG+PRS+2+SG
destruís-lhes	destruir+V.ele.DAT.3.PL+PRS+2+PL
destruis-lhes	destruir+V.ele.DAT.3.PL+PRS+2+SG
destruís-me	destruir+V.eu.AD.1.SG+PRS+2+PL
destruis-me	destruir+V.eu.AD.1.SG+PRS+2+SG
destruíste-a	destruir+V.ele.ACC.3.F.SG+PRF+2+SG
destruíste-as	destruir+V.ele.ACC.3.F.PL+PRF+2+SG
destruís-te	destruir+V.tu.AD.2.SG+PRS+2+PL
destruis-te	destruir+V.tu.AD.2.SG+PRS+2+SG
destruíste-la	destruir+V.ele.ACC.3.F.SG+PRF+2+PL
destruíste-las	destruir+V.ele.ACC.3.F.PL+PRF+2+PL
destruíste-lhe	destruir+V.ele.DAT.3.SG+PRF+2+SG
destruíste-lhes	destruir+V.ele.DAT.3.PL+PRF+2+SG
destruíste-lo	destruir+V.ele.ACC.3.M.SG+PRF+2+PL
destruíste-los	destruir+V.ele.ACC.3.M.PL+PRF+2+PL
destruíste-me	destruir+V.eu.AD.1.SG+PRF+2+SG
destruíste-nos	destruir+nós.AD.1.PL+PRF+2+PL
destruíste-nos	destruir+nós.AD.1.PL+PRF+2+SG
destruíste-o	destruir+V.ele.ACC.3.M.SG+PRF+2+SG
destruíste-os	destruir+V.ele.ACC.3.M.PL+PRF+2+SG
destruístes-lhe	destruir+V.ele.DAT.3.SG+PRF+2+PL
destruístes-lhes	destruir+V.ele.DAT.3.PL+PRF+2+PL
destruístes-me	destruir+V.eu.AD.1.SG+PRF+2+PL
destruístes-te	destruir+V.tu.AD.2.SG+PRF+2+PL
destruístes-vos	destruir+V.vós.AD.2.PL+PRF+2+PL
destruíste-te	destruir+V.tu.AD.2.SG+PRF+2+SG
destruíste-vos	destruir+V.vós.AD.2.PL+PRF+2+SG
destruís-vos	destruir+V.vós.AD.2.PL+PRS+2+PL
destruis-vos	destruir+V.vós.AD.2.PL+PRS+2+SG
destruí-te	destruir+V.tu.AD.2.SG+PRF+1+SG
destrui-te	destruir+V.tu.AD.2.SG+PRS+3+SG
destruiu-a	destruir+V.ele.ACC.3.F.SG+PRF+3+SG
destruiu-as	destruir+V.ele.ACC.3.F.PL+PRF+3+SG
destruiu-lhe	destruir+V.ele.DAT.3.SG+PRF+3+SG
destruiu-lhes	destruir+V.ele.DAT.3.PL+PRF+3+SG
destruiu-me	destruir+V.eu.AD.1.SG+PRF+3+SG
destruiu-nos	destruir+nós.AD.1.PL+PRF+3+SG
destruiu-o	destruir+V.ele.ACC.3.M.SG+PRF+3+SG
destruiu-os	destruir+V.ele.ACC.3.M.PL+PRF+3+SG
destruiu-se	destruir+V.ele.REFL+PRF+3+SG
destruiu-te	destruir+V.tu.AD.2.SG+PRF+3+SG
destruiu-vos	destruir+V.vós.AD.2.PL+PRF+3+SG
destruí-vos	destruir+V.vós.AD.2.PL+PRF+1+SG
destrui-vos	destruir+V.vós.AD.2.PL+PRS+3+SG
destrunfa-a	destrunfar+V.ele.ACC.3.F.SG+PRS+3+SG
destrunfa-as	destrunfar+V.ele.ACC.3.F.PL+PRS+3+SG
destrunfai-la	destrunfar+V.ele.ACC.3.F.SG+PRS+2+PL
destrunfai-las	destrunfar+V.ele.ACC.3.F.PL+PRS+2+PL
destrunfai-lo	destrunfar+V.ele.ACC.3.M.SG+PRS+2+PL
destrunfai-los	destrunfar+V.ele.ACC.3.M.PL+PRS+2+PL
destrunfai-nos	destrunfar+nós.AD.1.PL+PRS+2+PL
destrunfais-lhe	destrunfar+V.ele.DAT.3.SG+PRS+2+PL
destrunfais-lhes	destrunfar+V.ele.DAT.3.PL+PRS+2+PL
destrunfais-me	destrunfar+V.eu.AD.1.SG+PRS+2+PL
destrunfais-te	destrunfar+V.tu.AD.2.SG+PRS+2+PL
destrunfais-vos	destrunfar+V.vós.AD.2.PL+PRS+2+PL
destrunfá-la-á	destrunfar+V.ele.ACC.3.F.SG+FUT+3+SG
destrunfá-la-ão	destrunfar+V.ele.ACC.3.F.SG+FUT+3+PL
destrunfá-la-ás	destrunfar+V.ele.ACC.3.F.SG+FUT+2+SG
destrunfá-la	destrunfar+V.ele.ACC.3.F.SG+INF+1+SG
destrunfá-la	destrunfar+V.ele.ACC.3.F.SG+INF+3+SG
destrunfa-la	destrunfar+V.ele.ACC.3.F.SG+PRS+2+SG
destrunfá-la	destrunfar+V.ele.ACC.3.F.SG+SBJF+1+SG
destrunfá-la	destrunfar+V.ele.ACC.3.F.SG+SBJF+3+SG
destrunfá-la-ei	destrunfar+V.ele.ACC.3.F.SG+FUT+1+SG
destrunfá-la-eis	destrunfar+V.ele.ACC.3.F.SG+FUT+2+PL
destrunfá-la-emos	destrunfar+V.ele.ACC.3.F.SG+FUT+1+PL
destrunfá-la-ia	destrunfar+V.ele.ACC.3.F.SG+COND+1+SG
destrunfá-la-ia	destrunfar+V.ele.ACC.3.F.SG+COND+3+SG
destrunfá-la-iam	destrunfar+V.ele.ACC.3.F.SG+COND+3+PL
destrunfá-la-íamos	destrunfar+V.ele.ACC.3.F.SG+COND+1+PL
destrunfá-la-ias	destrunfar+V.ele.ACC.3.F.SG+COND+2+SG
destrunfá-la-íeis	destrunfar+V.ele.ACC.3.F.SG+COND+2+PL
destrunfá-las-á	destrunfar+V.ele.ACC.3.F.PL+FUT+3+SG
destrunfá-las-ão	destrunfar+V.ele.ACC.3.F.PL+FUT+3+PL
destrunfá-las-ás	destrunfar+V.ele.ACC.3.F.PL+FUT+2+SG
destrunfá-las	destrunfar+V.ele.ACC.3.F.PL+INF+1+SG
destrunfá-las	destrunfar+V.ele.ACC.3.F.PL+INF+3+SG
destrunfa-las	destrunfar+V.ele.ACC.3.F.PL+PRS+2+SG
destrunfá-las	destrunfar+V.ele.ACC.3.F.PL+SBJF+1+SG
destrunfá-las	destrunfar+V.ele.ACC.3.F.PL+SBJF+3+SG
destrunfá-las-ei	destrunfar+V.ele.ACC.3.F.PL+FUT+1+SG
destrunfá-las-eis	destrunfar+V.ele.ACC.3.F.PL+FUT+2+PL
destrunfá-las-emos	destrunfar+V.ele.ACC.3.F.PL+FUT+1+PL
destrunfá-las-ia	destrunfar+V.ele.ACC.3.F.PL+COND+1+SG
destrunfá-las-ia	destrunfar+V.ele.ACC.3.F.PL+COND+3+SG
destrunfá-las-iam	destrunfar+V.ele.ACC.3.F.PL+COND+3+PL
destrunfá-las-íamos	destrunfar+V.ele.ACC.3.F.PL+COND+1+PL
destrunfá-las-ias	destrunfar+V.ele.ACC.3.F.PL+COND+2+SG
destrunfá-las-íeis	destrunfar+V.ele.ACC.3.F.PL+COND+2+PL
destrunfa-lhe	destrunfar+V.ele.DAT.3.SG+PRS+3+SG
destrunfa-lhes	destrunfar+V.ele.DAT.3.PL+PRS+3+SG
destrunfá-lo-á	destrunfar+V.ele.ACC.3.M.SG+FUT+3+SG
destrunfá-lo-ão	destrunfar+V.ele.ACC.3.M.SG+FUT+3+PL
destrunfá-lo-ás	destrunfar+V.ele.ACC.3.M.SG+FUT+2+SG
destrunfá-lo	destrunfar+V.ele.ACC.3.M.SG+INF+1+SG
destrunfá-lo	destrunfar+V.ele.ACC.3.M.SG+INF+3+SG
destrunfa-lo	destrunfar+V.ele.ACC.3.M.SG+PRS+2+SG
destrunfá-lo	destrunfar+V.ele.ACC.3.M.SG+SBJF+1+SG
destrunfá-lo	destrunfar+V.ele.ACC.3.M.SG+SBJF+3+SG
destrunfá-lo-ei	destrunfar+V.ele.ACC.3.M.SG+FUT+1+SG
destrunfá-lo-eis	destrunfar+V.ele.ACC.3.M.SG+FUT+2+PL
destrunfá-lo-emos	destrunfar+V.ele.ACC.3.M.SG+FUT+1+PL
destrunfá-lo-ia	destrunfar+V.ele.ACC.3.M.SG+COND+1+SG
destrunfá-lo-ia	destrunfar+V.ele.ACC.3.M.SG+COND+3+SG
destrunfá-lo-iam	destrunfar+V.ele.ACC.3.M.SG+COND+3+PL
destrunfá-lo-íamos	destrunfar+V.ele.ACC.3.M.SG+COND+1+PL
destrunfá-lo-ias	destrunfar+V.ele.ACC.3.M.SG+COND+2+SG
destrunfá-lo-íeis	destrunfar+V.ele.ACC.3.M.SG+COND+2+PL
destrunfá-los-á	destrunfar+V.ele.ACC.3.M.PL+FUT+3+SG
destrunfá-los-ão	destrunfar+V.ele.ACC.3.M.PL+FUT+3+PL
destrunfá-los-ás	destrunfar+V.ele.ACC.3.M.PL+FUT+2+SG
destrunfá-los	destrunfar+V.ele.ACC.3.M.PL+INF+1+SG
destrunfá-los	destrunfar+V.ele.ACC.3.M.PL+INF+3+SG
destrunfa-los	destrunfar+V.ele.ACC.3.M.PL+PRS+2+SG
destrunfá-los	destrunfar+V.ele.ACC.3.M.PL+SBJF+1+SG
destrunfá-los	destrunfar+V.ele.ACC.3.M.PL+SBJF+3+SG
destrunfá-los-ei	destrunfar+V.ele.ACC.3.M.PL+FUT+1+SG
destrunfá-los-eis	destrunfar+V.ele.ACC.3.M.PL+FUT+2+PL
destrunfá-los-emos	destrunfar+V.ele.ACC.3.M.PL+FUT+1+PL
destrunfá-los-ia	destrunfar+V.ele.ACC.3.M.PL+COND+1+SG
destrunfá-los-ia	destrunfar+V.ele.ACC.3.M.PL+COND+3+SG
destrunfá-los-iam	destrunfar+V.ele.ACC.3.M.PL+COND+3+PL
destrunfá-los-íamos	destrunfar+V.ele.ACC.3.M.PL+COND+1+PL
destrunfá-los-ias	destrunfar+V.ele.ACC.3.M.PL+COND+2+SG
destrunfá-los-íeis	destrunfar+V.ele.ACC.3.M.PL+COND+2+PL
destrunfa-me	destrunfar+V.eu.AD.1.SG+PRS+3+SG
destrunfam-lhe	destrunfar+V.ele.DAT.3.SG+PRS+3+PL
destrunfam-lhes	destrunfar+V.ele.DAT.3.PL+PRS+3+PL
destrunfam-me	destrunfar+V.eu.AD.1.SG+PRS+3+PL
destrunfam-na	destrunfar+V.ele.ACC.3.F.SG+PRS+3+PL
destrunfam-nas	destrunfar+V.ele.ACC.3.F.PL+PRS+3+PL
destrunfam-no	destrunfar+V.ele.ACC.3.M.SG+PRS+3+PL
destrunfam-nos	destrunfar+V.ele.ACC.3.M.PL+PRS+3+PL
destrunfam-nos	destrunfar+V.nós.AD.1.PL+PRS+3+PL
destrunfamo-la	destrunfar+V.ele.ACC.3.F.SG+PRF+1+PL
destrunfamo-la	destrunfar+V.ele.ACC.3.F.SG+PRS+1+PL
destrunfamo-las	destrunfar+V.ele.ACC.3.F.PL+PRF+1+PL
destrunfamo-las	destrunfar+V.ele.ACC.3.F.PL+PRS+1+PL
destrunfamo-lo	destrunfar+V.ele.ACC.3.M.SG+PRF+1+PL
destrunfamo-lo	destrunfar+V.ele.ACC.3.M.SG+PRS+1+PL
destrunfamo-los	destrunfar+V.ele.ACC.3.M.PL+PRF+1+PL
destrunfamo-los	destrunfar+V.ele.ACC.3.M.PL+PRS+1+PL
destrunfamo-nos	destrunfar+nós.AD.1.PL+PRF+1+PL
destrunfamo-nos	destrunfar+nós.AD.1.PL+PRS+1+PL
destrunfamos-lhe	destrunfar+V.ele.DAT.3.SG+PRF+1+PL
destrunfamos-lhe	destrunfar+V.ele.DAT.3.SG+PRS+1+PL
destrunfamos-lhes	destrunfar+V.ele.DAT.3.PL+PRF+1+PL
destrunfamos-lhes	destrunfar+V.ele.DAT.3.PL+PRS+1+PL
destrunfamos-me	destrunfar+V.eu.AD.1.SG+PRF+1+PL
destrunfamos-me	destrunfar+V.eu.AD.1.SG+PRS+1+PL
destrunfamos-te	destrunfar+V.tu.AD.2.SG+PRF+1+PL
destrunfamos-te	destrunfar+V.tu.AD.2.SG+PRS+1+PL
destrunfamos-vos	destrunfar+V.vós.AD.2.PL+PRF+1+PL
destrunfamos-vos	destrunfar+V.vós.AD.2.PL+PRS+1+PL
destrunfam-se	destrunfar+V.ele.REFL+PRS+3+PL
destrunfam-te	destrunfar+V.tu.AD.2.SG+PRS+3+PL
destrunfam-vos	destrunfar+V.vós.AD.2.PL+PRS+3+PL
destrunfando-a	destrunfar+V.ele.ACC.3.F.SG+GRD
destrunfando-as	destrunfar+V.ele.ACC.3.F.PL+GRD
destrunfando-lhe	destrunfar+V.ele.DAT.3.SG+GRD
destrunfando-lhes	destrunfar+V.ele.DAT.3.PL+GRD
destrunfando-me	destrunfar+V.eu.AD.1.SG+GRD
destrunfando-nos	destrunfar+nós.AD.1.PL+GRD
destrunfando-o	destrunfar+V.ele.ACC.3.M.SG+GRD
destrunfando-os	destrunfar+V.ele.ACC.3.M.PL+GRD
destrunfando-se	destrunfar+V.ele.REFL+GRD
destrunfando-te	destrunfar+V.tu.AD.2.SG+GRD
destrunfando-vos	destrunfar+V.vós.AD.2.PL+GRD
destrunfa-nos	destrunfar+nós.AD.1.PL+PRS+2+SG
destrunfa-nos	destrunfar+nós.AD.1.PL+PRS+3+SG
destrunfa-o	destrunfar+V.ele.ACC.3.M.SG+PRS+3+SG
destrunfa-os	destrunfar+V.ele.ACC.3.M.PL+PRS+3+SG
destrunfara-a	destrunfar+V.ele.ACC.3.F.SG+PQP+1+SG
destrunfara-a	destrunfar+V.ele.ACC.3.F.SG+PQP+3+SG
destrunfara-as	destrunfar+V.ele.ACC.3.F.PL+PQP+1+SG
destrunfara-as	destrunfar+V.ele.ACC.3.F.PL+PQP+3+SG
destrunfara-la	destrunfar+V.ele.ACC.3.F.SG+PQP+2+SG
destrunfara-las	destrunfar+V.ele.ACC.3.F.PL+PQP+2+SG
destrunfara-lhe	destrunfar+V.ele.DAT.3.SG+PQP+1+SG
destrunfara-lhe	destrunfar+V.ele.DAT.3.SG+PQP+3+SG
destrunfara-lhes	destrunfar+V.ele.DAT.3.PL+PQP+1+SG
destrunfara-lhes	destrunfar+V.ele.DAT.3.PL+PQP+3+SG
destrunfara-lo	destrunfar+V.ele.ACC.3.M.SG+PQP+2+SG
destrunfara-los	destrunfar+V.ele.ACC.3.M.PL+PQP+2+SG
destrunfara-me	destrunfar+V.eu.AD.1.SG+PQP+1+SG
destrunfara-me	destrunfar+V.eu.AD.1.SG+PQP+3+SG
destrunfaram-lhe	destrunfar+V.ele.DAT.3.SG+PQP+3+PL
destrunfaram-lhe	destrunfar+V.ele.DAT.3.SG+PRF+3+PL
destrunfaram-lhes	destrunfar+V.ele.DAT.3.PL+PQP+3+PL
destrunfaram-lhes	destrunfar+V.ele.DAT.3.PL+PRF+3+PL
destrunfaram-me	destrunfar+V.eu.AD.1.SG+PQP+3+PL
destrunfaram-me	destrunfar+V.eu.AD.1.SG+PRF+3+PL
destrunfaram-na	destrunfar+V.ele.ACC.3.F.SG+PQP+3+PL
destrunfaram-na	destrunfar+V.ele.ACC.3.F.SG+PRF+3+PL
destrunfaram-nas	destrunfar+V.ele.ACC.3.F.PL+PQP+3+PL
destrunfaram-nas	destrunfar+V.ele.ACC.3.F.PL+PRF+3+PL
destrunfaram-no	destrunfar+V.ele.ACC.3.M.SG+PQP+3+PL
destrunfaram-no	destrunfar+V.ele.ACC.3.M.SG+PRF+3+PL
destrunfaram-nos	destrunfar+V.ele.ACC.3.M.PL+PQP+3+PL
destrunfaram-nos	destrunfar+V.ele.ACC.3.M.PL+PRF+3+PL
destrunfaram-nos	destrunfar+V.nós.AD.1.PL+PQP+3+PL
destrunfaram-nos	destrunfar+V.nós.AD.1.PL+PRF+3+PL
destrunfáramo-la	destrunfar+V.ele.ACC.3.F.SG+PQP+1+PL
destrunfáramo-las	destrunfar+V.ele.ACC.3.F.PL+PQP+1+PL
destrunfáramo-lo	destrunfar+V.ele.ACC.3.M.SG+PQP+1+PL
destrunfáramo-los	destrunfar+V.ele.ACC.3.M.PL+PQP+1+PL
destrunfáramo-nos	destrunfar+nós.AD.1.PL+PQP+1+PL
destrunfáramos-lhe	destrunfar+V.ele.DAT.3.SG+PQP+1+PL
destrunfáramos-lhes	destrunfar+V.ele.DAT.3.PL+PQP+1+PL
destrunfáramos-me	destrunfar+V.eu.AD.1.SG+PQP+1+PL
destrunfáramos-te	destrunfar+V.tu.AD.2.SG+PQP+1+PL
destrunfáramos-vos	destrunfar+V.vós.AD.2.PL+PQP+1+PL
destrunfaram-se	destrunfar+V.ele.REFL+PQP+3+PL
destrunfaram-se	destrunfar+V.ele.REFL+PRF+3+PL
destrunfaram-te	destrunfar+V.tu.AD.2.SG+PQP+3+PL
destrunfaram-te	destrunfar+V.tu.AD.2.SG+PRF+3+PL
destrunfaram-vos	destrunfar+V.vós.AD.2.PL+PQP+3+PL
destrunfaram-vos	destrunfar+V.vós.AD.2.PL+PRF+3+PL
destrunfara-nos	destrunfar+nós.AD.1.PL+PQP+1+SG
destrunfara-nos	destrunfar+nós.AD.1.PL+PQP+2+SG
destrunfara-nos	destrunfar+nós.AD.1.PL+PQP+3+SG
destrunfara-o	destrunfar+V.ele.ACC.3.M.SG+PQP+1+SG
destrunfara-o	destrunfar+V.ele.ACC.3.M.SG+PQP+3+SG
destrunfara-os	destrunfar+V.ele.ACC.3.M.PL+PQP+1+SG
destrunfara-os	destrunfar+V.ele.ACC.3.M.PL+PQP+3+SG
destrunfara-se	destrunfar+V.ele.REFL+PQP+1+SG
destrunfara-se	destrunfar+V.ele.REFL+PQP+3+SG
destrunfaras-lhe	destrunfar+V.ele.DAT.3.SG+PQP+2+SG
destrunfaras-lhes	destrunfar+V.ele.DAT.3.PL+PQP+2+SG
destrunfaras-me	destrunfar+V.eu.AD.1.SG+PQP+2+SG
destrunfaras-te	destrunfar+V.tu.AD.2.SG+PQP+2+SG
destrunfaras-vos	destrunfar+V.vós.AD.2.PL+PQP+2+SG
destrunfara-te	destrunfar+V.tu.AD.2.SG+PQP+1+SG
destrunfara-te	destrunfar+V.tu.AD.2.SG+PQP+3+SG
destrunfara-vos	destrunfar+V.vós.AD.2.PL+PQP+1+SG
destrunfara-vos	destrunfar+V.vós.AD.2.PL+PQP+3+SG
destrunfarde-la	destrunfar+V.ele.ACC.3.F.SG+INF+2+PL
destrunfarde-la	destrunfar+V.ele.ACC.3.F.SG+SBJF+2+PL
