dogmatizar-lhes-ão	dogmatizar+V.ele.DAT.3.PL+FUT+3+PL
dogmatizar-lhes-ás	dogmatizar+V.ele.DAT.3.PL+FUT+2+SG
dogmatizar-lhes	dogmatizar+V.ele.DAT.3.PL+INF
dogmatizar-lhes	dogmatizar+V.ele.DAT.3.PL+INF+1+SG
dogmatizar-lhes	dogmatizar+V.ele.DAT.3.PL+INF+3+SG
dogmatizar-lhes	dogmatizar+V.ele.DAT.3.PL+SBJF+1+SG
dogmatizar-lhes	dogmatizar+V.ele.DAT.3.PL+SBJF+3+SG
dogmatizar-lhes-ei	dogmatizar+V.ele.DAT.3.PL+FUT+1+SG
dogmatizar-lhes-eis	dogmatizar+V.ele.DAT.3.PL+FUT+2+PL
dogmatizar-lhes-emos	dogmatizar+V.ele.DAT.3.PL+FUT+1+PL
dogmatizar-lhes-ia	dogmatizar+V.ele.DAT.3.PL+COND+1+SG
dogmatizar-lhes-ia	dogmatizar+V.ele.DAT.3.PL+COND+3+SG
dogmatizar-lhes-iam	dogmatizar+V.ele.DAT.3.PL+COND+3+PL
dogmatizar-lhes-íamos	dogmatizar+V.ele.DAT.3.PL+COND+1+PL
dogmatizar-lhes-ias	dogmatizar+V.ele.DAT.3.PL+COND+2+SG
dogmatizar-lhes-íeis	dogmatizar+V.ele.DAT.3.PL+COND+2+PL
dogmatizar-me-á	dogmatizar+V.eu.AD.1.SG+FUT+3+SG
dogmatizar-me-ão	dogmatizar+V.eu.AD.1.SG+FUT+3+PL
dogmatizar-me-ás	dogmatizar+V.eu.AD.1.SG+FUT+2+SG
dogmatizar-me	dogmatizar+V.eu.AD.1.SG+INF
dogmatizar-me	dogmatizar+V.eu.AD.1.SG+INF+1+SG
dogmatizar-me	dogmatizar+V.eu.AD.1.SG+INF+3+SG
dogmatizar-me	dogmatizar+V.eu.AD.1.SG+SBJF+1+SG
dogmatizar-me	dogmatizar+V.eu.AD.1.SG+SBJF+3+SG
dogmatizar-me-ei	dogmatizar+V.eu.AD.1.SG+FUT+1+SG
dogmatizar-me-eis	dogmatizar+V.eu.AD.1.SG+FUT+2+PL
dogmatizar-me-emos	dogmatizar+V.eu.AD.1.SG+FUT+1+PL
dogmatizar-me-ia	dogmatizar+V.eu.AD.1.SG+COND+1+SG
dogmatizar-me-ia	dogmatizar+V.eu.AD.1.SG+COND+3+SG
dogmatizar-me-iam	dogmatizar+V.eu.AD.1.SG+COND+3+PL
dogmatizar-me-íamos	dogmatizar+V.eu.AD.1.SG+COND+1+PL
dogmatizar-me-ias	dogmatizar+V.eu.AD.1.SG+COND+2+SG
dogmatizar-me-íeis	dogmatizar+V.eu.AD.1.SG+COND+2+PL
dogmatizarmo-la	dogmatizar+V.ele.ACC.3.F.SG+INF+1+PL
dogmatizarmo-la	dogmatizar+V.ele.ACC.3.F.SG+SBJF+1+PL
dogmatizarmo-las	dogmatizar+V.ele.ACC.3.F.PL+INF+1+PL
dogmatizarmo-las	dogmatizar+V.ele.ACC.3.F.PL+SBJF+1+PL
dogmatizarmo-lo	dogmatizar+V.ele.ACC.3.M.SG+INF+1+PL
dogmatizarmo-lo	dogmatizar+V.ele.ACC.3.M.SG+SBJF+1+PL
dogmatizarmo-los	dogmatizar+V.ele.ACC.3.M.PL+INF+1+PL
dogmatizarmo-los	dogmatizar+V.ele.ACC.3.M.PL+SBJF+1+PL
dogmatizarmo-nos	dogmatizar+nós.AD.1.PL+INF+1+PL
dogmatizarmo-nos	dogmatizar+nós.AD.1.PL+SBJF+1+PL
dogmatizarmos-lhe	dogmatizar+V.ele.DAT.3.SG+INF+1+PL
dogmatizarmos-lhe	dogmatizar+V.ele.DAT.3.SG+SBJF+1+PL
dogmatizarmos-lhes	dogmatizar+V.ele.DAT.3.PL+INF+1+PL
dogmatizarmos-lhes	dogmatizar+V.ele.DAT.3.PL+SBJF+1+PL
dogmatizarmos-me	dogmatizar+V.eu.AD.1.SG+INF+1+PL
dogmatizarmos-me	dogmatizar+V.eu.AD.1.SG+SBJF+1+PL
dogmatizarmos-te	dogmatizar+V.tu.AD.2.SG+INF+1+PL
dogmatizarmos-te	dogmatizar+V.tu.AD.2.SG+SBJF+1+PL
dogmatizarmos-vos	dogmatizar+V.vós.AD.2.PL+INF+1+PL
dogmatizarmos-vos	dogmatizar+V.vós.AD.2.PL+SBJF+1+PL
dogmatizar-nos-á	dogmatizar+nós.AD.1.PL+FUT+3+SG
dogmatizar-nos-ão	dogmatizar+nós.AD.1.PL+FUT+3+PL
dogmatizar-nos-ás	dogmatizar+nós.AD.1.PL+FUT+2+SG
dogmatizar-nos	dogmatizar+nós.AD.1.PL+INF
dogmatizar-nos	dogmatizar+nós.AD.1.PL+INF+1+SG
dogmatizar-nos	dogmatizar+nós.AD.1.PL+INF+3+SG
dogmatizar-nos	dogmatizar+nós.AD.1.PL+SBJF+1+SG
dogmatizar-nos	dogmatizar+nós.AD.1.PL+SBJF+3+SG
dogmatizar-nos-ei	dogmatizar+nós.AD.1.PL+FUT+1+SG
dogmatizar-nos-eis	dogmatizar+nós.AD.1.PL+FUT+2+PL
dogmatizar-nos-emos	dogmatizar+nós.AD.1.PL+FUT+1+PL
dogmatizar-nos-ia	dogmatizar+nós.AD.1.PL+COND+1+SG
dogmatizar-nos-ia	dogmatizar+nós.AD.1.PL+COND+3+SG
dogmatizar-nos-iam	dogmatizar+nós.AD.1.PL+COND+3+PL
dogmatizar-nos-íamos	dogmatizar+nós.AD.1.PL+COND+1+PL
dogmatizar-nos-ias	dogmatizar+nós.AD.1.PL+COND+2+SG
dogmatizar-nos-íeis	dogmatizar+nós.AD.1.PL+COND+2+PL
dogmatizar-se-á	dogmatizar+V.ele.REFL+FUT+3+SG
dogmatizar-se-ão	dogmatizar+V.ele.REFL+FUT+3+PL
dogmatizar-se	dogmatizar+V.ele.REFL+INF
dogmatizar-se	dogmatizar+V.ele.REFL+INF+3+SG
dogmatizar-se	dogmatizar+V.ele.REFL+SBJF+3+SG
dogmatizar-se-ia	dogmatizar+V.ele.REFL+COND+3+SG
dogmatizar-se-iam	dogmatizar+V.ele.REFL+COND+3+PL
dogmatizar-te-á	dogmatizar+V.tu.AD.2.SG+FUT+3+SG
dogmatizar-te-ão	dogmatizar+V.tu.AD.2.SG+FUT+3+PL
dogmatizar-te-ás	dogmatizar+V.tu.AD.2.SG+FUT+2+SG
dogmatizar-te	dogmatizar+V.tu.AD.2.SG+INF
dogmatizar-te	dogmatizar+V.tu.AD.2.SG+INF+1+SG
dogmatizar-te	dogmatizar+V.tu.AD.2.SG+INF+3+SG
dogmatizar-te	dogmatizar+V.tu.AD.2.SG+SBJF+1+SG
dogmatizar-te	dogmatizar+V.tu.AD.2.SG+SBJF+3+SG
dogmatizar-te-ei	dogmatizar+V.tu.AD.2.SG+FUT+1+SG
dogmatizar-te-eis	dogmatizar+V.tu.AD.2.SG+FUT+2+PL
dogmatizar-te-emos	dogmatizar+V.tu.AD.2.SG+FUT+1+PL
dogmatizar-te-ia	dogmatizar+V.tu.AD.2.SG+COND+1+SG
dogmatizar-te-ia	dogmatizar+V.tu.AD.2.SG+COND+3+SG
dogmatizar-te-iam	dogmatizar+V.tu.AD.2.SG+COND+3+PL
dogmatizar-te-íamos	dogmatizar+V.tu.AD.2.SG+COND+1+PL
dogmatizar-te-ias	dogmatizar+V.tu.AD.2.SG+COND+2+SG
dogmatizar-te-íeis	dogmatizar+V.tu.AD.2.SG+COND+2+PL
dogmatizar-vos-á	dogmatizar+V.vós.AD.2.PL+FUT+3+SG
dogmatizar-vos-ão	dogmatizar+V.vós.AD.2.PL+FUT+3+PL
dogmatizar-vos-ás	dogmatizar+V.vós.AD.2.PL+FUT+2+SG
dogmatizar-vos	dogmatizar+V.vós.AD.2.PL+INF
dogmatizar-vos	dogmatizar+V.vós.AD.2.PL+INF+1+SG
dogmatizar-vos	dogmatizar+V.vós.AD.2.PL+INF+3+SG
dogmatizar-vos	dogmatizar+V.vós.AD.2.PL+SBJF+1+SG
dogmatizar-vos	dogmatizar+V.vós.AD.2.PL+SBJF+3+SG
dogmatizar-vos-ei	dogmatizar+V.vós.AD.2.PL+FUT+1+SG
dogmatizar-vos-eis	dogmatizar+V.vós.AD.2.PL+FUT+2+PL
dogmatizar-vos-emos	dogmatizar+V.vós.AD.2.PL+FUT+1+PL
dogmatizar-vos-ia	dogmatizar+V.vós.AD.2.PL+COND+1+SG
dogmatizar-vos-ia	dogmatizar+V.vós.AD.2.PL+COND+3+SG
dogmatizar-vos-iam	dogmatizar+V.vós.AD.2.PL+COND+3+PL
dogmatizar-vos-íamos	dogmatizar+V.vós.AD.2.PL+COND+1+PL
dogmatizar-vos-ias	dogmatizar+V.vós.AD.2.PL+COND+2+SG
dogmatizar-vos-íeis	dogmatizar+V.vós.AD.2.PL+COND+2+PL
dogmatiza-se	dogmatizar+V.ele.REFL+PRS+3+SG
dogmatizas-lhe	dogmatizar+V.ele.DAT.3.SG+PRS+2+SG
dogmatizas-lhes	dogmatizar+V.ele.DAT.3.PL+PRS+2+SG
dogmatizas-me	dogmatizar+V.eu.AD.1.SG+PRS+2+SG
dogmatizaste-a	dogmatizar+V.ele.ACC.3.F.SG+PRF+2+SG
dogmatizaste-as	dogmatizar+V.ele.ACC.3.F.PL+PRF+2+SG
dogmatizas-te	dogmatizar+V.tu.AD.2.SG+PRS+2+SG
dogmatizaste-la	dogmatizar+V.ele.ACC.3.F.SG+PRF+2+PL
dogmatizaste-las	dogmatizar+V.ele.ACC.3.F.PL+PRF+2+PL
dogmatizaste-lhe	dogmatizar+V.ele.DAT.3.SG+PRF+2+SG
dogmatizaste-lhes	dogmatizar+V.ele.DAT.3.PL+PRF+2+SG
dogmatizaste-lo	dogmatizar+V.ele.ACC.3.M.SG+PRF+2+PL
dogmatizaste-los	dogmatizar+V.ele.ACC.3.M.PL+PRF+2+PL
dogmatizaste-me	dogmatizar+V.eu.AD.1.SG+PRF+2+SG
dogmatizaste-nos	dogmatizar+nós.AD.1.PL+PRF+2+PL
dogmatizaste-nos	dogmatizar+nós.AD.1.PL+PRF+2+SG
dogmatizaste-o	dogmatizar+V.ele.ACC.3.M.SG+PRF+2+SG
dogmatizaste-os	dogmatizar+V.ele.ACC.3.M.PL+PRF+2+SG
dogmatizastes-lhe	dogmatizar+V.ele.DAT.3.SG+PRF+2+PL
dogmatizastes-lhes	dogmatizar+V.ele.DAT.3.PL+PRF+2+PL
dogmatizastes-me	dogmatizar+V.eu.AD.1.SG+PRF+2+PL
dogmatizastes-te	dogmatizar+V.tu.AD.2.SG+PRF+2+PL
dogmatizastes-vos	dogmatizar+V.vós.AD.2.PL+PRF+2+PL
dogmatizaste-te	dogmatizar+V.tu.AD.2.SG+PRF+2+SG
dogmatizaste-vos	dogmatizar+V.vós.AD.2.PL+PRF+2+SG
dogmatizas-vos	dogmatizar+V.vós.AD.2.PL+PRS+2+SG
dogmatiza-te	dogmatizar+V.tu.AD.2.SG+PRS+3+SG
dogmatizava-a	dogmatizar+V.ele.ACC.3.F.SG+IMPF+1+SG
dogmatizava-a	dogmatizar+V.ele.ACC.3.F.SG+IMPF+3+SG
dogmatizava-as	dogmatizar+V.ele.ACC.3.F.PL+IMPF+1+SG
dogmatizava-as	dogmatizar+V.ele.ACC.3.F.PL+IMPF+3+SG
dogmatizava-la	dogmatizar+V.ele.ACC.3.F.SG+IMPF+2+SG
dogmatizava-las	dogmatizar+V.ele.ACC.3.F.PL+IMPF+2+SG
dogmatizava-lhe	dogmatizar+V.ele.DAT.3.SG+IMPF+1+SG
dogmatizava-lhe	dogmatizar+V.ele.DAT.3.SG+IMPF+3+SG
dogmatizava-lhes	dogmatizar+V.ele.DAT.3.PL+IMPF+1+SG
dogmatizava-lhes	dogmatizar+V.ele.DAT.3.PL+IMPF+3+SG
dogmatizava-lo	dogmatizar+V.ele.ACC.3.M.SG+IMPF+2+SG
dogmatizava-los	dogmatizar+V.ele.ACC.3.M.PL+IMPF+2+SG
dogmatizava-me	dogmatizar+V.eu.AD.1.SG+IMPF+1+SG
dogmatizava-me	dogmatizar+V.eu.AD.1.SG+IMPF+3+SG
dogmatizavam-lhe	dogmatizar+V.ele.DAT.3.SG+IMPF+3+PL
dogmatizavam-lhes	dogmatizar+V.ele.DAT.3.PL+IMPF+3+PL
dogmatizavam-me	dogmatizar+V.eu.AD.1.SG+IMPF+3+PL
dogmatizavam-na	dogmatizar+V.ele.ACC.3.F.SG+IMPF+3+PL
dogmatizavam-nas	dogmatizar+V.ele.ACC.3.F.PL+IMPF+3+PL
dogmatizavam-no	dogmatizar+V.ele.ACC.3.M.SG+IMPF+3+PL
dogmatizavam-nos	dogmatizar+V.ele.ACC.3.M.PL+IMPF+3+PL
dogmatizavam-nos	dogmatizar+V.nós.AD.1.PL+IMPF+3+PL
dogmatizávamo-la	dogmatizar+V.ele.ACC.3.F.SG+IMPF+1+PL
dogmatizávamo-las	dogmatizar+V.ele.ACC.3.F.PL+IMPF+1+PL
dogmatizávamo-lo	dogmatizar+V.ele.ACC.3.M.SG+IMPF+1+PL
dogmatizávamo-los	dogmatizar+V.ele.ACC.3.M.PL+IMPF+1+PL
dogmatizávamo-nos	dogmatizar+nós.AD.1.PL+IMPF+1+PL
dogmatizávamos-lhe	dogmatizar+V.ele.DAT.3.SG+IMPF+1+PL
dogmatizávamos-lhes	dogmatizar+V.ele.DAT.3.PL+IMPF+1+PL
dogmatizávamos-me	dogmatizar+V.eu.AD.1.SG+IMPF+1+PL
dogmatizávamos-te	dogmatizar+V.tu.AD.2.SG+IMPF+1+PL
dogmatizávamos-vos	dogmatizar+V.vós.AD.2.PL+IMPF+1+PL
dogmatizavam-se	dogmatizar+V.ele.REFL+IMPF+3+PL
dogmatizavam-te	dogmatizar+V.tu.AD.2.SG+IMPF+3+PL
dogmatizavam-vos	dogmatizar+V.vós.AD.2.PL+IMPF+3+PL
dogmatizava-nos	dogmatizar+nós.AD.1.PL+IMPF+1+SG
dogmatizava-nos	dogmatizar+nós.AD.1.PL+IMPF+2+SG
dogmatizava-nos	dogmatizar+nós.AD.1.PL+IMPF+3+SG
dogmatizava-o	dogmatizar+V.ele.ACC.3.M.SG+IMPF+1+SG
dogmatizava-o	dogmatizar+V.ele.ACC.3.M.SG+IMPF+3+SG
dogmatizava-os	dogmatizar+V.ele.ACC.3.M.PL+IMPF+1+SG
dogmatizava-os	dogmatizar+V.ele.ACC.3.M.PL+IMPF+3+SG
dogmatizava-se	dogmatizar+V.ele.REFL+IMPF+1+SG
dogmatizava-se	dogmatizar+V.ele.REFL+IMPF+3+SG
dogmatizavas-lhe	dogmatizar+V.ele.DAT.3.SG+IMPF+2+SG
dogmatizavas-lhes	dogmatizar+V.ele.DAT.3.PL+IMPF+2+SG
dogmatizavas-me	dogmatizar+V.eu.AD.1.SG+IMPF+2+SG
dogmatizavas-te	dogmatizar+V.tu.AD.2.SG+IMPF+2+SG
dogmatizavas-vos	dogmatizar+V.vós.AD.2.PL+IMPF+2+SG
dogmatizava-te	dogmatizar+V.tu.AD.2.SG+IMPF+1+SG
dogmatizava-te	dogmatizar+V.tu.AD.2.SG+IMPF+3+SG
dogmatizava-vos	dogmatizar+V.vós.AD.2.PL+IMPF+1+SG
dogmatizava-vos	dogmatizar+V.vós.AD.2.PL+IMPF+3+SG
dogmatizávei-la	dogmatizar+V.ele.ACC.3.F.SG+IMPF+2+PL
dogmatizávei-las	dogmatizar+V.ele.ACC.3.F.PL+IMPF+2+PL
dogmatizávei-lo	dogmatizar+V.ele.ACC.3.M.SG+IMPF+2+PL
dogmatizávei-los	dogmatizar+V.ele.ACC.3.M.PL+IMPF+2+PL
dogmatizávei-nos	dogmatizar+nós.AD.1.PL+IMPF+2+PL
dogmatizáveis-lhe	dogmatizar+V.ele.DAT.3.SG+IMPF+2+PL
dogmatizáveis-lhes	dogmatizar+V.ele.DAT.3.PL+IMPF+2+PL
dogmatizáveis-me	dogmatizar+V.eu.AD.1.SG+IMPF+2+PL
dogmatizáveis-te	dogmatizar+V.tu.AD.2.SG+IMPF+2+PL
dogmatizáveis-vos	dogmatizar+V.vós.AD.2.PL+IMPF+2+PL
dogmatiza-vos	dogmatizar+V.vós.AD.2.PL+PRS+3+SG
dogmatize-a	dogmatizar+V.ele.ACC.3.F.SG+IMP+3+SG
dogmatize-as	dogmatizar+V.ele.ACC.3.F.PL+IMP+3+SG
dogmatizei-a	dogmatizar+V.ele.ACC.3.F.SG+PRF+1+SG
dogmatizei-as	dogmatizar+V.ele.ACC.3.F.PL+PRF+1+SG
dogmatizei-lhe	dogmatizar+V.ele.DAT.3.SG+PRF+1+SG
dogmatizei-lhes	dogmatizar+V.ele.DAT.3.PL+PRF+1+SG
dogmatizei-me	dogmatizar+V.eu.AD.1.SG+PRF+1+SG
dogmatizei-nos	dogmatizar+nós.AD.1.PL+PRF+1+SG
dogmatizei-o	dogmatizar+V.ele.ACC.3.M.SG+PRF+1+SG
dogmatizei-os	dogmatizar+V.ele.ACC.3.M.PL+PRF+1+SG
dogmatizei-te	dogmatizar+V.tu.AD.2.SG+PRF+1+SG
dogmatizei-vos	dogmatizar+V.vós.AD.2.PL+PRF+1+SG
dogmatize-lhe	dogmatizar+V.ele.DAT.3.SG+IMP+3+SG
dogmatize-lhes	dogmatizar+V.ele.DAT.3.PL+IMP+3+SG
dogmatize-me	dogmatizar+V.eu.AD.1.SG+IMP+3+SG
dogmatizem-lhe	dogmatizar+V.ele.DAT.3.SG+IMP+3+PL
dogmatizem-lhes	dogmatizar+V.ele.DAT.3.PL+IMP+3+PL
dogmatizem-me	dogmatizar+V.eu.AD.1.SG+IMP+3+PL
dogmatizem-na	dogmatizar+V.ele.ACC.3.F.SG+IMP+3+PL
dogmatizem-nas	dogmatizar+V.ele.ACC.3.F.PL+IMP+3+PL
dogmatizem-no	dogmatizar+V.ele.ACC.3.M.SG+IMP+3+PL
dogmatizem-nos	dogmatizar+V.ele.ACC.3.M.PL+IMP+3+PL
dogmatizem-nos	dogmatizar+V.nós.AD.1.PL+IMP+3+PL
dogmatizemo-la	dogmatizar+V.ele.ACC.3.F.SG+IMP+1+PL
dogmatizemo-las	dogmatizar+V.ele.ACC.3.F.PL+IMP+1+PL
dogmatizemo-lo	dogmatizar+V.ele.ACC.3.M.SG+IMP+1+PL
dogmatizemo-los	dogmatizar+V.ele.ACC.3.M.PL+IMP+1+PL
dogmatizemo-nos	dogmatizar+nós.AD.1.PL+IMP+1+PL
dogmatizemos-lhe	dogmatizar+V.ele.DAT.3.SG+IMP+1+PL
dogmatizemos-lhes	dogmatizar+V.ele.DAT.3.PL+IMP+1+PL
dogmatizemos-me	dogmatizar+V.eu.AD.1.SG+IMP+1+PL
dogmatizemos-te	dogmatizar+V.tu.AD.2.SG+IMP+1+PL
dogmatizemos-vos	dogmatizar+V.vós.AD.2.PL+IMP+1+PL
dogmatizem-se	dogmatizar+V.ele.REFL+IMP+3+PL
dogmatizem-te	dogmatizar+V.tu.AD.2.SG+IMP+3+PL
dogmatizem-vos	dogmatizar+V.vós.AD.2.PL+IMP+3+PL
dogmatize-nos	dogmatizar+nós.AD.1.PL+IMP+3+SG
dogmatize-o	dogmatizar+V.ele.ACC.3.M.SG+IMP+3+SG
dogmatize-os	dogmatizar+V.ele.ACC.3.M.PL+IMP+3+SG
dogmatize-se	dogmatizar+V.ele.REFL+IMP+3+SG
dogmatize-te	dogmatizar+V.tu.AD.2.SG+IMP+3+SG
dogmatize-vos	dogmatizar+V.vós.AD.2.PL+IMP+3+SG
dogmatizo-a	dogmatizar+V.ele.ACC.3.F.SG+PRS+1+SG
dogmatizo-as	dogmatizar+V.ele.ACC.3.F.PL+PRS+1+SG
dogmatizo-lhe	dogmatizar+V.ele.DAT.3.SG+PRS+1+SG
dogmatizo-lhes	dogmatizar+V.ele.DAT.3.PL+PRS+1+SG
dogmatizo-me	dogmatizar+V.eu.AD.1.SG+PRS+1+SG
dogmatizo-nos	dogmatizar+nós.AD.1.PL+PRS+1+SG
dogmatizo-o	dogmatizar+V.ele.ACC.3.M.SG+PRS+1+SG
dogmatizo-os	dogmatizar+V.ele.ACC.3.M.PL+PRS+1+SG
dogmatizo-te	dogmatizar+V.tu.AD.2.SG+PRS+1+SG
dogmatizou-a	dogmatizar+V.ele.ACC.3.F.SG+PRF+3+SG
dogmatizou-as	dogmatizar+V.ele.ACC.3.F.PL+PRF+3+SG
dogmatizou-lhe	dogmatizar+V.ele.DAT.3.SG+PRF+3+SG
dogmatizou-lhes	dogmatizar+V.ele.DAT.3.PL+PRF+3+SG
dogmatizou-me	dogmatizar+V.eu.AD.1.SG+PRF+3+SG
dogmatizou-nos	dogmatizar+nós.AD.1.PL+PRF+3+SG
dogmatizou-o	dogmatizar+V.ele.ACC.3.M.SG+PRF+3+SG
dogmatizou-os	dogmatizar+V.ele.ACC.3.M.PL+PRF+3+SG
dogmatizou-se	dogmatizar+V.ele.REFL+PRF+3+SG
dogmatizou-te	dogmatizar+V.tu.AD.2.SG+PRF+3+SG
dogmatizou-vos	dogmatizar+V.vós.AD.2.PL+PRF+3+SG
dogmatizo-vos	dogmatizar+V.vós.AD.2.PL+PRS+1+SG
doía-a	doer+V.ele.ACC.3.F.SG+IMPF+1+SG
doía-a	doer+V.ele.ACC.3.F.SG+IMPF+3+SG
doía-as	doer+V.ele.ACC.3.F.PL+IMPF+1+SG
doía-as	doer+V.ele.ACC.3.F.PL+IMPF+3+SG
doí-a	doer+V.ele.ACC.3.F.SG+PRF+1+SG
dói-a	doer+V.ele.ACC.3.F.SG+PRS+3+SG
doía-la	doer+V.ele.ACC.3.F.SG+IMPF+2+SG
doía-las	doer+V.ele.ACC.3.F.PL+IMPF+2+SG
doía-lhe	doer+V.ele.DAT.3.SG+IMPF+1+SG
doía-lhe	doer+V.ele.DAT.3.SG+IMPF+3+SG
doía-lhes	doer+V.ele.DAT.3.PL+IMPF+1+SG
doía-lhes	doer+V.ele.DAT.3.PL+IMPF+3+SG
doía-lo	doer+V.ele.ACC.3.M.SG+IMPF+2+SG
doía-los	doer+V.ele.ACC.3.M.PL+IMPF+2+SG
doía-me	doer+V.eu.AD.1.SG+IMPF+1+SG
doía-me	doer+V.eu.AD.1.SG+IMPF+3+SG
doíam-lhe	doer+V.ele.DAT.3.SG+IMPF+3+PL
doíam-lhes	doer+V.ele.DAT.3.PL+IMPF+3+PL
doíam-me	doer+V.eu.AD.1.SG+IMPF+3+PL
doíam-na	doer+V.ele.ACC.3.F.SG+IMPF+3+PL
doíam-nas	doer+V.ele.ACC.3.F.PL+IMPF+3+PL
doíam-no	doer+V.ele.ACC.3.M.SG+IMPF+3+PL
doíam-nos	doer+nós.AD.1.PL+IMPF+3+PL
doíamo-la	doer+V.ele.ACC.3.F.SG+IMPF+1+PL
doíamo-las	doer+V.ele.ACC.3.F.PL+IMPF+1+PL
doíamo-lo	doer+V.ele.ACC.3.M.SG+IMPF+1+PL
doíamo-los	doer+V.ele.ACC.3.M.PL+IMPF+1+PL
doíamo-nos	doer+nós.AD.1.PL+IMPF+1+PL
doíamos-lhe	doer+V.ele.DAT.3.SG+IMPF+1+PL
doíamos-lhes	doer+V.ele.DAT.3.PL+IMPF+1+PL
doíamos-me	doer+V.eu.AD.1.SG+IMPF+1+PL
doíamos-te	doer+V.tu.AD.2.SG+IMPF+1+PL
doíamos-vos	doer+V.vós.AD.2.PL+IMPF+1+PL
doíam-se	doer+V.ele.REFL+IMPF+3+PL
doíam-te	doer+V.tu.AD.2.SG+IMPF+3+PL
doíam-vos	doer+V.vós.AD.2.PL+IMPF+3+PL
doía-nos	doer+nós.AD.1.PL+IMPF+1+SG
doía-nos	doer+nós.AD.1.PL+IMPF+2+SG
doía-nos	doer+nós.AD.1.PL+IMPF+3+SG
doía-o	doer+V.ele.ACC.3.M.SG+IMPF+1+SG
doía-o	doer+V.ele.ACC.3.M.SG+IMPF+3+SG
doía-os	doer+V.ele.ACC.3.M.PL+IMPF+1+SG
doía-os	doer+V.ele.ACC.3.M.PL+IMPF+3+SG
doí-as	doer+V.ele.ACC.3.F.PL+PRF+1+SG
dói-as	doer+V.ele.ACC.3.F.PL+PRS+3+SG
doía-se	doer+V.ele.REFL+IMPF+3+SG
doías-lhe	doer+V.ele.DAT.3.SG+IMPF+2+SG
doías-lhes	doer+V.ele.DAT.3.PL+IMPF+2+SG
doías-me	doer+V.eu.AD.1.SG+IMPF+2+SG
doías-te	doer+V.tu.AD.2.SG+IMPF+2+SG
doías-vos	doer+V.vós.AD.2.PL+IMPF+2+SG
doía-te	doer+V.tu.AD.2.SG+IMPF+1+SG
doía-te	doer+V.tu.AD.2.SG+IMPF+3+SG
doía-vos	doer+V.vós.AD.2.PL+IMPF+1+SG
doía-vos	doer+V.vós.AD.2.PL+IMPF+3+SG
doideja-a	doidejar+V.ele.ACC.3.F.SG+PRS+3+SG
doideja-as	doidejar+V.ele.ACC.3.F.PL+PRS+3+SG
doidejai-la	doidejar+V.ele.ACC.3.F.SG+PRS+2+PL
doidejai-las	doidejar+V.ele.ACC.3.F.PL+PRS+2+PL
doidejai-lo	doidejar+V.ele.ACC.3.M.SG+PRS+2+PL
doidejai-los	doidejar+V.ele.ACC.3.M.PL+PRS+2+PL
doidejai-nos	doidejar+nós.AD.1.PL+PRS+2+PL
doidejais-lhe	doidejar+V.ele.DAT.3.SG+PRS+2+PL
doidejais-lhes	doidejar+V.ele.DAT.3.PL+PRS+2+PL
doidejais-me	doidejar+V.eu.AD.1.SG+PRS+2+PL
doidejais-te	doidejar+V.tu.AD.2.SG+PRS+2+PL
doidejais-vos	doidejar+V.vós.AD.2.PL+PRS+2+PL
doidejá-la-á	doidejar+V.ele.ACC.3.F.SG+FUT+3+SG
doidejá-la-ão	doidejar+V.ele.ACC.3.F.SG+FUT+3+PL
doidejá-la-ás	doidejar+V.ele.ACC.3.F.SG+FUT+2+SG
doidejá-la	doidejar+V.ele.ACC.3.F.SG+INF+1+SG
doidejá-la	doidejar+V.ele.ACC.3.F.SG+INF+3+SG
doideja-la	doidejar+V.ele.ACC.3.F.SG+PRS+2+SG
doidejá-la	doidejar+V.ele.ACC.3.F.SG+SBJF+1+SG
doidejá-la	doidejar+V.ele.ACC.3.F.SG+SBJF+3+SG
doidejá-la-ei	doidejar+V.ele.ACC.3.F.SG+FUT+1+SG
doidejá-la-eis	doidejar+V.ele.ACC.3.F.SG+FUT+2+PL
doidejá-la-emos	doidejar+V.ele.ACC.3.F.SG+FUT+1+PL
doidejá-la-ia	doidejar+V.ele.ACC.3.F.SG+COND+1+SG
doidejá-la-ia	doidejar+V.ele.ACC.3.F.SG+COND+3+SG
doidejá-la-iam	doidejar+V.ele.ACC.3.F.SG+COND+3+PL
doidejá-la-íamos	doidejar+V.ele.ACC.3.F.SG+COND+1+PL
doidejá-la-ias	doidejar+V.ele.ACC.3.F.SG+COND+2+SG
doidejá-la-íeis	doidejar+V.ele.ACC.3.F.SG+COND+2+PL
doidejá-las-á	doidejar+V.ele.ACC.3.F.PL+FUT+3+SG
doidejá-las-ão	doidejar+V.ele.ACC.3.F.PL+FUT+3+PL
doidejá-las-ás	doidejar+V.ele.ACC.3.F.PL+FUT+2+SG
doidejá-las	doidejar+V.ele.ACC.3.F.PL+INF+1+SG
doidejá-las	doidejar+V.ele.ACC.3.F.PL+INF+3+SG
doideja-las	doidejar+V.ele.ACC.3.F.PL+PRS+2+SG
doidejá-las	doidejar+V.ele.ACC.3.F.PL+SBJF+1+SG
doidejá-las	doidejar+V.ele.ACC.3.F.PL+SBJF+3+SG
doidejá-las-ei	doidejar+V.ele.ACC.3.F.PL+FUT+1+SG
doidejá-las-eis	doidejar+V.ele.ACC.3.F.PL+FUT+2+PL
doidejá-las-emos	doidejar+V.ele.ACC.3.F.PL+FUT+1+PL
doidejá-las-ia	doidejar+V.ele.ACC.3.F.PL+COND+1+SG
doidejá-las-ia	doidejar+V.ele.ACC.3.F.PL+COND+3+SG
doidejá-las-iam	doidejar+V.ele.ACC.3.F.PL+COND+3+PL
doidejá-las-íamos	doidejar+V.ele.ACC.3.F.PL+COND+1+PL
doidejá-las-ias	doidejar+V.ele.ACC.3.F.PL+COND+2+SG
doidejá-las-íeis	doidejar+V.ele.ACC.3.F.PL+COND+2+PL
doideja-lhe	doidejar+V.ele.DAT.3.SG+PRS+3+SG
doideja-lhes	doidejar+V.ele.DAT.3.PL+PRS+3+SG
doidejá-lo-á	doidejar+V.ele.ACC.3.M.SG+FUT+3+SG
doidejá-lo-ão	doidejar+V.ele.ACC.3.M.SG+FUT+3+PL
doidejá-lo-ás	doidejar+V.ele.ACC.3.M.SG+FUT+2+SG
doidejá-lo	doidejar+V.ele.ACC.3.M.SG+INF+1+SG
doidejá-lo	doidejar+V.ele.ACC.3.M.SG+INF+3+SG
doideja-lo	doidejar+V.ele.ACC.3.M.SG+PRS+2+SG
doidejá-lo	doidejar+V.ele.ACC.3.M.SG+SBJF+1+SG
doidejá-lo	doidejar+V.ele.ACC.3.M.SG+SBJF+3+SG
doidejá-lo-ei	doidejar+V.ele.ACC.3.M.SG+FUT+1+SG
doidejá-lo-eis	doidejar+V.ele.ACC.3.M.SG+FUT+2+PL
doidejá-lo-emos	doidejar+V.ele.ACC.3.M.SG+FUT+1+PL
doidejá-lo-ia	doidejar+V.ele.ACC.3.M.SG+COND+1+SG
doidejá-lo-ia	doidejar+V.ele.ACC.3.M.SG+COND+3+SG
doidejá-lo-iam	doidejar+V.ele.ACC.3.M.SG+COND+3+PL
doidejá-lo-íamos	doidejar+V.ele.ACC.3.M.SG+COND+1+PL
doidejá-lo-ias	doidejar+V.ele.ACC.3.M.SG+COND+2+SG
doidejá-lo-íeis	doidejar+V.ele.ACC.3.M.SG+COND+2+PL
doidejá-los-á	doidejar+V.ele.ACC.3.M.PL+FUT+3+SG
doidejá-los-ão	doidejar+V.ele.ACC.3.M.PL+FUT+3+PL
doidejá-los-ás	doidejar+V.ele.ACC.3.M.PL+FUT+2+SG
doidejá-los	doidejar+V.ele.ACC.3.M.PL+INF+1+SG
doidejá-los	doidejar+V.ele.ACC.3.M.PL+INF+3+SG
doideja-los	doidejar+V.ele.ACC.3.M.PL+PRS+2+SG
doidejá-los	doidejar+V.ele.ACC.3.M.PL+SBJF+1+SG
doidejá-los	doidejar+V.ele.ACC.3.M.PL+SBJF+3+SG
doidejá-los-ei	doidejar+V.ele.ACC.3.M.PL+FUT+1+SG
doidejá-los-eis	doidejar+V.ele.ACC.3.M.PL+FUT+2+PL
doidejá-los-emos	doidejar+V.ele.ACC.3.M.PL+FUT+1+PL
doidejá-los-ia	doidejar+V.ele.ACC.3.M.PL+COND+1+SG
doidejá-los-ia	doidejar+V.ele.ACC.3.M.PL+COND+3+SG
doidejá-los-iam	doidejar+V.ele.ACC.3.M.PL+COND+3+PL
doidejá-los-íamos	doidejar+V.ele.ACC.3.M.PL+COND+1+PL
doidejá-los-ias	doidejar+V.ele.ACC.3.M.PL+COND+2+SG
doidejá-los-íeis	doidejar+V.ele.ACC.3.M.PL+COND+2+PL
doideja-me	doidejar+V.eu.AD.1.SG+PRS+3+SG
doidejam-lhe	doidejar+V.ele.DAT.3.SG+PRS+3+PL
doidejam-lhes	doidejar+V.ele.DAT.3.PL+PRS+3+PL
doidejam-me	doidejar+V.eu.AD.1.SG+PRS+3+PL
doidejam-na	doidejar+V.ele.ACC.3.F.SG+PRS+3+PL
doidejam-nas	doidejar+V.ele.ACC.3.F.PL+PRS+3+PL
doidejam-no	doidejar+V.ele.ACC.3.M.SG+PRS+3+PL
doidejam-nos	doidejar+V.ele.ACC.3.M.PL+PRS+3+PL
doidejam-nos	doidejar+V.nós.AD.1.PL+PRS+3+PL
doidejamo-la	doidejar+V.ele.ACC.3.F.SG+PRF+1+PL
doidejamo-la	doidejar+V.ele.ACC.3.F.SG+PRS+1+PL
doidejamo-las	doidejar+V.ele.ACC.3.F.PL+PRF+1+PL
doidejamo-las	doidejar+V.ele.ACC.3.F.PL+PRS+1+PL
doidejamo-lo	doidejar+V.ele.ACC.3.M.SG+PRF+1+PL
doidejamo-lo	doidejar+V.ele.ACC.3.M.SG+PRS+1+PL
doidejamo-los	doidejar+V.ele.ACC.3.M.PL+PRF+1+PL
doidejamo-los	doidejar+V.ele.ACC.3.M.PL+PRS+1+PL
doidejamo-nos	doidejar+nós.AD.1.PL+PRF+1+PL
doidejamo-nos	doidejar+nós.AD.1.PL+PRS+1+PL
doidejamos-lhe	doidejar+V.ele.DAT.3.SG+PRF+1+PL
doidejamos-lhe	doidejar+V.ele.DAT.3.SG+PRS+1+PL
doidejamos-lhes	doidejar+V.ele.DAT.3.PL+PRF+1+PL
doidejamos-lhes	doidejar+V.ele.DAT.3.PL+PRS+1+PL
doidejamos-me	doidejar+V.eu.AD.1.SG+PRF+1+PL
doidejamos-me	doidejar+V.eu.AD.1.SG+PRS+1+PL
doidejamos-te	doidejar+V.tu.AD.2.SG+PRF+1+PL
doidejamos-te	doidejar+V.tu.AD.2.SG+PRS+1+PL
doidejamos-vos	doidejar+V.vós.AD.2.PL+PRF+1+PL
doidejamos-vos	doidejar+V.vós.AD.2.PL+PRS+1+PL
doidejam-se	doidejar+V.ele.REFL+PRS+3+PL
doidejam-te	doidejar+V.tu.AD.2.SG+PRS+3+PL
doidejam-vos	doidejar+V.vós.AD.2.PL+PRS+3+PL
doidejando-a	doidejar+V.ele.ACC.3.F.SG+GRD
doidejando-as	doidejar+V.ele.ACC.3.F.PL+GRD
doidejando-lhe	doidejar+V.ele.DAT.3.SG+GRD
doidejando-lhes	doidejar+V.ele.DAT.3.PL+GRD
doidejando-me	doidejar+V.eu.AD.1.SG+GRD
doidejando-nos	doidejar+nós.AD.1.PL+GRD
doidejando-o	doidejar+V.ele.ACC.3.M.SG+GRD
doidejando-os	doidejar+V.ele.ACC.3.M.PL+GRD
doidejando-se	doidejar+V.ele.REFL+GRD
doidejando-te	doidejar+V.tu.AD.2.SG+GRD
doidejando-vos	doidejar+V.vós.AD.2.PL+GRD
doideja-nos	doidejar+nós.AD.1.PL+PRS+2+SG
doideja-nos	doidejar+nós.AD.1.PL+PRS+3+SG
doideja-o	doidejar+V.ele.ACC.3.M.SG+PRS+3+SG
doideja-os	doidejar+V.ele.ACC.3.M.PL+PRS+3+SG
doidejara-a	doidejar+V.ele.ACC.3.F.SG+PQP+1+SG
doidejara-a	doidejar+V.ele.ACC.3.F.SG+PQP+3+SG
doidejara-as	doidejar+V.ele.ACC.3.F.PL+PQP+1+SG
doidejara-as	doidejar+V.ele.ACC.3.F.PL+PQP+3+SG
doidejara-la	doidejar+V.ele.ACC.3.F.SG+PQP+2+SG
doidejara-las	doidejar+V.ele.ACC.3.F.PL+PQP+2+SG
doidejara-lhe	doidejar+V.ele.DAT.3.SG+PQP+1+SG
doidejara-lhe	doidejar+V.ele.DAT.3.SG+PQP+3+SG
doidejara-lhes	doidejar+V.ele.DAT.3.PL+PQP+1+SG
doidejara-lhes	doidejar+V.ele.DAT.3.PL+PQP+3+SG
doidejara-lo	doidejar+V.ele.ACC.3.M.SG+PQP+2+SG
doidejara-los	doidejar+V.ele.ACC.3.M.PL+PQP+2+SG
doidejara-me	doidejar+V.eu.AD.1.SG+PQP+1+SG
doidejara-me	doidejar+V.eu.AD.1.SG+PQP+3+SG
doidejaram-lhe	doidejar+V.ele.DAT.3.SG+PQP+3+PL
doidejaram-lhe	doidejar+V.ele.DAT.3.SG+PRF+3+PL
doidejaram-lhes	doidejar+V.ele.DAT.3.PL+PQP+3+PL
doidejaram-lhes	doidejar+V.ele.DAT.3.PL+PRF+3+PL
doidejaram-me	doidejar+V.eu.AD.1.SG+PQP+3+PL
doidejaram-me	doidejar+V.eu.AD.1.SG+PRF+3+PL
doidejaram-na	doidejar+V.ele.ACC.3.F.SG+PQP+3+PL
doidejaram-na	doidejar+V.ele.ACC.3.F.SG+PRF+3+PL
doidejaram-nas	doidejar+V.ele.ACC.3.F.PL+PQP+3+PL
doidejaram-nas	doidejar+V.ele.ACC.3.F.PL+PRF+3+PL
doidejaram-no	doidejar+V.ele.ACC.3.M.SG+PQP+3+PL
doidejaram-no	doidejar+V.ele.ACC.3.M.SG+PRF+3+PL
doidejaram-nos	doidejar+V.ele.ACC.3.M.PL+PQP+3+PL
doidejaram-nos	doidejar+V.ele.ACC.3.M.PL+PRF+3+PL
doidejaram-nos	doidejar+V.nós.AD.1.PL+PQP+3+PL
doidejaram-nos	doidejar+V.nós.AD.1.PL+PRF+3+PL
doidejáramo-la	doidejar+V.ele.ACC.3.F.SG+PQP+1+PL
doidejáramo-las	doidejar+V.ele.ACC.3.F.PL+PQP+1+PL
doidejáramo-lo	doidejar+V.ele.ACC.3.M.SG+PQP+1+PL
doidejáramo-los	doidejar+V.ele.ACC.3.M.PL+PQP+1+PL
doidejáramo-nos	doidejar+nós.AD.1.PL+PQP+1+PL
doidejáramos-lhe	doidejar+V.ele.DAT.3.SG+PQP+1+PL
doidejáramos-lhes	doidejar+V.ele.DAT.3.PL+PQP+1+PL
doidejáramos-me	doidejar+V.eu.AD.1.SG+PQP+1+PL
doidejáramos-te	doidejar+V.tu.AD.2.SG+PQP+1+PL
doidejáramos-vos	doidejar+V.vós.AD.2.PL+PQP+1+PL
doidejaram-se	doidejar+V.ele.REFL+PQP+3+PL
doidejaram-se	doidejar+V.ele.REFL+PRF+3+PL
doidejaram-te	doidejar+V.tu.AD.2.SG+PQP+3+PL
doidejaram-te	doidejar+V.tu.AD.2.SG+PRF+3+PL
doidejaram-vos	doidejar+V.vós.AD.2.PL+PQP+3+PL
doidejaram-vos	doidejar+V.vós.AD.2.PL+PRF+3+PL
doidejara-nos	doidejar+nós.AD.1.PL+PQP+1+SG
doidejara-nos	doidejar+nós.AD.1.PL+PQP+2+SG
doidejara-nos	doidejar+nós.AD.1.PL+PQP+3+SG
doidejara-o	doidejar+V.ele.ACC.3.M.SG+PQP+1+SG
doidejara-o	doidejar+V.ele.ACC.3.M.SG+PQP+3+SG
doidejara-os	doidejar+V.ele.ACC.3.M.PL+PQP+1+SG
doidejara-os	doidejar+V.ele.ACC.3.M.PL+PQP+3+SG
doidejara-se	doidejar+V.ele.REFL+PQP+1+SG
doidejara-se	doidejar+V.ele.REFL+PQP+3+SG
doidejaras-lhe	doidejar+V.ele.DAT.3.SG+PQP+2+SG
doidejaras-lhes	doidejar+V.ele.DAT.3.PL+PQP+2+SG
doidejaras-me	doidejar+V.eu.AD.1.SG+PQP+2+SG
doidejaras-te	doidejar+V.tu.AD.2.SG+PQP+2+SG
doidejaras-vos	doidejar+V.vós.AD.2.PL+PQP+2+SG
doidejara-te	doidejar+V.tu.AD.2.SG+PQP+1+SG
doidejara-te	doidejar+V.tu.AD.2.SG+PQP+3+SG
doidejara-vos	doidejar+V.vós.AD.2.PL+PQP+1+SG
doidejara-vos	doidejar+V.vós.AD.2.PL+PQP+3+SG
doidejarde-la	doidejar+V.ele.ACC.3.F.SG+INF+2+PL
doidejarde-la	doidejar+V.ele.ACC.3.F.SG+SBJF+2+PL
doidejarde-las	doidejar+V.ele.ACC.3.F.PL+INF+2+PL
doidejarde-las	doidejar+V.ele.ACC.3.F.PL+SBJF+2+PL
doidejarde-lo	doidejar+V.ele.ACC.3.M.SG+INF+2+PL
doidejarde-lo	doidejar+V.ele.ACC.3.M.SG+SBJF+2+PL
doidejarde-los	doidejar+V.ele.ACC.3.M.PL+INF+2+PL
doidejarde-los	doidejar+V.ele.ACC.3.M.PL+SBJF+2+PL
doidejarde-nos	doidejar+nós.AD.1.PL+INF+2+PL
doidejarde-nos	doidejar+nós.AD.1.PL+SBJF+2+PL
doidejardes-lhe	doidejar+V.ele.DAT.3.SG+INF+2+PL
doidejardes-lhe	doidejar+V.ele.DAT.3.SG+SBJF+2+PL
doidejardes-lhes	doidejar+V.ele.DAT.3.PL+INF+2+PL
doidejardes-lhes	doidejar+V.ele.DAT.3.PL+SBJF+2+PL
doidejardes-me	doidejar+V.eu.AD.1.SG+INF+2+PL
doidejardes-me	doidejar+V.eu.AD.1.SG+SBJF+2+PL
doidejardes-te	doidejar+V.tu.AD.2.SG+INF+2+PL
doidejardes-te	doidejar+V.tu.AD.2.SG+SBJF+2+PL
doidejardes-vos	doidejar+V.vós.AD.2.PL+INF+2+PL
doidejardes-vos	doidejar+V.vós.AD.2.PL+SBJF+2+PL
doidejárei-la	doidejar+V.ele.ACC.3.F.SG+PQP+2+PL
doidejárei-las	doidejar+V.ele.ACC.3.F.PL+PQP+2+PL
doidejárei-lo	doidejar+V.ele.ACC.3.M.SG+PQP+2+PL
doidejárei-los	doidejar+V.ele.ACC.3.M.PL+PQP+2+PL
doidejárei-nos	doidejar+nós.AD.1.PL+PQP+2+PL
doidejáreis-lhe	doidejar+V.ele.DAT.3.SG+PQP+2+PL
doidejáreis-lhes	doidejar+V.ele.DAT.3.PL+PQP+2+PL
doidejáreis-me	doidejar+V.eu.AD.1.SG+PQP+2+PL
doidejáreis-te	doidejar+V.tu.AD.2.SG+PQP+2+PL
doidejáreis-vos	doidejar+V.vós.AD.2.PL+PQP+2+PL
doidejare-la	doidejar+V.ele.ACC.3.F.SG+INF+2+SG
doidejare-la	doidejar+V.ele.ACC.3.F.SG+SBJF+2+SG
doidejare-las	doidejar+V.ele.ACC.3.F.PL+INF+2+SG
doidejare-las	doidejar+V.ele.ACC.3.F.PL+SBJF+2+SG
doidejare-lo	doidejar+V.ele.ACC.3.M.SG+INF+2+SG
doidejare-lo	doidejar+V.ele.ACC.3.M.SG+SBJF+2+SG
doidejare-los	doidejar+V.ele.ACC.3.M.PL+INF+2+SG
doidejare-los	doidejar+V.ele.ACC.3.M.PL+SBJF+2+SG
doidejarem-lhe	doidejar+V.ele.DAT.3.SG+INF+3+PL
doidejarem-lhe	doidejar+V.ele.DAT.3.SG+SBJF+3+PL
doidejarem-lhes	doidejar+V.ele.DAT.3.PL+INF+3+PL
doidejarem-lhes	doidejar+V.ele.DAT.3.PL+SBJF+3+PL
doidejarem-me	doidejar+V.eu.AD.1.SG+INF+3+PL
doidejarem-me	doidejar+V.eu.AD.1.SG+SBJF+3+PL
doidejarem-na	doidejar+V.ele.ACC.3.F.SG+INF+3+PL
doidejarem-na	doidejar+V.ele.ACC.3.F.SG+SBJF+3+PL
doidejarem-nas	doidejar+V.ele.ACC.3.F.PL+INF+3+PL
doidejarem-nas	doidejar+V.ele.ACC.3.F.PL+SBJF+3+PL
doidejarem-no	doidejar+V.ele.ACC.3.M.SG+INF+3+PL
doidejarem-no	doidejar+V.ele.ACC.3.M.SG+SBJF+3+PL
doidejarem-nos	doidejar+V.ele.ACC.3.M.PL+INF+3+PL
doidejarem-nos	doidejar+V.ele.ACC.3.M.PL+SBJF+3+PL
doidejarem-nos	doidejar+V.nós.AD.1.PL+INF+3+PL
doidejarem-nos	doidejar+V.nós.AD.1.PL+SBJF+3+PL
doidejarem-se	doidejar+V.ele.REFL+INF+3+PL
doidejarem-se	doidejar+V.ele.REFL+SBJF+3+PL
doidejarem-te	doidejar+V.tu.AD.2.SG+INF+3+PL
doidejarem-te	doidejar+V.tu.AD.2.SG+SBJF+3+PL
doidejarem-vos	doidejar+V.vós.AD.2.PL+INF+3+PL
doidejarem-vos	doidejar+V.vós.AD.2.PL+SBJF+3+PL
doidejare-nos	doidejar+nós.AD.1.PL+INF+2+SG
doidejare-nos	doidejar+nós.AD.1.PL+SBJF+2+SG
doidejares-lhe	doidejar+V.ele.DAT.3.SG+INF+2+SG
doidejares-lhe	doidejar+V.ele.DAT.3.SG+SBJF+2+SG
doidejares-lhes	doidejar+V.ele.DAT.3.PL+INF+2+SG
doidejares-lhes	doidejar+V.ele.DAT.3.PL+SBJF+2+SG
doidejares-me	doidejar+V.eu.AD.1.SG+INF+2+SG
doidejares-me	doidejar+V.eu.AD.1.SG+SBJF+2+SG
doidejares-te	doidejar+V.tu.AD.2.SG+INF+2+SG
doidejares-te	doidejar+V.tu.AD.2.SG+SBJF+2+SG
doidejares-vos	doidejar+V.vós.AD.2.PL+INF+2+SG
doidejares-vos	doidejar+V.vós.AD.2.PL+SBJF+2+SG
doidejar-lhe-á	doidejar+V.ele.DAT.3.SG+FUT+3+SG
doidejar-lhe-ão	doidejar+V.ele.DAT.3.SG+FUT+3+PL
doidejar-lhe-ás	doidejar+V.ele.DAT.3.SG+FUT+2+SG
doidejar-lhe	doidejar+V.ele.DAT.3.SG+INF
doidejar-lhe	doidejar+V.ele.DAT.3.SG+INF+1+SG
doidejar-lhe	doidejar+V.ele.DAT.3.SG+INF+3+SG
doidejar-lhe	doidejar+V.ele.DAT.3.SG+SBJF+1+SG
doidejar-lhe	doidejar+V.ele.DAT.3.SG+SBJF+3+SG
doidejar-lhe-ei	doidejar+V.ele.DAT.3.SG+FUT+1+SG
doidejar-lhe-eis	doidejar+V.ele.DAT.3.SG+FUT+2+PL
doidejar-lhe-emos	doidejar+V.ele.DAT.3.SG+FUT+1+PL
doidejar-lhe-ia	doidejar+V.ele.DAT.3.SG+COND+1+SG
doidejar-lhe-ia	doidejar+V.ele.DAT.3.SG+COND+3+SG
doidejar-lhe-iam	doidejar+V.ele.DAT.3.SG+COND+3+PL
doidejar-lhe-íamos	doidejar+V.ele.DAT.3.SG+COND+1+PL
doidejar-lhe-ias	doidejar+V.ele.DAT.3.SG+COND+2+SG
doidejar-lhe-íeis	doidejar+V.ele.DAT.3.SG+COND+2+PL
doidejar-lhes-á	doidejar+V.ele.DAT.3.PL+FUT+3+SG
doidejar-lhes-ão	doidejar+V.ele.DAT.3.PL+FUT+3+PL
doidejar-lhes-ás	doidejar+V.ele.DAT.3.PL+FUT+2+SG
doidejar-lhes	doidejar+V.ele.DAT.3.PL+INF
doidejar-lhes	doidejar+V.ele.DAT.3.PL+INF+1+SG
doidejar-lhes	doidejar+V.ele.DAT.3.PL+INF+3+SG
doidejar-lhes	doidejar+V.ele.DAT.3.PL+SBJF+1+SG
doidejar-lhes	doidejar+V.ele.DAT.3.PL+SBJF+3+SG
doidejar-lhes-ei	doidejar+V.ele.DAT.3.PL+FUT+1+SG
doidejar-lhes-eis	doidejar+V.ele.DAT.3.PL+FUT+2+PL
doidejar-lhes-emos	doidejar+V.ele.DAT.3.PL+FUT+1+PL
doidejar-lhes-ia	doidejar+V.ele.DAT.3.PL+COND+1+SG
doidejar-lhes-ia	doidejar+V.ele.DAT.3.PL+COND+3+SG
doidejar-lhes-iam	doidejar+V.ele.DAT.3.PL+COND+3+PL
doidejar-lhes-íamos	doidejar+V.ele.DAT.3.PL+COND+1+PL
doidejar-lhes-ias	doidejar+V.ele.DAT.3.PL+COND+2+SG
doidejar-lhes-íeis	doidejar+V.ele.DAT.3.PL+COND+2+PL
doidejar-me-á	doidejar+V.eu.AD.1.SG+FUT+3+SG
doidejar-me-ão	doidejar+V.eu.AD.1.SG+FUT+3+PL
doidejar-me-ás	doidejar+V.eu.AD.1.SG+FUT+2+SG
doidejar-me	doidejar+V.eu.AD.1.SG+INF
doidejar-me	doidejar+V.eu.AD.1.SG+INF+1+SG
doidejar-me	doidejar+V.eu.AD.1.SG+INF+3+SG
doidejar-me	doidejar+V.eu.AD.1.SG+SBJF+1+SG
doidejar-me	doidejar+V.eu.AD.1.SG+SBJF+3+SG
doidejar-me-ei	doidejar+V.eu.AD.1.SG+FUT+1+SG
doidejar-me-eis	doidejar+V.eu.AD.1.SG+FUT+2+PL
doidejar-me-emos	doidejar+V.eu.AD.1.SG+FUT+1+PL
doidejar-me-ia	doidejar+V.eu.AD.1.SG+COND+1+SG
doidejar-me-ia	doidejar+V.eu.AD.1.SG+COND+3+SG
doidejar-me-iam	doidejar+V.eu.AD.1.SG+COND+3+PL
doidejar-me-íamos	doidejar+V.eu.AD.1.SG+COND+1+PL
doidejar-me-ias	doidejar+V.eu.AD.1.SG+COND+2+SG
doidejar-me-íeis	doidejar+V.eu.AD.1.SG+COND+2+PL
doidejarmo-la	doidejar+V.ele.ACC.3.F.SG+INF+1+PL
doidejarmo-la	doidejar+V.ele.ACC.3.F.SG+SBJF+1+PL
doidejarmo-las	doidejar+V.ele.ACC.3.F.PL+INF+1+PL
doidejarmo-las	doidejar+V.ele.ACC.3.F.PL+SBJF+1+PL
doidejarmo-lo	doidejar+V.ele.ACC.3.M.SG+INF+1+PL
doidejarmo-lo	doidejar+V.ele.ACC.3.M.SG+SBJF+1+PL
doidejarmo-los	doidejar+V.ele.ACC.3.M.PL+INF+1+PL
doidejarmo-los	doidejar+V.ele.ACC.3.M.PL+SBJF+1+PL
doidejarmo-nos	doidejar+nós.AD.1.PL+INF+1+PL
doidejarmo-nos	doidejar+nós.AD.1.PL+SBJF+1+PL
doidejarmos-lhe	doidejar+V.ele.DAT.3.SG+INF+1+PL
doidejarmos-lhe	doidejar+V.ele.DAT.3.SG+SBJF+1+PL
doidejarmos-lhes	doidejar+V.ele.DAT.3.PL+INF+1+PL
doidejarmos-lhes	doidejar+V.ele.DAT.3.PL+SBJF+1+PL
doidejarmos-me	doidejar+V.eu.AD.1.SG+INF+1+PL
doidejarmos-me	doidejar+V.eu.AD.1.SG+SBJF+1+PL
doidejarmos-te	doidejar+V.tu.AD.2.SG+INF+1+PL
doidejarmos-te	doidejar+V.tu.AD.2.SG+SBJF+1+PL
doidejarmos-vos	doidejar+V.vós.AD.2.PL+INF+1+PL
doidejarmos-vos	doidejar+V.vós.AD.2.PL+SBJF+1+PL
doidejar-nos-á	doidejar+nós.AD.1.PL+FUT+3+SG
doidejar-nos-ão	doidejar+nós.AD.1.PL+FUT+3+PL
doidejar-nos-ás	doidejar+nós.AD.1.PL+FUT+2+SG
doidejar-nos	doidejar+nós.AD.1.PL+INF
doidejar-nos	doidejar+nós.AD.1.PL+INF+1+SG
doidejar-nos	doidejar+nós.AD.1.PL+INF+3+SG
doidejar-nos	doidejar+nós.AD.1.PL+SBJF+1+SG
doidejar-nos	doidejar+nós.AD.1.PL+SBJF+3+SG
doidejar-nos-ei	doidejar+nós.AD.1.PL+FUT+1+SG
doidejar-nos-eis	doidejar+nós.AD.1.PL+FUT+2+PL
doidejar-nos-emos	doidejar+nós.AD.1.PL+FUT+1+PL
doidejar-nos-ia	doidejar+nós.AD.1.PL+COND+1+SG
doidejar-nos-ia	doidejar+nós.AD.1.PL+COND+3+SG
doidejar-nos-iam	doidejar+nós.AD.1.PL+COND+3+PL
doidejar-nos-íamos	doidejar+nós.AD.1.PL+COND+1+PL
doidejar-nos-ias	doidejar+nós.AD.1.PL+COND+2+SG
doidejar-nos-íeis	doidejar+nós.AD.1.PL+COND+2+PL
doidejar-se-á	doidejar+V.ele.REFL+FUT+3+SG
doidejar-se-ão	doidejar+V.ele.REFL+FUT+3+PL
doidejar-se	doidejar+V.ele.REFL+INF
doidejar-se	doidejar+V.ele.REFL+INF+3+SG
doidejar-se	doidejar+V.ele.REFL+SBJF+3+SG
doidejar-se-ia	doidejar+V.ele.REFL+COND+3+SG
doidejar-se-iam	doidejar+V.ele.REFL+COND+3+PL
doidejar-te-á	doidejar+V.tu.AD.2.SG+FUT+3+SG
doidejar-te-ão	doidejar+V.tu.AD.2.SG+FUT+3+PL
doidejar-te-ás	doidejar+V.tu.AD.2.SG+FUT+2+SG
doidejar-te	doidejar+V.tu.AD.2.SG+INF
doidejar-te	doidejar+V.tu.AD.2.SG+INF+1+SG
doidejar-te	doidejar+V.tu.AD.2.SG+INF+3+SG
doidejar-te	doidejar+V.tu.AD.2.SG+SBJF+1+SG
doidejar-te	doidejar+V.tu.AD.2.SG+SBJF+3+SG
doidejar-te-ei	doidejar+V.tu.AD.2.SG+FUT+1+SG
doidejar-te-eis	doidejar+V.tu.AD.2.SG+FUT+2+PL
doidejar-te-emos	doidejar+V.tu.AD.2.SG+FUT+1+PL
doidejar-te-ia	doidejar+V.tu.AD.2.SG+COND+1+SG
doidejar-te-ia	doidejar+V.tu.AD.2.SG+COND+3+SG
doidejar-te-iam	doidejar+V.tu.AD.2.SG+COND+3+PL
doidejar-te-íamos	doidejar+V.tu.AD.2.SG+COND+1+PL
doidejar-te-ias	doidejar+V.tu.AD.2.SG+COND+2+SG
doidejar-te-íeis	doidejar+V.tu.AD.2.SG+COND+2+PL
doidejar-vos-á	doidejar+V.vós.AD.2.PL+FUT+3+SG
doidejar-vos-ão	doidejar+V.vós.AD.2.PL+FUT+3+PL
doidejar-vos-ás	doidejar+V.vós.AD.2.PL+FUT+2+SG
doidejar-vos	doidejar+V.vós.AD.2.PL+INF
doidejar-vos	doidejar+V.vós.AD.2.PL+INF+1+SG
doidejar-vos	doidejar+V.vós.AD.2.PL+INF+3+SG
doidejar-vos	doidejar+V.vós.AD.2.PL+SBJF+1+SG
doidejar-vos	doidejar+V.vós.AD.2.PL+SBJF+3+SG
doidejar-vos-ei	doidejar+V.vós.AD.2.PL+FUT+1+SG
doidejar-vos-eis	doidejar+V.vós.AD.2.PL+FUT+2+PL
doidejar-vos-emos	doidejar+V.vós.AD.2.PL+FUT+1+PL
doidejar-vos-ia	doidejar+V.vós.AD.2.PL+COND+1+SG
doidejar-vos-ia	doidejar+V.vós.AD.2.PL+COND+3+SG
doidejar-vos-iam	doidejar+V.vós.AD.2.PL+COND+3+PL
doidejar-vos-íamos	doidejar+V.vós.AD.2.PL+COND+1+PL
doidejar-vos-ias	doidejar+V.vós.AD.2.PL+COND+2+SG
doidejar-vos-íeis	doidejar+V.vós.AD.2.PL+COND+2+PL
doideja-se	doidejar+V.ele.REFL+PRS+3+SG
doidejas-lhe	doidejar+V.ele.DAT.3.SG+PRS+2+SG
doidejas-lhes	doidejar+V.ele.DAT.3.PL+PRS+2+SG
doidejas-me	doidejar+V.eu.AD.1.SG+PRS+2+SG
doidejaste-a	doidejar+V.ele.ACC.3.F.SG+PRF+2+SG
doidejaste-as	doidejar+V.ele.ACC.3.F.PL+PRF+2+SG
doidejas-te	doidejar+V.tu.AD.2.SG+PRS+2+SG
doidejaste-la	doidejar+V.ele.ACC.3.F.SG+PRF+2+PL
doidejaste-las	doidejar+V.ele.ACC.3.F.PL+PRF+2+PL
doidejaste-lhe	doidejar+V.ele.DAT.3.SG+PRF+2+SG
doidejaste-lhes	doidejar+V.ele.DAT.3.PL+PRF+2+SG
doidejaste-lo	doidejar+V.ele.ACC.3.M.SG+PRF+2+PL
doidejaste-los	doidejar+V.ele.ACC.3.M.PL+PRF+2+PL
doidejaste-me	doidejar+V.eu.AD.1.SG+PRF+2+SG
doidejaste-nos	doidejar+nós.AD.1.PL+PRF+2+PL
doidejaste-nos	doidejar+nós.AD.1.PL+PRF+2+SG
doidejaste-o	doidejar+V.ele.ACC.3.M.SG+PRF+2+SG
doidejaste-os	doidejar+V.ele.ACC.3.M.PL+PRF+2+SG
doidejastes-lhe	doidejar+V.ele.DAT.3.SG+PRF+2+PL
doidejastes-lhes	doidejar+V.ele.DAT.3.PL+PRF+2+PL
doidejastes-me	doidejar+V.eu.AD.1.SG+PRF+2+PL
doidejastes-te	doidejar+V.tu.AD.2.SG+PRF+2+PL
doidejastes-vos	doidejar+V.vós.AD.2.PL+PRF+2+PL
doidejaste-te	doidejar+V.tu.AD.2.SG+PRF+2+SG
doidejaste-vos	doidejar+V.vós.AD.2.PL+PRF+2+SG
doidejas-vos	doidejar+V.vós.AD.2.PL+PRS+2+SG
doideja-te	doidejar+V.tu.AD.2.SG+PRS+3+SG
doidejava-a	doidejar+V.ele.ACC.3.F.SG+IMPF+1+SG
doidejava-a	doidejar+V.ele.ACC.3.F.SG+IMPF+3+SG
doidejava-as	doidejar+V.ele.ACC.3.F.PL+IMPF+1+SG
doidejava-as	doidejar+V.ele.ACC.3.F.PL+IMPF+3+SG
doidejava-la	doidejar+V.ele.ACC.3.F.SG+IMPF+2+SG
doidejava-las	doidejar+V.ele.ACC.3.F.PL+IMPF+2+SG
doidejava-lhe	doidejar+V.ele.DAT.3.SG+IMPF+1+SG
doidejava-lhe	doidejar+V.ele.DAT.3.SG+IMPF+3+SG
doidejava-lhes	doidejar+V.ele.DAT.3.PL+IMPF+1+SG
doidejava-lhes	doidejar+V.ele.DAT.3.PL+IMPF+3+SG
doidejava-lo	doidejar+V.ele.ACC.3.M.SG+IMPF+2+SG
doidejava-los	doidejar+V.ele.ACC.3.M.PL+IMPF+2+SG
doidejava-me	doidejar+V.eu.AD.1.SG+IMPF+1+SG
doidejava-me	doidejar+V.eu.AD.1.SG+IMPF+3+SG
doidejavam-lhe	doidejar+V.ele.DAT.3.SG+IMPF+3+PL
doidejavam-lhes	doidejar+V.ele.DAT.3.PL+IMPF+3+PL
doidejavam-me	doidejar+V.eu.AD.1.SG+IMPF+3+PL
doidejavam-na	doidejar+V.ele.ACC.3.F.SG+IMPF+3+PL
doidejavam-nas	doidejar+V.ele.ACC.3.F.PL+IMPF+3+PL
doidejavam-no	doidejar+V.ele.ACC.3.M.SG+IMPF+3+PL
doidejavam-nos	doidejar+V.ele.ACC.3.M.PL+IMPF+3+PL
doidejavam-nos	doidejar+V.nós.AD.1.PL+IMPF+3+PL
doidejávamo-la	doidejar+V.ele.ACC.3.F.SG+IMPF+1+PL
doidejávamo-las	doidejar+V.ele.ACC.3.F.PL+IMPF+1+PL
doidejávamo-lo	doidejar+V.ele.ACC.3.M.SG+IMPF+1+PL
doidejávamo-los	doidejar+V.ele.ACC.3.M.PL+IMPF+1+PL
doidejávamo-nos	doidejar+nós.AD.1.PL+IMPF+1+PL
doidejávamos-lhe	doidejar+V.ele.DAT.3.SG+IMPF+1+PL
doidejávamos-lhes	doidejar+V.ele.DAT.3.PL+IMPF+1+PL
doidejávamos-me	doidejar+V.eu.AD.1.SG+IMPF+1+PL
doidejávamos-te	doidejar+V.tu.AD.2.SG+IMPF+1+PL
doidejávamos-vos	doidejar+V.vós.AD.2.PL+IMPF+1+PL
doidejavam-se	doidejar+V.ele.REFL+IMPF+3+PL
doidejavam-te	doidejar+V.tu.AD.2.SG+IMPF+3+PL
doidejavam-vos	doidejar+V.vós.AD.2.PL+IMPF+3+PL
doidejava-nos	doidejar+nós.AD.1.PL+IMPF+1+SG
doidejava-nos	doidejar+nós.AD.1.PL+IMPF+2+SG
doidejava-nos	doidejar+nós.AD.1.PL+IMPF+3+SG
doidejava-o	doidejar+V.ele.ACC.3.M.SG+IMPF+1+SG
doidejava-o	doidejar+V.ele.ACC.3.M.SG+IMPF+3+SG
doidejava-os	doidejar+V.ele.ACC.3.M.PL+IMPF+1+SG
doidejava-os	doidejar+V.ele.ACC.3.M.PL+IMPF+3+SG
doidejava-se	doidejar+V.ele.REFL+IMPF+1+SG
doidejava-se	doidejar+V.ele.REFL+IMPF+3+SG
doidejavas-lhe	doidejar+V.ele.DAT.3.SG+IMPF+2+SG
doidejavas-lhes	doidejar+V.ele.DAT.3.PL+IMPF+2+SG
doidejavas-me	doidejar+V.eu.AD.1.SG+IMPF+2+SG
doidejavas-te	doidejar+V.tu.AD.2.SG+IMPF+2+SG
doidejavas-vos	doidejar+V.vós.AD.2.PL+IMPF+2+SG
doidejava-te	doidejar+V.tu.AD.2.SG+IMPF+1+SG
doidejava-te	doidejar+V.tu.AD.2.SG+IMPF+3+SG
doidejava-vos	doidejar+V.vós.AD.2.PL+IMPF+1+SG
doidejava-vos	doidejar+V.vós.AD.2.PL+IMPF+3+SG
doidejávei-la	doidejar+V.ele.ACC.3.F.SG+IMPF+2+PL
doidejávei-las	doidejar+V.ele.ACC.3.F.PL+IMPF+2+PL
doidejávei-lo	doidejar+V.ele.ACC.3.M.SG+IMPF+2+PL
doidejávei-los	doidejar+V.ele.ACC.3.M.PL+IMPF+2+PL
doidejávei-nos	doidejar+nós.AD.1.PL+IMPF+2+PL
doidejáveis-lhe	doidejar+V.ele.DAT.3.SG+IMPF+2+PL
doidejáveis-lhes	doidejar+V.ele.DAT.3.PL+IMPF+2+PL
doidejáveis-me	doidejar+V.eu.AD.1.SG+IMPF+2+PL
doidejáveis-te	doidejar+V.tu.AD.2.SG+IMPF+2+PL
doidejáveis-vos	doidejar+V.vós.AD.2.PL+IMPF+2+PL
doideja-vos	doidejar+V.vós.AD.2.PL+PRS+3+SG
doideje-a	doidejar+V.ele.ACC.3.F.SG+IMP+3+SG
doideje-as	doidejar+V.ele.ACC.3.F.PL+IMP+3+SG
doidejei-a	doidejar+V.ele.ACC.3.F.SG+PRF+1+SG
doidejei-as	doidejar+V.ele.ACC.3.F.PL+PRF+1+SG
doidejei-lhe	doidejar+V.ele.DAT.3.SG+PRF+1+SG
doidejei-lhes	doidejar+V.ele.DAT.3.PL+PRF+1+SG
doidejei-me	doidejar+V.eu.AD.1.SG+PRF+1+SG
doidejei-nos	doidejar+nós.AD.1.PL+PRF+1+SG
doidejei-o	doidejar+V.ele.ACC.3.M.SG+PRF+1+SG
doidejei-os	doidejar+V.ele.ACC.3.M.PL+PRF+1+SG
doidejei-te	doidejar+V.tu.AD.2.SG+PRF+1+SG
doidejei-vos	doidejar+V.vós.AD.2.PL+PRF+1+SG
doideje-lhe	doidejar+V.ele.DAT.3.SG+IMP+3+SG
doideje-lhes	doidejar+V.ele.DAT.3.PL+IMP+3+SG
doideje-me	doidejar+V.eu.AD.1.SG+IMP+3+SG
doidejem-lhe	doidejar+V.ele.DAT.3.SG+IMP+3+PL
doidejem-lhes	doidejar+V.ele.DAT.3.PL+IMP+3+PL
doidejem-me	doidejar+V.eu.AD.1.SG+IMP+3+PL
doidejem-na	doidejar+V.ele.ACC.3.F.SG+IMP+3+PL
doidejem-nas	doidejar+V.ele.ACC.3.F.PL+IMP+3+PL
doidejem-no	doidejar+V.ele.ACC.3.M.SG+IMP+3+PL
doidejem-nos	doidejar+V.ele.ACC.3.M.PL+IMP+3+PL
doidejem-nos	doidejar+V.nós.AD.1.PL+IMP+3+PL
doidejemo-la	doidejar+V.ele.ACC.3.F.SG+IMP+1+PL
doidejemo-las	doidejar+V.ele.ACC.3.F.PL+IMP+1+PL
doidejemo-lo	doidejar+V.ele.ACC.3.M.SG+IMP+1+PL
doidejemo-los	doidejar+V.ele.ACC.3.M.PL+IMP+1+PL
doidejemo-nos	doidejar+nós.AD.1.PL+IMP+1+PL
doidejemos-lhe	doidejar+V.ele.DAT.3.SG+IMP+1+PL
doidejemos-lhes	doidejar+V.ele.DAT.3.PL+IMP+1+PL
doidejemos-me	doidejar+V.eu.AD.1.SG+IMP+1+PL
doidejemos-te	doidejar+V.tu.AD.2.SG+IMP+1+PL
doidejemos-vos	doidejar+V.vós.AD.2.PL+IMP+1+PL
doidejem-se	doidejar+V.ele.REFL+IMP+3+PL
doidejem-te	doidejar+V.tu.AD.2.SG+IMP+3+PL
doidejem-vos	doidejar+V.vós.AD.2.PL+IMP+3+PL
doideje-nos	doidejar+nós.AD.1.PL+IMP+3+SG
doideje-o	doidejar+V.ele.ACC.3.M.SG+IMP+3+SG
doideje-os	doidejar+V.ele.ACC.3.M.PL+IMP+3+SG
doideje-se	doidejar+V.ele.REFL+IMP+3+SG
doideje-te	doidejar+V.tu.AD.2.SG+IMP+3+SG
doideje-vos	doidejar+V.vós.AD.2.PL+IMP+3+SG
doidejo-a	doidejar+V.ele.ACC.3.F.SG+PRS+1+SG
doidejo-as	doidejar+V.ele.ACC.3.F.PL+PRS+1+SG
doidejo-lhe	doidejar+V.ele.DAT.3.SG+PRS+1+SG
doidejo-lhes	doidejar+V.ele.DAT.3.PL+PRS+1+SG
doidejo-me	doidejar+V.eu.AD.1.SG+PRS+1+SG
doidejo-nos	doidejar+nós.AD.1.PL+PRS+1+SG
doidejo-o	doidejar+V.ele.ACC.3.M.SG+PRS+1+SG
doidejo-os	doidejar+V.ele.ACC.3.M.PL+PRS+1+SG
doidejo-te	doidejar+V.tu.AD.2.SG+PRS+1+SG
doidejou-a	doidejar+V.ele.ACC.3.F.SG+PRF+3+SG
doidejou-as	doidejar+V.ele.ACC.3.F.PL+PRF+3+SG
doidejou-lhe	doidejar+V.ele.DAT.3.SG+PRF+3+SG
doidejou-lhes	doidejar+V.ele.DAT.3.PL+PRF+3+SG
doidejou-me	doidejar+V.eu.AD.1.SG+PRF+3+SG
doidejou-nos	doidejar+nós.AD.1.PL+PRF+3+SG
doidejou-o	doidejar+V.ele.ACC.3.M.SG+PRF+3+SG
doidejou-os	doidejar+V.ele.ACC.3.M.PL+PRF+3+SG
doidejou-se	doidejar+V.ele.REFL+PRF+3+SG
doidejou-te	doidejar+V.tu.AD.2.SG+PRF+3+SG
doidejou-vos	doidejar+V.vós.AD.2.PL+PRF+3+SG
doidejo-vos	doidejar+V.vós.AD.2.PL+PRS+1+SG
doidivana-a	doidivanar+V.ele.ACC.3.F.SG+PRS+3+SG
doidivana-as	doidivanar+V.ele.ACC.3.F.PL+PRS+3+SG
doidivanai-la	doidivanar+V.ele.ACC.3.F.SG+PRS+2+PL
doidivanai-las	doidivanar+V.ele.ACC.3.F.PL+PRS+2+PL
doidivanai-lo	doidivanar+V.ele.ACC.3.M.SG+PRS+2+PL
doidivanai-los	doidivanar+V.ele.ACC.3.M.PL+PRS+2+PL
doidivanai-nos	doidivanar+nós.AD.1.PL+PRS+2+PL
doidivanais-lhe	doidivanar+V.ele.DAT.3.SG+PRS+2+PL
doidivanais-lhes	doidivanar+V.ele.DAT.3.PL+PRS+2+PL
doidivanais-me	doidivanar+V.eu.AD.1.SG+PRS+2+PL
doidivanais-te	doidivanar+V.tu.AD.2.SG+PRS+2+PL
doidivanais-vos	doidivanar+V.vós.AD.2.PL+PRS+2+PL
doidivaná-la-á	doidivanar+V.ele.ACC.3.F.SG+FUT+3+SG
doidivaná-la-ão	doidivanar+V.ele.ACC.3.F.SG+FUT+3+PL
doidivaná-la-ás	doidivanar+V.ele.ACC.3.F.SG+FUT+2+SG
doidivaná-la	doidivanar+V.ele.ACC.3.F.SG+INF+1+SG
doidivaná-la	doidivanar+V.ele.ACC.3.F.SG+INF+3+SG
doidivana-la	doidivanar+V.ele.ACC.3.F.SG+PRS+2+SG
doidivaná-la	doidivanar+V.ele.ACC.3.F.SG+SBJF+1+SG
doidivaná-la	doidivanar+V.ele.ACC.3.F.SG+SBJF+3+SG
doidivaná-la-ei	doidivanar+V.ele.ACC.3.F.SG+FUT+1+SG
doidivaná-la-eis	doidivanar+V.ele.ACC.3.F.SG+FUT+2+PL
doidivaná-la-emos	doidivanar+V.ele.ACC.3.F.SG+FUT+1+PL
doidivaná-la-ia	doidivanar+V.ele.ACC.3.F.SG+COND+1+SG
doidivaná-la-ia	doidivanar+V.ele.ACC.3.F.SG+COND+3+SG
doidivaná-la-iam	doidivanar+V.ele.ACC.3.F.SG+COND+3+PL
doidivaná-la-íamos	doidivanar+V.ele.ACC.3.F.SG+COND+1+PL
doidivaná-la-ias	doidivanar+V.ele.ACC.3.F.SG+COND+2+SG
doidivaná-la-íeis	doidivanar+V.ele.ACC.3.F.SG+COND+2+PL
doidivaná-las-á	doidivanar+V.ele.ACC.3.F.PL+FUT+3+SG
doidivaná-las-ão	doidivanar+V.ele.ACC.3.F.PL+FUT+3+PL
doidivaná-las-ás	doidivanar+V.ele.ACC.3.F.PL+FUT+2+SG
doidivaná-las	doidivanar+V.ele.ACC.3.F.PL+INF+1+SG
doidivaná-las	doidivanar+V.ele.ACC.3.F.PL+INF+3+SG
doidivana-las	doidivanar+V.ele.ACC.3.F.PL+PRS+2+SG
doidivaná-las	doidivanar+V.ele.ACC.3.F.PL+SBJF+1+SG
doidivaná-las	doidivanar+V.ele.ACC.3.F.PL+SBJF+3+SG
doidivaná-las-ei	doidivanar+V.ele.ACC.3.F.PL+FUT+1+SG
doidivaná-las-eis	doidivanar+V.ele.ACC.3.F.PL+FUT+2+PL
doidivaná-las-emos	doidivanar+V.ele.ACC.3.F.PL+FUT+1+PL
doidivaná-las-ia	doidivanar+V.ele.ACC.3.F.PL+COND+1+SG
doidivaná-las-ia	doidivanar+V.ele.ACC.3.F.PL+COND+3+SG
doidivaná-las-iam	doidivanar+V.ele.ACC.3.F.PL+COND+3+PL
doidivaná-las-íamos	doidivanar+V.ele.ACC.3.F.PL+COND+1+PL
doidivaná-las-ias	doidivanar+V.ele.ACC.3.F.PL+COND+2+SG
doidivaná-las-íeis	doidivanar+V.ele.ACC.3.F.PL+COND+2+PL
doidivana-lhe	doidivanar+V.ele.DAT.3.SG+PRS+3+SG
doidivana-lhes	doidivanar+V.ele.DAT.3.PL+PRS+3+SG
doidivaná-lo-á	doidivanar+V.ele.ACC.3.M.SG+FUT+3+SG
doidivaná-lo-ão	doidivanar+V.ele.ACC.3.M.SG+FUT+3+PL
doidivaná-lo-ás	doidivanar+V.ele.ACC.3.M.SG+FUT+2+SG
doidivaná-lo	doidivanar+V.ele.ACC.3.M.SG+INF+1+SG
doidivaná-lo	doidivanar+V.ele.ACC.3.M.SG+INF+3+SG
doidivana-lo	doidivanar+V.ele.ACC.3.M.SG+PRS+2+SG
doidivaná-lo	doidivanar+V.ele.ACC.3.M.SG+SBJF+1+SG
doidivaná-lo	doidivanar+V.ele.ACC.3.M.SG+SBJF+3+SG
doidivaná-lo-ei	doidivanar+V.ele.ACC.3.M.SG+FUT+1+SG
doidivaná-lo-eis	doidivanar+V.ele.ACC.3.M.SG+FUT+2+PL
doidivaná-lo-emos	doidivanar+V.ele.ACC.3.M.SG+FUT+1+PL
doidivaná-lo-ia	doidivanar+V.ele.ACC.3.M.SG+COND+1+SG
doidivaná-lo-ia	doidivanar+V.ele.ACC.3.M.SG+COND+3+SG
doidivaná-lo-iam	doidivanar+V.ele.ACC.3.M.SG+COND+3+PL
doidivaná-lo-íamos	doidivanar+V.ele.ACC.3.M.SG+COND+1+PL
doidivaná-lo-ias	doidivanar+V.ele.ACC.3.M.SG+COND+2+SG
doidivaná-lo-íeis	doidivanar+V.ele.ACC.3.M.SG+COND+2+PL
doidivaná-los-á	doidivanar+V.ele.ACC.3.M.PL+FUT+3+SG
doidivaná-los-ão	doidivanar+V.ele.ACC.3.M.PL+FUT+3+PL
doidivaná-los-ás	doidivanar+V.ele.ACC.3.M.PL+FUT+2+SG
doidivaná-los	doidivanar+V.ele.ACC.3.M.PL+INF+1+SG
doidivaná-los	doidivanar+V.ele.ACC.3.M.PL+INF+3+SG
doidivana-los	doidivanar+V.ele.ACC.3.M.PL+PRS+2+SG
doidivaná-los	doidivanar+V.ele.ACC.3.M.PL+SBJF+1+SG
doidivaná-los	doidivanar+V.ele.ACC.3.M.PL+SBJF+3+SG
doidivaná-los-ei	doidivanar+V.ele.ACC.3.M.PL+FUT+1+SG
doidivaná-los-eis	doidivanar+V.ele.ACC.3.M.PL+FUT+2+PL
doidivaná-los-emos	doidivanar+V.ele.ACC.3.M.PL+FUT+1+PL
doidivaná-los-ia	doidivanar+V.ele.ACC.3.M.PL+COND+1+SG
doidivaná-los-ia	doidivanar+V.ele.ACC.3.M.PL+COND+3+SG
doidivaná-los-iam	doidivanar+V.ele.ACC.3.M.PL+COND+3+PL
doidivaná-los-íamos	doidivanar+V.ele.ACC.3.M.PL+COND+1+PL
doidivaná-los-ias	doidivanar+V.ele.ACC.3.M.PL+COND+2+SG
doidivaná-los-íeis	doidivanar+V.ele.ACC.3.M.PL+COND+2+PL
doidivana-me	doidivanar+V.eu.AD.1.SG+PRS+3+SG
doidivanam-lhe	doidivanar+V.ele.DAT.3.SG+PRS+3+PL
doidivanam-lhes	doidivanar+V.ele.DAT.3.PL+PRS+3+PL
doidivanam-me	doidivanar+V.eu.AD.1.SG+PRS+3+PL
doidivanam-na	doidivanar+V.ele.ACC.3.F.SG+PRS+3+PL
doidivanam-nas	doidivanar+V.ele.ACC.3.F.PL+PRS+3+PL
doidivanam-no	doidivanar+V.ele.ACC.3.M.SG+PRS+3+PL
doidivanam-nos	doidivanar+V.ele.ACC.3.M.PL+PRS+3+PL
doidivanam-nos	doidivanar+V.nós.AD.1.PL+PRS+3+PL
doidivanamo-la	doidivanar+V.ele.ACC.3.F.SG+PRF+1+PL
doidivanamo-la	doidivanar+V.ele.ACC.3.F.SG+PRS+1+PL
doidivanamo-las	doidivanar+V.ele.ACC.3.F.PL+PRF+1+PL
doidivanamo-las	doidivanar+V.ele.ACC.3.F.PL+PRS+1+PL
doidivanamo-lo	doidivanar+V.ele.ACC.3.M.SG+PRF+1+PL
doidivanamo-lo	doidivanar+V.ele.ACC.3.M.SG+PRS+1+PL
doidivanamo-los	doidivanar+V.ele.ACC.3.M.PL+PRF+1+PL
doidivanamo-los	doidivanar+V.ele.ACC.3.M.PL+PRS+1+PL
doidivanamo-nos	doidivanar+nós.AD.1.PL+PRF+1+PL
doidivanamo-nos	doidivanar+nós.AD.1.PL+PRS+1+PL
doidivanamos-lhe	doidivanar+V.ele.DAT.3.SG+PRF+1+PL
doidivanamos-lhe	doidivanar+V.ele.DAT.3.SG+PRS+1+PL
doidivanamos-lhes	doidivanar+V.ele.DAT.3.PL+PRF+1+PL
doidivanamos-lhes	doidivanar+V.ele.DAT.3.PL+PRS+1+PL
doidivanamos-me	doidivanar+V.eu.AD.1.SG+PRF+1+PL
doidivanamos-me	doidivanar+V.eu.AD.1.SG+PRS+1+PL
doidivanamos-te	doidivanar+V.tu.AD.2.SG+PRF+1+PL
doidivanamos-te	doidivanar+V.tu.AD.2.SG+PRS+1+PL
doidivanamos-vos	doidivanar+V.vós.AD.2.PL+PRF+1+PL
doidivanamos-vos	doidivanar+V.vós.AD.2.PL+PRS+1+PL
doidivanam-se	doidivanar+V.ele.REFL+PRS+3+PL
doidivanam-te	doidivanar+V.tu.AD.2.SG+PRS+3+PL
doidivanam-vos	doidivanar+V.vós.AD.2.PL+PRS+3+PL
doidivanando-a	doidivanar+V.ele.ACC.3.F.SG+GRD
doidivanando-as	doidivanar+V.ele.ACC.3.F.PL+GRD
doidivanando-lhe	doidivanar+V.ele.DAT.3.SG+GRD
doidivanando-lhes	doidivanar+V.ele.DAT.3.PL+GRD
doidivanando-me	doidivanar+V.eu.AD.1.SG+GRD
doidivanando-nos	doidivanar+nós.AD.1.PL+GRD
doidivanando-o	doidivanar+V.ele.ACC.3.M.SG+GRD
doidivanando-os	doidivanar+V.ele.ACC.3.M.PL+GRD
doidivanando-se	doidivanar+V.ele.REFL+GRD
doidivanando-te	doidivanar+V.tu.AD.2.SG+GRD
doidivanando-vos	doidivanar+V.vós.AD.2.PL+GRD
doidivana-nos	doidivanar+nós.AD.1.PL+PRS+2+SG
doidivana-nos	doidivanar+nós.AD.1.PL+PRS+3+SG
doidivana-o	doidivanar+V.ele.ACC.3.M.SG+PRS+3+SG
doidivana-os	doidivanar+V.ele.ACC.3.M.PL+PRS+3+SG
doidivanara-a	doidivanar+V.ele.ACC.3.F.SG+PQP+1+SG
doidivanara-a	doidivanar+V.ele.ACC.3.F.SG+PQP+3+SG
doidivanara-as	doidivanar+V.ele.ACC.3.F.PL+PQP+1+SG
