enceleirar-vos-ás	enceleirar+V.vós.AD.2.PL+FUT+2+SG
enceleirar-vos-ei	enceleirar+V.vós.AD.2.PL+FUT+1+SG
enceleirar-vos-eis	enceleirar+V.vós.AD.2.PL+FUT+2+PL
enceleirar-vos-emos	enceleirar+V.vós.AD.2.PL+FUT+1+PL
enceleirar-vos	enceleirar+V.vós.AD.2.PL+INF
enceleirar-vos	enceleirar+V.vós.AD.2.PL+INF+1+SG
enceleirar-vos	enceleirar+V.vós.AD.2.PL+INF+3+SG
enceleirar-vos	enceleirar+V.vós.AD.2.PL+SBJF+1+SG
enceleirar-vos	enceleirar+V.vós.AD.2.PL+SBJF+3+SG
enceleirar-vos-ia	enceleirar+V.vós.AD.2.PL+COND+1+SG
enceleirar-vos-ia	enceleirar+V.vós.AD.2.PL+COND+3+SG
enceleirar-vos-iam	enceleirar+V.vós.AD.2.PL+COND+3+PL
enceleirar-vos-íamos	enceleirar+V.vós.AD.2.PL+COND+1+PL
enceleirar-vos-ias	enceleirar+V.vós.AD.2.PL+COND+2+SG
enceleirar-vos-íeis	enceleirar+V.vós.AD.2.PL+COND+2+PL
enceleira-se	enceleirar+V.ele.REFL+PRS+3+SG
enceleiras-lhe	enceleirar+V.ele.DAT.3.SG+PRS+2+SG
enceleiras-lhes	enceleirar+V.ele.DAT.3.PL+PRS+2+SG
enceleiras-me	enceleirar+V.eu.AD.1.SG+PRS+2+SG
enceleiraste-a	enceleirar+V.ele.ACC.3.F.SG+PRF+2+SG
enceleiraste-as	enceleirar+V.ele.ACC.3.F.PL+PRF+2+SG
enceleiras-te	enceleirar+V.tu.AD.2.SG+PRS+2+SG
enceleiraste-la	enceleirar+V.ele.ACC.3.F.SG+PRF+2+PL
enceleiraste-las	enceleirar+V.ele.ACC.3.F.PL+PRF+2+PL
enceleiraste-lhe	enceleirar+V.ele.DAT.3.SG+PRF+2+SG
enceleiraste-lhes	enceleirar+V.ele.DAT.3.PL+PRF+2+SG
enceleiraste-lo	enceleirar+V.ele.ACC.3.M.SG+PRF+2+PL
enceleiraste-los	enceleirar+V.ele.ACC.3.M.PL+PRF+2+PL
enceleiraste-me	enceleirar+V.eu.AD.1.SG+PRF+2+SG
enceleiraste-nos	enceleirar+nós.AD.1.PL+PRF+2+PL
enceleiraste-nos	enceleirar+nós.AD.1.PL+PRF+2+SG
enceleiraste-o	enceleirar+V.ele.ACC.3.M.SG+PRF+2+SG
enceleiraste-os	enceleirar+V.ele.ACC.3.M.PL+PRF+2+SG
enceleirastes-lhe	enceleirar+V.ele.DAT.3.SG+PRF+2+PL
enceleirastes-lhes	enceleirar+V.ele.DAT.3.PL+PRF+2+PL
enceleirastes-me	enceleirar+V.eu.AD.1.SG+PRF+2+PL
enceleirastes-te	enceleirar+V.tu.AD.2.SG+PRF+2+PL
enceleirastes-vos	enceleirar+V.vós.AD.2.PL+PRF+2+PL
enceleiraste-te	enceleirar+V.tu.AD.2.SG+PRF+2+SG
enceleiraste-vos	enceleirar+V.vós.AD.2.PL+PRF+2+SG
enceleiras-vos	enceleirar+V.vós.AD.2.PL+PRS+2+SG
enceleira-te	enceleirar+V.tu.AD.2.SG+PRS+3+SG
enceleirava-a	enceleirar+V.ele.ACC.3.F.SG+IMPF+1+SG
enceleirava-a	enceleirar+V.ele.ACC.3.F.SG+IMPF+3+SG
enceleirava-as	enceleirar+V.ele.ACC.3.F.PL+IMPF+1+SG
enceleirava-as	enceleirar+V.ele.ACC.3.F.PL+IMPF+3+SG
enceleirava-la	enceleirar+V.ele.ACC.3.F.SG+IMPF+2+SG
enceleirava-las	enceleirar+V.ele.ACC.3.F.PL+IMPF+2+SG
enceleirava-lhe	enceleirar+V.ele.DAT.3.SG+IMPF+1+SG
enceleirava-lhe	enceleirar+V.ele.DAT.3.SG+IMPF+3+SG
enceleirava-lhes	enceleirar+V.ele.DAT.3.PL+IMPF+1+SG
enceleirava-lhes	enceleirar+V.ele.DAT.3.PL+IMPF+3+SG
enceleirava-lo	enceleirar+V.ele.ACC.3.M.SG+IMPF+2+SG
enceleirava-los	enceleirar+V.ele.ACC.3.M.PL+IMPF+2+SG
enceleirava-me	enceleirar+V.eu.AD.1.SG+IMPF+1+SG
enceleirava-me	enceleirar+V.eu.AD.1.SG+IMPF+3+SG
enceleiravam-lhe	enceleirar+V.ele.DAT.3.SG+IMPF+3+PL
enceleiravam-lhes	enceleirar+V.ele.DAT.3.PL+IMPF+3+PL
enceleiravam-me	enceleirar+V.eu.AD.1.SG+IMPF+3+PL
enceleiravam-na	enceleirar+V.ele.ACC.3.F.SG+IMPF+3+PL
enceleiravam-nas	enceleirar+V.ele.ACC.3.F.PL+IMPF+3+PL
enceleiravam-no	enceleirar+V.ele.ACC.3.M.SG+IMPF+3+PL
enceleiravam-nos	enceleirar+V.ele.ACC.3.M.PL+IMPF+3+PL
enceleiravam-nos	enceleirar+V.nós.AD.1.PL+IMPF+3+PL
enceleirávamo-la	enceleirar+V.ele.ACC.3.F.SG+IMPF+1+PL
enceleirávamo-las	enceleirar+V.ele.ACC.3.F.PL+IMPF+1+PL
enceleirávamo-lo	enceleirar+V.ele.ACC.3.M.SG+IMPF+1+PL
enceleirávamo-los	enceleirar+V.ele.ACC.3.M.PL+IMPF+1+PL
enceleirávamo-nos	enceleirar+nós.AD.1.PL+IMPF+1+PL
enceleirávamos-lhe	enceleirar+V.ele.DAT.3.SG+IMPF+1+PL
enceleirávamos-lhes	enceleirar+V.ele.DAT.3.PL+IMPF+1+PL
enceleirávamos-me	enceleirar+V.eu.AD.1.SG+IMPF+1+PL
enceleirávamos-te	enceleirar+V.tu.AD.2.SG+IMPF+1+PL
enceleirávamos-vos	enceleirar+V.vós.AD.2.PL+IMPF+1+PL
enceleiravam-se	enceleirar+V.ele.REFL+IMPF+3+PL
enceleiravam-te	enceleirar+V.tu.AD.2.SG+IMPF+3+PL
enceleiravam-vos	enceleirar+V.vós.AD.2.PL+IMPF+3+PL
enceleirava-nos	enceleirar+nós.AD.1.PL+IMPF+1+SG
enceleirava-nos	enceleirar+nós.AD.1.PL+IMPF+2+SG
enceleirava-nos	enceleirar+nós.AD.1.PL+IMPF+3+SG
enceleirava-o	enceleirar+V.ele.ACC.3.M.SG+IMPF+1+SG
enceleirava-o	enceleirar+V.ele.ACC.3.M.SG+IMPF+3+SG
enceleirava-os	enceleirar+V.ele.ACC.3.M.PL+IMPF+1+SG
enceleirava-os	enceleirar+V.ele.ACC.3.M.PL+IMPF+3+SG
enceleirava-se	enceleirar+V.ele.REFL+IMPF+1+SG
enceleirava-se	enceleirar+V.ele.REFL+IMPF+3+SG
enceleiravas-lhe	enceleirar+V.ele.DAT.3.SG+IMPF+2+SG
enceleiravas-lhes	enceleirar+V.ele.DAT.3.PL+IMPF+2+SG
enceleiravas-me	enceleirar+V.eu.AD.1.SG+IMPF+2+SG
enceleiravas-te	enceleirar+V.tu.AD.2.SG+IMPF+2+SG
enceleiravas-vos	enceleirar+V.vós.AD.2.PL+IMPF+2+SG
enceleirava-te	enceleirar+V.tu.AD.2.SG+IMPF+1+SG
enceleirava-te	enceleirar+V.tu.AD.2.SG+IMPF+3+SG
enceleirava-vos	enceleirar+V.vós.AD.2.PL+IMPF+1+SG
enceleirava-vos	enceleirar+V.vós.AD.2.PL+IMPF+3+SG
enceleirávei-la	enceleirar+V.ele.ACC.3.F.SG+IMPF+2+PL
enceleirávei-las	enceleirar+V.ele.ACC.3.F.PL+IMPF+2+PL
enceleirávei-lo	enceleirar+V.ele.ACC.3.M.SG+IMPF+2+PL
enceleirávei-los	enceleirar+V.ele.ACC.3.M.PL+IMPF+2+PL
enceleirávei-nos	enceleirar+nós.AD.1.PL+IMPF+2+PL
enceleiráveis-lhe	enceleirar+V.ele.DAT.3.SG+IMPF+2+PL
enceleiráveis-lhes	enceleirar+V.ele.DAT.3.PL+IMPF+2+PL
enceleiráveis-me	enceleirar+V.eu.AD.1.SG+IMPF+2+PL
enceleiráveis-te	enceleirar+V.tu.AD.2.SG+IMPF+2+PL
enceleiráveis-vos	enceleirar+V.vós.AD.2.PL+IMPF+2+PL
enceleira-vos	enceleirar+V.vós.AD.2.PL+PRS+3+SG
enceleire-a	enceleirar+V.ele.ACC.3.F.SG+IMP+3+SG
enceleire-as	enceleirar+V.ele.ACC.3.F.PL+IMP+3+SG
enceleirei-a	enceleirar+V.ele.ACC.3.F.SG+PRF+1+SG
enceleirei-as	enceleirar+V.ele.ACC.3.F.PL+PRF+1+SG
enceleirei-lhe	enceleirar+V.ele.DAT.3.SG+PRF+1+SG
enceleirei-lhes	enceleirar+V.ele.DAT.3.PL+PRF+1+SG
enceleirei-me	enceleirar+V.eu.AD.1.SG+PRF+1+SG
enceleirei-nos	enceleirar+nós.AD.1.PL+PRF+1+SG
enceleirei-o	enceleirar+V.ele.ACC.3.M.SG+PRF+1+SG
enceleirei-os	enceleirar+V.ele.ACC.3.M.PL+PRF+1+SG
enceleirei-te	enceleirar+V.tu.AD.2.SG+PRF+1+SG
enceleirei-vos	enceleirar+V.vós.AD.2.PL+PRF+1+SG
enceleire-lhe	enceleirar+V.ele.DAT.3.SG+IMP+3+SG
enceleire-lhes	enceleirar+V.ele.DAT.3.PL+IMP+3+SG
enceleire-me	enceleirar+V.eu.AD.1.SG+IMP+3+SG
enceleirem-lhe	enceleirar+V.ele.DAT.3.SG+IMP+3+PL
enceleirem-lhes	enceleirar+V.ele.DAT.3.PL+IMP+3+PL
enceleirem-me	enceleirar+V.eu.AD.1.SG+IMP+3+PL
enceleirem-na	enceleirar+V.ele.ACC.3.F.SG+IMP+3+PL
enceleirem-nas	enceleirar+V.ele.ACC.3.F.PL+IMP+3+PL
enceleirem-no	enceleirar+V.ele.ACC.3.M.SG+IMP+3+PL
enceleirem-nos	enceleirar+V.ele.ACC.3.M.PL+IMP+3+PL
enceleirem-nos	enceleirar+V.nós.AD.1.PL+IMP+3+PL
enceleiremo-la	enceleirar+V.ele.ACC.3.F.SG+IMP+1+PL
enceleiremo-las	enceleirar+V.ele.ACC.3.F.PL+IMP+1+PL
enceleiremo-lo	enceleirar+V.ele.ACC.3.M.SG+IMP+1+PL
enceleiremo-los	enceleirar+V.ele.ACC.3.M.PL+IMP+1+PL
enceleiremo-nos	enceleirar+nós.AD.1.PL+IMP+1+PL
enceleiremos-lhe	enceleirar+V.ele.DAT.3.SG+IMP+1+PL
enceleiremos-lhes	enceleirar+V.ele.DAT.3.PL+IMP+1+PL
enceleiremos-me	enceleirar+V.eu.AD.1.SG+IMP+1+PL
enceleiremos-te	enceleirar+V.tu.AD.2.SG+IMP+1+PL
enceleiremos-vos	enceleirar+V.vós.AD.2.PL+IMP+1+PL
enceleirem-se	enceleirar+V.ele.REFL+IMP+3+PL
enceleirem-te	enceleirar+V.tu.AD.2.SG+IMP+3+PL
enceleirem-vos	enceleirar+V.vós.AD.2.PL+IMP+3+PL
enceleire-nos	enceleirar+nós.AD.1.PL+IMP+3+SG
enceleire-o	enceleirar+V.ele.ACC.3.M.SG+IMP+3+SG
enceleire-os	enceleirar+V.ele.ACC.3.M.PL+IMP+3+SG
enceleire-se	enceleirar+V.ele.REFL+IMP+3+SG
enceleire-te	enceleirar+V.tu.AD.2.SG+IMP+3+SG
enceleire-vos	enceleirar+V.vós.AD.2.PL+IMP+3+SG
enceleiro-a	enceleirar+V.ele.ACC.3.F.SG+PRS+1+SG
enceleiro-as	enceleirar+V.ele.ACC.3.F.PL+PRS+1+SG
enceleiro-lhe	enceleirar+V.ele.DAT.3.SG+PRS+1+SG
enceleiro-lhes	enceleirar+V.ele.DAT.3.PL+PRS+1+SG
enceleiro-me	enceleirar+V.eu.AD.1.SG+PRS+1+SG
enceleiro-nos	enceleirar+nós.AD.1.PL+PRS+1+SG
enceleiro-o	enceleirar+V.ele.ACC.3.M.SG+PRS+1+SG
enceleiro-os	enceleirar+V.ele.ACC.3.M.PL+PRS+1+SG
enceleiro-te	enceleirar+V.tu.AD.2.SG+PRS+1+SG
enceleirou-a	enceleirar+V.ele.ACC.3.F.SG+PRF+3+SG
enceleirou-as	enceleirar+V.ele.ACC.3.F.PL+PRF+3+SG
enceleirou-lhe	enceleirar+V.ele.DAT.3.SG+PRF+3+SG
enceleirou-lhes	enceleirar+V.ele.DAT.3.PL+PRF+3+SG
enceleirou-me	enceleirar+V.eu.AD.1.SG+PRF+3+SG
enceleirou-nos	enceleirar+nós.AD.1.PL+PRF+3+SG
enceleirou-o	enceleirar+V.ele.ACC.3.M.SG+PRF+3+SG
enceleirou-os	enceleirar+V.ele.ACC.3.M.PL+PRF+3+SG
enceleirou-se	enceleirar+V.ele.REFL+PRF+3+SG
enceleirou-te	enceleirar+V.tu.AD.2.SG+PRF+3+SG
enceleirou-vos	enceleirar+V.vós.AD.2.PL+PRF+3+SG
enceleiro-vos	enceleirar+V.vós.AD.2.PL+PRS+1+SG
encelei-te	encelar+V.tu.AD.2.SG+PRF+1+SG
encelei-vos	encelar+V.vós.AD.2.PL+PRF+1+SG
encele-lhe	encelar+V.ele.DAT.3.SG+IMP+3+SG
encele-lhes	encelar+V.ele.DAT.3.PL+IMP+3+SG
encele-me	encelar+V.eu.AD.1.SG+IMP+3+SG
encelem-lhe	encelar+V.ele.DAT.3.SG+IMP+3+PL
encelem-lhes	encelar+V.ele.DAT.3.PL+IMP+3+PL
encelem-me	encelar+V.eu.AD.1.SG+IMP+3+PL
encelem-na	encelar+V.ele.ACC.3.F.SG+IMP+3+PL
encelem-nas	encelar+V.ele.ACC.3.F.PL+IMP+3+PL
encelem-no	encelar+V.ele.ACC.3.M.SG+IMP+3+PL
encelem-nos	encelar+V.ele.ACC.3.M.PL+IMP+3+PL
encelem-nos	encelar+V.nós.AD.1.PL+IMP+3+PL
encelemo-la	encelar+V.ele.ACC.3.F.SG+IMP+1+PL
encelemo-las	encelar+V.ele.ACC.3.F.PL+IMP+1+PL
encelemo-lo	encelar+V.ele.ACC.3.M.SG+IMP+1+PL
encelemo-los	encelar+V.ele.ACC.3.M.PL+IMP+1+PL
encelemo-nos	encelar+nós.AD.1.PL+IMP+1+PL
encelemos-lhe	encelar+V.ele.DAT.3.SG+IMP+1+PL
encelemos-lhes	encelar+V.ele.DAT.3.PL+IMP+1+PL
encelemos-me	encelar+V.eu.AD.1.SG+IMP+1+PL
encelemos-te	encelar+V.tu.AD.2.SG+IMP+1+PL
encelemos-vos	encelar+V.vós.AD.2.PL+IMP+1+PL
encelem-se	encelar+V.ele.REFL+IMP+3+PL
encelem-te	encelar+V.tu.AD.2.SG+IMP+3+PL
encelem-vos	encelar+V.vós.AD.2.PL+IMP+3+PL
encele-nos	encelar+nós.AD.1.PL+IMP+3+SG
encele-o	encelar+V.ele.ACC.3.M.SG+IMP+3+SG
encele-os	encelar+V.ele.ACC.3.M.PL+IMP+3+SG
encele-se	encelar+V.ele.REFL+IMP+3+SG
encele-te	encelar+V.tu.AD.2.SG+IMP+3+SG
encele-vos	encelar+V.vós.AD.2.PL+IMP+3+SG
encelo-a	encelar+V.ele.ACC.3.F.SG+PRS+1+SG
encelo-as	encelar+V.ele.ACC.3.F.PL+PRS+1+SG
encelo-lhe	encelar+V.ele.DAT.3.SG+PRS+1+SG
encelo-lhes	encelar+V.ele.DAT.3.PL+PRS+1+SG
encelo-me	encelar+V.eu.AD.1.SG+PRS+1+SG
encelo-nos	encelar+nós.AD.1.PL+PRS+1+SG
encelo-o	encelar+V.ele.ACC.3.M.SG+PRS+1+SG
encelo-os	encelar+V.ele.ACC.3.M.PL+PRS+1+SG
encelo-te	encelar+V.tu.AD.2.SG+PRS+1+SG
encelou-a	encelar+V.ele.ACC.3.F.SG+PRF+3+SG
encelou-as	encelar+V.ele.ACC.3.F.PL+PRF+3+SG
encelou-lhe	encelar+V.ele.DAT.3.SG+PRF+3+SG
encelou-lhes	encelar+V.ele.DAT.3.PL+PRF+3+SG
encelou-me	encelar+V.eu.AD.1.SG+PRF+3+SG
encelou-nos	encelar+nós.AD.1.PL+PRF+3+SG
encelou-o	encelar+V.ele.ACC.3.M.SG+PRF+3+SG
encelou-os	encelar+V.ele.ACC.3.M.PL+PRF+3+SG
encelou-se	encelar+V.ele.REFL+PRF+3+SG
encelou-te	encelar+V.tu.AD.2.SG+PRF+3+SG
encelou-vos	encelar+V.vós.AD.2.PL+PRF+3+SG
encelo-vos	encelar+V.vós.AD.2.PL+PRS+1+SG
encena-a	encenar+V.ele.ACC.3.F.SG+PRS+3+SG
encena-as	encenar+V.ele.ACC.3.F.PL+PRS+3+SG
encenai-la	encenar+V.ele.ACC.3.F.SG+PRS+2+PL
encenai-las	encenar+V.ele.ACC.3.F.PL+PRS+2+PL
encenai-lo	encenar+V.ele.ACC.3.M.SG+PRS+2+PL
encenai-los	encenar+V.ele.ACC.3.M.PL+PRS+2+PL
encenai-nos	encenar+nós.AD.1.PL+PRS+2+PL
encenais-lhe	encenar+V.ele.DAT.3.SG+PRS+2+PL
encenais-lhes	encenar+V.ele.DAT.3.PL+PRS+2+PL
encenais-me	encenar+V.eu.AD.1.SG+PRS+2+PL
encenais-te	encenar+V.tu.AD.2.SG+PRS+2+PL
encenais-vos	encenar+V.vós.AD.2.PL+PRS+2+PL
encená-la-á	encenar+V.ele.ACC.3.F.SG+FUT+3+SG
encená-la-ão	encenar+V.ele.ACC.3.F.SG+FUT+3+PL
encená-la-ás	encenar+V.ele.ACC.3.F.SG+FUT+2+SG
encená-la-ei	encenar+V.ele.ACC.3.F.SG+FUT+1+SG
encená-la-eis	encenar+V.ele.ACC.3.F.SG+FUT+2+PL
encená-la-emos	encenar+V.ele.ACC.3.F.SG+FUT+1+PL
encená-la	encenar+V.ele.ACC.3.F.SG+INF+1+SG
encená-la	encenar+V.ele.ACC.3.F.SG+INF+3+SG
encena-la	encenar+V.ele.ACC.3.F.SG+PRS+2+SG
encená-la	encenar+V.ele.ACC.3.F.SG+SBJF+1+SG
encená-la	encenar+V.ele.ACC.3.F.SG+SBJF+3+SG
encená-la-ia	encenar+V.ele.ACC.3.F.SG+COND+1+SG
encená-la-ia	encenar+V.ele.ACC.3.F.SG+COND+3+SG
encená-la-iam	encenar+V.ele.ACC.3.F.SG+COND+3+PL
encená-la-íamos	encenar+V.ele.ACC.3.F.SG+COND+1+PL
encená-la-ias	encenar+V.ele.ACC.3.F.SG+COND+2+SG
encená-la-íeis	encenar+V.ele.ACC.3.F.SG+COND+2+PL
encená-las-á	encenar+V.ele.ACC.3.F.PL+FUT+3+SG
encená-las-ão	encenar+V.ele.ACC.3.F.PL+FUT+3+PL
encená-las-ás	encenar+V.ele.ACC.3.F.PL+FUT+2+SG
encená-las-ei	encenar+V.ele.ACC.3.F.PL+FUT+1+SG
encená-las-eis	encenar+V.ele.ACC.3.F.PL+FUT+2+PL
encená-las-emos	encenar+V.ele.ACC.3.F.PL+FUT+1+PL
encená-las	encenar+V.ele.ACC.3.F.PL+INF+1+SG
encená-las	encenar+V.ele.ACC.3.F.PL+INF+3+SG
encena-las	encenar+V.ele.ACC.3.F.PL+PRS+2+SG
encená-las	encenar+V.ele.ACC.3.F.PL+SBJF+1+SG
encená-las	encenar+V.ele.ACC.3.F.PL+SBJF+3+SG
encená-las-ia	encenar+V.ele.ACC.3.F.PL+COND+1+SG
encená-las-ia	encenar+V.ele.ACC.3.F.PL+COND+3+SG
encená-las-iam	encenar+V.ele.ACC.3.F.PL+COND+3+PL
encená-las-íamos	encenar+V.ele.ACC.3.F.PL+COND+1+PL
encená-las-ias	encenar+V.ele.ACC.3.F.PL+COND+2+SG
encená-las-íeis	encenar+V.ele.ACC.3.F.PL+COND+2+PL
encena-lhe	encenar+V.ele.DAT.3.SG+PRS+3+SG
encena-lhes	encenar+V.ele.DAT.3.PL+PRS+3+SG
encená-lo-á	encenar+V.ele.ACC.3.M.SG+FUT+3+SG
encená-lo-ão	encenar+V.ele.ACC.3.M.SG+FUT+3+PL
encená-lo-ás	encenar+V.ele.ACC.3.M.SG+FUT+2+SG
encená-lo-ei	encenar+V.ele.ACC.3.M.SG+FUT+1+SG
encená-lo-eis	encenar+V.ele.ACC.3.M.SG+FUT+2+PL
encená-lo-emos	encenar+V.ele.ACC.3.M.SG+FUT+1+PL
encená-lo	encenar+V.ele.ACC.3.M.SG+INF+1+SG
encená-lo	encenar+V.ele.ACC.3.M.SG+INF+3+SG
encena-lo	encenar+V.ele.ACC.3.M.SG+PRS+2+SG
encená-lo	encenar+V.ele.ACC.3.M.SG+SBJF+1+SG
encená-lo	encenar+V.ele.ACC.3.M.SG+SBJF+3+SG
encená-lo-ia	encenar+V.ele.ACC.3.M.SG+COND+1+SG
encená-lo-ia	encenar+V.ele.ACC.3.M.SG+COND+3+SG
encená-lo-iam	encenar+V.ele.ACC.3.M.SG+COND+3+PL
encená-lo-íamos	encenar+V.ele.ACC.3.M.SG+COND+1+PL
encená-lo-ias	encenar+V.ele.ACC.3.M.SG+COND+2+SG
encená-lo-íeis	encenar+V.ele.ACC.3.M.SG+COND+2+PL
encená-los-á	encenar+V.ele.ACC.3.M.PL+FUT+3+SG
encená-los-ão	encenar+V.ele.ACC.3.M.PL+FUT+3+PL
encená-los-ás	encenar+V.ele.ACC.3.M.PL+FUT+2+SG
encená-los-ei	encenar+V.ele.ACC.3.M.PL+FUT+1+SG
encená-los-eis	encenar+V.ele.ACC.3.M.PL+FUT+2+PL
encená-los-emos	encenar+V.ele.ACC.3.M.PL+FUT+1+PL
encená-los	encenar+V.ele.ACC.3.M.PL+INF+1+SG
encená-los	encenar+V.ele.ACC.3.M.PL+INF+3+SG
encena-los	encenar+V.ele.ACC.3.M.PL+PRS+2+SG
encená-los	encenar+V.ele.ACC.3.M.PL+SBJF+1+SG
encená-los	encenar+V.ele.ACC.3.M.PL+SBJF+3+SG
encená-los-ia	encenar+V.ele.ACC.3.M.PL+COND+1+SG
encená-los-ia	encenar+V.ele.ACC.3.M.PL+COND+3+SG
encená-los-iam	encenar+V.ele.ACC.3.M.PL+COND+3+PL
encená-los-íamos	encenar+V.ele.ACC.3.M.PL+COND+1+PL
encená-los-ias	encenar+V.ele.ACC.3.M.PL+COND+2+SG
encená-los-íeis	encenar+V.ele.ACC.3.M.PL+COND+2+PL
encena-me	encenar+V.eu.AD.1.SG+PRS+3+SG
encenam-lhe	encenar+V.ele.DAT.3.SG+PRS+3+PL
encenam-lhes	encenar+V.ele.DAT.3.PL+PRS+3+PL
encenam-me	encenar+V.eu.AD.1.SG+PRS+3+PL
encenam-na	encenar+V.ele.ACC.3.F.SG+PRS+3+PL
encenam-nas	encenar+V.ele.ACC.3.F.PL+PRS+3+PL
encenam-no	encenar+V.ele.ACC.3.M.SG+PRS+3+PL
encenam-nos	encenar+V.ele.ACC.3.M.PL+PRS+3+PL
encenam-nos	encenar+V.nós.AD.1.PL+PRS+3+PL
encenamo-la	encenar+V.ele.ACC.3.F.SG+PRF+1+PL
encenamo-la	encenar+V.ele.ACC.3.F.SG+PRS+1+PL
encenamo-las	encenar+V.ele.ACC.3.F.PL+PRF+1+PL
encenamo-las	encenar+V.ele.ACC.3.F.PL+PRS+1+PL
encenamo-lo	encenar+V.ele.ACC.3.M.SG+PRF+1+PL
encenamo-lo	encenar+V.ele.ACC.3.M.SG+PRS+1+PL
encenamo-los	encenar+V.ele.ACC.3.M.PL+PRF+1+PL
encenamo-los	encenar+V.ele.ACC.3.M.PL+PRS+1+PL
encenamo-nos	encenar+nós.AD.1.PL+PRF+1+PL
encenamo-nos	encenar+nós.AD.1.PL+PRS+1+PL
encenamos-lhe	encenar+V.ele.DAT.3.SG+PRF+1+PL
encenamos-lhe	encenar+V.ele.DAT.3.SG+PRS+1+PL
encenamos-lhes	encenar+V.ele.DAT.3.PL+PRF+1+PL
encenamos-lhes	encenar+V.ele.DAT.3.PL+PRS+1+PL
encenamos-me	encenar+V.eu.AD.1.SG+PRF+1+PL
encenamos-me	encenar+V.eu.AD.1.SG+PRS+1+PL
encenamos-te	encenar+V.tu.AD.2.SG+PRF+1+PL
encenamos-te	encenar+V.tu.AD.2.SG+PRS+1+PL
encenamos-vos	encenar+V.vós.AD.2.PL+PRF+1+PL
encenamos-vos	encenar+V.vós.AD.2.PL+PRS+1+PL
encenam-se	encenar+V.ele.REFL+PRS+3+PL
encenam-te	encenar+V.tu.AD.2.SG+PRS+3+PL
encenam-vos	encenar+V.vós.AD.2.PL+PRS+3+PL
encenando-a	encenar+V.ele.ACC.3.F.SG+GRD
encenando-as	encenar+V.ele.ACC.3.F.PL+GRD
encenando-lhe	encenar+V.ele.DAT.3.SG+GRD
encenando-lhes	encenar+V.ele.DAT.3.PL+GRD
encenando-me	encenar+V.eu.AD.1.SG+GRD
encenando-nos	encenar+nós.AD.1.PL+GRD
encenando-o	encenar+V.ele.ACC.3.M.SG+GRD
encenando-os	encenar+V.ele.ACC.3.M.PL+GRD
encenando-se	encenar+V.ele.REFL+GRD
encenando-te	encenar+V.tu.AD.2.SG+GRD
encenando-vos	encenar+V.vós.AD.2.PL+GRD
encena-nos	encenar+nós.AD.1.PL+PRS+2+SG
encena-nos	encenar+nós.AD.1.PL+PRS+3+SG
encena-o	encenar+V.ele.ACC.3.M.SG+PRS+3+SG
encena-os	encenar+V.ele.ACC.3.M.PL+PRS+3+SG
encenara-a	encenar+V.ele.ACC.3.F.SG+PQP+1+SG
encenara-a	encenar+V.ele.ACC.3.F.SG+PQP+3+SG
encenara-as	encenar+V.ele.ACC.3.F.PL+PQP+1+SG
encenara-as	encenar+V.ele.ACC.3.F.PL+PQP+3+SG
encenara-la	encenar+V.ele.ACC.3.F.SG+PQP+2+SG
encenara-las	encenar+V.ele.ACC.3.F.PL+PQP+2+SG
encenara-lhe	encenar+V.ele.DAT.3.SG+PQP+1+SG
encenara-lhe	encenar+V.ele.DAT.3.SG+PQP+3+SG
encenara-lhes	encenar+V.ele.DAT.3.PL+PQP+1+SG
encenara-lhes	encenar+V.ele.DAT.3.PL+PQP+3+SG
encenara-lo	encenar+V.ele.ACC.3.M.SG+PQP+2+SG
encenara-los	encenar+V.ele.ACC.3.M.PL+PQP+2+SG
encenara-me	encenar+V.eu.AD.1.SG+PQP+1+SG
encenara-me	encenar+V.eu.AD.1.SG+PQP+3+SG
encenaram-lhe	encenar+V.ele.DAT.3.SG+PQP+3+PL
encenaram-lhe	encenar+V.ele.DAT.3.SG+PRF+3+PL
encenaram-lhes	encenar+V.ele.DAT.3.PL+PQP+3+PL
encenaram-lhes	encenar+V.ele.DAT.3.PL+PRF+3+PL
encenaram-me	encenar+V.eu.AD.1.SG+PQP+3+PL
encenaram-me	encenar+V.eu.AD.1.SG+PRF+3+PL
encenaram-na	encenar+V.ele.ACC.3.F.SG+PQP+3+PL
encenaram-na	encenar+V.ele.ACC.3.F.SG+PRF+3+PL
encenaram-nas	encenar+V.ele.ACC.3.F.PL+PQP+3+PL
encenaram-nas	encenar+V.ele.ACC.3.F.PL+PRF+3+PL
encenaram-no	encenar+V.ele.ACC.3.M.SG+PQP+3+PL
encenaram-no	encenar+V.ele.ACC.3.M.SG+PRF+3+PL
encenaram-nos	encenar+V.ele.ACC.3.M.PL+PQP+3+PL
encenaram-nos	encenar+V.ele.ACC.3.M.PL+PRF+3+PL
encenaram-nos	encenar+V.nós.AD.1.PL+PQP+3+PL
encenaram-nos	encenar+V.nós.AD.1.PL+PRF+3+PL
encenáramo-la	encenar+V.ele.ACC.3.F.SG+PQP+1+PL
encenáramo-las	encenar+V.ele.ACC.3.F.PL+PQP+1+PL
encenáramo-lo	encenar+V.ele.ACC.3.M.SG+PQP+1+PL
encenáramo-los	encenar+V.ele.ACC.3.M.PL+PQP+1+PL
encenáramo-nos	encenar+nós.AD.1.PL+PQP+1+PL
encenáramos-lhe	encenar+V.ele.DAT.3.SG+PQP+1+PL
encenáramos-lhes	encenar+V.ele.DAT.3.PL+PQP+1+PL
encenáramos-me	encenar+V.eu.AD.1.SG+PQP+1+PL
encenáramos-te	encenar+V.tu.AD.2.SG+PQP+1+PL
encenáramos-vos	encenar+V.vós.AD.2.PL+PQP+1+PL
encenaram-se	encenar+V.ele.REFL+PQP+3+PL
encenaram-se	encenar+V.ele.REFL+PRF+3+PL
encenaram-te	encenar+V.tu.AD.2.SG+PQP+3+PL
encenaram-te	encenar+V.tu.AD.2.SG+PRF+3+PL
encenaram-vos	encenar+V.vós.AD.2.PL+PQP+3+PL
encenaram-vos	encenar+V.vós.AD.2.PL+PRF+3+PL
encenara-nos	encenar+nós.AD.1.PL+PQP+1+SG
encenara-nos	encenar+nós.AD.1.PL+PQP+2+SG
encenara-nos	encenar+nós.AD.1.PL+PQP+3+SG
encenara-o	encenar+V.ele.ACC.3.M.SG+PQP+1+SG
encenara-o	encenar+V.ele.ACC.3.M.SG+PQP+3+SG
encenara-os	encenar+V.ele.ACC.3.M.PL+PQP+1+SG
encenara-os	encenar+V.ele.ACC.3.M.PL+PQP+3+SG
encenara-se	encenar+V.ele.REFL+PQP+1+SG
encenara-se	encenar+V.ele.REFL+PQP+3+SG
encenaras-lhe	encenar+V.ele.DAT.3.SG+PQP+2+SG
encenaras-lhes	encenar+V.ele.DAT.3.PL+PQP+2+SG
encenaras-me	encenar+V.eu.AD.1.SG+PQP+2+SG
encenaras-te	encenar+V.tu.AD.2.SG+PQP+2+SG
encenaras-vos	encenar+V.vós.AD.2.PL+PQP+2+SG
encenara-te	encenar+V.tu.AD.2.SG+PQP+1+SG
encenara-te	encenar+V.tu.AD.2.SG+PQP+3+SG
encenara-vos	encenar+V.vós.AD.2.PL+PQP+1+SG
encenara-vos	encenar+V.vós.AD.2.PL+PQP+3+SG
encenarde-la	encenar+V.ele.ACC.3.F.SG+INF+2+PL
encenarde-la	encenar+V.ele.ACC.3.F.SG+SBJF+2+PL
encenarde-las	encenar+V.ele.ACC.3.F.PL+INF+2+PL
encenarde-las	encenar+V.ele.ACC.3.F.PL+SBJF+2+PL
encenarde-lo	encenar+V.ele.ACC.3.M.SG+INF+2+PL
encenarde-lo	encenar+V.ele.ACC.3.M.SG+SBJF+2+PL
encenarde-los	encenar+V.ele.ACC.3.M.PL+INF+2+PL
encenarde-los	encenar+V.ele.ACC.3.M.PL+SBJF+2+PL
encenarde-nos	encenar+nós.AD.1.PL+INF+2+PL
encenarde-nos	encenar+nós.AD.1.PL+SBJF+2+PL
encenardes-lhe	encenar+V.ele.DAT.3.SG+INF+2+PL
encenardes-lhe	encenar+V.ele.DAT.3.SG+SBJF+2+PL
encenardes-lhes	encenar+V.ele.DAT.3.PL+INF+2+PL
encenardes-lhes	encenar+V.ele.DAT.3.PL+SBJF+2+PL
encenardes-me	encenar+V.eu.AD.1.SG+INF+2+PL
encenardes-me	encenar+V.eu.AD.1.SG+SBJF+2+PL
encenardes-te	encenar+V.tu.AD.2.SG+INF+2+PL
encenardes-te	encenar+V.tu.AD.2.SG+SBJF+2+PL
encenardes-vos	encenar+V.vós.AD.2.PL+INF+2+PL
encenardes-vos	encenar+V.vós.AD.2.PL+SBJF+2+PL
encenárei-la	encenar+V.ele.ACC.3.F.SG+PQP+2+PL
encenárei-las	encenar+V.ele.ACC.3.F.PL+PQP+2+PL
encenárei-lo	encenar+V.ele.ACC.3.M.SG+PQP+2+PL
encenárei-los	encenar+V.ele.ACC.3.M.PL+PQP+2+PL
encenárei-nos	encenar+nós.AD.1.PL+PQP+2+PL
encenáreis-lhe	encenar+V.ele.DAT.3.SG+PQP+2+PL
encenáreis-lhes	encenar+V.ele.DAT.3.PL+PQP+2+PL
encenáreis-me	encenar+V.eu.AD.1.SG+PQP+2+PL
encenáreis-te	encenar+V.tu.AD.2.SG+PQP+2+PL
encenáreis-vos	encenar+V.vós.AD.2.PL+PQP+2+PL
encenare-la	encenar+V.ele.ACC.3.F.SG+INF+2+SG
encenare-la	encenar+V.ele.ACC.3.F.SG+SBJF+2+SG
encenare-las	encenar+V.ele.ACC.3.F.PL+INF+2+SG
encenare-las	encenar+V.ele.ACC.3.F.PL+SBJF+2+SG
encenare-lo	encenar+V.ele.ACC.3.M.SG+INF+2+SG
encenare-lo	encenar+V.ele.ACC.3.M.SG+SBJF+2+SG
encenare-los	encenar+V.ele.ACC.3.M.PL+INF+2+SG
encenare-los	encenar+V.ele.ACC.3.M.PL+SBJF+2+SG
encenarem-lhe	encenar+V.ele.DAT.3.SG+INF+3+PL
encenarem-lhe	encenar+V.ele.DAT.3.SG+SBJF+3+PL
encenarem-lhes	encenar+V.ele.DAT.3.PL+INF+3+PL
encenarem-lhes	encenar+V.ele.DAT.3.PL+SBJF+3+PL
encenarem-me	encenar+V.eu.AD.1.SG+INF+3+PL
encenarem-me	encenar+V.eu.AD.1.SG+SBJF+3+PL
encenarem-na	encenar+V.ele.ACC.3.F.SG+INF+3+PL
encenarem-na	encenar+V.ele.ACC.3.F.SG+SBJF+3+PL
encenarem-nas	encenar+V.ele.ACC.3.F.PL+INF+3+PL
encenarem-nas	encenar+V.ele.ACC.3.F.PL+SBJF+3+PL
encenarem-no	encenar+V.ele.ACC.3.M.SG+INF+3+PL
encenarem-no	encenar+V.ele.ACC.3.M.SG+SBJF+3+PL
encenarem-nos	encenar+V.ele.ACC.3.M.PL+INF+3+PL
encenarem-nos	encenar+V.ele.ACC.3.M.PL+SBJF+3+PL
encenarem-nos	encenar+V.nós.AD.1.PL+INF+3+PL
encenarem-nos	encenar+V.nós.AD.1.PL+SBJF+3+PL
encenarem-se	encenar+V.ele.REFL+INF+3+PL
encenarem-se	encenar+V.ele.REFL+SBJF+3+PL
encenarem-te	encenar+V.tu.AD.2.SG+INF+3+PL
encenarem-te	encenar+V.tu.AD.2.SG+SBJF+3+PL
encenarem-vos	encenar+V.vós.AD.2.PL+INF+3+PL
encenarem-vos	encenar+V.vós.AD.2.PL+SBJF+3+PL
encenare-nos	encenar+nós.AD.1.PL+INF+2+SG
encenare-nos	encenar+nós.AD.1.PL+SBJF+2+SG
encenares-lhe	encenar+V.ele.DAT.3.SG+INF+2+SG
encenares-lhe	encenar+V.ele.DAT.3.SG+SBJF+2+SG
encenares-lhes	encenar+V.ele.DAT.3.PL+INF+2+SG
encenares-lhes	encenar+V.ele.DAT.3.PL+SBJF+2+SG
encenares-me	encenar+V.eu.AD.1.SG+INF+2+SG
encenares-me	encenar+V.eu.AD.1.SG+SBJF+2+SG
encenares-te	encenar+V.tu.AD.2.SG+INF+2+SG
encenares-te	encenar+V.tu.AD.2.SG+SBJF+2+SG
encenares-vos	encenar+V.vós.AD.2.PL+INF+2+SG
encenares-vos	encenar+V.vós.AD.2.PL+SBJF+2+SG
encenar-lhe-á	encenar+V.ele.DAT.3.SG+FUT+3+SG
encenar-lhe-ão	encenar+V.ele.DAT.3.SG+FUT+3+PL
encenar-lhe-ás	encenar+V.ele.DAT.3.SG+FUT+2+SG
encenar-lhe-ei	encenar+V.ele.DAT.3.SG+FUT+1+SG
encenar-lhe-eis	encenar+V.ele.DAT.3.SG+FUT+2+PL
encenar-lhe-emos	encenar+V.ele.DAT.3.SG+FUT+1+PL
encenar-lhe	encenar+V.ele.DAT.3.SG+INF
encenar-lhe	encenar+V.ele.DAT.3.SG+INF+1+SG
encenar-lhe	encenar+V.ele.DAT.3.SG+INF+3+SG
encenar-lhe	encenar+V.ele.DAT.3.SG+SBJF+1+SG
encenar-lhe	encenar+V.ele.DAT.3.SG+SBJF+3+SG
encenar-lhe-ia	encenar+V.ele.DAT.3.SG+COND+1+SG
encenar-lhe-ia	encenar+V.ele.DAT.3.SG+COND+3+SG
encenar-lhe-iam	encenar+V.ele.DAT.3.SG+COND+3+PL
encenar-lhe-íamos	encenar+V.ele.DAT.3.SG+COND+1+PL
encenar-lhe-ias	encenar+V.ele.DAT.3.SG+COND+2+SG
encenar-lhe-íeis	encenar+V.ele.DAT.3.SG+COND+2+PL
encenar-lhes-á	encenar+V.ele.DAT.3.PL+FUT+3+SG
encenar-lhes-ão	encenar+V.ele.DAT.3.PL+FUT+3+PL
encenar-lhes-ás	encenar+V.ele.DAT.3.PL+FUT+2+SG
encenar-lhes-ei	encenar+V.ele.DAT.3.PL+FUT+1+SG
encenar-lhes-eis	encenar+V.ele.DAT.3.PL+FUT+2+PL
encenar-lhes-emos	encenar+V.ele.DAT.3.PL+FUT+1+PL
encenar-lhes	encenar+V.ele.DAT.3.PL+INF
encenar-lhes	encenar+V.ele.DAT.3.PL+INF+1+SG
encenar-lhes	encenar+V.ele.DAT.3.PL+INF+3+SG
encenar-lhes	encenar+V.ele.DAT.3.PL+SBJF+1+SG
encenar-lhes	encenar+V.ele.DAT.3.PL+SBJF+3+SG
encenar-lhes-ia	encenar+V.ele.DAT.3.PL+COND+1+SG
encenar-lhes-ia	encenar+V.ele.DAT.3.PL+COND+3+SG
encenar-lhes-iam	encenar+V.ele.DAT.3.PL+COND+3+PL
encenar-lhes-íamos	encenar+V.ele.DAT.3.PL+COND+1+PL
encenar-lhes-ias	encenar+V.ele.DAT.3.PL+COND+2+SG
encenar-lhes-íeis	encenar+V.ele.DAT.3.PL+COND+2+PL
encenar-me-á	encenar+V.eu.AD.1.SG+FUT+3+SG
encenar-me-ão	encenar+V.eu.AD.1.SG+FUT+3+PL
encenar-me-ás	encenar+V.eu.AD.1.SG+FUT+2+SG
encenar-me-ei	encenar+V.eu.AD.1.SG+FUT+1+SG
encenar-me-eis	encenar+V.eu.AD.1.SG+FUT+2+PL
encenar-me-emos	encenar+V.eu.AD.1.SG+FUT+1+PL
encenar-me	encenar+V.eu.AD.1.SG+INF
encenar-me	encenar+V.eu.AD.1.SG+INF+1+SG
encenar-me	encenar+V.eu.AD.1.SG+INF+3+SG
encenar-me	encenar+V.eu.AD.1.SG+SBJF+1+SG
encenar-me	encenar+V.eu.AD.1.SG+SBJF+3+SG
encenar-me-ia	encenar+V.eu.AD.1.SG+COND+1+SG
encenar-me-ia	encenar+V.eu.AD.1.SG+COND+3+SG
encenar-me-iam	encenar+V.eu.AD.1.SG+COND+3+PL
encenar-me-íamos	encenar+V.eu.AD.1.SG+COND+1+PL
encenar-me-ias	encenar+V.eu.AD.1.SG+COND+2+SG
encenar-me-íeis	encenar+V.eu.AD.1.SG+COND+2+PL
encenarmo-la	encenar+V.ele.ACC.3.F.SG+INF+1+PL
encenarmo-la	encenar+V.ele.ACC.3.F.SG+SBJF+1+PL
encenarmo-las	encenar+V.ele.ACC.3.F.PL+INF+1+PL
encenarmo-las	encenar+V.ele.ACC.3.F.PL+SBJF+1+PL
encenarmo-lo	encenar+V.ele.ACC.3.M.SG+INF+1+PL
encenarmo-lo	encenar+V.ele.ACC.3.M.SG+SBJF+1+PL
encenarmo-los	encenar+V.ele.ACC.3.M.PL+INF+1+PL
encenarmo-los	encenar+V.ele.ACC.3.M.PL+SBJF+1+PL
encenarmo-nos	encenar+nós.AD.1.PL+INF+1+PL
encenarmo-nos	encenar+nós.AD.1.PL+SBJF+1+PL
encenarmos-lhe	encenar+V.ele.DAT.3.SG+INF+1+PL
encenarmos-lhe	encenar+V.ele.DAT.3.SG+SBJF+1+PL
encenarmos-lhes	encenar+V.ele.DAT.3.PL+INF+1+PL
encenarmos-lhes	encenar+V.ele.DAT.3.PL+SBJF+1+PL
encenarmos-me	encenar+V.eu.AD.1.SG+INF+1+PL
encenarmos-me	encenar+V.eu.AD.1.SG+SBJF+1+PL
encenarmos-te	encenar+V.tu.AD.2.SG+INF+1+PL
encenarmos-te	encenar+V.tu.AD.2.SG+SBJF+1+PL
encenarmos-vos	encenar+V.vós.AD.2.PL+INF+1+PL
encenarmos-vos	encenar+V.vós.AD.2.PL+SBJF+1+PL
encenar-nos-á	encenar+nós.AD.1.PL+FUT+3+SG
encenar-nos-ão	encenar+nós.AD.1.PL+FUT+3+PL
encenar-nos-ás	encenar+nós.AD.1.PL+FUT+2+SG
encenar-nos-ei	encenar+nós.AD.1.PL+FUT+1+SG
encenar-nos-eis	encenar+nós.AD.1.PL+FUT+2+PL
encenar-nos-emos	encenar+nós.AD.1.PL+FUT+1+PL
encenar-nos	encenar+nós.AD.1.PL+INF
encenar-nos	encenar+nós.AD.1.PL+INF+1+SG
encenar-nos	encenar+nós.AD.1.PL+INF+3+SG
encenar-nos	encenar+nós.AD.1.PL+SBJF+1+SG
encenar-nos	encenar+nós.AD.1.PL+SBJF+3+SG
encenar-nos-ia	encenar+nós.AD.1.PL+COND+1+SG
encenar-nos-ia	encenar+nós.AD.1.PL+COND+3+SG
encenar-nos-iam	encenar+nós.AD.1.PL+COND+3+PL
encenar-nos-íamos	encenar+nós.AD.1.PL+COND+1+PL
encenar-nos-ias	encenar+nós.AD.1.PL+COND+2+SG
encenar-nos-íeis	encenar+nós.AD.1.PL+COND+2+PL
encenar-se-á	encenar+V.ele.REFL+FUT+3+SG
encenar-se-ão	encenar+V.ele.REFL+FUT+3+PL
encenar-se	encenar+V.ele.REFL+INF
encenar-se	encenar+V.ele.REFL+INF+3+SG
encenar-se	encenar+V.ele.REFL+SBJF+3+SG
encenar-se-ia	encenar+V.ele.REFL+COND+3+SG
encenar-se-iam	encenar+V.ele.REFL+COND+3+PL
encenar-te-á	encenar+V.tu.AD.2.SG+FUT+3+SG
encenar-te-ão	encenar+V.tu.AD.2.SG+FUT+3+PL
encenar-te-ás	encenar+V.tu.AD.2.SG+FUT+2+SG
encenar-te-ei	encenar+V.tu.AD.2.SG+FUT+1+SG
encenar-te-eis	encenar+V.tu.AD.2.SG+FUT+2+PL
encenar-te-emos	encenar+V.tu.AD.2.SG+FUT+1+PL
encenar-te	encenar+V.tu.AD.2.SG+INF
encenar-te	encenar+V.tu.AD.2.SG+INF+1+SG
encenar-te	encenar+V.tu.AD.2.SG+INF+3+SG
encenar-te	encenar+V.tu.AD.2.SG+SBJF+1+SG
encenar-te	encenar+V.tu.AD.2.SG+SBJF+3+SG
encenar-te-ia	encenar+V.tu.AD.2.SG+COND+1+SG
encenar-te-ia	encenar+V.tu.AD.2.SG+COND+3+SG
encenar-te-iam	encenar+V.tu.AD.2.SG+COND+3+PL
encenar-te-íamos	encenar+V.tu.AD.2.SG+COND+1+PL
encenar-te-ias	encenar+V.tu.AD.2.SG+COND+2+SG
encenar-te-íeis	encenar+V.tu.AD.2.SG+COND+2+PL
encenar-vos-á	encenar+V.vós.AD.2.PL+FUT+3+SG
encenar-vos-ão	encenar+V.vós.AD.2.PL+FUT+3+PL
encenar-vos-ás	encenar+V.vós.AD.2.PL+FUT+2+SG
encenar-vos-ei	encenar+V.vós.AD.2.PL+FUT+1+SG
encenar-vos-eis	encenar+V.vós.AD.2.PL+FUT+2+PL
encenar-vos-emos	encenar+V.vós.AD.2.PL+FUT+1+PL
encenar-vos	encenar+V.vós.AD.2.PL+INF
encenar-vos	encenar+V.vós.AD.2.PL+INF+1+SG
encenar-vos	encenar+V.vós.AD.2.PL+INF+3+SG
encenar-vos	encenar+V.vós.AD.2.PL+SBJF+1+SG
encenar-vos	encenar+V.vós.AD.2.PL+SBJF+3+SG
encenar-vos-ia	encenar+V.vós.AD.2.PL+COND+1+SG
encenar-vos-ia	encenar+V.vós.AD.2.PL+COND+3+SG
encenar-vos-iam	encenar+V.vós.AD.2.PL+COND+3+PL
encenar-vos-íamos	encenar+V.vós.AD.2.PL+COND+1+PL
encenar-vos-ias	encenar+V.vós.AD.2.PL+COND+2+SG
encenar-vos-íeis	encenar+V.vós.AD.2.PL+COND+2+PL
encena-se	encenar+V.ele.REFL+PRS+3+SG
encenas-lhe	encenar+V.ele.DAT.3.SG+PRS+2+SG
encenas-lhes	encenar+V.ele.DAT.3.PL+PRS+2+SG
encenas-me	encenar+V.eu.AD.1.SG+PRS+2+SG
encenaste-a	encenar+V.ele.ACC.3.F.SG+PRF+2+SG
encenaste-as	encenar+V.ele.ACC.3.F.PL+PRF+2+SG
encenas-te	encenar+V.tu.AD.2.SG+PRS+2+SG
encenaste-la	encenar+V.ele.ACC.3.F.SG+PRF+2+PL
encenaste-las	encenar+V.ele.ACC.3.F.PL+PRF+2+PL
encenaste-lhe	encenar+V.ele.DAT.3.SG+PRF+2+SG
encenaste-lhes	encenar+V.ele.DAT.3.PL+PRF+2+SG
encenaste-lo	encenar+V.ele.ACC.3.M.SG+PRF+2+PL
encenaste-los	encenar+V.ele.ACC.3.M.PL+PRF+2+PL
encenaste-me	encenar+V.eu.AD.1.SG+PRF+2+SG
encenaste-nos	encenar+nós.AD.1.PL+PRF+2+PL
encenaste-nos	encenar+nós.AD.1.PL+PRF+2+SG
encenaste-o	encenar+V.ele.ACC.3.M.SG+PRF+2+SG
encenaste-os	encenar+V.ele.ACC.3.M.PL+PRF+2+SG
encenastes-lhe	encenar+V.ele.DAT.3.SG+PRF+2+PL
encenastes-lhes	encenar+V.ele.DAT.3.PL+PRF+2+PL
encenastes-me	encenar+V.eu.AD.1.SG+PRF+2+PL
encenastes-te	encenar+V.tu.AD.2.SG+PRF+2+PL
encenastes-vos	encenar+V.vós.AD.2.PL+PRF+2+PL
encenaste-te	encenar+V.tu.AD.2.SG+PRF+2+SG
encenaste-vos	encenar+V.vós.AD.2.PL+PRF+2+SG
encenas-vos	encenar+V.vós.AD.2.PL+PRS+2+SG
encena-te	encenar+V.tu.AD.2.SG+PRS+3+SG
encenava-a	encenar+V.ele.ACC.3.F.SG+IMPF+1+SG
encenava-a	encenar+V.ele.ACC.3.F.SG+IMPF+3+SG
encenava-as	encenar+V.ele.ACC.3.F.PL+IMPF+1+SG
encenava-as	encenar+V.ele.ACC.3.F.PL+IMPF+3+SG
encenava-la	encenar+V.ele.ACC.3.F.SG+IMPF+2+SG
encenava-las	encenar+V.ele.ACC.3.F.PL+IMPF+2+SG
encenava-lhe	encenar+V.ele.DAT.3.SG+IMPF+1+SG
encenava-lhe	encenar+V.ele.DAT.3.SG+IMPF+3+SG
encenava-lhes	encenar+V.ele.DAT.3.PL+IMPF+1+SG
encenava-lhes	encenar+V.ele.DAT.3.PL+IMPF+3+SG
encenava-lo	encenar+V.ele.ACC.3.M.SG+IMPF+2+SG
encenava-los	encenar+V.ele.ACC.3.M.PL+IMPF+2+SG
encenava-me	encenar+V.eu.AD.1.SG+IMPF+1+SG
encenava-me	encenar+V.eu.AD.1.SG+IMPF+3+SG
encenavam-lhe	encenar+V.ele.DAT.3.SG+IMPF+3+PL
encenavam-lhes	encenar+V.ele.DAT.3.PL+IMPF+3+PL
encenavam-me	encenar+V.eu.AD.1.SG+IMPF+3+PL
encenavam-na	encenar+V.ele.ACC.3.F.SG+IMPF+3+PL
encenavam-nas	encenar+V.ele.ACC.3.F.PL+IMPF+3+PL
encenavam-no	encenar+V.ele.ACC.3.M.SG+IMPF+3+PL
encenavam-nos	encenar+V.ele.ACC.3.M.PL+IMPF+3+PL
encenavam-nos	encenar+V.nós.AD.1.PL+IMPF+3+PL
encenávamo-la	encenar+V.ele.ACC.3.F.SG+IMPF+1+PL
encenávamo-las	encenar+V.ele.ACC.3.F.PL+IMPF+1+PL
encenávamo-lo	encenar+V.ele.ACC.3.M.SG+IMPF+1+PL
encenávamo-los	encenar+V.ele.ACC.3.M.PL+IMPF+1+PL
encenávamo-nos	encenar+nós.AD.1.PL+IMPF+1+PL
encenávamos-lhe	encenar+V.ele.DAT.3.SG+IMPF+1+PL
encenávamos-lhes	encenar+V.ele.DAT.3.PL+IMPF+1+PL
encenávamos-me	encenar+V.eu.AD.1.SG+IMPF+1+PL
encenávamos-te	encenar+V.tu.AD.2.SG+IMPF+1+PL
encenávamos-vos	encenar+V.vós.AD.2.PL+IMPF+1+PL
encenavam-se	encenar+V.ele.REFL+IMPF+3+PL
encenavam-te	encenar+V.tu.AD.2.SG+IMPF+3+PL
encenavam-vos	encenar+V.vós.AD.2.PL+IMPF+3+PL
encenava-nos	encenar+nós.AD.1.PL+IMPF+1+SG
encenava-nos	encenar+nós.AD.1.PL+IMPF+2+SG
encenava-nos	encenar+nós.AD.1.PL+IMPF+3+SG
encenava-o	encenar+V.ele.ACC.3.M.SG+IMPF+1+SG
encenava-o	encenar+V.ele.ACC.3.M.SG+IMPF+3+SG
encenava-os	encenar+V.ele.ACC.3.M.PL+IMPF+1+SG
encenava-os	encenar+V.ele.ACC.3.M.PL+IMPF+3+SG
encenava-se	encenar+V.ele.REFL+IMPF+1+SG
encenava-se	encenar+V.ele.REFL+IMPF+3+SG
encenavas-lhe	encenar+V.ele.DAT.3.SG+IMPF+2+SG
encenavas-lhes	encenar+V.ele.DAT.3.PL+IMPF+2+SG
encenavas-me	encenar+V.eu.AD.1.SG+IMPF+2+SG
encenavas-te	encenar+V.tu.AD.2.SG+IMPF+2+SG
encenavas-vos	encenar+V.vós.AD.2.PL+IMPF+2+SG
encenava-te	encenar+V.tu.AD.2.SG+IMPF+1+SG
encenava-te	encenar+V.tu.AD.2.SG+IMPF+3+SG
encenava-vos	encenar+V.vós.AD.2.PL+IMPF+1+SG
encenava-vos	encenar+V.vós.AD.2.PL+IMPF+3+SG
encenávei-la	encenar+V.ele.ACC.3.F.SG+IMPF+2+PL
encenávei-las	encenar+V.ele.ACC.3.F.PL+IMPF+2+PL
encenávei-lo	encenar+V.ele.ACC.3.M.SG+IMPF+2+PL
encenávei-los	encenar+V.ele.ACC.3.M.PL+IMPF+2+PL
encenávei-nos	encenar+nós.AD.1.PL+IMPF+2+PL
encenáveis-lhe	encenar+V.ele.DAT.3.SG+IMPF+2+PL
encenáveis-lhes	encenar+V.ele.DAT.3.PL+IMPF+2+PL
encenáveis-me	encenar+V.eu.AD.1.SG+IMPF+2+PL
encenáveis-te	encenar+V.tu.AD.2.SG+IMPF+2+PL
encenáveis-vos	encenar+V.vós.AD.2.PL+IMPF+2+PL
encena-vos	encenar+V.vós.AD.2.PL+PRS+3+SG
encenda-a	encender+V.ele.ACC.3.F.SG+IMP+3+SG
encenda-as	encender+V.ele.ACC.3.F.PL+IMP+3+SG
encenda-lhe	encender+V.ele.DAT.3.SG+IMP+3+SG
encenda-lhes	encender+V.ele.DAT.3.PL+IMP+3+SG
encenda-me	encender+V.eu.AD.1.SG+IMP+3+SG
encendam-lhe	encender+V.ele.DAT.3.SG+IMP+3+PL
encendam-lhes	encender+V.ele.DAT.3.PL+IMP+3+PL
encendam-me	encender+V.eu.AD.1.SG+IMP+3+PL
encendam-na	encender+V.ele.ACC.3.F.SG+IMP+3+PL
encendam-nas	encender+V.ele.ACC.3.F.PL+IMP+3+PL
encendam-no	encender+V.ele.ACC.3.M.SG+IMP+3+PL
encendam-nos	encender+V.ele.ACC.3.M.PL+IMP+3+PL
encendam-nos	encender+V.nós.AD.1.PL+IMP+3+PL
encendamo-la	encender+V.ele.ACC.3.F.SG+IMP+1+PL
encendamo-las	encender+V.ele.ACC.3.F.PL+IMP+1+PL
encendamo-lo	encender+V.ele.ACC.3.M.SG+IMP+1+PL
encendamo-los	encender+V.ele.ACC.3.M.PL+IMP+1+PL
encendamo-nos	encender+nós.AD.1.PL+IMP+1+PL
encendamos-lhe	encender+V.ele.DAT.3.SG+IMP+1+PL
encendamos-lhes	encender+V.ele.DAT.3.PL+IMP+1+PL
encendamos-me	encender+V.eu.AD.1.SG+IMP+1+PL
encendamos-te	encender+V.tu.AD.2.SG+IMP+1+PL
encendamos-vos	encender+V.vós.AD.2.PL+IMP+1+PL
encendam-se	encender+V.ele.REFL+IMP+3+PL
encendam-te	encender+V.tu.AD.2.SG+IMP+3+PL
encendam-vos	encender+V.vós.AD.2.PL+IMP+3+PL
encenda-nos	encender+nós.AD.1.PL+IMP+3+SG
encenda-o	encender+V.ele.ACC.3.M.SG+IMP+3+SG
encenda-os	encender+V.ele.ACC.3.M.PL+IMP+3+SG
encenda-se	encender+V.ele.REFL+IMP+3+SG
encenda-te	encender+V.tu.AD.2.SG+IMP+3+SG
encenda-vos	encender+V.vós.AD.2.PL+IMP+3+SG
encende-a	encender+V.ele.ACC.3.F.SG+PRS+3+SG
encende-as	encender+V.ele.ACC.3.F.PL+PRS+3+SG
encendei-la	encender+V.ele.ACC.3.F.SG+PRS+2+PL
encendei-las	encender+V.ele.ACC.3.F.PL+PRS+2+PL
encendei-lo	encender+V.ele.ACC.3.M.SG+PRS+2+PL
encendei-los	encender+V.ele.ACC.3.M.PL+PRS+2+PL
encendei-nos	encender+nós.AD.1.PL+PRS+2+PL
encendeis-lhe	encender+V.ele.DAT.3.SG+PRS+2+PL
encendeis-lhes	encender+V.ele.DAT.3.PL+PRS+2+PL
encendeis-me	encender+V.eu.AD.1.SG+PRS+2+PL
encendeis-te	encender+V.tu.AD.2.SG+PRS+2+PL
encendeis-vos	encender+V.vós.AD.2.PL+PRS+2+PL
encendê-la-á	encender+V.ele.ACC.3.F.SG+FUT+3+SG
encendê-la-ão	encender+V.ele.ACC.3.F.SG+FUT+3+PL
encendê-la-ás	encender+V.ele.ACC.3.F.SG+FUT+2+SG
encendê-la-ei	encender+V.ele.ACC.3.F.SG+FUT+1+SG
encendê-la-eis	encender+V.ele.ACC.3.F.SG+FUT+2+PL
encendê-la-emos	encender+V.ele.ACC.3.F.SG+FUT+1+PL
encendê-la	encender+V.ele.ACC.3.F.SG+INF
encendê-la	encender+V.ele.ACC.3.F.SG+INF+1+SG
encendê-la	encender+V.ele.ACC.3.F.SG+INF+3+SG
encende-la	encender+V.ele.ACC.3.F.SG+PRS+2+SG
encendê-la	encender+V.ele.ACC.3.F.SG+SBJF+1+SG
encendê-la	encender+V.ele.ACC.3.F.SG+SBJF+3+SG
encendê-la-ia	encender+V.ele.ACC.3.F.SG+COND+1+SG
encendê-la-ia	encender+V.ele.ACC.3.F.SG+COND+3+SG
encendê-la-iam	encender+V.ele.ACC.3.F.SG+COND+3+PL
encendê-la-íamos	encender+V.ele.ACC.3.F.SG+COND+1+PL
encendê-la-ias	encender+V.ele.ACC.3.F.SG+COND+2+SG
encendê-la-íeis	encender+V.ele.ACC.3.F.SG+COND+2+PL
encendê-las-á	encender+V.ele.ACC.3.F.PL+FUT+3+SG
encendê-las-ão	encender+V.ele.ACC.3.F.PL+FUT+3+PL
encendê-las-ás	encender+V.ele.ACC.3.F.PL+FUT+2+SG
encendê-las-ei	encender+V.ele.ACC.3.F.PL+FUT+1+SG
encendê-las-eis	encender+V.ele.ACC.3.F.PL+FUT+2+PL
encendê-las-emos	encender+V.ele.ACC.3.F.PL+FUT+1+PL
encendê-las	encender+V.ele.ACC.3.F.PL+INF
encendê-las	encender+V.ele.ACC.3.F.PL+INF+1+SG
encendê-las	encender+V.ele.ACC.3.F.PL+INF+3+SG
encende-las	encender+V.ele.ACC.3.F.PL+PRS+2+SG
encendê-las	encender+V.ele.ACC.3.F.PL+SBJF+1+SG
encendê-las	encender+V.ele.ACC.3.F.PL+SBJF+3+SG
encendê-las-ia	encender+V.ele.ACC.3.F.PL+COND+1+SG
encendê-las-ia	encender+V.ele.ACC.3.F.PL+COND+3+SG
encendê-las-iam	encender+V.ele.ACC.3.F.PL+COND+3+PL
encendê-las-íamos	encender+V.ele.ACC.3.F.PL+COND+1+PL
encendê-las-ias	encender+V.ele.ACC.3.F.PL+COND+2+SG
encendê-las-íeis	encender+V.ele.ACC.3.F.PL+COND+2+PL
encende-lhe	encender+V.ele.DAT.3.SG+PRS+3+SG
encende-lhes	encender+V.ele.DAT.3.PL+PRS+3+SG
encendê-lo-á	encender+V.ele.ACC.3.M.SG+FUT+3+SG
encendê-lo-ão	encender+V.ele.ACC.3.M.SG+FUT+3+PL
encendê-lo-ás	encender+V.ele.ACC.3.M.SG+FUT+2+SG
encendê-lo-ei	encender+V.ele.ACC.3.M.SG+FUT+1+SG
encendê-lo-eis	encender+V.ele.ACC.3.M.SG+FUT+2+PL
encendê-lo-emos	encender+V.ele.ACC.3.M.SG+FUT+1+PL
encendê-lo	encender+V.ele.ACC.3.M.SG+INF
encendê-lo	encender+V.ele.ACC.3.M.SG+INF+1+SG
encendê-lo	encender+V.ele.ACC.3.M.SG+INF+3+SG
encende-lo	encender+V.ele.ACC.3.M.SG+PRS+2+SG
encendê-lo	encender+V.ele.ACC.3.M.SG+SBJF+1+SG
encendê-lo	encender+V.ele.ACC.3.M.SG+SBJF+3+SG
encendê-lo-ia	encender+V.ele.ACC.3.M.SG+COND+1+SG
encendê-lo-ia	encender+V.ele.ACC.3.M.SG+COND+3+SG
encendê-lo-iam	encender+V.ele.ACC.3.M.SG+COND+3+PL
encendê-lo-íamos	encender+V.ele.ACC.3.M.SG+COND+1+PL
encendê-lo-ias	encender+V.ele.ACC.3.M.SG+COND+2+SG
encendê-lo-íeis	encender+V.ele.ACC.3.M.SG+COND+2+PL
encendê-los-á	encender+V.ele.ACC.3.M.PL+FUT+3+SG
encendê-los-ão	encender+V.ele.ACC.3.M.PL+FUT+3+PL
encendê-los-ás	encender+V.ele.ACC.3.M.PL+FUT+2+SG
encendê-los-ei	encender+V.ele.ACC.3.M.PL+FUT+1+SG
encendê-los-eis	encender+V.ele.ACC.3.M.PL+FUT+2+PL
encendê-los-emos	encender+V.ele.ACC.3.M.PL+FUT+1+PL
encendê-los	encender+V.ele.ACC.3.M.PL+INF
encendê-los	encender+V.ele.ACC.3.M.PL+INF+1+SG
encendê-los	encender+V.ele.ACC.3.M.PL+INF+3+SG
encende-los	encender+V.ele.ACC.3.M.PL+PRS+2+SG
encendê-los	encender+V.ele.ACC.3.M.PL+SBJF+1+SG
encendê-los	encender+V.ele.ACC.3.M.PL+SBJF+3+SG
encendê-los-ia	encender+V.ele.ACC.3.M.PL+COND+1+SG
encendê-los-ia	encender+V.ele.ACC.3.M.PL+COND+3+SG
encendê-los-iam	encender+V.ele.ACC.3.M.PL+COND+3+PL
encendê-los-íamos	encender+V.ele.ACC.3.M.PL+COND+1+PL
encendê-los-ias	encender+V.ele.ACC.3.M.PL+COND+2+SG
encendê-los-íeis	encender+V.ele.ACC.3.M.PL+COND+2+PL
encende-me	encender+V.eu.AD.1.SG+PRS+3+SG
encendem-lhe	encender+V.ele.DAT.3.SG+PRS+3+PL
encendem-lhes	encender+V.ele.DAT.3.PL+PRS+3+PL
encendem-me	encender+V.eu.AD.1.SG+PRS+3+PL
encendem-na	encender+V.ele.ACC.3.F.SG+PRS+3+PL
encendem-nas	encender+V.ele.ACC.3.F.PL+PRS+3+PL
encendem-no	encender+V.ele.ACC.3.M.SG+PRS+3+PL
encendem-nos	encender+V.ele.ACC.3.M.PL+PRS+3+PL
encendem-nos	encender+V.nós.AD.1.PL+PRS+3+PL
encendemo-la	encender+V.ele.ACC.3.F.SG+PRF+1+PL
encendemo-la	encender+V.ele.ACC.3.F.SG+PRS+1+PL
encendemo-las	encender+V.ele.ACC.3.F.PL+PRF+1+PL
encendemo-las	encender+V.ele.ACC.3.F.PL+PRS+1+PL
encendemo-lo	encender+V.ele.ACC.3.M.SG+PRF+1+PL
encendemo-lo	encender+V.ele.ACC.3.M.SG+PRS+1+PL
encendemo-los	encender+V.ele.ACC.3.M.PL+PRF+1+PL
encendemo-los	encender+V.ele.ACC.3.M.PL+PRS+1+PL
encendemo-nos	encender+nós.AD.1.PL+PRF+1+PL
encendemo-nos	encender+nós.AD.1.PL+PRS+1+PL
encendemos-lhe	encender+V.ele.DAT.3.SG+PRF+1+PL
encendemos-lhe	encender+V.ele.DAT.3.SG+PRS+1+PL
encendemos-lhes	encender+V.ele.DAT.3.PL+PRF+1+PL
encendemos-lhes	encender+V.ele.DAT.3.PL+PRS+1+PL
encendemos-me	encender+V.eu.AD.1.SG+PRF+1+PL
encendemos-me	encender+V.eu.AD.1.SG+PRS+1+PL
encendemos-te	encender+V.tu.AD.2.SG+PRF+1+PL
encendemos-te	encender+V.tu.AD.2.SG+PRS+1+PL
encendemos-vos	encender+V.vós.AD.2.PL+PRF+1+PL
encendemos-vos	encender+V.vós.AD.2.PL+PRS+1+PL
encendem-se	encender+V.ele.REFL+PRS+3+PL
encendem-te	encender+V.tu.AD.2.SG+PRS+3+PL
encendem-vos	encender+V.vós.AD.2.PL+PRS+3+PL
encendendo-a	encender+V.ele.ACC.3.F.SG+GRD
encendendo-as	encender+V.ele.ACC.3.F.PL+GRD
encendendo-lhe	encender+V.ele.DAT.3.SG+GRD
encendendo-lhes	encender+V.ele.DAT.3.PL+GRD
encendendo-me	encender+V.eu.AD.1.SG+GRD
encendendo-nos	encender+nós.AD.1.PL+GRD
encendendo-o	encender+V.ele.ACC.3.M.SG+GRD
encendendo-os	encender+V.ele.ACC.3.M.PL+GRD
encendendo-se	encender+V.ele.REFL+GRD
encendendo-te	encender+V.tu.AD.2.SG+GRD
encendendo-vos	encender+V.vós.AD.2.PL+GRD
encende-nos	encender+nós.AD.1.PL+PRS+2+SG
encende-nos	encender+nós.AD.1.PL+PRS+3+SG
encende-o	encender+V.ele.ACC.3.M.SG+PRS+3+SG
encende-os	encender+V.ele.ACC.3.M.PL+PRS+3+SG
encendera-a	encender+V.ele.ACC.3.F.SG+PQP+1+SG
encendera-a	encender+V.ele.ACC.3.F.SG+PQP+3+SG
encendera-as	encender+V.ele.ACC.3.F.PL+PQP+1+SG
encendera-as	encender+V.ele.ACC.3.F.PL+PQP+3+SG
encendera-la	encender+V.ele.ACC.3.F.SG+PQP+2+SG
encendera-las	encender+V.ele.ACC.3.F.PL+PQP+2+SG
encendera-lhe	encender+V.ele.DAT.3.SG+PQP+1+SG
encendera-lhe	encender+V.ele.DAT.3.SG+PQP+3+SG
encendera-lhes	encender+V.ele.DAT.3.PL+PQP+1+SG
encendera-lhes	encender+V.ele.DAT.3.PL+PQP+3+SG
encendera-lo	encender+V.ele.ACC.3.M.SG+PQP+2+SG
encendera-los	encender+V.ele.ACC.3.M.PL+PQP+2+SG
encendera-me	encender+V.eu.AD.1.SG+PQP+1+SG
encendera-me	encender+V.eu.AD.1.SG+PQP+3+SG
encenderam-lhe	encender+V.ele.DAT.3.SG+PQP+3+PL
encenderam-lhe	encender+V.ele.DAT.3.SG+PRF+3+PL
encenderam-lhes	encender+V.ele.DAT.3.PL+PQP+3+PL
encenderam-lhes	encender+V.ele.DAT.3.PL+PRF+3+PL
encenderam-me	encender+V.eu.AD.1.SG+PQP+3+PL
encenderam-me	encender+V.eu.AD.1.SG+PRF+3+PL
encenderam-na	encender+V.ele.ACC.3.F.SG+PQP+3+PL
encenderam-na	encender+V.ele.ACC.3.F.SG+PRF+3+PL
encenderam-nas	encender+V.ele.ACC.3.F.PL+PQP+3+PL
encenderam-nas	encender+V.ele.ACC.3.F.PL+PRF+3+PL
encenderam-no	encender+V.ele.ACC.3.M.SG+PQP+3+PL
encenderam-no	encender+V.ele.ACC.3.M.SG+PRF+3+PL
encenderam-nos	encender+V.ele.ACC.3.M.PL+PQP+3+PL
encenderam-nos	encender+V.ele.ACC.3.M.PL+PRF+3+PL
encenderam-nos	encender+V.nós.AD.1.PL+PQP+3+PL
encenderam-nos	encender+V.nós.AD.1.PL+PRF+3+PL
encendêramo-la	encender+V.ele.ACC.3.F.SG+PQP+1+PL
encendêramo-las	encender+V.ele.ACC.3.F.PL+PQP+1+PL
encendêramo-lo	encender+V.ele.ACC.3.M.SG+PQP+1+PL
encendêramo-los	encender+V.ele.ACC.3.M.PL+PQP+1+PL
encendêramo-nos	encender+nós.AD.1.PL+PQP+1+PL
encendêramos-lhe	encender+V.ele.DAT.3.SG+PQP+1+PL
encendêramos-lhes	encender+V.ele.DAT.3.PL+PQP+1+PL
encendêramos-me	encender+V.eu.AD.1.SG+PQP+1+PL
encendêramos-te	encender+V.tu.AD.2.SG+PQP+1+PL
encendêramos-vos	encender+V.vós.AD.2.PL+PQP+1+PL
encenderam-se	encender+V.ele.REFL+PQP+3+PL
encenderam-se	encender+V.ele.REFL+PRF+3+PL
encenderam-te	encender+V.tu.AD.2.SG+PQP+3+PL
encenderam-te	encender+V.tu.AD.2.SG+PRF+3+PL
encenderam-vos	encender+V.vós.AD.2.PL+PQP+3+PL
encenderam-vos	encender+V.vós.AD.2.PL+PRF+3+PL
encendera-nos	encender+nós.AD.1.PL+PQP+1+SG
encendera-nos	encender+nós.AD.1.PL+PQP+2+SG
encendera-nos	encender+nós.AD.1.PL+PQP+3+SG
encendera-o	encender+V.ele.ACC.3.M.SG+PQP+1+SG
encendera-o	encender+V.ele.ACC.3.M.SG+PQP+3+SG
encendera-os	encender+V.ele.ACC.3.M.PL+PQP+1+SG
encendera-os	encender+V.ele.ACC.3.M.PL+PQP+3+SG
encendera-se	encender+V.ele.REFL+PQP+3+SG
encenderas-lhe	encender+V.ele.DAT.3.SG+PQP+2+SG
encenderas-lhes	encender+V.ele.DAT.3.PL+PQP+2+SG
encenderas-me	encender+V.eu.AD.1.SG+PQP+2+SG
encenderas-te	encender+V.tu.AD.2.SG+PQP+2+SG
encenderas-vos	encender+V.vós.AD.2.PL+PQP+2+SG
encendera-te	encender+V.tu.AD.2.SG+PQP+1+SG
encendera-te	encender+V.tu.AD.2.SG+PQP+3+SG
encendera-vos	encender+V.vós.AD.2.PL+PQP+1+SG
encendera-vos	encender+V.vós.AD.2.PL+PQP+3+SG
encenderde-la	encender+V.ele.ACC.3.F.SG+INF+2+PL
encenderde-la	encender+V.ele.ACC.3.F.SG+SBJF+2+PL
encenderde-las	encender+V.ele.ACC.3.F.PL+INF+2+PL
encenderde-las	encender+V.ele.ACC.3.F.PL+SBJF+2+PL
encenderde-lo	encender+V.ele.ACC.3.M.SG+INF+2+PL
encenderde-lo	encender+V.ele.ACC.3.M.SG+SBJF+2+PL
encenderde-los	encender+V.ele.ACC.3.M.PL+INF+2+PL
encenderde-los	encender+V.ele.ACC.3.M.PL+SBJF+2+PL
encenderde-nos	encender+nós.AD.1.PL+INF+2+PL
encenderde-nos	encender+nós.AD.1.PL+SBJF+2+PL
encenderdes-lhe	encender+V.ele.DAT.3.SG+INF+2+PL
encenderdes-lhe	encender+V.ele.DAT.3.SG+SBJF+2+PL
encenderdes-lhes	encender+V.ele.DAT.3.PL+INF+2+PL
encenderdes-lhes	encender+V.ele.DAT.3.PL+SBJF+2+PL
encenderdes-me	encender+V.eu.AD.1.SG+INF+2+PL
encenderdes-me	encender+V.eu.AD.1.SG+SBJF+2+PL
encenderdes-te	encender+V.tu.AD.2.SG+INF+2+PL
encenderdes-te	encender+V.tu.AD.2.SG+SBJF+2+PL
encenderdes-vos	encender+V.vós.AD.2.PL+INF+2+PL
encenderdes-vos	encender+V.vós.AD.2.PL+SBJF+2+PL
encendêrei-la	encender+V.ele.ACC.3.F.SG+PQP+2+PL
encendêrei-las	encender+V.ele.ACC.3.F.PL+PQP+2+PL
encendêrei-lo	encender+V.ele.ACC.3.M.SG+PQP+2+PL
encendêrei-los	encender+V.ele.ACC.3.M.PL+PQP+2+PL
encendêrei-nos	encender+nós.AD.1.PL+PQP+2+PL
encendêreis-lhe	encender+V.ele.DAT.3.SG+PQP+2+PL
encendêreis-lhes	encender+V.ele.DAT.3.PL+PQP+2+PL
encendêreis-me	encender+V.eu.AD.1.SG+PQP+2+PL
encendêreis-te	encender+V.tu.AD.2.SG+PQP+2+PL
encendêreis-vos	encender+V.vós.AD.2.PL+PQP+2+PL
encendere-la	encender+V.ele.ACC.3.F.SG+INF+2+SG
encendere-la	encender+V.ele.ACC.3.F.SG+SBJF+2+SG
encendere-las	encender+V.ele.ACC.3.F.PL+INF+2+SG
encendere-las	encender+V.ele.ACC.3.F.PL+SBJF+2+SG
encendere-lo	encender+V.ele.ACC.3.M.SG+INF+2+SG
encendere-lo	encender+V.ele.ACC.3.M.SG+SBJF+2+SG
encendere-los	encender+V.ele.ACC.3.M.PL+INF+2+SG
encendere-los	encender+V.ele.ACC.3.M.PL+SBJF+2+SG
encenderem-lhe	encender+V.ele.DAT.3.SG+INF+3+PL
encenderem-lhe	encender+V.ele.DAT.3.SG+SBJF+3+PL
encenderem-lhes	encender+V.ele.DAT.3.PL+INF+3+PL
encenderem-lhes	encender+V.ele.DAT.3.PL+SBJF+3+PL
encenderem-me	encender+V.eu.AD.1.SG+INF+3+PL
encenderem-me	encender+V.eu.AD.1.SG+SBJF+3+PL
encenderem-na	encender+V.ele.ACC.3.F.SG+INF+3+PL
encenderem-na	encender+V.ele.ACC.3.F.SG+SBJF+3+PL
encenderem-nas	encender+V.ele.ACC.3.F.PL+INF+3+PL
encenderem-nas	encender+V.ele.ACC.3.F.PL+SBJF+3+PL
encenderem-no	encender+V.ele.ACC.3.M.SG+INF+3+PL
encenderem-no	encender+V.ele.ACC.3.M.SG+SBJF+3+PL
encenderem-nos	encender+V.ele.ACC.3.M.PL+INF+3+PL
encenderem-nos	encender+V.ele.ACC.3.M.PL+SBJF+3+PL
encenderem-nos	encender+V.nós.AD.1.PL+INF+3+PL
encenderem-nos	encender+V.nós.AD.1.PL+SBJF+3+PL
encenderem-se	encender+V.ele.REFL+INF+3+PL
encenderem-se	encender+V.ele.REFL+SBJF+3+PL
encenderem-te	encender+V.tu.AD.2.SG+INF+3+PL
encenderem-te	encender+V.tu.AD.2.SG+SBJF+3+PL
encenderem-vos	encender+V.vós.AD.2.PL+INF+3+PL
encenderem-vos	encender+V.vós.AD.2.PL+SBJF+3+PL
encendere-nos	encender+nós.AD.1.PL+INF+2+SG
encendere-nos	encender+nós.AD.1.PL+SBJF+2+SG
encenderes-lhe	encender+V.ele.DAT.3.SG+INF+2+SG
encenderes-lhe	encender+V.ele.DAT.3.SG+SBJF+2+SG
encenderes-lhes	encender+V.ele.DAT.3.PL+INF+2+SG
