engradecestes-me	engradecer+V.eu.AD.1.SG+PRF+2+PL
engradecestes-te	engradecer+V.tu.AD.2.SG+PRF+2+PL
engradecestes-vos	engradecer+V.vós.AD.2.PL+PRF+2+PL
engradeceste-te	engradecer+V.tu.AD.2.SG+PRF+2+SG
engradeceste-vos	engradecer+V.vós.AD.2.PL+PRF+2+SG
engradeces-vos	engradecer+V.vós.AD.2.PL+PRS+2+SG
engradeceu-a	engradecer+V.ele.ACC.3.F.SG+PRF+3+SG
engradeceu-as	engradecer+V.ele.ACC.3.F.PL+PRF+3+SG
engradeceu-lhe	engradecer+V.ele.DAT.3.SG+PRF+3+SG
engradeceu-lhes	engradecer+V.ele.DAT.3.PL+PRF+3+SG
engradeceu-me	engradecer+V.eu.AD.1.SG+PRF+3+SG
engradeceu-nos	engradecer+nós.AD.1.PL+PRF+3+SG
engradeceu-o	engradecer+V.ele.ACC.3.M.SG+PRF+3+SG
engradeceu-os	engradecer+V.ele.ACC.3.M.PL+PRF+3+SG
engradeceu-se	engradecer+V.ele.REFL+PRF+3+SG
engradeceu-te	engradecer+V.tu.AD.2.SG+PRF+3+SG
engradeceu-vos	engradecer+V.vós.AD.2.PL+PRF+3+SG
engradecia-a	engradecer+V.ele.ACC.3.F.SG+IMPF+1+SG
engradecia-a	engradecer+V.ele.ACC.3.F.SG+IMPF+3+SG
engradecia-as	engradecer+V.ele.ACC.3.F.PL+IMPF+1+SG
engradecia-as	engradecer+V.ele.ACC.3.F.PL+IMPF+3+SG
engradeci-a	engradecer+V.ele.ACC.3.F.SG+PRF+1+SG
engradecia-la	engradecer+V.ele.ACC.3.F.SG+IMPF+2+SG
engradecia-las	engradecer+V.ele.ACC.3.F.PL+IMPF+2+SG
engradecia-lhe	engradecer+V.ele.DAT.3.SG+IMPF+1+SG
engradecia-lhe	engradecer+V.ele.DAT.3.SG+IMPF+3+SG
engradecia-lhes	engradecer+V.ele.DAT.3.PL+IMPF+1+SG
engradecia-lhes	engradecer+V.ele.DAT.3.PL+IMPF+3+SG
engradecia-lo	engradecer+V.ele.ACC.3.M.SG+IMPF+2+SG
engradecia-los	engradecer+V.ele.ACC.3.M.PL+IMPF+2+SG
engradecia-me	engradecer+V.eu.AD.1.SG+IMPF+1+SG
engradecia-me	engradecer+V.eu.AD.1.SG+IMPF+3+SG
engradeciam-lhe	engradecer+V.ele.DAT.3.SG+IMPF+3+PL
engradeciam-lhes	engradecer+V.ele.DAT.3.PL+IMPF+3+PL
engradeciam-me	engradecer+V.eu.AD.1.SG+IMPF+3+PL
engradeciam-na	engradecer+V.ele.ACC.3.F.SG+IMPF+3+PL
engradeciam-nas	engradecer+V.ele.ACC.3.F.PL+IMPF+3+PL
engradeciam-no	engradecer+V.ele.ACC.3.M.SG+IMPF+3+PL
engradeciam-nos	engradecer+V.ele.ACC.3.M.PL+IMPF+3+PL
engradeciam-nos	engradecer+V.nós.AD.1.PL+IMPF+3+PL
engradecíamo-la	engradecer+V.ele.ACC.3.F.SG+IMPF+1+PL
engradecíamo-las	engradecer+V.ele.ACC.3.F.PL+IMPF+1+PL
engradecíamo-lo	engradecer+V.ele.ACC.3.M.SG+IMPF+1+PL
engradecíamo-los	engradecer+V.ele.ACC.3.M.PL+IMPF+1+PL
engradecíamo-nos	engradecer+nós.AD.1.PL+IMPF+1+PL
engradecíamos-lhe	engradecer+V.ele.DAT.3.SG+IMPF+1+PL
engradecíamos-lhes	engradecer+V.ele.DAT.3.PL+IMPF+1+PL
engradecíamos-me	engradecer+V.eu.AD.1.SG+IMPF+1+PL
engradecíamos-te	engradecer+V.tu.AD.2.SG+IMPF+1+PL
engradecíamos-vos	engradecer+V.vós.AD.2.PL+IMPF+1+PL
engradeciam-se	engradecer+V.ele.REFL+IMPF+3+PL
engradeciam-te	engradecer+V.tu.AD.2.SG+IMPF+3+PL
engradeciam-vos	engradecer+V.vós.AD.2.PL+IMPF+3+PL
engradecia-nos	engradecer+nós.AD.1.PL+IMPF+1+SG
engradecia-nos	engradecer+nós.AD.1.PL+IMPF+2+SG
engradecia-nos	engradecer+nós.AD.1.PL+IMPF+3+SG
engradecia-o	engradecer+V.ele.ACC.3.M.SG+IMPF+1+SG
engradecia-o	engradecer+V.ele.ACC.3.M.SG+IMPF+3+SG
engradecia-os	engradecer+V.ele.ACC.3.M.PL+IMPF+1+SG
engradecia-os	engradecer+V.ele.ACC.3.M.PL+IMPF+3+SG
engradecia-se	engradecer+V.ele.REFL+IMPF+3+SG
engradeci-as	engradecer+V.ele.ACC.3.F.PL+PRF+1+SG
engradecias-lhe	engradecer+V.ele.DAT.3.SG+IMPF+2+SG
engradecias-lhes	engradecer+V.ele.DAT.3.PL+IMPF+2+SG
engradecias-me	engradecer+V.eu.AD.1.SG+IMPF+2+SG
engradecias-te	engradecer+V.tu.AD.2.SG+IMPF+2+SG
engradecias-vos	engradecer+V.vós.AD.2.PL+IMPF+2+SG
engradecia-te	engradecer+V.tu.AD.2.SG+IMPF+1+SG
engradecia-te	engradecer+V.tu.AD.2.SG+IMPF+3+SG
engradecia-vos	engradecer+V.vós.AD.2.PL+IMPF+1+SG
engradecia-vos	engradecer+V.vós.AD.2.PL+IMPF+3+SG
engradecíei-la	engradecer+V.ele.ACC.3.F.SG+IMPF+2+PL
engradecíei-las	engradecer+V.ele.ACC.3.F.PL+IMPF+2+PL
engradecíei-lo	engradecer+V.ele.ACC.3.M.SG+IMPF+2+PL
engradecíei-los	engradecer+V.ele.ACC.3.M.PL+IMPF+2+PL
engradecíei-nos	engradecer+nós.AD.1.PL+IMPF+2+PL
engradecíeis-lhe	engradecer+V.ele.DAT.3.SG+IMPF+2+PL
engradecíeis-lhes	engradecer+V.ele.DAT.3.PL+IMPF+2+PL
engradecíeis-me	engradecer+V.eu.AD.1.SG+IMPF+2+PL
engradecíeis-te	engradecer+V.tu.AD.2.SG+IMPF+2+PL
engradecíeis-vos	engradecer+V.vós.AD.2.PL+IMPF+2+PL
engradeci-lhe	engradecer+V.ele.DAT.3.SG+PRF+1+SG
engradeci-lhes	engradecer+V.ele.DAT.3.PL+PRF+1+SG
engradeci-me	engradecer+V.eu.AD.1.SG+PRF+1+SG
engradeci-nos	engradecer+nós.AD.1.PL+PRF+1+SG
engradeci-o	engradecer+V.ele.ACC.3.M.SG+PRF+1+SG
engradeci-os	engradecer+V.ele.ACC.3.M.PL+PRF+1+SG
engradeci-te	engradecer+V.tu.AD.2.SG+PRF+1+SG
engradeci-vos	engradecer+V.vós.AD.2.PL+PRF+1+SG
engradeço-a	engradecer+V.ele.ACC.3.F.SG+PRS+1+SG
engradeço-as	engradecer+V.ele.ACC.3.F.PL+PRS+1+SG
engradeço-lhe	engradecer+V.ele.DAT.3.SG+PRS+1+SG
engradeço-lhes	engradecer+V.ele.DAT.3.PL+PRS+1+SG
engradeço-me	engradecer+V.eu.AD.1.SG+PRS+1+SG
engradeço-nos	engradecer+nós.AD.1.PL+PRS+1+SG
engradeço-o	engradecer+V.ele.ACC.3.M.SG+PRS+1+SG
engradeço-os	engradecer+V.ele.ACC.3.M.PL+PRS+1+SG
engradeço-te	engradecer+V.tu.AD.2.SG+PRS+1+SG
engradeço-vos	engradecer+V.vós.AD.2.PL+PRS+1+SG
engradeei-a	engradear+V.ele.ACC.3.F.SG+PRF+1+SG
engradeei-as	engradear+V.ele.ACC.3.F.PL+PRF+1+SG
engradeei-lhe	engradear+V.ele.DAT.3.SG+PRF+1+SG
engradeei-lhes	engradear+V.ele.DAT.3.PL+PRF+1+SG
engradeei-me	engradear+V.eu.AD.1.SG+PRF+1+SG
engradeei-nos	engradear+nós.AD.1.PL+PRF+1+SG
engradeei-o	engradear+V.ele.ACC.3.M.SG+PRF+1+SG
engradeei-os	engradear+V.ele.ACC.3.M.PL+PRF+1+SG
engradeei-te	engradear+V.tu.AD.2.SG+PRF+1+SG
engradeei-vos	engradear+V.vós.AD.2.PL+PRF+1+SG
engradeia-a	engradear+V.ele.ACC.3.F.SG+PRS+3+SG
engradeia-as	engradear+V.ele.ACC.3.F.PL+PRS+3+SG
engradei-a	engradar+V.ele.ACC.3.F.SG+PRF+1+SG
engradeia-la	engradear+V.ele.ACC.3.F.SG+PRS+2+SG
engradeia-las	engradear+V.ele.ACC.3.F.PL+PRS+2+SG
engradeia-lhe	engradear+V.ele.DAT.3.SG+PRS+3+SG
engradeia-lhes	engradear+V.ele.DAT.3.PL+PRS+3+SG
engradeia-lo	engradear+V.ele.ACC.3.M.SG+PRS+2+SG
engradeia-los	engradear+V.ele.ACC.3.M.PL+PRS+2+SG
engradeia-me	engradear+V.eu.AD.1.SG+PRS+3+SG
engradeiam-lhe	engradear+V.ele.DAT.3.SG+PRS+3+PL
engradeiam-lhes	engradear+V.ele.DAT.3.PL+PRS+3+PL
engradeiam-me	engradear+V.eu.AD.1.SG+PRS+3+PL
engradeiam-na	engradear+V.ele.ACC.3.F.SG+PRS+3+PL
engradeiam-nas	engradear+V.ele.ACC.3.F.PL+PRS+3+PL
engradeiam-no	engradear+V.ele.ACC.3.M.SG+PRS+3+PL
engradeiam-nos	engradear+V.ele.ACC.3.M.PL+PRS+3+PL
engradeiam-nos	engradear+V.nós.AD.1.PL+PRS+3+PL
engradeiam-se	engradear+V.ele.REFL+PRS+3+PL
engradeiam-te	engradear+V.tu.AD.2.SG+PRS+3+PL
engradeiam-vos	engradear+V.vós.AD.2.PL+PRS+3+PL
engradeia-nos	engradear+nós.AD.1.PL+PRS+2+SG
engradeia-nos	engradear+nós.AD.1.PL+PRS+3+SG
engradeia-o	engradear+V.ele.ACC.3.M.SG+PRS+3+SG
engradeia-os	engradear+V.ele.ACC.3.M.PL+PRS+3+SG
engradeia-se	engradear+V.ele.REFL+PRS+3+SG
engradei-as	engradar+V.ele.ACC.3.F.PL+PRF+1+SG
engradeias-lhe	engradear+V.ele.DAT.3.SG+PRS+2+SG
engradeias-lhes	engradear+V.ele.DAT.3.PL+PRS+2+SG
engradeias-me	engradear+V.eu.AD.1.SG+PRS+2+SG
engradeias-te	engradear+V.tu.AD.2.SG+PRS+2+SG
engradeias-vos	engradear+V.vós.AD.2.PL+PRS+2+SG
engradeia-te	engradear+V.tu.AD.2.SG+PRS+3+SG
engradeia-vos	engradear+V.vós.AD.2.PL+PRS+3+SG
engradei-lhe	engradar+V.ele.DAT.3.SG+PRF+1+SG
engradei-lhes	engradar+V.ele.DAT.3.PL+PRF+1+SG
engradei-me	engradar+V.eu.AD.1.SG+PRF+1+SG
engradei-nos	engradar+nós.AD.1.PL+PRF+1+SG
engradeio-a	engradear+V.ele.ACC.3.F.SG+PRS+1+SG
engradeio-as	engradear+V.ele.ACC.3.F.PL+PRS+1+SG
engradei-o	engradar+V.ele.ACC.3.M.SG+PRF+1+SG
engradeio-lhe	engradear+V.ele.DAT.3.SG+PRS+1+SG
engradeio-lhes	engradear+V.ele.DAT.3.PL+PRS+1+SG
engradeio-me	engradear+V.eu.AD.1.SG+PRS+1+SG
engradeio-nos	engradear+nós.AD.1.PL+PRS+1+SG
engradeio-o	engradear+V.ele.ACC.3.M.SG+PRS+1+SG
engradeio-os	engradear+V.ele.ACC.3.M.PL+PRS+1+SG
engradei-os	engradar+V.ele.ACC.3.M.PL+PRF+1+SG
engradeio-te	engradear+V.tu.AD.2.SG+PRS+1+SG
engradeio-vos	engradear+V.vós.AD.2.PL+PRS+1+SG
engradei-te	engradar+V.tu.AD.2.SG+PRF+1+SG
engradei-vos	engradar+V.vós.AD.2.PL+PRF+1+SG
engrade-lhe	engradar+V.ele.DAT.3.SG+IMP+3+SG
engrade-lhes	engradar+V.ele.DAT.3.PL+IMP+3+SG
engrade-me	engradar+V.eu.AD.1.SG+IMP+3+SG
engradem-lhe	engradar+V.ele.DAT.3.SG+IMP+3+PL
engradem-lhes	engradar+V.ele.DAT.3.PL+IMP+3+PL
engradem-me	engradar+V.eu.AD.1.SG+IMP+3+PL
engradem-na	engradar+V.ele.ACC.3.F.SG+IMP+3+PL
engradem-nas	engradar+V.ele.ACC.3.F.PL+IMP+3+PL
engradem-no	engradar+V.ele.ACC.3.M.SG+IMP+3+PL
engradem-nos	engradar+V.ele.ACC.3.M.PL+IMP+3+PL
engradem-nos	engradar+V.nós.AD.1.PL+IMP+3+PL
engrademo-la	engradar+V.ele.ACC.3.F.SG+IMP+1+PL
engrademo-las	engradar+V.ele.ACC.3.F.PL+IMP+1+PL
engrademo-lo	engradar+V.ele.ACC.3.M.SG+IMP+1+PL
engrademo-los	engradar+V.ele.ACC.3.M.PL+IMP+1+PL
engrademo-nos	engradar+nós.AD.1.PL+IMP+1+PL
engrademos-lhe	engradar+V.ele.DAT.3.SG+IMP+1+PL
engrademos-lhes	engradar+V.ele.DAT.3.PL+IMP+1+PL
engrademos-me	engradar+V.eu.AD.1.SG+IMP+1+PL
engrademos-te	engradar+V.tu.AD.2.SG+IMP+1+PL
engrademos-vos	engradar+V.vós.AD.2.PL+IMP+1+PL
engradem-se	engradar+V.ele.REFL+IMP+3+PL
engradem-te	engradar+V.tu.AD.2.SG+IMP+3+PL
engradem-vos	engradar+V.vós.AD.2.PL+IMP+3+PL
engrade-nos	engradar+nós.AD.1.PL+IMP+3+SG
engrade-o	engradar+V.ele.ACC.3.M.SG+IMP+3+SG
engrade-os	engradar+V.ele.ACC.3.M.PL+IMP+3+SG
engradeou-a	engradear+V.ele.ACC.3.F.SG+PRF+3+SG
engradeou-as	engradear+V.ele.ACC.3.F.PL+PRF+3+SG
engradeou-lhe	engradear+V.ele.DAT.3.SG+PRF+3+SG
engradeou-lhes	engradear+V.ele.DAT.3.PL+PRF+3+SG
engradeou-me	engradear+V.eu.AD.1.SG+PRF+3+SG
engradeou-nos	engradear+nós.AD.1.PL+PRF+3+SG
engradeou-o	engradear+V.ele.ACC.3.M.SG+PRF+3+SG
engradeou-os	engradear+V.ele.ACC.3.M.PL+PRF+3+SG
engradeou-se	engradear+V.ele.REFL+PRF+3+SG
engradeou-te	engradear+V.tu.AD.2.SG+PRF+3+SG
engradeou-vos	engradear+V.vós.AD.2.PL+PRF+3+SG
engrade-se	engradar+V.ele.REFL+IMP+3+SG
engrade-te	engradar+V.tu.AD.2.SG+IMP+3+SG
engrade-vos	engradar+V.vós.AD.2.PL+IMP+3+SG
engrado-a	engradar+V.ele.ACC.3.F.SG+PRS+1+SG
engrado-as	engradar+V.ele.ACC.3.F.PL+PRS+1+SG
engrado-lhe	engradar+V.ele.DAT.3.SG+PRS+1+SG
engrado-lhes	engradar+V.ele.DAT.3.PL+PRS+1+SG
engrado-me	engradar+V.eu.AD.1.SG+PRS+1+SG
engrado-nos	engradar+nós.AD.1.PL+PRS+1+SG
engrado-o	engradar+V.ele.ACC.3.M.SG+PRS+1+SG
engrado-os	engradar+V.ele.ACC.3.M.PL+PRS+1+SG
engrado-te	engradar+V.tu.AD.2.SG+PRS+1+SG
engradou-a	engradar+V.ele.ACC.3.F.SG+PRF+3+SG
engradou-as	engradar+V.ele.ACC.3.F.PL+PRF+3+SG
engradou-lhe	engradar+V.ele.DAT.3.SG+PRF+3+SG
engradou-lhes	engradar+V.ele.DAT.3.PL+PRF+3+SG
engradou-me	engradar+V.eu.AD.1.SG+PRF+3+SG
engradou-nos	engradar+nós.AD.1.PL+PRF+3+SG
engradou-o	engradar+V.ele.ACC.3.M.SG+PRF+3+SG
engradou-os	engradar+V.ele.ACC.3.M.PL+PRF+3+SG
engradou-se	engradar+V.ele.REFL+PRF+3+SG
engradou-te	engradar+V.tu.AD.2.SG+PRF+3+SG
engradou-vos	engradar+V.vós.AD.2.PL+PRF+3+SG
engrado-vos	engradar+V.vós.AD.2.PL+PRS+1+SG
engraeça-a	engraecer+V.ele.ACC.3.F.SG+IMP+3+SG
engraeça-as	engraecer+V.ele.ACC.3.F.PL+IMP+3+SG
engraeça-lhe	engraecer+V.ele.DAT.3.SG+IMP+3+SG
engraeça-lhes	engraecer+V.ele.DAT.3.PL+IMP+3+SG
engraeça-me	engraecer+V.eu.AD.1.SG+IMP+3+SG
engraeçam-lhe	engraecer+V.ele.DAT.3.SG+IMP+3+PL
engraeçam-lhes	engraecer+V.ele.DAT.3.PL+IMP+3+PL
engraeçam-me	engraecer+V.eu.AD.1.SG+IMP+3+PL
engraeçam-na	engraecer+V.ele.ACC.3.F.SG+IMP+3+PL
engraeçam-nas	engraecer+V.ele.ACC.3.F.PL+IMP+3+PL
engraeçam-no	engraecer+V.ele.ACC.3.M.SG+IMP+3+PL
engraeçam-nos	engraecer+nós.AD.1.PL+IMP+3+PL
engraeçamo-la	engraecer+V.ele.ACC.3.F.SG+IMP+1+PL
engraeçamo-las	engraecer+V.ele.ACC.3.F.PL+IMP+1+PL
engraeçamo-lo	engraecer+V.ele.ACC.3.M.SG+IMP+1+PL
engraeçamo-los	engraecer+V.ele.ACC.3.M.PL+IMP+1+PL
engraeçamo-nos	engraecer+nós.AD.1.PL+IMP+1+PL
engraeçamos-lhe	engraecer+V.ele.DAT.3.SG+IMP+1+PL
engraeçamos-lhes	engraecer+V.ele.DAT.3.PL+IMP+1+PL
engraeçamos-me	engraecer+V.eu.AD.1.SG+IMP+1+PL
engraeçamos-te	engraecer+V.tu.AD.2.SG+IMP+1+PL
engraeçamos-vos	engraecer+V.vós.AD.2.PL+IMP+1+PL
engraeçam-se	engraecer+V.ele.REFL+IMP+3+PL
engraeçam-te	engraecer+V.tu.AD.2.SG+IMP+3+PL
engraeçam-vos	engraecer+V.vós.AD.2.PL+IMP+3+PL
engraeça-nos	engraecer+nós.AD.1.PL+IMP+3+SG
engraeça-o	engraecer+V.ele.ACC.3.M.SG+IMP+3+SG
engraeça-os	engraecer+V.ele.ACC.3.M.PL+IMP+3+SG
engraeça-se	engraecer+V.ele.REFL+IMP+3+SG
engraeça-te	engraecer+V.tu.AD.2.SG+IMP+3+SG
engraeça-vos	engraecer+V.vós.AD.2.PL+IMP+3+SG
engraecei-la	engraecer+V.ele.ACC.3.F.SG+PRS+2+PL
engraecei-las	engraecer+V.ele.ACC.3.F.PL+PRS+2+PL
engraecei-lo	engraecer+V.ele.ACC.3.M.SG+PRS+2+PL
engraecei-los	engraecer+V.ele.ACC.3.M.PL+PRS+2+PL
engraecei-nos	engraecer+nós.AD.1.PL+PRS+2+PL
engraeceis-lhe	engraecer+V.ele.DAT.3.SG+PRS+2+PL
engraeceis-lhes	engraecer+V.ele.DAT.3.PL+PRS+2+PL
engraeceis-me	engraecer+V.eu.AD.1.SG+PRS+2+PL
engraeceis-te	engraecer+V.tu.AD.2.SG+PRS+2+PL
engraeceis-vos	engraecer+V.vós.AD.2.PL+PRS+2+PL
engraecê-la-á	engraecer+V.ele.ACC.3.F.SG+FUT+3+SG
engraecê-la-ão	engraecer+V.ele.ACC.3.F.SG+FUT+3+PL
engraecê-la-ás	engraecer+V.ele.ACC.3.F.SG+FUT+2+SG
engraecê-la-ei	engraecer+V.ele.ACC.3.F.SG+FUT+1+SG
engraecê-la-eis	engraecer+V.ele.ACC.3.F.SG+FUT+2+PL
engraecê-la-emos	engraecer+V.ele.ACC.3.F.SG+FUT+1+PL
engraecê-la	engraecer+V.ele.ACC.3.F.SG+INF
engraecê-la	engraecer+V.ele.ACC.3.F.SG+INF+1+SG
engraecê-la	engraecer+V.ele.ACC.3.F.SG+INF+3+SG
engraece-la	engraecer+V.ele.ACC.3.F.SG+PRS+2+SG
engraecê-la	engraecer+V.ele.ACC.3.F.SG+SBJF+1+SG
engraecê-la	engraecer+V.ele.ACC.3.F.SG+SBJF+3+SG
engraecê-la-ia	engraecer+V.ele.ACC.3.F.SG+COND+1+SG
engraecê-la-ia	engraecer+V.ele.ACC.3.F.SG+COND+3+SG
engraecê-la-iam	engraecer+V.ele.ACC.3.F.SG+COND+3+PL
engraecê-la-íamos	engraecer+V.ele.ACC.3.F.SG+COND+1+PL
engraecê-la-ias	engraecer+V.ele.ACC.3.F.SG+COND+2+SG
engraecê-la-íeis	engraecer+V.ele.ACC.3.F.SG+COND+2+PL
engraecê-las-á	engraecer+V.ele.ACC.3.F.PL+FUT+3+SG
engraecê-las-ão	engraecer+V.ele.ACC.3.F.PL+FUT+3+PL
engraecê-las-ás	engraecer+V.ele.ACC.3.F.PL+FUT+2+SG
engraecê-las-ei	engraecer+V.ele.ACC.3.F.PL+FUT+1+SG
engraecê-las-eis	engraecer+V.ele.ACC.3.F.PL+FUT+2+PL
engraecê-las-emos	engraecer+V.ele.ACC.3.F.PL+FUT+1+PL
engraecê-las	engraecer+V.ele.ACC.3.F.PL+INF
engraecê-las	engraecer+V.ele.ACC.3.F.PL+INF+1+SG
engraecê-las	engraecer+V.ele.ACC.3.F.PL+INF+3+SG
engraece-las	engraecer+V.ele.ACC.3.F.PL+PRS+2+SG
engraecê-las	engraecer+V.ele.ACC.3.F.PL+SBJF+1+SG
engraecê-las	engraecer+V.ele.ACC.3.F.PL+SBJF+3+SG
engraecê-las-ia	engraecer+V.ele.ACC.3.F.PL+COND+1+SG
engraecê-las-ia	engraecer+V.ele.ACC.3.F.PL+COND+3+SG
engraecê-las-iam	engraecer+V.ele.ACC.3.F.PL+COND+3+PL
engraecê-las-íamos	engraecer+V.ele.ACC.3.F.PL+COND+1+PL
engraecê-las-ias	engraecer+V.ele.ACC.3.F.PL+COND+2+SG
engraecê-las-íeis	engraecer+V.ele.ACC.3.F.PL+COND+2+PL
engraecê-lo-á	engraecer+V.ele.ACC.3.M.SG+FUT+3+SG
engraecê-lo-ão	engraecer+V.ele.ACC.3.M.SG+FUT+3+PL
engraecê-lo-ás	engraecer+V.ele.ACC.3.M.SG+FUT+2+SG
engraecê-lo-ei	engraecer+V.ele.ACC.3.M.SG+FUT+1+SG
engraecê-lo-eis	engraecer+V.ele.ACC.3.M.SG+FUT+2+PL
engraecê-lo-emos	engraecer+V.ele.ACC.3.M.SG+FUT+1+PL
engraecê-lo	engraecer+V.ele.ACC.3.M.SG+INF
engraecê-lo	engraecer+V.ele.ACC.3.M.SG+INF+1+SG
engraecê-lo	engraecer+V.ele.ACC.3.M.SG+INF+3+SG
engraece-lo	engraecer+V.ele.ACC.3.M.SG+PRS+2+SG
engraecê-lo	engraecer+V.ele.ACC.3.M.SG+SBJF+1+SG
engraecê-lo	engraecer+V.ele.ACC.3.M.SG+SBJF+3+SG
engraecê-lo-ia	engraecer+V.ele.ACC.3.M.SG+COND+1+SG
engraecê-lo-ia	engraecer+V.ele.ACC.3.M.SG+COND+3+SG
engraecê-lo-iam	engraecer+V.ele.ACC.3.M.SG+COND+3+PL
engraecê-lo-íamos	engraecer+V.ele.ACC.3.M.SG+COND+1+PL
engraecê-lo-ias	engraecer+V.ele.ACC.3.M.SG+COND+2+SG
engraecê-lo-íeis	engraecer+V.ele.ACC.3.M.SG+COND+2+PL
engraecê-los-á	engraecer+V.ele.ACC.3.M.PL+FUT+3+SG
engraecê-los-ão	engraecer+V.ele.ACC.3.M.PL+FUT+3+PL
engraecê-los-ás	engraecer+V.ele.ACC.3.M.PL+FUT+2+SG
engraecê-los-ei	engraecer+V.ele.ACC.3.M.PL+FUT+1+SG
engraecê-los-eis	engraecer+V.ele.ACC.3.M.PL+FUT+2+PL
engraecê-los-emos	engraecer+V.ele.ACC.3.M.PL+FUT+1+PL
engraecê-los	engraecer+V.ele.ACC.3.M.PL+INF
engraecê-los	engraecer+V.ele.ACC.3.M.PL+INF+1+SG
engraecê-los	engraecer+V.ele.ACC.3.M.PL+INF+3+SG
engraece-los	engraecer+V.ele.ACC.3.M.PL+PRS+2+SG
engraecê-los	engraecer+V.ele.ACC.3.M.PL+SBJF+1+SG
engraecê-los	engraecer+V.ele.ACC.3.M.PL+SBJF+3+SG
engraecê-los-ia	engraecer+V.ele.ACC.3.M.PL+COND+1+SG
engraecê-los-ia	engraecer+V.ele.ACC.3.M.PL+COND+3+SG
engraecê-los-iam	engraecer+V.ele.ACC.3.M.PL+COND+3+PL
engraecê-los-íamos	engraecer+V.ele.ACC.3.M.PL+COND+1+PL
engraecê-los-ias	engraecer+V.ele.ACC.3.M.PL+COND+2+SG
engraecê-los-íeis	engraecer+V.ele.ACC.3.M.PL+COND+2+PL
engraecem-lhe	engraecer+V.ele.DAT.3.SG+PRS+3+PL
engraecem-lhes	engraecer+V.ele.DAT.3.PL+PRS+3+PL
engraecem-me	engraecer+V.eu.AD.1.SG+PRS+3+PL
engraecem-na	engraecer+V.ele.ACC.3.F.SG+PRS+3+PL
engraecem-nas	engraecer+V.ele.ACC.3.F.PL+PRS+3+PL
engraecem-no	engraecer+V.ele.ACC.3.M.SG+PRS+3+PL
engraecem-nos	engraecer+V.ele.ACC.3.M.PL+PRS+3+PL
engraecem-nos	engraecer+V.nós.AD.1.PL+PRS+3+PL
engraecemo-la	engraecer+V.ele.ACC.3.F.SG+PRF+1+PL
engraecemo-la	engraecer+V.ele.ACC.3.F.SG+PRS+1+PL
engraecemo-las	engraecer+V.ele.ACC.3.F.PL+PRF+1+PL
engraecemo-las	engraecer+V.ele.ACC.3.F.PL+PRS+1+PL
engraecemo-lo	engraecer+V.ele.ACC.3.M.SG+PRF+1+PL
engraecemo-lo	engraecer+V.ele.ACC.3.M.SG+PRS+1+PL
engraecemo-los	engraecer+V.ele.ACC.3.M.PL+PRF+1+PL
engraecemo-los	engraecer+V.ele.ACC.3.M.PL+PRS+1+PL
engraecemo-nos	engraecer+nós.AD.1.PL+PRF+1+PL
engraecemo-nos	engraecer+nós.AD.1.PL+PRS+1+PL
engraecemos-lhe	engraecer+V.ele.DAT.3.SG+PRF+1+PL
engraecemos-lhe	engraecer+V.ele.DAT.3.SG+PRS+1+PL
engraecemos-lhes	engraecer+V.ele.DAT.3.PL+PRF+1+PL
engraecemos-lhes	engraecer+V.ele.DAT.3.PL+PRS+1+PL
engraecemos-me	engraecer+V.eu.AD.1.SG+PRF+1+PL
engraecemos-me	engraecer+V.eu.AD.1.SG+PRS+1+PL
engraecemos-te	engraecer+V.tu.AD.2.SG+PRF+1+PL
engraecemos-te	engraecer+V.tu.AD.2.SG+PRS+1+PL
engraecemos-vos	engraecer+V.vós.AD.2.PL+PRF+1+PL
engraecemos-vos	engraecer+V.vós.AD.2.PL+PRS+1+PL
engraecem-se	engraecer+V.ele.REFL+PRS+3+PL
engraecem-te	engraecer+V.tu.AD.2.SG+PRS+3+PL
engraecem-vos	engraecer+V.vós.AD.2.PL+PRS+3+PL
engraecendo-a	engraecer+V.ele.ACC.3.F.SG+GRD
engraecendo-as	engraecer+V.ele.ACC.3.F.PL+GRD
engraecendo-lhe	engraecer+V.ele.DAT.3.SG+GRD
engraecendo-lhes	engraecer+V.ele.DAT.3.PL+GRD
engraecendo-me	engraecer+V.eu.AD.1.SG+GRD
engraecendo-nos	engraecer+nós.AD.1.PL+GRD
engraecendo-o	engraecer+V.ele.ACC.3.M.SG+GRD
engraecendo-os	engraecer+V.ele.ACC.3.M.PL+GRD
engraecendo-se	engraecer+V.ele.REFL+GRD
engraecendo-te	engraecer+V.tu.AD.2.SG+GRD
engraecendo-vos	engraecer+V.vós.AD.2.PL+GRD
engraece-nos	engraecer+nós.AD.1.PL+PRS+2+SG
engraecera-a	engraecer+V.ele.ACC.3.F.SG+PQP+1+SG
engraecera-a	engraecer+V.ele.ACC.3.F.SG+PQP+3+SG
engraecera-as	engraecer+V.ele.ACC.3.F.PL+PQP+1+SG
engraecera-as	engraecer+V.ele.ACC.3.F.PL+PQP+3+SG
engraecera-la	engraecer+V.ele.ACC.3.F.SG+PQP+2+SG
engraecera-las	engraecer+V.ele.ACC.3.F.PL+PQP+2+SG
engraecera-lhe	engraecer+V.ele.DAT.3.SG+PQP+1+SG
engraecera-lhe	engraecer+V.ele.DAT.3.SG+PQP+3+SG
engraecera-lhes	engraecer+V.ele.DAT.3.PL+PQP+1+SG
engraecera-lhes	engraecer+V.ele.DAT.3.PL+PQP+3+SG
engraecera-lo	engraecer+V.ele.ACC.3.M.SG+PQP+2+SG
engraecera-los	engraecer+V.ele.ACC.3.M.PL+PQP+2+SG
engraecera-me	engraecer+V.eu.AD.1.SG+PQP+1+SG
engraecera-me	engraecer+V.eu.AD.1.SG+PQP+3+SG
engraeceram-lhe	engraecer+V.ele.DAT.3.SG+PQP+3+PL
engraeceram-lhe	engraecer+V.ele.DAT.3.SG+PRF+3+PL
engraeceram-lhes	engraecer+V.ele.DAT.3.PL+PQP+3+PL
engraeceram-lhes	engraecer+V.ele.DAT.3.PL+PRF+3+PL
engraeceram-me	engraecer+V.eu.AD.1.SG+PQP+3+PL
engraeceram-me	engraecer+V.eu.AD.1.SG+PRF+3+PL
engraeceram-na	engraecer+V.ele.ACC.3.F.SG+PQP+3+PL
engraeceram-na	engraecer+V.ele.ACC.3.F.SG+PRF+3+PL
engraeceram-nas	engraecer+V.ele.ACC.3.F.PL+PQP+3+PL
engraeceram-nas	engraecer+V.ele.ACC.3.F.PL+PRF+3+PL
engraeceram-no	engraecer+V.ele.ACC.3.M.SG+PQP+3+PL
engraeceram-no	engraecer+V.ele.ACC.3.M.SG+PRF+3+PL
engraeceram-nos	engraecer+V.ele.ACC.3.M.PL+PQP+3+PL
engraeceram-nos	engraecer+V.ele.ACC.3.M.PL+PRF+3+PL
engraeceram-nos	engraecer+V.nós.AD.1.PL+PQP+3+PL
engraeceram-nos	engraecer+V.nós.AD.1.PL+PRF+3+PL
engraecêramo-la	engraecer+V.ele.ACC.3.F.SG+PQP+1+PL
engraecêramo-las	engraecer+V.ele.ACC.3.F.PL+PQP+1+PL
engraecêramo-lo	engraecer+V.ele.ACC.3.M.SG+PQP+1+PL
engraecêramo-los	engraecer+V.ele.ACC.3.M.PL+PQP+1+PL
engraecêramo-nos	engraecer+nós.AD.1.PL+PQP+1+PL
engraecêramos-lhe	engraecer+V.ele.DAT.3.SG+PQP+1+PL
engraecêramos-lhes	engraecer+V.ele.DAT.3.PL+PQP+1+PL
engraecêramos-me	engraecer+V.eu.AD.1.SG+PQP+1+PL
engraecêramos-te	engraecer+V.tu.AD.2.SG+PQP+1+PL
engraecêramos-vos	engraecer+V.vós.AD.2.PL+PQP+1+PL
engraeceram-se	engraecer+V.ele.REFL+PQP+3+PL
engraeceram-se	engraecer+V.ele.REFL+PRF+3+PL
engraeceram-te	engraecer+V.tu.AD.2.SG+PQP+3+PL
engraeceram-te	engraecer+V.tu.AD.2.SG+PRF+3+PL
engraeceram-vos	engraecer+V.vós.AD.2.PL+PQP+3+PL
engraeceram-vos	engraecer+V.vós.AD.2.PL+PRF+3+PL
engraecera-nos	engraecer+nós.AD.1.PL+PQP+1+SG
engraecera-nos	engraecer+nós.AD.1.PL+PQP+2+SG
engraecera-nos	engraecer+nós.AD.1.PL+PQP+3+SG
engraecera-o	engraecer+V.ele.ACC.3.M.SG+PQP+1+SG
engraecera-o	engraecer+V.ele.ACC.3.M.SG+PQP+3+SG
engraecera-os	engraecer+V.ele.ACC.3.M.PL+PQP+1+SG
engraecera-os	engraecer+V.ele.ACC.3.M.PL+PQP+3+SG
engraecera-se	engraecer+V.ele.REFL+PQP+3+SG
engraeceras-lhe	engraecer+V.ele.DAT.3.SG+PQP+2+SG
engraeceras-lhes	engraecer+V.ele.DAT.3.PL+PQP+2+SG
engraeceras-me	engraecer+V.eu.AD.1.SG+PQP+2+SG
engraeceras-te	engraecer+V.tu.AD.2.SG+PQP+2+SG
engraeceras-vos	engraecer+V.vós.AD.2.PL+PQP+2+SG
engraecera-te	engraecer+V.tu.AD.2.SG+PQP+1+SG
engraecera-te	engraecer+V.tu.AD.2.SG+PQP+3+SG
engraecera-vos	engraecer+V.vós.AD.2.PL+PQP+1+SG
engraecera-vos	engraecer+V.vós.AD.2.PL+PQP+3+SG
engraecerde-la	engraecer+V.ele.ACC.3.F.SG+INF+2+PL
engraecerde-la	engraecer+V.ele.ACC.3.F.SG+SBJF+2+PL
engraecerde-las	engraecer+V.ele.ACC.3.F.PL+INF+2+PL
engraecerde-las	engraecer+V.ele.ACC.3.F.PL+SBJF+2+PL
engraecerde-lo	engraecer+V.ele.ACC.3.M.SG+INF+2+PL
engraecerde-lo	engraecer+V.ele.ACC.3.M.SG+SBJF+2+PL
engraecerde-los	engraecer+V.ele.ACC.3.M.PL+INF+2+PL
engraecerde-los	engraecer+V.ele.ACC.3.M.PL+SBJF+2+PL
engraecerde-nos	engraecer+nós.AD.1.PL+INF+2+PL
engraecerde-nos	engraecer+nós.AD.1.PL+SBJF+2+PL
engraecerdes-lhe	engraecer+V.ele.DAT.3.SG+INF+2+PL
engraecerdes-lhe	engraecer+V.ele.DAT.3.SG+SBJF+2+PL
engraecerdes-lhes	engraecer+V.ele.DAT.3.PL+INF+2+PL
engraecerdes-lhes	engraecer+V.ele.DAT.3.PL+SBJF+2+PL
engraecerdes-me	engraecer+V.eu.AD.1.SG+INF+2+PL
engraecerdes-me	engraecer+V.eu.AD.1.SG+SBJF+2+PL
engraecerdes-te	engraecer+V.tu.AD.2.SG+INF+2+PL
engraecerdes-te	engraecer+V.tu.AD.2.SG+SBJF+2+PL
engraecerdes-vos	engraecer+V.vós.AD.2.PL+INF+2+PL
engraecerdes-vos	engraecer+V.vós.AD.2.PL+SBJF+2+PL
engraecêrei-la	engraecer+V.ele.ACC.3.F.SG+PQP+2+PL
engraecêrei-las	engraecer+V.ele.ACC.3.F.PL+PQP+2+PL
engraecêrei-lo	engraecer+V.ele.ACC.3.M.SG+PQP+2+PL
engraecêrei-los	engraecer+V.ele.ACC.3.M.PL+PQP+2+PL
engraecêrei-nos	engraecer+nós.AD.1.PL+PQP+2+PL
engraecêreis-lhe	engraecer+V.ele.DAT.3.SG+PQP+2+PL
engraecêreis-lhes	engraecer+V.ele.DAT.3.PL+PQP+2+PL
engraecêreis-me	engraecer+V.eu.AD.1.SG+PQP+2+PL
engraecêreis-te	engraecer+V.tu.AD.2.SG+PQP+2+PL
engraecêreis-vos	engraecer+V.vós.AD.2.PL+PQP+2+PL
engraecere-la	engraecer+V.ele.ACC.3.F.SG+INF+2+SG
engraecere-la	engraecer+V.ele.ACC.3.F.SG+SBJF+2+SG
engraecere-las	engraecer+V.ele.ACC.3.F.PL+INF+2+SG
engraecere-las	engraecer+V.ele.ACC.3.F.PL+SBJF+2+SG
engraecere-lo	engraecer+V.ele.ACC.3.M.SG+INF+2+SG
engraecere-lo	engraecer+V.ele.ACC.3.M.SG+SBJF+2+SG
engraecere-los	engraecer+V.ele.ACC.3.M.PL+INF+2+SG
engraecere-los	engraecer+V.ele.ACC.3.M.PL+SBJF+2+SG
engraecerem-lhe	engraecer+V.ele.DAT.3.SG+INF+3+PL
engraecerem-lhe	engraecer+V.ele.DAT.3.SG+SBJF+3+PL
engraecerem-lhes	engraecer+V.ele.DAT.3.PL+INF+3+PL
engraecerem-lhes	engraecer+V.ele.DAT.3.PL+SBJF+3+PL
engraecerem-me	engraecer+V.eu.AD.1.SG+INF+3+PL
engraecerem-me	engraecer+V.eu.AD.1.SG+SBJF+3+PL
engraecerem-na	engraecer+V.ele.ACC.3.F.SG+INF+3+PL
engraecerem-na	engraecer+V.ele.ACC.3.F.SG+SBJF+3+PL
engraecerem-nas	engraecer+V.ele.ACC.3.F.PL+INF+3+PL
engraecerem-nas	engraecer+V.ele.ACC.3.F.PL+SBJF+3+PL
engraecerem-no	engraecer+V.ele.ACC.3.M.SG+INF+3+PL
engraecerem-no	engraecer+V.ele.ACC.3.M.SG+SBJF+3+PL
engraecerem-nos	engraecer+V.ele.ACC.3.M.PL+INF+3+PL
engraecerem-nos	engraecer+V.ele.ACC.3.M.PL+SBJF+3+PL
engraecerem-nos	engraecer+V.nós.AD.1.PL+INF+3+PL
engraecerem-nos	engraecer+V.nós.AD.1.PL+SBJF+3+PL
engraecerem-se	engraecer+V.ele.REFL+INF+3+PL
engraecerem-se	engraecer+V.ele.REFL+SBJF+3+PL
engraecerem-te	engraecer+V.tu.AD.2.SG+INF+3+PL
engraecerem-te	engraecer+V.tu.AD.2.SG+SBJF+3+PL
engraecerem-vos	engraecer+V.vós.AD.2.PL+INF+3+PL
engraecerem-vos	engraecer+V.vós.AD.2.PL+SBJF+3+PL
engraecere-nos	engraecer+nós.AD.1.PL+INF+2+SG
engraecere-nos	engraecer+nós.AD.1.PL+SBJF+2+SG
engraeceres-lhe	engraecer+V.ele.DAT.3.SG+INF+2+SG
engraeceres-lhe	engraecer+V.ele.DAT.3.SG+SBJF+2+SG
engraeceres-lhes	engraecer+V.ele.DAT.3.PL+INF+2+SG
engraeceres-lhes	engraecer+V.ele.DAT.3.PL+SBJF+2+SG
engraeceres-me	engraecer+V.eu.AD.1.SG+INF+2+SG
engraeceres-me	engraecer+V.eu.AD.1.SG+SBJF+2+SG
engraeceres-te	engraecer+V.tu.AD.2.SG+INF+2+SG
engraeceres-te	engraecer+V.tu.AD.2.SG+SBJF+2+SG
engraeceres-vos	engraecer+V.vós.AD.2.PL+INF+2+SG
engraeceres-vos	engraecer+V.vós.AD.2.PL+SBJF+2+SG
engraecer-lhe-á	engraecer+V.ele.DAT.3.SG+FUT+3+SG
engraecer-lhe-ão	engraecer+V.ele.DAT.3.SG+FUT+3+PL
engraecer-lhe-ás	engraecer+V.ele.DAT.3.SG+FUT+2+SG
engraecer-lhe-ei	engraecer+V.ele.DAT.3.SG+FUT+1+SG
engraecer-lhe-eis	engraecer+V.ele.DAT.3.SG+FUT+2+PL
engraecer-lhe-emos	engraecer+V.ele.DAT.3.SG+FUT+1+PL
engraecer-lhe	engraecer+V.ele.DAT.3.SG+INF
engraecer-lhe	engraecer+V.ele.DAT.3.SG+INF+1+SG
engraecer-lhe	engraecer+V.ele.DAT.3.SG+INF+3+SG
engraecer-lhe	engraecer+V.ele.DAT.3.SG+SBJF+1+SG
engraecer-lhe	engraecer+V.ele.DAT.3.SG+SBJF+3+SG
engraecer-lhe-ia	engraecer+V.ele.DAT.3.SG+COND+1+SG
engraecer-lhe-ia	engraecer+V.ele.DAT.3.SG+COND+3+SG
engraecer-lhe-iam	engraecer+V.ele.DAT.3.SG+COND+3+PL
engraecer-lhe-íamos	engraecer+V.ele.DAT.3.SG+COND+1+PL
engraecer-lhe-ias	engraecer+V.ele.DAT.3.SG+COND+2+SG
engraecer-lhe-íeis	engraecer+V.ele.DAT.3.SG+COND+2+PL
engraecer-lhes-á	engraecer+V.ele.DAT.3.PL+FUT+3+SG
engraecer-lhes-ão	engraecer+V.ele.DAT.3.PL+FUT+3+PL
engraecer-lhes-ás	engraecer+V.ele.DAT.3.PL+FUT+2+SG
engraecer-lhes-ei	engraecer+V.ele.DAT.3.PL+FUT+1+SG
engraecer-lhes-eis	engraecer+V.ele.DAT.3.PL+FUT+2+PL
engraecer-lhes-emos	engraecer+V.ele.DAT.3.PL+FUT+1+PL
engraecer-lhes	engraecer+V.ele.DAT.3.PL+INF
engraecer-lhes	engraecer+V.ele.DAT.3.PL+INF+1+SG
engraecer-lhes	engraecer+V.ele.DAT.3.PL+INF+3+SG
engraecer-lhes	engraecer+V.ele.DAT.3.PL+SBJF+1+SG
engraecer-lhes	engraecer+V.ele.DAT.3.PL+SBJF+3+SG
engraecer-lhes-ia	engraecer+V.ele.DAT.3.PL+COND+1+SG
engraecer-lhes-ia	engraecer+V.ele.DAT.3.PL+COND+3+SG
engraecer-lhes-iam	engraecer+V.ele.DAT.3.PL+COND+3+PL
engraecer-lhes-íamos	engraecer+V.ele.DAT.3.PL+COND+1+PL
engraecer-lhes-ias	engraecer+V.ele.DAT.3.PL+COND+2+SG
engraecer-lhes-íeis	engraecer+V.ele.DAT.3.PL+COND+2+PL
engraecer-me-á	engraecer+V.eu.AD.1.SG+FUT+3+SG
engraecer-me-ão	engraecer+V.eu.AD.1.SG+FUT+3+PL
engraecer-me-ás	engraecer+V.eu.AD.1.SG+FUT+2+SG
engraecer-me-ei	engraecer+V.eu.AD.1.SG+FUT+1+SG
engraecer-me-eis	engraecer+V.eu.AD.1.SG+FUT+2+PL
engraecer-me-emos	engraecer+V.eu.AD.1.SG+FUT+1+PL
engraecer-me	engraecer+V.eu.AD.1.SG+INF
engraecer-me	engraecer+V.eu.AD.1.SG+INF+1+SG
engraecer-me	engraecer+V.eu.AD.1.SG+INF+3+SG
engraecer-me	engraecer+V.eu.AD.1.SG+SBJF+1+SG
engraecer-me	engraecer+V.eu.AD.1.SG+SBJF+3+SG
engraecer-me-ia	engraecer+V.eu.AD.1.SG+COND+1+SG
engraecer-me-ia	engraecer+V.eu.AD.1.SG+COND+3+SG
engraecer-me-iam	engraecer+V.eu.AD.1.SG+COND+3+PL
engraecer-me-íamos	engraecer+V.eu.AD.1.SG+COND+1+PL
engraecer-me-ias	engraecer+V.eu.AD.1.SG+COND+2+SG
engraecer-me-íeis	engraecer+V.eu.AD.1.SG+COND+2+PL
engraecermo-la	engraecer+V.ele.ACC.3.F.SG+INF+1+PL
engraecermo-la	engraecer+V.ele.ACC.3.F.SG+SBJF+1+PL
engraecermo-las	engraecer+V.ele.ACC.3.F.PL+INF+1+PL
engraecermo-las	engraecer+V.ele.ACC.3.F.PL+SBJF+1+PL
engraecermo-lo	engraecer+V.ele.ACC.3.M.SG+INF+1+PL
engraecermo-lo	engraecer+V.ele.ACC.3.M.SG+SBJF+1+PL
engraecermo-los	engraecer+V.ele.ACC.3.M.PL+INF+1+PL
engraecermo-los	engraecer+V.ele.ACC.3.M.PL+SBJF+1+PL
engraecermo-nos	engraecer+nós.AD.1.PL+INF+1+PL
engraecermo-nos	engraecer+nós.AD.1.PL+SBJF+1+PL
engraecermos-lhe	engraecer+V.ele.DAT.3.SG+INF+1+PL
engraecermos-lhe	engraecer+V.ele.DAT.3.SG+SBJF+1+PL
engraecermos-lhes	engraecer+V.ele.DAT.3.PL+INF+1+PL
engraecermos-lhes	engraecer+V.ele.DAT.3.PL+SBJF+1+PL
engraecermos-me	engraecer+V.eu.AD.1.SG+INF+1+PL
engraecermos-me	engraecer+V.eu.AD.1.SG+SBJF+1+PL
engraecermos-te	engraecer+V.tu.AD.2.SG+INF+1+PL
engraecermos-te	engraecer+V.tu.AD.2.SG+SBJF+1+PL
engraecermos-vos	engraecer+V.vós.AD.2.PL+INF+1+PL
engraecermos-vos	engraecer+V.vós.AD.2.PL+SBJF+1+PL
engraecer-nos-á	engraecer+nós.AD.1.PL+FUT+3+SG
engraecer-nos-ão	engraecer+nós.AD.1.PL+FUT+3+PL
engraecer-nos-ás	engraecer+nós.AD.1.PL+FUT+2+SG
engraecer-nos-ei	engraecer+nós.AD.1.PL+FUT+1+SG
engraecer-nos-eis	engraecer+nós.AD.1.PL+FUT+2+PL
engraecer-nos-emos	engraecer+nós.AD.1.PL+FUT+1+PL
engraecer-nos	engraecer+nós.AD.1.PL+INF
engraecer-nos	engraecer+nós.AD.1.PL+INF+1+SG
engraecer-nos	engraecer+nós.AD.1.PL+INF+3+SG
engraecer-nos	engraecer+nós.AD.1.PL+SBJF+1+SG
engraecer-nos	engraecer+nós.AD.1.PL+SBJF+3+SG
engraecer-nos-ia	engraecer+nós.AD.1.PL+COND+1+SG
engraecer-nos-ia	engraecer+nós.AD.1.PL+COND+3+SG
engraecer-nos-iam	engraecer+nós.AD.1.PL+COND+3+PL
engraecer-nos-íamos	engraecer+nós.AD.1.PL+COND+1+PL
engraecer-nos-ias	engraecer+nós.AD.1.PL+COND+2+SG
engraecer-nos-íeis	engraecer+nós.AD.1.PL+COND+2+PL
engraecer-se-á	engraecer+V.ele.REFL+FUT+3+SG
engraecer-se-ão	engraecer+V.ele.REFL+FUT+3+PL
engraecer-se	engraecer+V.ele.REFL+INF
engraecer-se	engraecer+V.ele.REFL+INF+3+SG
engraecer-se	engraecer+V.ele.REFL+SBJF+3+SG
engraecer-se-ia	engraecer+V.ele.REFL+COND+3+SG
engraecer-se-iam	engraecer+V.ele.REFL+COND+3+PL
engraecer-te-á	engraecer+V.tu.AD.2.SG+FUT+3+SG
engraecer-te-ão	engraecer+V.tu.AD.2.SG+FUT+3+PL
engraecer-te-ás	engraecer+V.tu.AD.2.SG+FUT+2+SG
engraecer-te-ei	engraecer+V.tu.AD.2.SG+FUT+1+SG
engraecer-te-eis	engraecer+V.tu.AD.2.SG+FUT+2+PL
engraecer-te-emos	engraecer+V.tu.AD.2.SG+FUT+1+PL
engraecer-te	engraecer+V.tu.AD.2.SG+INF
engraecer-te	engraecer+V.tu.AD.2.SG+INF+1+SG
engraecer-te	engraecer+V.tu.AD.2.SG+INF+3+SG
engraecer-te	engraecer+V.tu.AD.2.SG+SBJF+1+SG
engraecer-te	engraecer+V.tu.AD.2.SG+SBJF+3+SG
engraecer-te-ia	engraecer+V.tu.AD.2.SG+COND+1+SG
engraecer-te-ia	engraecer+V.tu.AD.2.SG+COND+3+SG
engraecer-te-iam	engraecer+V.tu.AD.2.SG+COND+3+PL
engraecer-te-íamos	engraecer+V.tu.AD.2.SG+COND+1+PL
engraecer-te-ias	engraecer+V.tu.AD.2.SG+COND+2+SG
engraecer-te-íeis	engraecer+V.tu.AD.2.SG+COND+2+PL
engraecer-vos-á	engraecer+V.vós.AD.2.PL+FUT+3+SG
engraecer-vos-ão	engraecer+V.vós.AD.2.PL+FUT+3+PL
engraecer-vos-ás	engraecer+V.vós.AD.2.PL+FUT+2+SG
engraecer-vos-ei	engraecer+V.vós.AD.2.PL+FUT+1+SG
engraecer-vos-eis	engraecer+V.vós.AD.2.PL+FUT+2+PL
engraecer-vos-emos	engraecer+V.vós.AD.2.PL+FUT+1+PL
engraecer-vos	engraecer+V.vós.AD.2.PL+INF
engraecer-vos	engraecer+V.vós.AD.2.PL+INF+1+SG
engraecer-vos	engraecer+V.vós.AD.2.PL+INF+3+SG
engraecer-vos	engraecer+V.vós.AD.2.PL+SBJF+1+SG
engraecer-vos	engraecer+V.vós.AD.2.PL+SBJF+3+SG
engraecer-vos-ia	engraecer+V.vós.AD.2.PL+COND+1+SG
engraecer-vos-ia	engraecer+V.vós.AD.2.PL+COND+3+SG
engraecer-vos-iam	engraecer+V.vós.AD.2.PL+COND+3+PL
engraecer-vos-íamos	engraecer+V.vós.AD.2.PL+COND+1+PL
engraecer-vos-ias	engraecer+V.vós.AD.2.PL+COND+2+SG
engraecer-vos-íeis	engraecer+V.vós.AD.2.PL+COND+2+PL
engraece-se	engraecer+V.ele.REFL+PRS+3+SG
engraeces-lhe	engraecer+V.ele.DAT.3.SG+PRS+2+SG
engraeces-lhes	engraecer+V.ele.DAT.3.PL+PRS+2+SG
engraeces-me	engraecer+V.eu.AD.1.SG+PRS+2+SG
engraeceste-a	engraecer+V.ele.ACC.3.F.SG+PRF+2+SG
engraeceste-as	engraecer+V.ele.ACC.3.F.PL+PRF+2+SG
engraeces-te	engraecer+V.tu.AD.2.SG+PRS+2+SG
engraeceste-la	engraecer+V.ele.ACC.3.F.SG+PRF+2+PL
engraeceste-las	engraecer+V.ele.ACC.3.F.PL+PRF+2+PL
engraeceste-lhe	engraecer+V.ele.DAT.3.SG+PRF+2+SG
engraeceste-lhes	engraecer+V.ele.DAT.3.PL+PRF+2+SG
engraeceste-lo	engraecer+V.ele.ACC.3.M.SG+PRF+2+PL
engraeceste-los	engraecer+V.ele.ACC.3.M.PL+PRF+2+PL
engraeceste-me	engraecer+V.eu.AD.1.SG+PRF+2+SG
engraeceste-nos	engraecer+nós.AD.1.PL+PRF+2+PL
engraeceste-nos	engraecer+nós.AD.1.PL+PRF+2+SG
engraeceste-o	engraecer+V.ele.ACC.3.M.SG+PRF+2+SG
engraeceste-os	engraecer+V.ele.ACC.3.M.PL+PRF+2+SG
engraecestes-lhe	engraecer+V.ele.DAT.3.SG+PRF+2+PL
engraecestes-lhes	engraecer+V.ele.DAT.3.PL+PRF+2+PL
engraecestes-me	engraecer+V.eu.AD.1.SG+PRF+2+PL
engraecestes-te	engraecer+V.tu.AD.2.SG+PRF+2+PL
engraecestes-vos	engraecer+V.vós.AD.2.PL+PRF+2+PL
engraeceste-te	engraecer+V.tu.AD.2.SG+PRF+2+SG
engraeceste-vos	engraecer+V.vós.AD.2.PL+PRF+2+SG
engraeces-vos	engraecer+V.vós.AD.2.PL+PRS+2+SG
engraeceu-a	engraecer+V.ele.ACC.3.F.SG+PRF+3+SG
engraeceu-as	engraecer+V.ele.ACC.3.F.PL+PRF+3+SG
engraeceu-lhe	engraecer+V.ele.DAT.3.SG+PRF+3+SG
engraeceu-lhes	engraecer+V.ele.DAT.3.PL+PRF+3+SG
engraeceu-me	engraecer+V.eu.AD.1.SG+PRF+3+SG
engraeceu-nos	engraecer+nós.AD.1.PL+PRF+3+SG
engraeceu-o	engraecer+V.ele.ACC.3.M.SG+PRF+3+SG
engraeceu-os	engraecer+V.ele.ACC.3.M.PL+PRF+3+SG
engraeceu-se	engraecer+V.ele.REFL+PRF+3+SG
engraeceu-te	engraecer+V.tu.AD.2.SG+PRF+3+SG
engraeceu-vos	engraecer+V.vós.AD.2.PL+PRF+3+SG
engraecia-a	engraecer+V.ele.ACC.3.F.SG+IMPF+1+SG
engraecia-a	engraecer+V.ele.ACC.3.F.SG+IMPF+3+SG
engraecia-as	engraecer+V.ele.ACC.3.F.PL+IMPF+1+SG
engraecia-as	engraecer+V.ele.ACC.3.F.PL+IMPF+3+SG
engraeci-a	engraecer+V.ele.ACC.3.F.SG+PRF+1+SG
engraecia-la	engraecer+V.ele.ACC.3.F.SG+IMPF+2+SG
engraecia-las	engraecer+V.ele.ACC.3.F.PL+IMPF+2+SG
engraecia-lhe	engraecer+V.ele.DAT.3.SG+IMPF+1+SG
engraecia-lhe	engraecer+V.ele.DAT.3.SG+IMPF+3+SG
engraecia-lhes	engraecer+V.ele.DAT.3.PL+IMPF+1+SG
engraecia-lhes	engraecer+V.ele.DAT.3.PL+IMPF+3+SG
engraecia-lo	engraecer+V.ele.ACC.3.M.SG+IMPF+2+SG
engraecia-los	engraecer+V.ele.ACC.3.M.PL+IMPF+2+SG
engraecia-me	engraecer+V.eu.AD.1.SG+IMPF+1+SG
engraecia-me	engraecer+V.eu.AD.1.SG+IMPF+3+SG
engraeciam-lhe	engraecer+V.ele.DAT.3.SG+IMPF+3+PL
engraeciam-lhes	engraecer+V.ele.DAT.3.PL+IMPF+3+PL
engraeciam-me	engraecer+V.eu.AD.1.SG+IMPF+3+PL
engraeciam-na	engraecer+V.ele.ACC.3.F.SG+IMPF+3+PL
engraeciam-nas	engraecer+V.ele.ACC.3.F.PL+IMPF+3+PL
engraeciam-no	engraecer+V.ele.ACC.3.M.SG+IMPF+3+PL
engraeciam-nos	engraecer+V.ele.ACC.3.M.PL+IMPF+3+PL
engraeciam-nos	engraecer+V.nós.AD.1.PL+IMPF+3+PL
engraecíamo-la	engraecer+V.ele.ACC.3.F.SG+IMPF+1+PL
engraecíamo-las	engraecer+V.ele.ACC.3.F.PL+IMPF+1+PL
engraecíamo-lo	engraecer+V.ele.ACC.3.M.SG+IMPF+1+PL
engraecíamo-los	engraecer+V.ele.ACC.3.M.PL+IMPF+1+PL
engraecíamo-nos	engraecer+nós.AD.1.PL+IMPF+1+PL
engraecíamos-lhe	engraecer+V.ele.DAT.3.SG+IMPF+1+PL
engraecíamos-lhes	engraecer+V.ele.DAT.3.PL+IMPF+1+PL
engraecíamos-me	engraecer+V.eu.AD.1.SG+IMPF+1+PL
engraecíamos-te	engraecer+V.tu.AD.2.SG+IMPF+1+PL
engraecíamos-vos	engraecer+V.vós.AD.2.PL+IMPF+1+PL
engraeciam-se	engraecer+V.ele.REFL+IMPF+3+PL
engraeciam-te	engraecer+V.tu.AD.2.SG+IMPF+3+PL
engraeciam-vos	engraecer+V.vós.AD.2.PL+IMPF+3+PL
engraecia-nos	engraecer+nós.AD.1.PL+IMPF+1+SG
engraecia-nos	engraecer+nós.AD.1.PL+IMPF+2+SG
engraecia-nos	engraecer+nós.AD.1.PL+IMPF+3+SG
engraecia-o	engraecer+V.ele.ACC.3.M.SG+IMPF+1+SG
engraecia-o	engraecer+V.ele.ACC.3.M.SG+IMPF+3+SG
engraecia-os	engraecer+V.ele.ACC.3.M.PL+IMPF+1+SG
engraecia-os	engraecer+V.ele.ACC.3.M.PL+IMPF+3+SG
engraecia-se	engraecer+V.ele.REFL+IMPF+3+SG
engraeci-as	engraecer+V.ele.ACC.3.F.PL+PRF+1+SG
engraecias-lhe	engraecer+V.ele.DAT.3.SG+IMPF+2+SG
engraecias-lhes	engraecer+V.ele.DAT.3.PL+IMPF+2+SG
engraecias-me	engraecer+V.eu.AD.1.SG+IMPF+2+SG
engraecias-te	engraecer+V.tu.AD.2.SG+IMPF+2+SG
engraecias-vos	engraecer+V.vós.AD.2.PL+IMPF+2+SG
engraecia-te	engraecer+V.tu.AD.2.SG+IMPF+1+SG
engraecia-te	engraecer+V.tu.AD.2.SG+IMPF+3+SG
engraecia-vos	engraecer+V.vós.AD.2.PL+IMPF+1+SG
engraecia-vos	engraecer+V.vós.AD.2.PL+IMPF+3+SG
engraecíei-la	engraecer+V.ele.ACC.3.F.SG+IMPF+2+PL
engraecíei-las	engraecer+V.ele.ACC.3.F.PL+IMPF+2+PL
engraecíei-lo	engraecer+V.ele.ACC.3.M.SG+IMPF+2+PL
engraecíei-los	engraecer+V.ele.ACC.3.M.PL+IMPF+2+PL
engraecíei-nos	engraecer+nós.AD.1.PL+IMPF+2+PL
engraecíeis-lhe	engraecer+V.ele.DAT.3.SG+IMPF+2+PL
engraecíeis-lhes	engraecer+V.ele.DAT.3.PL+IMPF+2+PL
engraecíeis-me	engraecer+V.eu.AD.1.SG+IMPF+2+PL
engraecíeis-te	engraecer+V.tu.AD.2.SG+IMPF+2+PL
engraecíeis-vos	engraecer+V.vós.AD.2.PL+IMPF+2+PL
engraeci-lhe	engraecer+V.ele.DAT.3.SG+PRF+1+SG
engraeci-lhes	engraecer+V.ele.DAT.3.PL+PRF+1+SG
engraeci-me	engraecer+V.eu.AD.1.SG+PRF+1+SG
engraeci-nos	engraecer+nós.AD.1.PL+PRF+1+SG
engraeci-o	engraecer+V.ele.ACC.3.M.SG+PRF+1+SG
engraeci-os	engraecer+V.ele.ACC.3.M.PL+PRF+1+SG
engraeci-te	engraecer+V.tu.AD.2.SG+PRF+1+SG
engraeci-vos	engraecer+V.vós.AD.2.PL+PRF+1+SG
engraeço-a	engraecer+V.ele.ACC.3.F.SG+PRS+1+SG
engraeço-as	engraecer+V.ele.ACC.3.F.PL+PRS+1+SG
engraeço-lhe	engraecer+V.ele.DAT.3.SG+PRS+1+SG
engraeço-lhes	engraecer+V.ele.DAT.3.PL+PRS+1+SG
engraeço-me	engraecer+V.eu.AD.1.SG+PRS+1+SG
engraeço-nos	engraecer+nós.AD.1.PL+PRS+1+SG
engraeço-o	engraecer+V.ele.ACC.3.M.SG+PRS+1+SG
engraeço-os	engraecer+V.ele.ACC.3.M.PL+PRS+1+SG
engraeço-te	engraecer+V.tu.AD.2.SG+PRS+1+SG
engraeço-vos	engraecer+V.vós.AD.2.PL+PRS+1+SG
engraixa-a	engraixar+V.ele.ACC.3.F.SG+PRS+3+SG
engraixa-as	engraixar+V.ele.ACC.3.F.PL+PRS+3+SG
engraixai-la	engraixar+V.ele.ACC.3.F.SG+PRS+2+PL
engraixai-las	engraixar+V.ele.ACC.3.F.PL+PRS+2+PL
engraixai-lo	engraixar+V.ele.ACC.3.M.SG+PRS+2+PL
engraixai-los	engraixar+V.ele.ACC.3.M.PL+PRS+2+PL
engraixai-nos	engraixar+nós.AD.1.PL+PRS+2+PL
engraixais-lhe	engraixar+V.ele.DAT.3.SG+PRS+2+PL
engraixais-lhes	engraixar+V.ele.DAT.3.PL+PRS+2+PL
engraixais-me	engraixar+V.eu.AD.1.SG+PRS+2+PL
engraixais-te	engraixar+V.tu.AD.2.SG+PRS+2+PL
engraixais-vos	engraixar+V.vós.AD.2.PL+PRS+2+PL
engraixá-la-á	engraixar+V.ele.ACC.3.F.SG+FUT+3+SG
engraixá-la-ão	engraixar+V.ele.ACC.3.F.SG+FUT+3+PL
engraixá-la-ás	engraixar+V.ele.ACC.3.F.SG+FUT+2+SG
engraixá-la-ei	engraixar+V.ele.ACC.3.F.SG+FUT+1+SG
engraixá-la-eis	engraixar+V.ele.ACC.3.F.SG+FUT+2+PL
engraixá-la-emos	engraixar+V.ele.ACC.3.F.SG+FUT+1+PL
engraixá-la	engraixar+V.ele.ACC.3.F.SG+INF+1+SG
engraixá-la	engraixar+V.ele.ACC.3.F.SG+INF+3+SG
engraixa-la	engraixar+V.ele.ACC.3.F.SG+PRS+2+SG
engraixá-la	engraixar+V.ele.ACC.3.F.SG+SBJF+1+SG
engraixá-la	engraixar+V.ele.ACC.3.F.SG+SBJF+3+SG
engraixá-la-ia	engraixar+V.ele.ACC.3.F.SG+COND+1+SG
engraixá-la-ia	engraixar+V.ele.ACC.3.F.SG+COND+3+SG
engraixá-la-iam	engraixar+V.ele.ACC.3.F.SG+COND+3+PL
engraixá-la-íamos	engraixar+V.ele.ACC.3.F.SG+COND+1+PL
engraixá-la-ias	engraixar+V.ele.ACC.3.F.SG+COND+2+SG
engraixá-la-íeis	engraixar+V.ele.ACC.3.F.SG+COND+2+PL
engraixá-las-á	engraixar+V.ele.ACC.3.F.PL+FUT+3+SG
engraixá-las-ão	engraixar+V.ele.ACC.3.F.PL+FUT+3+PL
engraixá-las-ás	engraixar+V.ele.ACC.3.F.PL+FUT+2+SG
engraixá-las-ei	engraixar+V.ele.ACC.3.F.PL+FUT+1+SG
engraixá-las-eis	engraixar+V.ele.ACC.3.F.PL+FUT+2+PL
engraixá-las-emos	engraixar+V.ele.ACC.3.F.PL+FUT+1+PL
engraixá-las	engraixar+V.ele.ACC.3.F.PL+INF+1+SG
engraixá-las	engraixar+V.ele.ACC.3.F.PL+INF+3+SG
engraixa-las	engraixar+V.ele.ACC.3.F.PL+PRS+2+SG
engraixá-las	engraixar+V.ele.ACC.3.F.PL+SBJF+1+SG
engraixá-las	engraixar+V.ele.ACC.3.F.PL+SBJF+3+SG
engraixá-las-ia	engraixar+V.ele.ACC.3.F.PL+COND+1+SG
engraixá-las-ia	engraixar+V.ele.ACC.3.F.PL+COND+3+SG
engraixá-las-iam	engraixar+V.ele.ACC.3.F.PL+COND+3+PL
engraixá-las-íamos	engraixar+V.ele.ACC.3.F.PL+COND+1+PL
engraixá-las-ias	engraixar+V.ele.ACC.3.F.PL+COND+2+SG
engraixá-las-íeis	engraixar+V.ele.ACC.3.F.PL+COND+2+PL
engraixa-lhe	engraixar+V.ele.DAT.3.SG+PRS+3+SG
engraixa-lhes	engraixar+V.ele.DAT.3.PL+PRS+3+SG
engraixá-lo-á	engraixar+V.ele.ACC.3.M.SG+FUT+3+SG
engraixá-lo-ão	engraixar+V.ele.ACC.3.M.SG+FUT+3+PL
engraixá-lo-ás	engraixar+V.ele.ACC.3.M.SG+FUT+2+SG
engraixá-lo-ei	engraixar+V.ele.ACC.3.M.SG+FUT+1+SG
engraixá-lo-eis	engraixar+V.ele.ACC.3.M.SG+FUT+2+PL
engraixá-lo-emos	engraixar+V.ele.ACC.3.M.SG+FUT+1+PL
engraixá-lo	engraixar+V.ele.ACC.3.M.SG+INF+1+SG
engraixá-lo	engraixar+V.ele.ACC.3.M.SG+INF+3+SG
engraixa-lo	engraixar+V.ele.ACC.3.M.SG+PRS+2+SG
engraixá-lo	engraixar+V.ele.ACC.3.M.SG+SBJF+1+SG
engraixá-lo	engraixar+V.ele.ACC.3.M.SG+SBJF+3+SG
engraixá-lo-ia	engraixar+V.ele.ACC.3.M.SG+COND+1+SG
engraixá-lo-ia	engraixar+V.ele.ACC.3.M.SG+COND+3+SG
engraixá-lo-iam	engraixar+V.ele.ACC.3.M.SG+COND+3+PL
engraixá-lo-íamos	engraixar+V.ele.ACC.3.M.SG+COND+1+PL
engraixá-lo-ias	engraixar+V.ele.ACC.3.M.SG+COND+2+SG
engraixá-lo-íeis	engraixar+V.ele.ACC.3.M.SG+COND+2+PL
engraixá-los-á	engraixar+V.ele.ACC.3.M.PL+FUT+3+SG
engraixá-los-ão	engraixar+V.ele.ACC.3.M.PL+FUT+3+PL
engraixá-los-ás	engraixar+V.ele.ACC.3.M.PL+FUT+2+SG
engraixá-los-ei	engraixar+V.ele.ACC.3.M.PL+FUT+1+SG
engraixá-los-eis	engraixar+V.ele.ACC.3.M.PL+FUT+2+PL
engraixá-los-emos	engraixar+V.ele.ACC.3.M.PL+FUT+1+PL
engraixá-los	engraixar+V.ele.ACC.3.M.PL+INF+1+SG
engraixá-los	engraixar+V.ele.ACC.3.M.PL+INF+3+SG
engraixa-los	engraixar+V.ele.ACC.3.M.PL+PRS+2+SG
engraixá-los	engraixar+V.ele.ACC.3.M.PL+SBJF+1+SG
engraixá-los	engraixar+V.ele.ACC.3.M.PL+SBJF+3+SG
engraixá-los-ia	engraixar+V.ele.ACC.3.M.PL+COND+1+SG
engraixá-los-ia	engraixar+V.ele.ACC.3.M.PL+COND+3+SG
engraixá-los-iam	engraixar+V.ele.ACC.3.M.PL+COND+3+PL
engraixá-los-íamos	engraixar+V.ele.ACC.3.M.PL+COND+1+PL
engraixá-los-ias	engraixar+V.ele.ACC.3.M.PL+COND+2+SG
engraixá-los-íeis	engraixar+V.ele.ACC.3.M.PL+COND+2+PL
engraixa-me	engraixar+V.eu.AD.1.SG+PRS+3+SG
engraixam-lhe	engraixar+V.ele.DAT.3.SG+PRS+3+PL
engraixam-lhes	engraixar+V.ele.DAT.3.PL+PRS+3+PL
engraixam-me	engraixar+V.eu.AD.1.SG+PRS+3+PL
engraixam-na	engraixar+V.ele.ACC.3.F.SG+PRS+3+PL
engraixam-nas	engraixar+V.ele.ACC.3.F.PL+PRS+3+PL
engraixam-no	engraixar+V.ele.ACC.3.M.SG+PRS+3+PL
engraixam-nos	engraixar+V.ele.ACC.3.M.PL+PRS+3+PL
engraixam-nos	engraixar+V.nós.AD.1.PL+PRS+3+PL
engraixamo-la	engraixar+V.ele.ACC.3.F.SG+PRF+1+PL
engraixamo-la	engraixar+V.ele.ACC.3.F.SG+PRS+1+PL
engraixamo-las	engraixar+V.ele.ACC.3.F.PL+PRF+1+PL
engraixamo-las	engraixar+V.ele.ACC.3.F.PL+PRS+1+PL
engraixamo-lo	engraixar+V.ele.ACC.3.M.SG+PRF+1+PL
engraixamo-lo	engraixar+V.ele.ACC.3.M.SG+PRS+1+PL
engraixamo-los	engraixar+V.ele.ACC.3.M.PL+PRF+1+PL
engraixamo-los	engraixar+V.ele.ACC.3.M.PL+PRS+1+PL
engraixamo-nos	engraixar+nós.AD.1.PL+PRF+1+PL
engraixamo-nos	engraixar+nós.AD.1.PL+PRS+1+PL
engraixamos-lhe	engraixar+V.ele.DAT.3.SG+PRF+1+PL
engraixamos-lhe	engraixar+V.ele.DAT.3.SG+PRS+1+PL
engraixamos-lhes	engraixar+V.ele.DAT.3.PL+PRF+1+PL
engraixamos-lhes	engraixar+V.ele.DAT.3.PL+PRS+1+PL
engraixamos-me	engraixar+V.eu.AD.1.SG+PRF+1+PL
engraixamos-me	engraixar+V.eu.AD.1.SG+PRS+1+PL
engraixamos-te	engraixar+V.tu.AD.2.SG+PRF+1+PL
engraixamos-te	engraixar+V.tu.AD.2.SG+PRS+1+PL
engraixamos-vos	engraixar+V.vós.AD.2.PL+PRF+1+PL
engraixamos-vos	engraixar+V.vós.AD.2.PL+PRS+1+PL
engraixam-se	engraixar+V.ele.REFL+PRS+3+PL
engraixam-te	engraixar+V.tu.AD.2.SG+PRS+3+PL
engraixam-vos	engraixar+V.vós.AD.2.PL+PRS+3+PL
engraixando-a	engraixar+V.ele.ACC.3.F.SG+GRD
engraixando-as	engraixar+V.ele.ACC.3.F.PL+GRD
engraixando-lhe	engraixar+V.ele.DAT.3.SG+GRD
engraixando-lhes	engraixar+V.ele.DAT.3.PL+GRD
engraixando-me	engraixar+V.eu.AD.1.SG+GRD
engraixando-nos	engraixar+nós.AD.1.PL+GRD
engraixando-o	engraixar+V.ele.ACC.3.M.SG+GRD
engraixando-os	engraixar+V.ele.ACC.3.M.PL+GRD
engraixando-se	engraixar+V.ele.REFL+GRD
engraixando-te	engraixar+V.tu.AD.2.SG+GRD
engraixando-vos	engraixar+V.vós.AD.2.PL+GRD
engraixa-nos	engraixar+nós.AD.1.PL+PRS+2+SG
engraixa-nos	engraixar+nós.AD.1.PL+PRS+3+SG
engraixa-o	engraixar+V.ele.ACC.3.M.SG+PRS+3+SG
engraixa-os	engraixar+V.ele.ACC.3.M.PL+PRS+3+SG
engraixara-a	engraixar+V.ele.ACC.3.F.SG+PQP+1+SG
engraixara-a	engraixar+V.ele.ACC.3.F.SG+PQP+3+SG
engraixara-as	engraixar+V.ele.ACC.3.F.PL+PQP+1+SG
engraixara-as	engraixar+V.ele.ACC.3.F.PL+PQP+3+SG
engraixara-la	engraixar+V.ele.ACC.3.F.SG+PQP+2+SG
engraixara-las	engraixar+V.ele.ACC.3.F.PL+PQP+2+SG
engraixara-lhe	engraixar+V.ele.DAT.3.SG+PQP+1+SG
engraixara-lhe	engraixar+V.ele.DAT.3.SG+PQP+3+SG
engraixara-lhes	engraixar+V.ele.DAT.3.PL+PQP+1+SG
engraixara-lhes	engraixar+V.ele.DAT.3.PL+PQP+3+SG
engraixara-lo	engraixar+V.ele.ACC.3.M.SG+PQP+2+SG
engraixara-los	engraixar+V.ele.ACC.3.M.PL+PQP+2+SG
engraixara-me	engraixar+V.eu.AD.1.SG+PQP+1+SG
engraixara-me	engraixar+V.eu.AD.1.SG+PQP+3+SG
engraixaram-lhe	engraixar+V.ele.DAT.3.SG+PQP+3+PL
engraixaram-lhe	engraixar+V.ele.DAT.3.SG+PRF+3+PL
engraixaram-lhes	engraixar+V.ele.DAT.3.PL+PQP+3+PL
engraixaram-lhes	engraixar+V.ele.DAT.3.PL+PRF+3+PL
engraixaram-me	engraixar+V.eu.AD.1.SG+PQP+3+PL
engraixaram-me	engraixar+V.eu.AD.1.SG+PRF+3+PL
engraixaram-na	engraixar+V.ele.ACC.3.F.SG+PQP+3+PL
engraixaram-na	engraixar+V.ele.ACC.3.F.SG+PRF+3+PL
engraixaram-nas	engraixar+V.ele.ACC.3.F.PL+PQP+3+PL
engraixaram-nas	engraixar+V.ele.ACC.3.F.PL+PRF+3+PL
engraixaram-no	engraixar+V.ele.ACC.3.M.SG+PQP+3+PL
engraixaram-no	engraixar+V.ele.ACC.3.M.SG+PRF+3+PL
engraixaram-nos	engraixar+V.ele.ACC.3.M.PL+PQP+3+PL
engraixaram-nos	engraixar+V.ele.ACC.3.M.PL+PRF+3+PL
engraixaram-nos	engraixar+V.nós.AD.1.PL+PQP+3+PL
engraixaram-nos	engraixar+V.nós.AD.1.PL+PRF+3+PL
engraixáramo-la	engraixar+V.ele.ACC.3.F.SG+PQP+1+PL
engraixáramo-las	engraixar+V.ele.ACC.3.F.PL+PQP+1+PL
engraixáramo-lo	engraixar+V.ele.ACC.3.M.SG+PQP+1+PL
engraixáramo-los	engraixar+V.ele.ACC.3.M.PL+PQP+1+PL
engraixáramo-nos	engraixar+nós.AD.1.PL+PQP+1+PL
engraixáramos-lhe	engraixar+V.ele.DAT.3.SG+PQP+1+PL
engraixáramos-lhes	engraixar+V.ele.DAT.3.PL+PQP+1+PL
engraixáramos-me	engraixar+V.eu.AD.1.SG+PQP+1+PL
engraixáramos-te	engraixar+V.tu.AD.2.SG+PQP+1+PL
engraixáramos-vos	engraixar+V.vós.AD.2.PL+PQP+1+PL
engraixaram-se	engraixar+V.ele.REFL+PQP+3+PL
engraixaram-se	engraixar+V.ele.REFL+PRF+3+PL
engraixaram-te	engraixar+V.tu.AD.2.SG+PQP+3+PL
engraixaram-te	engraixar+V.tu.AD.2.SG+PRF+3+PL
engraixaram-vos	engraixar+V.vós.AD.2.PL+PQP+3+PL
engraixaram-vos	engraixar+V.vós.AD.2.PL+PRF+3+PL
engraixara-nos	engraixar+nós.AD.1.PL+PQP+1+SG
engraixara-nos	engraixar+nós.AD.1.PL+PQP+2+SG
engraixara-nos	engraixar+nós.AD.1.PL+PQP+3+SG
engraixara-o	engraixar+V.ele.ACC.3.M.SG+PQP+1+SG
engraixara-o	engraixar+V.ele.ACC.3.M.SG+PQP+3+SG
engraixara-os	engraixar+V.ele.ACC.3.M.PL+PQP+1+SG
engraixara-os	engraixar+V.ele.ACC.3.M.PL+PQP+3+SG
engraixara-se	engraixar+V.ele.REFL+PQP+1+SG
engraixara-se	engraixar+V.ele.REFL+PQP+3+SG
engraixaras-lhe	engraixar+V.ele.DAT.3.SG+PQP+2+SG
engraixaras-lhes	engraixar+V.ele.DAT.3.PL+PQP+2+SG
engraixaras-me	engraixar+V.eu.AD.1.SG+PQP+2+SG
engraixaras-te	engraixar+V.tu.AD.2.SG+PQP+2+SG
engraixaras-vos	engraixar+V.vós.AD.2.PL+PQP+2+SG
engraixara-te	engraixar+V.tu.AD.2.SG+PQP+1+SG
engraixara-te	engraixar+V.tu.AD.2.SG+PQP+3+SG
engraixara-vos	engraixar+V.vós.AD.2.PL+PQP+1+SG
engraixara-vos	engraixar+V.vós.AD.2.PL+PQP+3+SG
engraixarde-la	engraixar+V.ele.ACC.3.F.SG+INF+2+PL
engraixarde-la	engraixar+V.ele.ACC.3.F.SG+SBJF+2+PL
engraixarde-las	engraixar+V.ele.ACC.3.F.PL+INF+2+PL
engraixarde-las	engraixar+V.ele.ACC.3.F.PL+SBJF+2+PL
engraixarde-lo	engraixar+V.ele.ACC.3.M.SG+INF+2+PL
engraixarde-lo	engraixar+V.ele.ACC.3.M.SG+SBJF+2+PL
engraixarde-los	engraixar+V.ele.ACC.3.M.PL+INF+2+PL
engraixarde-los	engraixar+V.ele.ACC.3.M.PL+SBJF+2+PL
engraixarde-nos	engraixar+nós.AD.1.PL+INF+2+PL
engraixarde-nos	engraixar+nós.AD.1.PL+SBJF+2+PL
engraixardes-lhe	engraixar+V.ele.DAT.3.SG+INF+2+PL
engraixardes-lhe	engraixar+V.ele.DAT.3.SG+SBJF+2+PL
engraixardes-lhes	engraixar+V.ele.DAT.3.PL+INF+2+PL
engraixardes-lhes	engraixar+V.ele.DAT.3.PL+SBJF+2+PL
engraixardes-me	engraixar+V.eu.AD.1.SG+INF+2+PL
engraixardes-me	engraixar+V.eu.AD.1.SG+SBJF+2+PL
engraixardes-te	engraixar+V.tu.AD.2.SG+INF+2+PL
engraixardes-te	engraixar+V.tu.AD.2.SG+SBJF+2+PL
engraixardes-vos	engraixar+V.vós.AD.2.PL+INF+2+PL
engraixardes-vos	engraixar+V.vós.AD.2.PL+SBJF+2+PL
engraixárei-la	engraixar+V.ele.ACC.3.F.SG+PQP+2+PL
engraixárei-las	engraixar+V.ele.ACC.3.F.PL+PQP+2+PL
engraixárei-lo	engraixar+V.ele.ACC.3.M.SG+PQP+2+PL
engraixárei-los	engraixar+V.ele.ACC.3.M.PL+PQP+2+PL
engraixárei-nos	engraixar+nós.AD.1.PL+PQP+2+PL
engraixáreis-lhe	engraixar+V.ele.DAT.3.SG+PQP+2+PL
engraixáreis-lhes	engraixar+V.ele.DAT.3.PL+PQP+2+PL
engraixáreis-me	engraixar+V.eu.AD.1.SG+PQP+2+PL
engraixáreis-te	engraixar+V.tu.AD.2.SG+PQP+2+PL
engraixáreis-vos	engraixar+V.vós.AD.2.PL+PQP+2+PL
engraixare-la	engraixar+V.ele.ACC.3.F.SG+INF+2+SG
engraixare-la	engraixar+V.ele.ACC.3.F.SG+SBJF+2+SG
engraixare-las	engraixar+V.ele.ACC.3.F.PL+INF+2+SG
engraixare-las	engraixar+V.ele.ACC.3.F.PL+SBJF+2+SG
engraixare-lo	engraixar+V.ele.ACC.3.M.SG+INF+2+SG
engraixare-lo	engraixar+V.ele.ACC.3.M.SG+SBJF+2+SG
engraixare-los	engraixar+V.ele.ACC.3.M.PL+INF+2+SG
engraixare-los	engraixar+V.ele.ACC.3.M.PL+SBJF+2+SG
engraixarem-lhe	engraixar+V.ele.DAT.3.SG+INF+3+PL
engraixarem-lhe	engraixar+V.ele.DAT.3.SG+SBJF+3+PL
engraixarem-lhes	engraixar+V.ele.DAT.3.PL+INF+3+PL
engraixarem-lhes	engraixar+V.ele.DAT.3.PL+SBJF+3+PL
engraixarem-me	engraixar+V.eu.AD.1.SG+INF+3+PL
engraixarem-me	engraixar+V.eu.AD.1.SG+SBJF+3+PL
engraixarem-na	engraixar+V.ele.ACC.3.F.SG+INF+3+PL
