entulhar-vos-íamos	entulhar+V.vós.AD.2.PL+COND+1+PL
entulhar-vos-ias	entulhar+V.vós.AD.2.PL+COND+2+SG
entulhar-vos-íeis	entulhar+V.vós.AD.2.PL+COND+2+PL
entulha-se	entulhar+V.ele.REFL+PRS+3+SG
entulhas-lhe	entulhar+V.ele.DAT.3.SG+PRS+2+SG
entulhas-lhes	entulhar+V.ele.DAT.3.PL+PRS+2+SG
entulhas-me	entulhar+V.eu.AD.1.SG+PRS+2+SG
entulhaste-a	entulhar+V.ele.ACC.3.F.SG+PRF+2+SG
entulhaste-as	entulhar+V.ele.ACC.3.F.PL+PRF+2+SG
entulhas-te	entulhar+V.tu.AD.2.SG+PRS+2+SG
entulhaste-la	entulhar+V.ele.ACC.3.F.SG+PRF+2+PL
entulhaste-las	entulhar+V.ele.ACC.3.F.PL+PRF+2+PL
entulhaste-lhe	entulhar+V.ele.DAT.3.SG+PRF+2+SG
entulhaste-lhes	entulhar+V.ele.DAT.3.PL+PRF+2+SG
entulhaste-lo	entulhar+V.ele.ACC.3.M.SG+PRF+2+PL
entulhaste-los	entulhar+V.ele.ACC.3.M.PL+PRF+2+PL
entulhaste-me	entulhar+V.eu.AD.1.SG+PRF+2+SG
entulhaste-nos	entulhar+nós.AD.1.PL+PRF+2+PL
entulhaste-nos	entulhar+nós.AD.1.PL+PRF+2+SG
entulhaste-o	entulhar+V.ele.ACC.3.M.SG+PRF+2+SG
entulhaste-os	entulhar+V.ele.ACC.3.M.PL+PRF+2+SG
entulhastes-lhe	entulhar+V.ele.DAT.3.SG+PRF+2+PL
entulhastes-lhes	entulhar+V.ele.DAT.3.PL+PRF+2+PL
entulhastes-me	entulhar+V.eu.AD.1.SG+PRF+2+PL
entulhastes-te	entulhar+V.tu.AD.2.SG+PRF+2+PL
entulhastes-vos	entulhar+V.vós.AD.2.PL+PRF+2+PL
entulhaste-te	entulhar+V.tu.AD.2.SG+PRF+2+SG
entulhaste-vos	entulhar+V.vós.AD.2.PL+PRF+2+SG
entulhas-vos	entulhar+V.vós.AD.2.PL+PRS+2+SG
entulha-te	entulhar+V.tu.AD.2.SG+PRS+3+SG
entulhava-a	entulhar+V.ele.ACC.3.F.SG+IMPF+1+SG
entulhava-a	entulhar+V.ele.ACC.3.F.SG+IMPF+3+SG
entulhava-as	entulhar+V.ele.ACC.3.F.PL+IMPF+1+SG
entulhava-as	entulhar+V.ele.ACC.3.F.PL+IMPF+3+SG
entulhava-la	entulhar+V.ele.ACC.3.F.SG+IMPF+2+SG
entulhava-las	entulhar+V.ele.ACC.3.F.PL+IMPF+2+SG
entulhava-lhe	entulhar+V.ele.DAT.3.SG+IMPF+1+SG
entulhava-lhe	entulhar+V.ele.DAT.3.SG+IMPF+3+SG
entulhava-lhes	entulhar+V.ele.DAT.3.PL+IMPF+1+SG
entulhava-lhes	entulhar+V.ele.DAT.3.PL+IMPF+3+SG
entulhava-lo	entulhar+V.ele.ACC.3.M.SG+IMPF+2+SG
entulhava-los	entulhar+V.ele.ACC.3.M.PL+IMPF+2+SG
entulhava-me	entulhar+V.eu.AD.1.SG+IMPF+1+SG
entulhava-me	entulhar+V.eu.AD.1.SG+IMPF+3+SG
entulhavam-lhe	entulhar+V.ele.DAT.3.SG+IMPF+3+PL
entulhavam-lhes	entulhar+V.ele.DAT.3.PL+IMPF+3+PL
entulhavam-me	entulhar+V.eu.AD.1.SG+IMPF+3+PL
entulhavam-na	entulhar+V.ele.ACC.3.F.SG+IMPF+3+PL
entulhavam-nas	entulhar+V.ele.ACC.3.F.PL+IMPF+3+PL
entulhavam-no	entulhar+V.ele.ACC.3.M.SG+IMPF+3+PL
entulhavam-nos	entulhar+V.ele.ACC.3.M.PL+IMPF+3+PL
entulhavam-nos	entulhar+V.nós.AD.1.PL+IMPF+3+PL
entulhávamo-la	entulhar+V.ele.ACC.3.F.SG+IMPF+1+PL
entulhávamo-las	entulhar+V.ele.ACC.3.F.PL+IMPF+1+PL
entulhávamo-lo	entulhar+V.ele.ACC.3.M.SG+IMPF+1+PL
entulhávamo-los	entulhar+V.ele.ACC.3.M.PL+IMPF+1+PL
entulhávamo-nos	entulhar+nós.AD.1.PL+IMPF+1+PL
entulhávamos-lhe	entulhar+V.ele.DAT.3.SG+IMPF+1+PL
entulhávamos-lhes	entulhar+V.ele.DAT.3.PL+IMPF+1+PL
entulhávamos-me	entulhar+V.eu.AD.1.SG+IMPF+1+PL
entulhávamos-te	entulhar+V.tu.AD.2.SG+IMPF+1+PL
entulhávamos-vos	entulhar+V.vós.AD.2.PL+IMPF+1+PL
entulhavam-se	entulhar+V.ele.REFL+IMPF+3+PL
entulhavam-te	entulhar+V.tu.AD.2.SG+IMPF+3+PL
entulhavam-vos	entulhar+V.vós.AD.2.PL+IMPF+3+PL
entulhava-nos	entulhar+nós.AD.1.PL+IMPF+1+SG
entulhava-nos	entulhar+nós.AD.1.PL+IMPF+2+SG
entulhava-nos	entulhar+nós.AD.1.PL+IMPF+3+SG
entulhava-o	entulhar+V.ele.ACC.3.M.SG+IMPF+1+SG
entulhava-o	entulhar+V.ele.ACC.3.M.SG+IMPF+3+SG
entulhava-os	entulhar+V.ele.ACC.3.M.PL+IMPF+1+SG
entulhava-os	entulhar+V.ele.ACC.3.M.PL+IMPF+3+SG
entulhava-se	entulhar+V.ele.REFL+IMPF+1+SG
entulhava-se	entulhar+V.ele.REFL+IMPF+3+SG
entulhavas-lhe	entulhar+V.ele.DAT.3.SG+IMPF+2+SG
entulhavas-lhes	entulhar+V.ele.DAT.3.PL+IMPF+2+SG
entulhavas-me	entulhar+V.eu.AD.1.SG+IMPF+2+SG
entulhavas-te	entulhar+V.tu.AD.2.SG+IMPF+2+SG
entulhavas-vos	entulhar+V.vós.AD.2.PL+IMPF+2+SG
entulhava-te	entulhar+V.tu.AD.2.SG+IMPF+1+SG
entulhava-te	entulhar+V.tu.AD.2.SG+IMPF+3+SG
entulhava-vos	entulhar+V.vós.AD.2.PL+IMPF+1+SG
entulhava-vos	entulhar+V.vós.AD.2.PL+IMPF+3+SG
entulhávei-la	entulhar+V.ele.ACC.3.F.SG+IMPF+2+PL
entulhávei-las	entulhar+V.ele.ACC.3.F.PL+IMPF+2+PL
entulhávei-lo	entulhar+V.ele.ACC.3.M.SG+IMPF+2+PL
entulhávei-los	entulhar+V.ele.ACC.3.M.PL+IMPF+2+PL
entulhávei-nos	entulhar+nós.AD.1.PL+IMPF+2+PL
entulháveis-lhe	entulhar+V.ele.DAT.3.SG+IMPF+2+PL
entulháveis-lhes	entulhar+V.ele.DAT.3.PL+IMPF+2+PL
entulháveis-me	entulhar+V.eu.AD.1.SG+IMPF+2+PL
entulháveis-te	entulhar+V.tu.AD.2.SG+IMPF+2+PL
entulháveis-vos	entulhar+V.vós.AD.2.PL+IMPF+2+PL
entulha-vos	entulhar+V.vós.AD.2.PL+PRS+3+SG
entulhe-a	entulhar+V.ele.ACC.3.F.SG+IMP+3+SG
entulhe-as	entulhar+V.ele.ACC.3.F.PL+IMP+3+SG
entulhei-a	entulhar+V.ele.ACC.3.F.SG+PRF+1+SG
entulhei-as	entulhar+V.ele.ACC.3.F.PL+PRF+1+SG
entulhei-lhe	entulhar+V.ele.DAT.3.SG+PRF+1+SG
entulhei-lhes	entulhar+V.ele.DAT.3.PL+PRF+1+SG
entulhei-me	entulhar+V.eu.AD.1.SG+PRF+1+SG
entulhei-nos	entulhar+nós.AD.1.PL+PRF+1+SG
entulhei-o	entulhar+V.ele.ACC.3.M.SG+PRF+1+SG
entulhei-os	entulhar+V.ele.ACC.3.M.PL+PRF+1+SG
entulhei-te	entulhar+V.tu.AD.2.SG+PRF+1+SG
entulhei-vos	entulhar+V.vós.AD.2.PL+PRF+1+SG
entulhe-lhe	entulhar+V.ele.DAT.3.SG+IMP+3+SG
entulhe-lhes	entulhar+V.ele.DAT.3.PL+IMP+3+SG
entulhe-me	entulhar+V.eu.AD.1.SG+IMP+3+SG
entulhem-lhe	entulhar+V.ele.DAT.3.SG+IMP+3+PL
entulhem-lhes	entulhar+V.ele.DAT.3.PL+IMP+3+PL
entulhem-me	entulhar+V.eu.AD.1.SG+IMP+3+PL
entulhem-na	entulhar+V.ele.ACC.3.F.SG+IMP+3+PL
entulhem-nas	entulhar+V.ele.ACC.3.F.PL+IMP+3+PL
entulhem-no	entulhar+V.ele.ACC.3.M.SG+IMP+3+PL
entulhem-nos	entulhar+V.ele.ACC.3.M.PL+IMP+3+PL
entulhem-nos	entulhar+V.nós.AD.1.PL+IMP+3+PL
entulhemo-la	entulhar+V.ele.ACC.3.F.SG+IMP+1+PL
entulhemo-las	entulhar+V.ele.ACC.3.F.PL+IMP+1+PL
entulhemo-lo	entulhar+V.ele.ACC.3.M.SG+IMP+1+PL
entulhemo-los	entulhar+V.ele.ACC.3.M.PL+IMP+1+PL
entulhemo-nos	entulhar+nós.AD.1.PL+IMP+1+PL
entulhemos-lhe	entulhar+V.ele.DAT.3.SG+IMP+1+PL
entulhemos-lhes	entulhar+V.ele.DAT.3.PL+IMP+1+PL
entulhemos-me	entulhar+V.eu.AD.1.SG+IMP+1+PL
entulhemos-te	entulhar+V.tu.AD.2.SG+IMP+1+PL
entulhemos-vos	entulhar+V.vós.AD.2.PL+IMP+1+PL
entulhem-se	entulhar+V.ele.REFL+IMP+3+PL
entulhem-te	entulhar+V.tu.AD.2.SG+IMP+3+PL
entulhem-vos	entulhar+V.vós.AD.2.PL+IMP+3+PL
entulhe-nos	entulhar+nós.AD.1.PL+IMP+3+SG
entulhe-o	entulhar+V.ele.ACC.3.M.SG+IMP+3+SG
entulhe-os	entulhar+V.ele.ACC.3.M.PL+IMP+3+SG
entulhe-se	entulhar+V.ele.REFL+IMP+3+SG
entulhe-te	entulhar+V.tu.AD.2.SG+IMP+3+SG
entulhe-vos	entulhar+V.vós.AD.2.PL+IMP+3+SG
entulho-a	entulhar+V.ele.ACC.3.F.SG+PRS+1+SG
entulho-as	entulhar+V.ele.ACC.3.F.PL+PRS+1+SG
entulho-lhe	entulhar+V.ele.DAT.3.SG+PRS+1+SG
entulho-lhes	entulhar+V.ele.DAT.3.PL+PRS+1+SG
entulho-me	entulhar+V.eu.AD.1.SG+PRS+1+SG
entulho-nos	entulhar+nós.AD.1.PL+PRS+1+SG
entulho-o	entulhar+V.ele.ACC.3.M.SG+PRS+1+SG
entulho-os	entulhar+V.ele.ACC.3.M.PL+PRS+1+SG
entulho-te	entulhar+V.tu.AD.2.SG+PRS+1+SG
entulhou-a	entulhar+V.ele.ACC.3.F.SG+PRF+3+SG
entulhou-as	entulhar+V.ele.ACC.3.F.PL+PRF+3+SG
entulhou-lhe	entulhar+V.ele.DAT.3.SG+PRF+3+SG
entulhou-lhes	entulhar+V.ele.DAT.3.PL+PRF+3+SG
entulhou-me	entulhar+V.eu.AD.1.SG+PRF+3+SG
entulhou-nos	entulhar+nós.AD.1.PL+PRF+3+SG
entulhou-o	entulhar+V.ele.ACC.3.M.SG+PRF+3+SG
entulhou-os	entulhar+V.ele.ACC.3.M.PL+PRF+3+SG
entulhou-se	entulhar+V.ele.REFL+PRF+3+SG
entulhou-te	entulhar+V.tu.AD.2.SG+PRF+3+SG
entulhou-vos	entulhar+V.vós.AD.2.PL+PRF+3+SG
entulho-vos	entulhar+V.vós.AD.2.PL+PRS+1+SG
entupa-a	entupir+V.ele.ACC.3.F.SG+IMP+3+SG
entupa-as	entupir+V.ele.ACC.3.F.PL+IMP+3+SG
entupa-lhe	entupir+V.ele.DAT.3.SG+IMP+3+SG
entupa-lhes	entupir+V.ele.DAT.3.PL+IMP+3+SG
entupa-me	entupir+V.eu.AD.1.SG+IMP+3+SG
entupam-lhe	entupir+V.ele.DAT.3.SG+IMP+3+PL
entupam-lhes	entupir+V.ele.DAT.3.PL+IMP+3+PL
entupam-me	entupir+V.eu.AD.1.SG+IMP+3+PL
entupam-na	entupir+V.ele.ACC.3.F.SG+IMP+3+PL
entupam-nas	entupir+V.ele.ACC.3.F.PL+IMP+3+PL
entupam-no	entupir+V.ele.ACC.3.M.SG+IMP+3+PL
entupam-nos	entupir+V.ele.ACC.3.M.PL+IMP+3+PL
entupam-nos	entupir+V.nós.AD.1.PL+IMP+3+PL
entupamo-la	entupir+V.ele.ACC.3.F.SG+IMP+1+PL
entupamo-las	entupir+V.ele.ACC.3.F.PL+IMP+1+PL
entupamo-lo	entupir+V.ele.ACC.3.M.SG+IMP+1+PL
entupamo-los	entupir+V.ele.ACC.3.M.PL+IMP+1+PL
entupamo-nos	entupir+nós.AD.1.PL+IMP+1+PL
entupamos-lhe	entupir+V.ele.DAT.3.SG+IMP+1+PL
entupamos-lhes	entupir+V.ele.DAT.3.PL+IMP+1+PL
entupamos-me	entupir+V.eu.AD.1.SG+IMP+1+PL
entupamos-te	entupir+V.tu.AD.2.SG+IMP+1+PL
entupamos-vos	entupir+V.vós.AD.2.PL+IMP+1+PL
entupam-se	entupir+V.ele.REFL+IMP+3+PL
entupam-te	entupir+V.tu.AD.2.SG+IMP+3+PL
entupam-vos	entupir+V.vós.AD.2.PL+IMP+3+PL
entupa-nos	entupir+nós.AD.1.PL+IMP+3+SG
entupa-o	entupir+V.ele.ACC.3.M.SG+IMP+3+SG
entupa-os	entupir+V.ele.ACC.3.M.PL+IMP+3+SG
entupa-se	entupir+V.ele.REFL+IMP+3+SG
entupa-te	entupir+V.tu.AD.2.SG+IMP+3+SG
entupa-vos	entupir+V.vós.AD.2.PL+IMP+3+SG
entupia-a	entupir+V.ele.ACC.3.F.SG+IMPF+1+SG
entupia-a	entupir+V.ele.ACC.3.F.SG+IMPF+3+SG
entupia-as	entupir+V.ele.ACC.3.F.PL+IMPF+1+SG
entupia-as	entupir+V.ele.ACC.3.F.PL+IMPF+3+SG
entupi-a	entupir+V.ele.ACC.3.F.SG+PRF+1+SG
entupia-la	entupir+V.ele.ACC.3.F.SG+IMPF+2+SG
entupia-las	entupir+V.ele.ACC.3.F.PL+IMPF+2+SG
entupia-lhe	entupir+V.ele.DAT.3.SG+IMPF+1+SG
entupia-lhe	entupir+V.ele.DAT.3.SG+IMPF+3+SG
entupia-lhes	entupir+V.ele.DAT.3.PL+IMPF+1+SG
entupia-lhes	entupir+V.ele.DAT.3.PL+IMPF+3+SG
entupia-lo	entupir+V.ele.ACC.3.M.SG+IMPF+2+SG
entupia-los	entupir+V.ele.ACC.3.M.PL+IMPF+2+SG
entupia-me	entupir+V.eu.AD.1.SG+IMPF+1+SG
entupia-me	entupir+V.eu.AD.1.SG+IMPF+3+SG
entupiam-lhe	entupir+V.ele.DAT.3.SG+IMPF+3+PL
entupiam-lhes	entupir+V.ele.DAT.3.PL+IMPF+3+PL
entupiam-me	entupir+V.eu.AD.1.SG+IMPF+3+PL
entupiam-na	entupir+V.ele.ACC.3.F.SG+IMPF+3+PL
entupiam-nas	entupir+V.ele.ACC.3.F.PL+IMPF+3+PL
entupiam-no	entupir+V.ele.ACC.3.M.SG+IMPF+3+PL
entupiam-nos	entupir+V.ele.ACC.3.M.PL+IMPF+3+PL
entupiam-nos	entupir+V.nós.AD.1.PL+IMPF+3+PL
entupíamo-la	entupir+V.ele.ACC.3.F.SG+IMPF+1+PL
entupíamo-las	entupir+V.ele.ACC.3.F.PL+IMPF+1+PL
entupíamo-lo	entupir+V.ele.ACC.3.M.SG+IMPF+1+PL
entupíamo-los	entupir+V.ele.ACC.3.M.PL+IMPF+1+PL
entupíamo-nos	entupir+nós.AD.1.PL+IMPF+1+PL
entupíamos-lhe	entupir+V.ele.DAT.3.SG+IMPF+1+PL
entupíamos-lhes	entupir+V.ele.DAT.3.PL+IMPF+1+PL
entupíamos-me	entupir+V.eu.AD.1.SG+IMPF+1+PL
entupíamos-te	entupir+V.tu.AD.2.SG+IMPF+1+PL
entupíamos-vos	entupir+V.vós.AD.2.PL+IMPF+1+PL
entupiam-se	entupir+V.ele.REFL+IMPF+3+PL
entupiam-te	entupir+V.tu.AD.2.SG+IMPF+3+PL
entupiam-vos	entupir+V.vós.AD.2.PL+IMPF+3+PL
entupia-nos	entupir+nós.AD.1.PL+IMPF+1+SG
entupia-nos	entupir+nós.AD.1.PL+IMPF+2+SG
entupia-nos	entupir+nós.AD.1.PL+IMPF+3+SG
entupia-o	entupir+V.ele.ACC.3.M.SG+IMPF+1+SG
entupia-o	entupir+V.ele.ACC.3.M.SG+IMPF+3+SG
entupia-os	entupir+V.ele.ACC.3.M.PL+IMPF+1+SG
entupia-os	entupir+V.ele.ACC.3.M.PL+IMPF+3+SG
entupia-se	entupir+V.ele.REFL+IMPF+3+SG
entupi-as	entupir+V.ele.ACC.3.F.PL+PRF+1+SG
entupias-lhe	entupir+V.ele.DAT.3.SG+IMPF+2+SG
entupias-lhes	entupir+V.ele.DAT.3.PL+IMPF+2+SG
entupias-me	entupir+V.eu.AD.1.SG+IMPF+2+SG
entupias-te	entupir+V.tu.AD.2.SG+IMPF+2+SG
entupias-vos	entupir+V.vós.AD.2.PL+IMPF+2+SG
entupia-te	entupir+V.tu.AD.2.SG+IMPF+1+SG
entupia-te	entupir+V.tu.AD.2.SG+IMPF+3+SG
entupia-vos	entupir+V.vós.AD.2.PL+IMPF+1+SG
entupia-vos	entupir+V.vós.AD.2.PL+IMPF+3+SG
entupíei-la	entupir+V.ele.ACC.3.F.SG+IMPF+2+PL
entupíei-las	entupir+V.ele.ACC.3.F.PL+IMPF+2+PL
entupíei-lo	entupir+V.ele.ACC.3.M.SG+IMPF+2+PL
entupíei-los	entupir+V.ele.ACC.3.M.PL+IMPF+2+PL
entupíei-nos	entupir+nós.AD.1.PL+IMPF+2+PL
entupíeis-lhe	entupir+V.ele.DAT.3.SG+IMPF+2+PL
entupíeis-lhes	entupir+V.ele.DAT.3.PL+IMPF+2+PL
entupíeis-me	entupir+V.eu.AD.1.SG+IMPF+2+PL
entupíeis-te	entupir+V.tu.AD.2.SG+IMPF+2+PL
entupíeis-vos	entupir+V.vós.AD.2.PL+IMPF+2+PL
entupigaita-a	entupigaitar+V.ele.ACC.3.F.SG+PRS+3+SG
entupigaita-as	entupigaitar+V.ele.ACC.3.F.PL+PRS+3+SG
entupigaitai-la	entupigaitar+V.ele.ACC.3.F.SG+PRS+2+PL
entupigaitai-las	entupigaitar+V.ele.ACC.3.F.PL+PRS+2+PL
entupigaitai-lo	entupigaitar+V.ele.ACC.3.M.SG+PRS+2+PL
entupigaitai-los	entupigaitar+V.ele.ACC.3.M.PL+PRS+2+PL
entupigaitai-nos	entupigaitar+nós.AD.1.PL+PRS+2+PL
entupigaitais-lhe	entupigaitar+V.ele.DAT.3.SG+PRS+2+PL
entupigaitais-lhes	entupigaitar+V.ele.DAT.3.PL+PRS+2+PL
entupigaitais-me	entupigaitar+V.eu.AD.1.SG+PRS+2+PL
entupigaitais-te	entupigaitar+V.tu.AD.2.SG+PRS+2+PL
entupigaitais-vos	entupigaitar+V.vós.AD.2.PL+PRS+2+PL
entupigaitá-la-á	entupigaitar+V.ele.ACC.3.F.SG+FUT+3+SG
entupigaitá-la-ão	entupigaitar+V.ele.ACC.3.F.SG+FUT+3+PL
entupigaitá-la-ás	entupigaitar+V.ele.ACC.3.F.SG+FUT+2+SG
entupigaitá-la-ei	entupigaitar+V.ele.ACC.3.F.SG+FUT+1+SG
entupigaitá-la-eis	entupigaitar+V.ele.ACC.3.F.SG+FUT+2+PL
entupigaitá-la-emos	entupigaitar+V.ele.ACC.3.F.SG+FUT+1+PL
entupigaitá-la	entupigaitar+V.ele.ACC.3.F.SG+INF+1+SG
entupigaitá-la	entupigaitar+V.ele.ACC.3.F.SG+INF+3+SG
entupigaita-la	entupigaitar+V.ele.ACC.3.F.SG+PRS+2+SG
entupigaitá-la	entupigaitar+V.ele.ACC.3.F.SG+SBJF+1+SG
entupigaitá-la	entupigaitar+V.ele.ACC.3.F.SG+SBJF+3+SG
entupigaitá-la-ia	entupigaitar+V.ele.ACC.3.F.SG+COND+1+SG
entupigaitá-la-ia	entupigaitar+V.ele.ACC.3.F.SG+COND+3+SG
entupigaitá-la-iam	entupigaitar+V.ele.ACC.3.F.SG+COND+3+PL
entupigaitá-la-íamos	entupigaitar+V.ele.ACC.3.F.SG+COND+1+PL
entupigaitá-la-ias	entupigaitar+V.ele.ACC.3.F.SG+COND+2+SG
entupigaitá-la-íeis	entupigaitar+V.ele.ACC.3.F.SG+COND+2+PL
entupigaitá-las-á	entupigaitar+V.ele.ACC.3.F.PL+FUT+3+SG
entupigaitá-las-ão	entupigaitar+V.ele.ACC.3.F.PL+FUT+3+PL
entupigaitá-las-ás	entupigaitar+V.ele.ACC.3.F.PL+FUT+2+SG
entupigaitá-las-ei	entupigaitar+V.ele.ACC.3.F.PL+FUT+1+SG
entupigaitá-las-eis	entupigaitar+V.ele.ACC.3.F.PL+FUT+2+PL
entupigaitá-las-emos	entupigaitar+V.ele.ACC.3.F.PL+FUT+1+PL
entupigaitá-las	entupigaitar+V.ele.ACC.3.F.PL+INF+1+SG
entupigaitá-las	entupigaitar+V.ele.ACC.3.F.PL+INF+3+SG
entupigaita-las	entupigaitar+V.ele.ACC.3.F.PL+PRS+2+SG
entupigaitá-las	entupigaitar+V.ele.ACC.3.F.PL+SBJF+1+SG
entupigaitá-las	entupigaitar+V.ele.ACC.3.F.PL+SBJF+3+SG
entupigaitá-las-ia	entupigaitar+V.ele.ACC.3.F.PL+COND+1+SG
entupigaitá-las-ia	entupigaitar+V.ele.ACC.3.F.PL+COND+3+SG
entupigaitá-las-iam	entupigaitar+V.ele.ACC.3.F.PL+COND+3+PL
entupigaitá-las-íamos	entupigaitar+V.ele.ACC.3.F.PL+COND+1+PL
entupigaitá-las-ias	entupigaitar+V.ele.ACC.3.F.PL+COND+2+SG
entupigaitá-las-íeis	entupigaitar+V.ele.ACC.3.F.PL+COND+2+PL
entupigaita-lhe	entupigaitar+V.ele.DAT.3.SG+PRS+3+SG
entupigaita-lhes	entupigaitar+V.ele.DAT.3.PL+PRS+3+SG
entupigaitá-lo-á	entupigaitar+V.ele.ACC.3.M.SG+FUT+3+SG
entupigaitá-lo-ão	entupigaitar+V.ele.ACC.3.M.SG+FUT+3+PL
entupigaitá-lo-ás	entupigaitar+V.ele.ACC.3.M.SG+FUT+2+SG
entupigaitá-lo-ei	entupigaitar+V.ele.ACC.3.M.SG+FUT+1+SG
entupigaitá-lo-eis	entupigaitar+V.ele.ACC.3.M.SG+FUT+2+PL
entupigaitá-lo-emos	entupigaitar+V.ele.ACC.3.M.SG+FUT+1+PL
entupigaitá-lo	entupigaitar+V.ele.ACC.3.M.SG+INF+1+SG
entupigaitá-lo	entupigaitar+V.ele.ACC.3.M.SG+INF+3+SG
entupigaita-lo	entupigaitar+V.ele.ACC.3.M.SG+PRS+2+SG
entupigaitá-lo	entupigaitar+V.ele.ACC.3.M.SG+SBJF+1+SG
entupigaitá-lo	entupigaitar+V.ele.ACC.3.M.SG+SBJF+3+SG
entupigaitá-lo-ia	entupigaitar+V.ele.ACC.3.M.SG+COND+1+SG
entupigaitá-lo-ia	entupigaitar+V.ele.ACC.3.M.SG+COND+3+SG
entupigaitá-lo-iam	entupigaitar+V.ele.ACC.3.M.SG+COND+3+PL
entupigaitá-lo-íamos	entupigaitar+V.ele.ACC.3.M.SG+COND+1+PL
entupigaitá-lo-ias	entupigaitar+V.ele.ACC.3.M.SG+COND+2+SG
entupigaitá-lo-íeis	entupigaitar+V.ele.ACC.3.M.SG+COND+2+PL
entupigaitá-los-á	entupigaitar+V.ele.ACC.3.M.PL+FUT+3+SG
entupigaitá-los-ão	entupigaitar+V.ele.ACC.3.M.PL+FUT+3+PL
entupigaitá-los-ás	entupigaitar+V.ele.ACC.3.M.PL+FUT+2+SG
entupigaitá-los-ei	entupigaitar+V.ele.ACC.3.M.PL+FUT+1+SG
entupigaitá-los-eis	entupigaitar+V.ele.ACC.3.M.PL+FUT+2+PL
entupigaitá-los-emos	entupigaitar+V.ele.ACC.3.M.PL+FUT+1+PL
entupigaitá-los	entupigaitar+V.ele.ACC.3.M.PL+INF+1+SG
entupigaitá-los	entupigaitar+V.ele.ACC.3.M.PL+INF+3+SG
entupigaita-los	entupigaitar+V.ele.ACC.3.M.PL+PRS+2+SG
entupigaitá-los	entupigaitar+V.ele.ACC.3.M.PL+SBJF+1+SG
entupigaitá-los	entupigaitar+V.ele.ACC.3.M.PL+SBJF+3+SG
entupigaitá-los-ia	entupigaitar+V.ele.ACC.3.M.PL+COND+1+SG
entupigaitá-los-ia	entupigaitar+V.ele.ACC.3.M.PL+COND+3+SG
entupigaitá-los-iam	entupigaitar+V.ele.ACC.3.M.PL+COND+3+PL
entupigaitá-los-íamos	entupigaitar+V.ele.ACC.3.M.PL+COND+1+PL
entupigaitá-los-ias	entupigaitar+V.ele.ACC.3.M.PL+COND+2+SG
entupigaitá-los-íeis	entupigaitar+V.ele.ACC.3.M.PL+COND+2+PL
entupigaita-me	entupigaitar+V.eu.AD.1.SG+PRS+3+SG
entupigaitam-lhe	entupigaitar+V.ele.DAT.3.SG+PRS+3+PL
entupigaitam-lhes	entupigaitar+V.ele.DAT.3.PL+PRS+3+PL
entupigaitam-me	entupigaitar+V.eu.AD.1.SG+PRS+3+PL
entupigaitam-na	entupigaitar+V.ele.ACC.3.F.SG+PRS+3+PL
entupigaitam-nas	entupigaitar+V.ele.ACC.3.F.PL+PRS+3+PL
entupigaitam-no	entupigaitar+V.ele.ACC.3.M.SG+PRS+3+PL
entupigaitam-nos	entupigaitar+V.ele.ACC.3.M.PL+PRS+3+PL
entupigaitam-nos	entupigaitar+V.nós.AD.1.PL+PRS+3+PL
entupigaitamo-la	entupigaitar+V.ele.ACC.3.F.SG+PRF+1+PL
entupigaitamo-la	entupigaitar+V.ele.ACC.3.F.SG+PRS+1+PL
entupigaitamo-las	entupigaitar+V.ele.ACC.3.F.PL+PRF+1+PL
entupigaitamo-las	entupigaitar+V.ele.ACC.3.F.PL+PRS+1+PL
entupigaitamo-lo	entupigaitar+V.ele.ACC.3.M.SG+PRF+1+PL
entupigaitamo-lo	entupigaitar+V.ele.ACC.3.M.SG+PRS+1+PL
entupigaitamo-los	entupigaitar+V.ele.ACC.3.M.PL+PRF+1+PL
entupigaitamo-los	entupigaitar+V.ele.ACC.3.M.PL+PRS+1+PL
entupigaitamo-nos	entupigaitar+nós.AD.1.PL+PRF+1+PL
entupigaitamo-nos	entupigaitar+nós.AD.1.PL+PRS+1+PL
entupigaitamos-lhe	entupigaitar+V.ele.DAT.3.SG+PRF+1+PL
entupigaitamos-lhe	entupigaitar+V.ele.DAT.3.SG+PRS+1+PL
entupigaitamos-lhes	entupigaitar+V.ele.DAT.3.PL+PRF+1+PL
entupigaitamos-lhes	entupigaitar+V.ele.DAT.3.PL+PRS+1+PL
entupigaitamos-me	entupigaitar+V.eu.AD.1.SG+PRF+1+PL
entupigaitamos-me	entupigaitar+V.eu.AD.1.SG+PRS+1+PL
entupigaitamos-te	entupigaitar+V.tu.AD.2.SG+PRF+1+PL
entupigaitamos-te	entupigaitar+V.tu.AD.2.SG+PRS+1+PL
entupigaitamos-vos	entupigaitar+V.vós.AD.2.PL+PRF+1+PL
entupigaitamos-vos	entupigaitar+V.vós.AD.2.PL+PRS+1+PL
entupigaitam-se	entupigaitar+V.ele.REFL+PRS+3+PL
entupigaitam-te	entupigaitar+V.tu.AD.2.SG+PRS+3+PL
entupigaitam-vos	entupigaitar+V.vós.AD.2.PL+PRS+3+PL
entupigaitando-a	entupigaitar+V.ele.ACC.3.F.SG+GRD
entupigaitando-as	entupigaitar+V.ele.ACC.3.F.PL+GRD
entupigaitando-lhe	entupigaitar+V.ele.DAT.3.SG+GRD
entupigaitando-lhes	entupigaitar+V.ele.DAT.3.PL+GRD
entupigaitando-me	entupigaitar+V.eu.AD.1.SG+GRD
entupigaitando-nos	entupigaitar+nós.AD.1.PL+GRD
entupigaitando-o	entupigaitar+V.ele.ACC.3.M.SG+GRD
entupigaitando-os	entupigaitar+V.ele.ACC.3.M.PL+GRD
entupigaitando-se	entupigaitar+V.ele.REFL+GRD
entupigaitando-te	entupigaitar+V.tu.AD.2.SG+GRD
entupigaitando-vos	entupigaitar+V.vós.AD.2.PL+GRD
entupigaita-nos	entupigaitar+nós.AD.1.PL+PRS+2+SG
entupigaita-nos	entupigaitar+nós.AD.1.PL+PRS+3+SG
entupigaita-o	entupigaitar+V.ele.ACC.3.M.SG+PRS+3+SG
entupigaita-os	entupigaitar+V.ele.ACC.3.M.PL+PRS+3+SG
entupigaitara-a	entupigaitar+V.ele.ACC.3.F.SG+PQP+1+SG
entupigaitara-a	entupigaitar+V.ele.ACC.3.F.SG+PQP+3+SG
entupigaitara-as	entupigaitar+V.ele.ACC.3.F.PL+PQP+1+SG
entupigaitara-as	entupigaitar+V.ele.ACC.3.F.PL+PQP+3+SG
entupigaitara-la	entupigaitar+V.ele.ACC.3.F.SG+PQP+2+SG
entupigaitara-las	entupigaitar+V.ele.ACC.3.F.PL+PQP+2+SG
entupigaitara-lhe	entupigaitar+V.ele.DAT.3.SG+PQP+1+SG
entupigaitara-lhe	entupigaitar+V.ele.DAT.3.SG+PQP+3+SG
entupigaitara-lhes	entupigaitar+V.ele.DAT.3.PL+PQP+1+SG
entupigaitara-lhes	entupigaitar+V.ele.DAT.3.PL+PQP+3+SG
entupigaitara-lo	entupigaitar+V.ele.ACC.3.M.SG+PQP+2+SG
entupigaitara-los	entupigaitar+V.ele.ACC.3.M.PL+PQP+2+SG
entupigaitara-me	entupigaitar+V.eu.AD.1.SG+PQP+1+SG
entupigaitara-me	entupigaitar+V.eu.AD.1.SG+PQP+3+SG
entupigaitaram-lhe	entupigaitar+V.ele.DAT.3.SG+PQP+3+PL
entupigaitaram-lhe	entupigaitar+V.ele.DAT.3.SG+PRF+3+PL
entupigaitaram-lhes	entupigaitar+V.ele.DAT.3.PL+PQP+3+PL
entupigaitaram-lhes	entupigaitar+V.ele.DAT.3.PL+PRF+3+PL
entupigaitaram-me	entupigaitar+V.eu.AD.1.SG+PQP+3+PL
entupigaitaram-me	entupigaitar+V.eu.AD.1.SG+PRF+3+PL
entupigaitaram-na	entupigaitar+V.ele.ACC.3.F.SG+PQP+3+PL
entupigaitaram-na	entupigaitar+V.ele.ACC.3.F.SG+PRF+3+PL
entupigaitaram-nas	entupigaitar+V.ele.ACC.3.F.PL+PQP+3+PL
entupigaitaram-nas	entupigaitar+V.ele.ACC.3.F.PL+PRF+3+PL
entupigaitaram-no	entupigaitar+V.ele.ACC.3.M.SG+PQP+3+PL
entupigaitaram-no	entupigaitar+V.ele.ACC.3.M.SG+PRF+3+PL
entupigaitaram-nos	entupigaitar+V.ele.ACC.3.M.PL+PQP+3+PL
entupigaitaram-nos	entupigaitar+V.ele.ACC.3.M.PL+PRF+3+PL
entupigaitaram-nos	entupigaitar+V.nós.AD.1.PL+PQP+3+PL
entupigaitaram-nos	entupigaitar+V.nós.AD.1.PL+PRF+3+PL
entupigaitáramo-la	entupigaitar+V.ele.ACC.3.F.SG+PQP+1+PL
entupigaitáramo-las	entupigaitar+V.ele.ACC.3.F.PL+PQP+1+PL
entupigaitáramo-lo	entupigaitar+V.ele.ACC.3.M.SG+PQP+1+PL
entupigaitáramo-los	entupigaitar+V.ele.ACC.3.M.PL+PQP+1+PL
entupigaitáramo-nos	entupigaitar+nós.AD.1.PL+PQP+1+PL
entupigaitáramos-lhe	entupigaitar+V.ele.DAT.3.SG+PQP+1+PL
entupigaitáramos-lhes	entupigaitar+V.ele.DAT.3.PL+PQP+1+PL
entupigaitáramos-me	entupigaitar+V.eu.AD.1.SG+PQP+1+PL
entupigaitáramos-te	entupigaitar+V.tu.AD.2.SG+PQP+1+PL
entupigaitáramos-vos	entupigaitar+V.vós.AD.2.PL+PQP+1+PL
entupigaitaram-se	entupigaitar+V.ele.REFL+PQP+3+PL
entupigaitaram-se	entupigaitar+V.ele.REFL+PRF+3+PL
entupigaitaram-te	entupigaitar+V.tu.AD.2.SG+PQP+3+PL
entupigaitaram-te	entupigaitar+V.tu.AD.2.SG+PRF+3+PL
entupigaitaram-vos	entupigaitar+V.vós.AD.2.PL+PQP+3+PL
entupigaitaram-vos	entupigaitar+V.vós.AD.2.PL+PRF+3+PL
entupigaitara-nos	entupigaitar+nós.AD.1.PL+PQP+1+SG
entupigaitara-nos	entupigaitar+nós.AD.1.PL+PQP+2+SG
entupigaitara-nos	entupigaitar+nós.AD.1.PL+PQP+3+SG
entupigaitara-o	entupigaitar+V.ele.ACC.3.M.SG+PQP+1+SG
entupigaitara-o	entupigaitar+V.ele.ACC.3.M.SG+PQP+3+SG
entupigaitara-os	entupigaitar+V.ele.ACC.3.M.PL+PQP+1+SG
entupigaitara-os	entupigaitar+V.ele.ACC.3.M.PL+PQP+3+SG
entupigaitara-se	entupigaitar+V.ele.REFL+PQP+1+SG
entupigaitara-se	entupigaitar+V.ele.REFL+PQP+3+SG
entupigaitaras-lhe	entupigaitar+V.ele.DAT.3.SG+PQP+2+SG
entupigaitaras-lhes	entupigaitar+V.ele.DAT.3.PL+PQP+2+SG
entupigaitaras-me	entupigaitar+V.eu.AD.1.SG+PQP+2+SG
entupigaitaras-te	entupigaitar+V.tu.AD.2.SG+PQP+2+SG
entupigaitaras-vos	entupigaitar+V.vós.AD.2.PL+PQP+2+SG
entupigaitara-te	entupigaitar+V.tu.AD.2.SG+PQP+1+SG
entupigaitara-te	entupigaitar+V.tu.AD.2.SG+PQP+3+SG
entupigaitara-vos	entupigaitar+V.vós.AD.2.PL+PQP+1+SG
entupigaitara-vos	entupigaitar+V.vós.AD.2.PL+PQP+3+SG
entupigaitarde-la	entupigaitar+V.ele.ACC.3.F.SG+INF+2+PL
entupigaitarde-la	entupigaitar+V.ele.ACC.3.F.SG+SBJF+2+PL
entupigaitarde-las	entupigaitar+V.ele.ACC.3.F.PL+INF+2+PL
entupigaitarde-las	entupigaitar+V.ele.ACC.3.F.PL+SBJF+2+PL
entupigaitarde-lo	entupigaitar+V.ele.ACC.3.M.SG+INF+2+PL
entupigaitarde-lo	entupigaitar+V.ele.ACC.3.M.SG+SBJF+2+PL
entupigaitarde-los	entupigaitar+V.ele.ACC.3.M.PL+INF+2+PL
entupigaitarde-los	entupigaitar+V.ele.ACC.3.M.PL+SBJF+2+PL
entupigaitarde-nos	entupigaitar+nós.AD.1.PL+INF+2+PL
entupigaitarde-nos	entupigaitar+nós.AD.1.PL+SBJF+2+PL
entupigaitardes-lhe	entupigaitar+V.ele.DAT.3.SG+INF+2+PL
entupigaitardes-lhe	entupigaitar+V.ele.DAT.3.SG+SBJF+2+PL
entupigaitardes-lhes	entupigaitar+V.ele.DAT.3.PL+INF+2+PL
entupigaitardes-lhes	entupigaitar+V.ele.DAT.3.PL+SBJF+2+PL
entupigaitardes-me	entupigaitar+V.eu.AD.1.SG+INF+2+PL
entupigaitardes-me	entupigaitar+V.eu.AD.1.SG+SBJF+2+PL
entupigaitardes-te	entupigaitar+V.tu.AD.2.SG+INF+2+PL
entupigaitardes-te	entupigaitar+V.tu.AD.2.SG+SBJF+2+PL
entupigaitardes-vos	entupigaitar+V.vós.AD.2.PL+INF+2+PL
entupigaitardes-vos	entupigaitar+V.vós.AD.2.PL+SBJF+2+PL
entupigaitárei-la	entupigaitar+V.ele.ACC.3.F.SG+PQP+2+PL
entupigaitárei-las	entupigaitar+V.ele.ACC.3.F.PL+PQP+2+PL
entupigaitárei-lo	entupigaitar+V.ele.ACC.3.M.SG+PQP+2+PL
entupigaitárei-los	entupigaitar+V.ele.ACC.3.M.PL+PQP+2+PL
entupigaitárei-nos	entupigaitar+nós.AD.1.PL+PQP+2+PL
entupigaitáreis-lhe	entupigaitar+V.ele.DAT.3.SG+PQP+2+PL
entupigaitáreis-lhes	entupigaitar+V.ele.DAT.3.PL+PQP+2+PL
entupigaitáreis-me	entupigaitar+V.eu.AD.1.SG+PQP+2+PL
entupigaitáreis-te	entupigaitar+V.tu.AD.2.SG+PQP+2+PL
entupigaitáreis-vos	entupigaitar+V.vós.AD.2.PL+PQP+2+PL
entupigaitare-la	entupigaitar+V.ele.ACC.3.F.SG+INF+2+SG
entupigaitare-la	entupigaitar+V.ele.ACC.3.F.SG+SBJF+2+SG
entupigaitare-las	entupigaitar+V.ele.ACC.3.F.PL+INF+2+SG
entupigaitare-las	entupigaitar+V.ele.ACC.3.F.PL+SBJF+2+SG
entupigaitare-lo	entupigaitar+V.ele.ACC.3.M.SG+INF+2+SG
entupigaitare-lo	entupigaitar+V.ele.ACC.3.M.SG+SBJF+2+SG
entupigaitare-los	entupigaitar+V.ele.ACC.3.M.PL+INF+2+SG
entupigaitare-los	entupigaitar+V.ele.ACC.3.M.PL+SBJF+2+SG
entupigaitarem-lhe	entupigaitar+V.ele.DAT.3.SG+INF+3+PL
entupigaitarem-lhe	entupigaitar+V.ele.DAT.3.SG+SBJF+3+PL
entupigaitarem-lhes	entupigaitar+V.ele.DAT.3.PL+INF+3+PL
entupigaitarem-lhes	entupigaitar+V.ele.DAT.3.PL+SBJF+3+PL
entupigaitarem-me	entupigaitar+V.eu.AD.1.SG+INF+3+PL
entupigaitarem-me	entupigaitar+V.eu.AD.1.SG+SBJF+3+PL
entupigaitarem-na	entupigaitar+V.ele.ACC.3.F.SG+INF+3+PL
entupigaitarem-na	entupigaitar+V.ele.ACC.3.F.SG+SBJF+3+PL
entupigaitarem-nas	entupigaitar+V.ele.ACC.3.F.PL+INF+3+PL
entupigaitarem-nas	entupigaitar+V.ele.ACC.3.F.PL+SBJF+3+PL
entupigaitarem-no	entupigaitar+V.ele.ACC.3.M.SG+INF+3+PL
entupigaitarem-no	entupigaitar+V.ele.ACC.3.M.SG+SBJF+3+PL
entupigaitarem-nos	entupigaitar+V.ele.ACC.3.M.PL+INF+3+PL
entupigaitarem-nos	entupigaitar+V.ele.ACC.3.M.PL+SBJF+3+PL
entupigaitarem-nos	entupigaitar+V.nós.AD.1.PL+INF+3+PL
entupigaitarem-nos	entupigaitar+V.nós.AD.1.PL+SBJF+3+PL
entupigaitarem-se	entupigaitar+V.ele.REFL+INF+3+PL
entupigaitarem-se	entupigaitar+V.ele.REFL+SBJF+3+PL
entupigaitarem-te	entupigaitar+V.tu.AD.2.SG+INF+3+PL
entupigaitarem-te	entupigaitar+V.tu.AD.2.SG+SBJF+3+PL
entupigaitarem-vos	entupigaitar+V.vós.AD.2.PL+INF+3+PL
entupigaitarem-vos	entupigaitar+V.vós.AD.2.PL+SBJF+3+PL
entupigaitare-nos	entupigaitar+nós.AD.1.PL+INF+2+SG
entupigaitare-nos	entupigaitar+nós.AD.1.PL+SBJF+2+SG
entupigaitares-lhe	entupigaitar+V.ele.DAT.3.SG+INF+2+SG
entupigaitares-lhe	entupigaitar+V.ele.DAT.3.SG+SBJF+2+SG
entupigaitares-lhes	entupigaitar+V.ele.DAT.3.PL+INF+2+SG
entupigaitares-lhes	entupigaitar+V.ele.DAT.3.PL+SBJF+2+SG
entupigaitares-me	entupigaitar+V.eu.AD.1.SG+INF+2+SG
entupigaitares-me	entupigaitar+V.eu.AD.1.SG+SBJF+2+SG
entupigaitares-te	entupigaitar+V.tu.AD.2.SG+INF+2+SG
entupigaitares-te	entupigaitar+V.tu.AD.2.SG+SBJF+2+SG
entupigaitares-vos	entupigaitar+V.vós.AD.2.PL+INF+2+SG
entupigaitares-vos	entupigaitar+V.vós.AD.2.PL+SBJF+2+SG
entupigaitar-lhe-á	entupigaitar+V.ele.DAT.3.SG+FUT+3+SG
entupigaitar-lhe-ão	entupigaitar+V.ele.DAT.3.SG+FUT+3+PL
entupigaitar-lhe-ás	entupigaitar+V.ele.DAT.3.SG+FUT+2+SG
entupigaitar-lhe-ei	entupigaitar+V.ele.DAT.3.SG+FUT+1+SG
entupigaitar-lhe-eis	entupigaitar+V.ele.DAT.3.SG+FUT+2+PL
entupigaitar-lhe-emos	entupigaitar+V.ele.DAT.3.SG+FUT+1+PL
entupigaitar-lhe	entupigaitar+V.ele.DAT.3.SG+INF
entupigaitar-lhe	entupigaitar+V.ele.DAT.3.SG+INF+1+SG
entupigaitar-lhe	entupigaitar+V.ele.DAT.3.SG+INF+3+SG
entupigaitar-lhe	entupigaitar+V.ele.DAT.3.SG+SBJF+1+SG
entupigaitar-lhe	entupigaitar+V.ele.DAT.3.SG+SBJF+3+SG
entupigaitar-lhe-ia	entupigaitar+V.ele.DAT.3.SG+COND+1+SG
entupigaitar-lhe-ia	entupigaitar+V.ele.DAT.3.SG+COND+3+SG
entupigaitar-lhe-iam	entupigaitar+V.ele.DAT.3.SG+COND+3+PL
entupigaitar-lhe-íamos	entupigaitar+V.ele.DAT.3.SG+COND+1+PL
entupigaitar-lhe-ias	entupigaitar+V.ele.DAT.3.SG+COND+2+SG
entupigaitar-lhe-íeis	entupigaitar+V.ele.DAT.3.SG+COND+2+PL
entupigaitar-lhes-á	entupigaitar+V.ele.DAT.3.PL+FUT+3+SG
entupigaitar-lhes-ão	entupigaitar+V.ele.DAT.3.PL+FUT+3+PL
entupigaitar-lhes-ás	entupigaitar+V.ele.DAT.3.PL+FUT+2+SG
entupigaitar-lhes-ei	entupigaitar+V.ele.DAT.3.PL+FUT+1+SG
entupigaitar-lhes-eis	entupigaitar+V.ele.DAT.3.PL+FUT+2+PL
entupigaitar-lhes-emos	entupigaitar+V.ele.DAT.3.PL+FUT+1+PL
entupigaitar-lhes	entupigaitar+V.ele.DAT.3.PL+INF
entupigaitar-lhes	entupigaitar+V.ele.DAT.3.PL+INF+1+SG
entupigaitar-lhes	entupigaitar+V.ele.DAT.3.PL+INF+3+SG
entupigaitar-lhes	entupigaitar+V.ele.DAT.3.PL+SBJF+1+SG
entupigaitar-lhes	entupigaitar+V.ele.DAT.3.PL+SBJF+3+SG
entupigaitar-lhes-ia	entupigaitar+V.ele.DAT.3.PL+COND+1+SG
entupigaitar-lhes-ia	entupigaitar+V.ele.DAT.3.PL+COND+3+SG
entupigaitar-lhes-iam	entupigaitar+V.ele.DAT.3.PL+COND+3+PL
entupigaitar-lhes-íamos	entupigaitar+V.ele.DAT.3.PL+COND+1+PL
entupigaitar-lhes-ias	entupigaitar+V.ele.DAT.3.PL+COND+2+SG
entupigaitar-lhes-íeis	entupigaitar+V.ele.DAT.3.PL+COND+2+PL
entupigaitar-me-á	entupigaitar+V.eu.AD.1.SG+FUT+3+SG
entupigaitar-me-ão	entupigaitar+V.eu.AD.1.SG+FUT+3+PL
entupigaitar-me-ás	entupigaitar+V.eu.AD.1.SG+FUT+2+SG
entupigaitar-me-ei	entupigaitar+V.eu.AD.1.SG+FUT+1+SG
entupigaitar-me-eis	entupigaitar+V.eu.AD.1.SG+FUT+2+PL
entupigaitar-me-emos	entupigaitar+V.eu.AD.1.SG+FUT+1+PL
entupigaitar-me	entupigaitar+V.eu.AD.1.SG+INF
entupigaitar-me	entupigaitar+V.eu.AD.1.SG+INF+1+SG
entupigaitar-me	entupigaitar+V.eu.AD.1.SG+INF+3+SG
entupigaitar-me	entupigaitar+V.eu.AD.1.SG+SBJF+1+SG
entupigaitar-me	entupigaitar+V.eu.AD.1.SG+SBJF+3+SG
entupigaitar-me-ia	entupigaitar+V.eu.AD.1.SG+COND+1+SG
entupigaitar-me-ia	entupigaitar+V.eu.AD.1.SG+COND+3+SG
entupigaitar-me-iam	entupigaitar+V.eu.AD.1.SG+COND+3+PL
entupigaitar-me-íamos	entupigaitar+V.eu.AD.1.SG+COND+1+PL
entupigaitar-me-ias	entupigaitar+V.eu.AD.1.SG+COND+2+SG
entupigaitar-me-íeis	entupigaitar+V.eu.AD.1.SG+COND+2+PL
entupigaitarmo-la	entupigaitar+V.ele.ACC.3.F.SG+INF+1+PL
entupigaitarmo-la	entupigaitar+V.ele.ACC.3.F.SG+SBJF+1+PL
entupigaitarmo-las	entupigaitar+V.ele.ACC.3.F.PL+INF+1+PL
entupigaitarmo-las	entupigaitar+V.ele.ACC.3.F.PL+SBJF+1+PL
entupigaitarmo-lo	entupigaitar+V.ele.ACC.3.M.SG+INF+1+PL
entupigaitarmo-lo	entupigaitar+V.ele.ACC.3.M.SG+SBJF+1+PL
entupigaitarmo-los	entupigaitar+V.ele.ACC.3.M.PL+INF+1+PL
entupigaitarmo-los	entupigaitar+V.ele.ACC.3.M.PL+SBJF+1+PL
entupigaitarmo-nos	entupigaitar+nós.AD.1.PL+INF+1+PL
entupigaitarmo-nos	entupigaitar+nós.AD.1.PL+SBJF+1+PL
entupigaitarmos-lhe	entupigaitar+V.ele.DAT.3.SG+INF+1+PL
entupigaitarmos-lhe	entupigaitar+V.ele.DAT.3.SG+SBJF+1+PL
entupigaitarmos-lhes	entupigaitar+V.ele.DAT.3.PL+INF+1+PL
entupigaitarmos-lhes	entupigaitar+V.ele.DAT.3.PL+SBJF+1+PL
entupigaitarmos-me	entupigaitar+V.eu.AD.1.SG+INF+1+PL
entupigaitarmos-me	entupigaitar+V.eu.AD.1.SG+SBJF+1+PL
entupigaitarmos-te	entupigaitar+V.tu.AD.2.SG+INF+1+PL
entupigaitarmos-te	entupigaitar+V.tu.AD.2.SG+SBJF+1+PL
entupigaitarmos-vos	entupigaitar+V.vós.AD.2.PL+INF+1+PL
entupigaitarmos-vos	entupigaitar+V.vós.AD.2.PL+SBJF+1+PL
entupigaitar-nos-á	entupigaitar+nós.AD.1.PL+FUT+3+SG
entupigaitar-nos-ão	entupigaitar+nós.AD.1.PL+FUT+3+PL
entupigaitar-nos-ás	entupigaitar+nós.AD.1.PL+FUT+2+SG
entupigaitar-nos-ei	entupigaitar+nós.AD.1.PL+FUT+1+SG
entupigaitar-nos-eis	entupigaitar+nós.AD.1.PL+FUT+2+PL
entupigaitar-nos-emos	entupigaitar+nós.AD.1.PL+FUT+1+PL
entupigaitar-nos	entupigaitar+nós.AD.1.PL+INF
entupigaitar-nos	entupigaitar+nós.AD.1.PL+INF+1+SG
entupigaitar-nos	entupigaitar+nós.AD.1.PL+INF+3+SG
entupigaitar-nos	entupigaitar+nós.AD.1.PL+SBJF+1+SG
entupigaitar-nos	entupigaitar+nós.AD.1.PL+SBJF+3+SG
entupigaitar-nos-ia	entupigaitar+nós.AD.1.PL+COND+1+SG
entupigaitar-nos-ia	entupigaitar+nós.AD.1.PL+COND+3+SG
entupigaitar-nos-iam	entupigaitar+nós.AD.1.PL+COND+3+PL
entupigaitar-nos-íamos	entupigaitar+nós.AD.1.PL+COND+1+PL
entupigaitar-nos-ias	entupigaitar+nós.AD.1.PL+COND+2+SG
entupigaitar-nos-íeis	entupigaitar+nós.AD.1.PL+COND+2+PL
entupigaitar-se-á	entupigaitar+V.ele.REFL+FUT+3+SG
entupigaitar-se-ão	entupigaitar+V.ele.REFL+FUT+3+PL
entupigaitar-se	entupigaitar+V.ele.REFL+INF
entupigaitar-se	entupigaitar+V.ele.REFL+INF+3+SG
entupigaitar-se	entupigaitar+V.ele.REFL+SBJF+3+SG
entupigaitar-se-ia	entupigaitar+V.ele.REFL+COND+3+SG
entupigaitar-se-iam	entupigaitar+V.ele.REFL+COND+3+PL
entupigaitar-te-á	entupigaitar+V.tu.AD.2.SG+FUT+3+SG
entupigaitar-te-ão	entupigaitar+V.tu.AD.2.SG+FUT+3+PL
entupigaitar-te-ás	entupigaitar+V.tu.AD.2.SG+FUT+2+SG
entupigaitar-te-ei	entupigaitar+V.tu.AD.2.SG+FUT+1+SG
entupigaitar-te-eis	entupigaitar+V.tu.AD.2.SG+FUT+2+PL
entupigaitar-te-emos	entupigaitar+V.tu.AD.2.SG+FUT+1+PL
entupigaitar-te	entupigaitar+V.tu.AD.2.SG+INF
entupigaitar-te	entupigaitar+V.tu.AD.2.SG+INF+1+SG
entupigaitar-te	entupigaitar+V.tu.AD.2.SG+INF+3+SG
entupigaitar-te	entupigaitar+V.tu.AD.2.SG+SBJF+1+SG
entupigaitar-te	entupigaitar+V.tu.AD.2.SG+SBJF+3+SG
entupigaitar-te-ia	entupigaitar+V.tu.AD.2.SG+COND+1+SG
entupigaitar-te-ia	entupigaitar+V.tu.AD.2.SG+COND+3+SG
entupigaitar-te-iam	entupigaitar+V.tu.AD.2.SG+COND+3+PL
entupigaitar-te-íamos	entupigaitar+V.tu.AD.2.SG+COND+1+PL
entupigaitar-te-ias	entupigaitar+V.tu.AD.2.SG+COND+2+SG
entupigaitar-te-íeis	entupigaitar+V.tu.AD.2.SG+COND+2+PL
entupigaitar-vos-á	entupigaitar+V.vós.AD.2.PL+FUT+3+SG
entupigaitar-vos-ão	entupigaitar+V.vós.AD.2.PL+FUT+3+PL
entupigaitar-vos-ás	entupigaitar+V.vós.AD.2.PL+FUT+2+SG
entupigaitar-vos-ei	entupigaitar+V.vós.AD.2.PL+FUT+1+SG
entupigaitar-vos-eis	entupigaitar+V.vós.AD.2.PL+FUT+2+PL
entupigaitar-vos-emos	entupigaitar+V.vós.AD.2.PL+FUT+1+PL
entupigaitar-vos	entupigaitar+V.vós.AD.2.PL+INF
entupigaitar-vos	entupigaitar+V.vós.AD.2.PL+INF+1+SG
entupigaitar-vos	entupigaitar+V.vós.AD.2.PL+INF+3+SG
entupigaitar-vos	entupigaitar+V.vós.AD.2.PL+SBJF+1+SG
entupigaitar-vos	entupigaitar+V.vós.AD.2.PL+SBJF+3+SG
entupigaitar-vos-ia	entupigaitar+V.vós.AD.2.PL+COND+1+SG
entupigaitar-vos-ia	entupigaitar+V.vós.AD.2.PL+COND+3+SG
entupigaitar-vos-iam	entupigaitar+V.vós.AD.2.PL+COND+3+PL
entupigaitar-vos-íamos	entupigaitar+V.vós.AD.2.PL+COND+1+PL
entupigaitar-vos-ias	entupigaitar+V.vós.AD.2.PL+COND+2+SG
entupigaitar-vos-íeis	entupigaitar+V.vós.AD.2.PL+COND+2+PL
entupigaita-se	entupigaitar+V.ele.REFL+PRS+3+SG
entupigaitas-lhe	entupigaitar+V.ele.DAT.3.SG+PRS+2+SG
entupigaitas-lhes	entupigaitar+V.ele.DAT.3.PL+PRS+2+SG
entupigaitas-me	entupigaitar+V.eu.AD.1.SG+PRS+2+SG
entupigaitaste-a	entupigaitar+V.ele.ACC.3.F.SG+PRF+2+SG
entupigaitaste-as	entupigaitar+V.ele.ACC.3.F.PL+PRF+2+SG
entupigaitas-te	entupigaitar+V.tu.AD.2.SG+PRS+2+SG
entupigaitaste-la	entupigaitar+V.ele.ACC.3.F.SG+PRF+2+PL
entupigaitaste-las	entupigaitar+V.ele.ACC.3.F.PL+PRF+2+PL
entupigaitaste-lhe	entupigaitar+V.ele.DAT.3.SG+PRF+2+SG
entupigaitaste-lhes	entupigaitar+V.ele.DAT.3.PL+PRF+2+SG
entupigaitaste-lo	entupigaitar+V.ele.ACC.3.M.SG+PRF+2+PL
entupigaitaste-los	entupigaitar+V.ele.ACC.3.M.PL+PRF+2+PL
entupigaitaste-me	entupigaitar+V.eu.AD.1.SG+PRF+2+SG
entupigaitaste-nos	entupigaitar+nós.AD.1.PL+PRF+2+PL
entupigaitaste-nos	entupigaitar+nós.AD.1.PL+PRF+2+SG
entupigaitaste-o	entupigaitar+V.ele.ACC.3.M.SG+PRF+2+SG
entupigaitaste-os	entupigaitar+V.ele.ACC.3.M.PL+PRF+2+SG
entupigaitastes-lhe	entupigaitar+V.ele.DAT.3.SG+PRF+2+PL
entupigaitastes-lhes	entupigaitar+V.ele.DAT.3.PL+PRF+2+PL
entupigaitastes-me	entupigaitar+V.eu.AD.1.SG+PRF+2+PL
entupigaitastes-te	entupigaitar+V.tu.AD.2.SG+PRF+2+PL
entupigaitastes-vos	entupigaitar+V.vós.AD.2.PL+PRF+2+PL
entupigaitaste-te	entupigaitar+V.tu.AD.2.SG+PRF+2+SG
entupigaitaste-vos	entupigaitar+V.vós.AD.2.PL+PRF+2+SG
entupigaitas-vos	entupigaitar+V.vós.AD.2.PL+PRS+2+SG
entupigaita-te	entupigaitar+V.tu.AD.2.SG+PRS+3+SG
entupigaitava-a	entupigaitar+V.ele.ACC.3.F.SG+IMPF+1+SG
entupigaitava-a	entupigaitar+V.ele.ACC.3.F.SG+IMPF+3+SG
entupigaitava-as	entupigaitar+V.ele.ACC.3.F.PL+IMPF+1+SG
entupigaitava-as	entupigaitar+V.ele.ACC.3.F.PL+IMPF+3+SG
entupigaitava-la	entupigaitar+V.ele.ACC.3.F.SG+IMPF+2+SG
entupigaitava-las	entupigaitar+V.ele.ACC.3.F.PL+IMPF+2+SG
entupigaitava-lhe	entupigaitar+V.ele.DAT.3.SG+IMPF+1+SG
entupigaitava-lhe	entupigaitar+V.ele.DAT.3.SG+IMPF+3+SG
entupigaitava-lhes	entupigaitar+V.ele.DAT.3.PL+IMPF+1+SG
entupigaitava-lhes	entupigaitar+V.ele.DAT.3.PL+IMPF+3+SG
entupigaitava-lo	entupigaitar+V.ele.ACC.3.M.SG+IMPF+2+SG
entupigaitava-los	entupigaitar+V.ele.ACC.3.M.PL+IMPF+2+SG
entupigaitava-me	entupigaitar+V.eu.AD.1.SG+IMPF+1+SG
entupigaitava-me	entupigaitar+V.eu.AD.1.SG+IMPF+3+SG
entupigaitavam-lhe	entupigaitar+V.ele.DAT.3.SG+IMPF+3+PL
entupigaitavam-lhes	entupigaitar+V.ele.DAT.3.PL+IMPF+3+PL
entupigaitavam-me	entupigaitar+V.eu.AD.1.SG+IMPF+3+PL
entupigaitavam-na	entupigaitar+V.ele.ACC.3.F.SG+IMPF+3+PL
entupigaitavam-nas	entupigaitar+V.ele.ACC.3.F.PL+IMPF+3+PL
entupigaitavam-no	entupigaitar+V.ele.ACC.3.M.SG+IMPF+3+PL
entupigaitavam-nos	entupigaitar+V.ele.ACC.3.M.PL+IMPF+3+PL
entupigaitavam-nos	entupigaitar+V.nós.AD.1.PL+IMPF+3+PL
entupigaitávamo-la	entupigaitar+V.ele.ACC.3.F.SG+IMPF+1+PL
entupigaitávamo-las	entupigaitar+V.ele.ACC.3.F.PL+IMPF+1+PL
entupigaitávamo-lo	entupigaitar+V.ele.ACC.3.M.SG+IMPF+1+PL
entupigaitávamo-los	entupigaitar+V.ele.ACC.3.M.PL+IMPF+1+PL
entupigaitávamo-nos	entupigaitar+nós.AD.1.PL+IMPF+1+PL
entupigaitávamos-lhe	entupigaitar+V.ele.DAT.3.SG+IMPF+1+PL
entupigaitávamos-lhes	entupigaitar+V.ele.DAT.3.PL+IMPF+1+PL
entupigaitávamos-me	entupigaitar+V.eu.AD.1.SG+IMPF+1+PL
entupigaitávamos-te	entupigaitar+V.tu.AD.2.SG+IMPF+1+PL
entupigaitávamos-vos	entupigaitar+V.vós.AD.2.PL+IMPF+1+PL
entupigaitavam-se	entupigaitar+V.ele.REFL+IMPF+3+PL
entupigaitavam-te	entupigaitar+V.tu.AD.2.SG+IMPF+3+PL
entupigaitavam-vos	entupigaitar+V.vós.AD.2.PL+IMPF+3+PL
entupigaitava-nos	entupigaitar+nós.AD.1.PL+IMPF+1+SG
entupigaitava-nos	entupigaitar+nós.AD.1.PL+IMPF+2+SG
entupigaitava-nos	entupigaitar+nós.AD.1.PL+IMPF+3+SG
entupigaitava-o	entupigaitar+V.ele.ACC.3.M.SG+IMPF+1+SG
entupigaitava-o	entupigaitar+V.ele.ACC.3.M.SG+IMPF+3+SG
entupigaitava-os	entupigaitar+V.ele.ACC.3.M.PL+IMPF+1+SG
entupigaitava-os	entupigaitar+V.ele.ACC.3.M.PL+IMPF+3+SG
entupigaitava-se	entupigaitar+V.ele.REFL+IMPF+1+SG
entupigaitava-se	entupigaitar+V.ele.REFL+IMPF+3+SG
entupigaitavas-lhe	entupigaitar+V.ele.DAT.3.SG+IMPF+2+SG
entupigaitavas-lhes	entupigaitar+V.ele.DAT.3.PL+IMPF+2+SG
entupigaitavas-me	entupigaitar+V.eu.AD.1.SG+IMPF+2+SG
entupigaitavas-te	entupigaitar+V.tu.AD.2.SG+IMPF+2+SG
entupigaitavas-vos	entupigaitar+V.vós.AD.2.PL+IMPF+2+SG
entupigaitava-te	entupigaitar+V.tu.AD.2.SG+IMPF+1+SG
entupigaitava-te	entupigaitar+V.tu.AD.2.SG+IMPF+3+SG
entupigaitava-vos	entupigaitar+V.vós.AD.2.PL+IMPF+1+SG
entupigaitava-vos	entupigaitar+V.vós.AD.2.PL+IMPF+3+SG
entupigaitávei-la	entupigaitar+V.ele.ACC.3.F.SG+IMPF+2+PL
entupigaitávei-las	entupigaitar+V.ele.ACC.3.F.PL+IMPF+2+PL
entupigaitávei-lo	entupigaitar+V.ele.ACC.3.M.SG+IMPF+2+PL
entupigaitávei-los	entupigaitar+V.ele.ACC.3.M.PL+IMPF+2+PL
entupigaitávei-nos	entupigaitar+nós.AD.1.PL+IMPF+2+PL
entupigaitáveis-lhe	entupigaitar+V.ele.DAT.3.SG+IMPF+2+PL
entupigaitáveis-lhes	entupigaitar+V.ele.DAT.3.PL+IMPF+2+PL
entupigaitáveis-me	entupigaitar+V.eu.AD.1.SG+IMPF+2+PL
entupigaitáveis-te	entupigaitar+V.tu.AD.2.SG+IMPF+2+PL
entupigaitáveis-vos	entupigaitar+V.vós.AD.2.PL+IMPF+2+PL
entupigaita-vos	entupigaitar+V.vós.AD.2.PL+PRS+3+SG
entupigaite-a	entupigaitar+V.ele.ACC.3.F.SG+IMP+3+SG
entupigaite-as	entupigaitar+V.ele.ACC.3.F.PL+IMP+3+SG
entupigaitei-a	entupigaitar+V.ele.ACC.3.F.SG+PRF+1+SG
entupigaitei-as	entupigaitar+V.ele.ACC.3.F.PL+PRF+1+SG
entupigaitei-lhe	entupigaitar+V.ele.DAT.3.SG+PRF+1+SG
entupigaitei-lhes	entupigaitar+V.ele.DAT.3.PL+PRF+1+SG
entupigaitei-me	entupigaitar+V.eu.AD.1.SG+PRF+1+SG
entupigaitei-nos	entupigaitar+nós.AD.1.PL+PRF+1+SG
entupigaitei-o	entupigaitar+V.ele.ACC.3.M.SG+PRF+1+SG
entupigaitei-os	entupigaitar+V.ele.ACC.3.M.PL+PRF+1+SG
entupigaitei-te	entupigaitar+V.tu.AD.2.SG+PRF+1+SG
entupigaitei-vos	entupigaitar+V.vós.AD.2.PL+PRF+1+SG
entupigaite-lhe	entupigaitar+V.ele.DAT.3.SG+IMP+3+SG
entupigaite-lhes	entupigaitar+V.ele.DAT.3.PL+IMP+3+SG
entupigaite-me	entupigaitar+V.eu.AD.1.SG+IMP+3+SG
entupigaitem-lhe	entupigaitar+V.ele.DAT.3.SG+IMP+3+PL
entupigaitem-lhes	entupigaitar+V.ele.DAT.3.PL+IMP+3+PL
entupigaitem-me	entupigaitar+V.eu.AD.1.SG+IMP+3+PL
entupigaitem-na	entupigaitar+V.ele.ACC.3.F.SG+IMP+3+PL
entupigaitem-nas	entupigaitar+V.ele.ACC.3.F.PL+IMP+3+PL
entupigaitem-no	entupigaitar+V.ele.ACC.3.M.SG+IMP+3+PL
entupigaitem-nos	entupigaitar+V.ele.ACC.3.M.PL+IMP+3+PL
entupigaitem-nos	entupigaitar+V.nós.AD.1.PL+IMP+3+PL
entupigaitemo-la	entupigaitar+V.ele.ACC.3.F.SG+IMP+1+PL
entupigaitemo-las	entupigaitar+V.ele.ACC.3.F.PL+IMP+1+PL
entupigaitemo-lo	entupigaitar+V.ele.ACC.3.M.SG+IMP+1+PL
entupigaitemo-los	entupigaitar+V.ele.ACC.3.M.PL+IMP+1+PL
entupigaitemo-nos	entupigaitar+nós.AD.1.PL+IMP+1+PL
entupigaitemos-lhe	entupigaitar+V.ele.DAT.3.SG+IMP+1+PL
entupigaitemos-lhes	entupigaitar+V.ele.DAT.3.PL+IMP+1+PL
entupigaitemos-me	entupigaitar+V.eu.AD.1.SG+IMP+1+PL
entupigaitemos-te	entupigaitar+V.tu.AD.2.SG+IMP+1+PL
entupigaitemos-vos	entupigaitar+V.vós.AD.2.PL+IMP+1+PL
entupigaitem-se	entupigaitar+V.ele.REFL+IMP+3+PL
entupigaitem-te	entupigaitar+V.tu.AD.2.SG+IMP+3+PL
entupigaitem-vos	entupigaitar+V.vós.AD.2.PL+IMP+3+PL
entupigaite-nos	entupigaitar+nós.AD.1.PL+IMP+3+SG
entupigaite-o	entupigaitar+V.ele.ACC.3.M.SG+IMP+3+SG
entupigaite-os	entupigaitar+V.ele.ACC.3.M.PL+IMP+3+SG
entupigaite-se	entupigaitar+V.ele.REFL+IMP+3+SG
entupigaite-te	entupigaitar+V.tu.AD.2.SG+IMP+3+SG
entupigaite-vos	entupigaitar+V.vós.AD.2.PL+IMP+3+SG
entupigaito-a	entupigaitar+V.ele.ACC.3.F.SG+PRS+1+SG
entupigaito-as	entupigaitar+V.ele.ACC.3.F.PL+PRS+1+SG
entupigaito-lhe	entupigaitar+V.ele.DAT.3.SG+PRS+1+SG
entupigaito-lhes	entupigaitar+V.ele.DAT.3.PL+PRS+1+SG
entupigaito-me	entupigaitar+V.eu.AD.1.SG+PRS+1+SG
entupigaito-nos	entupigaitar+nós.AD.1.PL+PRS+1+SG
entupigaito-o	entupigaitar+V.ele.ACC.3.M.SG+PRS+1+SG
entupigaito-os	entupigaitar+V.ele.ACC.3.M.PL+PRS+1+SG
entupigaito-te	entupigaitar+V.tu.AD.2.SG+PRS+1+SG
entupigaitou-a	entupigaitar+V.ele.ACC.3.F.SG+PRF+3+SG
entupigaitou-as	entupigaitar+V.ele.ACC.3.F.PL+PRF+3+SG
entupigaitou-lhe	entupigaitar+V.ele.DAT.3.SG+PRF+3+SG
entupigaitou-lhes	entupigaitar+V.ele.DAT.3.PL+PRF+3+SG
entupigaitou-me	entupigaitar+V.eu.AD.1.SG+PRF+3+SG
entupigaitou-nos	entupigaitar+nós.AD.1.PL+PRF+3+SG
entupigaitou-o	entupigaitar+V.ele.ACC.3.M.SG+PRF+3+SG
entupigaitou-os	entupigaitar+V.ele.ACC.3.M.PL+PRF+3+SG
entupigaitou-se	entupigaitar+V.ele.REFL+PRF+3+SG
entupigaitou-te	entupigaitar+V.tu.AD.2.SG+PRF+3+SG
entupigaitou-vos	entupigaitar+V.vós.AD.2.PL+PRF+3+SG
entupigaito-vos	entupigaitar+V.vós.AD.2.PL+PRS+1+SG
entupi-la-á	entupir+V.ele.ACC.3.F.SG+FUT+3+SG
entupi-la-ão	entupir+V.ele.ACC.3.F.SG+FUT+3+PL
entupi-la-ás	entupir+V.ele.ACC.3.F.SG+FUT+2+SG
entupi-la-ei	entupir+V.ele.ACC.3.F.SG+FUT+1+SG
entupi-la-eis	entupir+V.ele.ACC.3.F.SG+FUT+2+PL
entupi-la-emos	entupir+V.ele.ACC.3.F.SG+FUT+1+PL
entupi-la	entupir+V.ele.ACC.3.F.SG+INF+1+SG
entupi-la	entupir+V.ele.ACC.3.F.SG+INF+3+SG
entupi-la	entupir+V.ele.ACC.3.F.SG+SBJF+1+SG
entupi-la	entupir+V.ele.ACC.3.F.SG+SBJF+3+SG
entupi-la-ia	entupir+V.ele.ACC.3.F.SG+COND+1+SG
entupi-la-ia	entupir+V.ele.ACC.3.F.SG+COND+3+SG
entupi-la-iam	entupir+V.ele.ACC.3.F.SG+COND+3+PL
entupi-la-íamos	entupir+V.ele.ACC.3.F.SG+COND+1+PL
entupi-la-ias	entupir+V.ele.ACC.3.F.SG+COND+2+SG
entupi-la-íeis	entupir+V.ele.ACC.3.F.SG+COND+2+PL
entupi-las-á	entupir+V.ele.ACC.3.F.PL+FUT+3+SG
entupi-las-ão	entupir+V.ele.ACC.3.F.PL+FUT+3+PL
entupi-las-ás	entupir+V.ele.ACC.3.F.PL+FUT+2+SG
entupi-las-ei	entupir+V.ele.ACC.3.F.PL+FUT+1+SG
entupi-las-eis	entupir+V.ele.ACC.3.F.PL+FUT+2+PL
entupi-las-emos	entupir+V.ele.ACC.3.F.PL+FUT+1+PL
entupi-las	entupir+V.ele.ACC.3.F.PL+INF+1+SG
entupi-las	entupir+V.ele.ACC.3.F.PL+INF+3+SG
entupi-las	entupir+V.ele.ACC.3.F.PL+SBJF+1+SG
entupi-las	entupir+V.ele.ACC.3.F.PL+SBJF+3+SG
entupi-las-ia	entupir+V.ele.ACC.3.F.PL+COND+1+SG
entupi-las-ia	entupir+V.ele.ACC.3.F.PL+COND+3+SG
entupi-las-iam	entupir+V.ele.ACC.3.F.PL+COND+3+PL
entupi-las-íamos	entupir+V.ele.ACC.3.F.PL+COND+1+PL
entupi-las-ias	entupir+V.ele.ACC.3.F.PL+COND+2+SG
entupi-las-íeis	entupir+V.ele.ACC.3.F.PL+COND+2+PL
entupi-lhe	entupir+V.ele.DAT.3.SG+PRF+1+SG
entupi-lhes	entupir+V.ele.DAT.3.PL+PRF+1+SG
entupi-lo-á	entupir+V.ele.ACC.3.M.SG+FUT+3+SG
entupi-lo-ão	entupir+V.ele.ACC.3.M.SG+FUT+3+PL
entupi-lo-ás	entupir+V.ele.ACC.3.M.SG+FUT+2+SG
entupi-lo-ei	entupir+V.ele.ACC.3.M.SG+FUT+1+SG
entupi-lo-eis	entupir+V.ele.ACC.3.M.SG+FUT+2+PL
entupi-lo-emos	entupir+V.ele.ACC.3.M.SG+FUT+1+PL
entupi-lo	entupir+V.ele.ACC.3.M.SG+INF+1+SG
entupi-lo	entupir+V.ele.ACC.3.M.SG+INF+3+SG
entupi-lo	entupir+V.ele.ACC.3.M.SG+SBJF+1+SG
entupi-lo	entupir+V.ele.ACC.3.M.SG+SBJF+3+SG
entupi-lo-ia	entupir+V.ele.ACC.3.M.SG+COND+1+SG
entupi-lo-ia	entupir+V.ele.ACC.3.M.SG+COND+3+SG
entupi-lo-iam	entupir+V.ele.ACC.3.M.SG+COND+3+PL
entupi-lo-íamos	entupir+V.ele.ACC.3.M.SG+COND+1+PL
entupi-lo-ias	entupir+V.ele.ACC.3.M.SG+COND+2+SG
entupi-lo-íeis	entupir+V.ele.ACC.3.M.SG+COND+2+PL
entupi-los-á	entupir+V.ele.ACC.3.M.PL+FUT+3+SG
entupi-los-ão	entupir+V.ele.ACC.3.M.PL+FUT+3+PL
entupi-los-ás	entupir+V.ele.ACC.3.M.PL+FUT+2+SG
entupi-los-ei	entupir+V.ele.ACC.3.M.PL+FUT+1+SG
entupi-los-eis	entupir+V.ele.ACC.3.M.PL+FUT+2+PL
entupi-los-emos	entupir+V.ele.ACC.3.M.PL+FUT+1+PL
entupi-los	entupir+V.ele.ACC.3.M.PL+INF+1+SG
entupi-los	entupir+V.ele.ACC.3.M.PL+INF+3+SG
entupi-los	entupir+V.ele.ACC.3.M.PL+SBJF+1+SG
entupi-los	entupir+V.ele.ACC.3.M.PL+SBJF+3+SG
entupi-los-ia	entupir+V.ele.ACC.3.M.PL+COND+1+SG
entupi-los-ia	entupir+V.ele.ACC.3.M.PL+COND+3+SG
entupi-los-iam	entupir+V.ele.ACC.3.M.PL+COND+3+PL
entupi-los-íamos	entupir+V.ele.ACC.3.M.PL+COND+1+PL
entupi-los-ias	entupir+V.ele.ACC.3.M.PL+COND+2+SG
entupi-los-íeis	entupir+V.ele.ACC.3.M.PL+COND+2+PL
entupi-me	entupir+V.eu.AD.1.SG+PRF+1+SG
entupimo-la	entupir+V.ele.ACC.3.F.SG+PRF+1+PL
entupimo-las	entupir+V.ele.ACC.3.F.PL+PRF+1+PL
entupimo-lo	entupir+V.ele.ACC.3.M.SG+PRF+1+PL
entupimo-los	entupir+V.ele.ACC.3.M.PL+PRF+1+PL
entupimo-nos	entupir+nós.AD.1.PL+PRF+1+PL
entupimos-lhe	entupir+V.ele.DAT.3.SG+PRF+1+PL
entupimos-lhes	entupir+V.ele.DAT.3.PL+PRF+1+PL
entupimos-me	entupir+V.eu.AD.1.SG+PRF+1+PL
entupimos-te	entupir+V.tu.AD.2.SG+PRF+1+PL
entupimos-vos	entupir+V.vós.AD.2.PL+PRF+1+PL
entupindo-a	entupir+V.ele.ACC.3.F.SG+GRD
entupindo-as	entupir+V.ele.ACC.3.F.PL+GRD
entupindo-lhe	entupir+V.ele.DAT.3.SG+GRD
entupindo-lhes	entupir+V.ele.DAT.3.PL+GRD
entupindo-me	entupir+V.eu.AD.1.SG+GRD
entupindo-nos	entupir+nós.AD.1.PL+GRD
entupindo-o	entupir+V.ele.ACC.3.M.SG+GRD
entupindo-os	entupir+V.ele.ACC.3.M.PL+GRD
entupindo-se	entupir+V.ele.REFL+GRD
entupindo-te	entupir+V.tu.AD.2.SG+GRD
entupindo-vos	entupir+V.vós.AD.2.PL+GRD
entupi-nos	entupir+nós.AD.1.PL+PRF+1+SG
entupi-o	entupir+V.ele.ACC.3.M.SG+PRF+1+SG
entupi-os	entupir+V.ele.ACC.3.M.PL+PRF+1+SG
entupiram-lhe	entupir+V.ele.DAT.3.SG+PRF+3+PL
entupiram-lhes	entupir+V.ele.DAT.3.PL+PRF+3+PL
entupiram-me	entupir+V.eu.AD.1.SG+PRF+3+PL
entupiram-na	entupir+V.ele.ACC.3.F.SG+PRF+3+PL
entupiram-nas	entupir+V.ele.ACC.3.F.PL+PRF+3+PL
entupiram-no	entupir+V.ele.ACC.3.M.SG+PRF+3+PL
entupiram-nos	entupir+V.ele.ACC.3.M.PL+PRF+3+PL
entupiram-nos	entupir+V.nós.AD.1.PL+PRF+3+PL
entupiram-se	entupir+V.ele.REFL+PRF+3+PL
entupiram-te	entupir+V.tu.AD.2.SG+PRF+3+PL
entupiram-vos	entupir+V.vós.AD.2.PL+PRF+3+PL
entupirde-la	entupir+V.ele.ACC.3.F.SG+INF+2+PL
entupirde-la	entupir+V.ele.ACC.3.F.SG+SBJF+2+PL
entupirde-las	entupir+V.ele.ACC.3.F.PL+INF+2+PL
entupirde-las	entupir+V.ele.ACC.3.F.PL+SBJF+2+PL
entupirde-lo	entupir+V.ele.ACC.3.M.SG+INF+2+PL
entupirde-lo	entupir+V.ele.ACC.3.M.SG+SBJF+2+PL
entupirde-los	entupir+V.ele.ACC.3.M.PL+INF+2+PL
entupirde-los	entupir+V.ele.ACC.3.M.PL+SBJF+2+PL
entupirde-nos	entupir+nós.AD.1.PL+INF+2+PL
entupirde-nos	entupir+nós.AD.1.PL+SBJF+2+PL
entupirdes-lhe	entupir+V.ele.DAT.3.SG+INF+2+PL
entupirdes-lhe	entupir+V.ele.DAT.3.SG+SBJF+2+PL
entupirdes-lhes	entupir+V.ele.DAT.3.PL+INF+2+PL
entupirdes-lhes	entupir+V.ele.DAT.3.PL+SBJF+2+PL
entupirdes-me	entupir+V.eu.AD.1.SG+INF+2+PL
entupirdes-me	entupir+V.eu.AD.1.SG+SBJF+2+PL
entupirdes-te	entupir+V.tu.AD.2.SG+INF+2+PL
entupirdes-te	entupir+V.tu.AD.2.SG+SBJF+2+PL
entupirdes-vos	entupir+V.vós.AD.2.PL+INF+2+PL
entupirdes-vos	entupir+V.vós.AD.2.PL+SBJF+2+PL
entupire-la	entupir+V.ele.ACC.3.F.SG+INF+2+SG
entupire-la	entupir+V.ele.ACC.3.F.SG+SBJF+2+SG
entupire-las	entupir+V.ele.ACC.3.F.PL+INF+2+SG
entupire-las	entupir+V.ele.ACC.3.F.PL+SBJF+2+SG
entupire-lo	entupir+V.ele.ACC.3.M.SG+INF+2+SG
entupire-lo	entupir+V.ele.ACC.3.M.SG+SBJF+2+SG
entupire-los	entupir+V.ele.ACC.3.M.PL+INF+2+SG
entupire-los	entupir+V.ele.ACC.3.M.PL+SBJF+2+SG
entupirem-lhe	entupir+V.ele.DAT.3.SG+INF+3+PL
entupirem-lhe	entupir+V.ele.DAT.3.SG+SBJF+3+PL
entupirem-lhes	entupir+V.ele.DAT.3.PL+INF+3+PL
entupirem-lhes	entupir+V.ele.DAT.3.PL+SBJF+3+PL
entupirem-me	entupir+V.eu.AD.1.SG+INF+3+PL
entupirem-me	entupir+V.eu.AD.1.SG+SBJF+3+PL
entupirem-na	entupir+V.ele.ACC.3.F.SG+INF+3+PL
entupirem-na	entupir+V.ele.ACC.3.F.SG+SBJF+3+PL
entupirem-nas	entupir+V.ele.ACC.3.F.PL+INF+3+PL
entupirem-nas	entupir+V.ele.ACC.3.F.PL+SBJF+3+PL
entupirem-no	entupir+V.ele.ACC.3.M.SG+INF+3+PL
entupirem-no	entupir+V.ele.ACC.3.M.SG+SBJF+3+PL
entupirem-nos	entupir+V.ele.ACC.3.M.PL+INF+3+PL
entupirem-nos	entupir+V.ele.ACC.3.M.PL+SBJF+3+PL
entupirem-nos	entupir+V.nós.AD.1.PL+INF+3+PL
entupirem-nos	entupir+V.nós.AD.1.PL+SBJF+3+PL
entupirem-se	entupir+V.ele.REFL+INF+3+PL
entupirem-se	entupir+V.ele.REFL+SBJF+3+PL
entupirem-te	entupir+V.tu.AD.2.SG+INF+3+PL
entupirem-te	entupir+V.tu.AD.2.SG+SBJF+3+PL
entupirem-vos	entupir+V.vós.AD.2.PL+INF+3+PL
entupirem-vos	entupir+V.vós.AD.2.PL+SBJF+3+PL
entupire-nos	entupir+nós.AD.1.PL+INF+2+SG
entupire-nos	entupir+nós.AD.1.PL+SBJF+2+SG
entupires-lhe	entupir+V.ele.DAT.3.SG+INF+2+SG
entupires-lhe	entupir+V.ele.DAT.3.SG+SBJF+2+SG
entupires-lhes	entupir+V.ele.DAT.3.PL+INF+2+SG
entupires-lhes	entupir+V.ele.DAT.3.PL+SBJF+2+SG
entupires-me	entupir+V.eu.AD.1.SG+INF+2+SG
entupires-me	entupir+V.eu.AD.1.SG+SBJF+2+SG
entupires-te	entupir+V.tu.AD.2.SG+INF+2+SG
entupires-te	entupir+V.tu.AD.2.SG+SBJF+2+SG
entupires-vos	entupir+V.vós.AD.2.PL+INF+2+SG
entupires-vos	entupir+V.vós.AD.2.PL+SBJF+2+SG
entupir-lhe-á	entupir+V.ele.DAT.3.SG+FUT+3+SG
entupir-lhe-ão	entupir+V.ele.DAT.3.SG+FUT+3+PL
entupir-lhe-ás	entupir+V.ele.DAT.3.SG+FUT+2+SG
entupir-lhe-ei	entupir+V.ele.DAT.3.SG+FUT+1+SG
entupir-lhe-eis	entupir+V.ele.DAT.3.SG+FUT+2+PL
entupir-lhe-emos	entupir+V.ele.DAT.3.SG+FUT+1+PL
entupir-lhe	entupir+V.ele.DAT.3.SG+INF
entupir-lhe	entupir+V.ele.DAT.3.SG+INF+1+SG
entupir-lhe	entupir+V.ele.DAT.3.SG+INF+3+SG
entupir-lhe	entupir+V.ele.DAT.3.SG+SBJF+1+SG
entupir-lhe	entupir+V.ele.DAT.3.SG+SBJF+3+SG
entupir-lhe-ia	entupir+V.ele.DAT.3.SG+COND+1+SG
entupir-lhe-ia	entupir+V.ele.DAT.3.SG+COND+3+SG
entupir-lhe-iam	entupir+V.ele.DAT.3.SG+COND+3+PL
entupir-lhe-íamos	entupir+V.ele.DAT.3.SG+COND+1+PL
entupir-lhe-ias	entupir+V.ele.DAT.3.SG+COND+2+SG
entupir-lhe-íeis	entupir+V.ele.DAT.3.SG+COND+2+PL
entupir-lhes-á	entupir+V.ele.DAT.3.PL+FUT+3+SG
entupir-lhes-ão	entupir+V.ele.DAT.3.PL+FUT+3+PL
entupir-lhes-ás	entupir+V.ele.DAT.3.PL+FUT+2+SG
entupir-lhes-ei	entupir+V.ele.DAT.3.PL+FUT+1+SG
entupir-lhes-eis	entupir+V.ele.DAT.3.PL+FUT+2+PL
entupir-lhes-emos	entupir+V.ele.DAT.3.PL+FUT+1+PL
entupir-lhes	entupir+V.ele.DAT.3.PL+INF
entupir-lhes	entupir+V.ele.DAT.3.PL+INF+1+SG
entupir-lhes	entupir+V.ele.DAT.3.PL+INF+3+SG
entupir-lhes	entupir+V.ele.DAT.3.PL+SBJF+1+SG
entupir-lhes	entupir+V.ele.DAT.3.PL+SBJF+3+SG
entupir-lhes-ia	entupir+V.ele.DAT.3.PL+COND+1+SG
entupir-lhes-ia	entupir+V.ele.DAT.3.PL+COND+3+SG
entupir-lhes-iam	entupir+V.ele.DAT.3.PL+COND+3+PL
entupir-lhes-íamos	entupir+V.ele.DAT.3.PL+COND+1+PL
entupir-lhes-ias	entupir+V.ele.DAT.3.PL+COND+2+SG
entupir-lhes-íeis	entupir+V.ele.DAT.3.PL+COND+2+PL
entupir-me-á	entupir+V.eu.AD.1.SG+FUT+3+SG
