esboucelar-lhe-ás	esboucelar+V.ele.DAT.3.SG+FUT+2+SG
esboucelar-lhe-ei	esboucelar+V.ele.DAT.3.SG+FUT+1+SG
esboucelar-lhe-eis	esboucelar+V.ele.DAT.3.SG+FUT+2+PL
esboucelar-lhe-emos	esboucelar+V.ele.DAT.3.SG+FUT+1+PL
esboucelar-lhe	esboucelar+V.ele.DAT.3.SG+INF
esboucelar-lhe	esboucelar+V.ele.DAT.3.SG+INF+1+SG
esboucelar-lhe	esboucelar+V.ele.DAT.3.SG+INF+3+SG
esboucelar-lhe	esboucelar+V.ele.DAT.3.SG+SBJF+1+SG
esboucelar-lhe	esboucelar+V.ele.DAT.3.SG+SBJF+3+SG
esboucelar-lhe-ia	esboucelar+V.ele.DAT.3.SG+COND+1+SG
esboucelar-lhe-ia	esboucelar+V.ele.DAT.3.SG+COND+3+SG
esboucelar-lhe-iam	esboucelar+V.ele.DAT.3.SG+COND+3+PL
esboucelar-lhe-íamos	esboucelar+V.ele.DAT.3.SG+COND+1+PL
esboucelar-lhe-ias	esboucelar+V.ele.DAT.3.SG+COND+2+SG
esboucelar-lhe-íeis	esboucelar+V.ele.DAT.3.SG+COND+2+PL
esboucelar-lhes-á	esboucelar+V.ele.DAT.3.PL+FUT+3+SG
esboucelar-lhes-ão	esboucelar+V.ele.DAT.3.PL+FUT+3+PL
esboucelar-lhes-ás	esboucelar+V.ele.DAT.3.PL+FUT+2+SG
esboucelar-lhes-ei	esboucelar+V.ele.DAT.3.PL+FUT+1+SG
esboucelar-lhes-eis	esboucelar+V.ele.DAT.3.PL+FUT+2+PL
esboucelar-lhes-emos	esboucelar+V.ele.DAT.3.PL+FUT+1+PL
esboucelar-lhes	esboucelar+V.ele.DAT.3.PL+INF
esboucelar-lhes	esboucelar+V.ele.DAT.3.PL+INF+1+SG
esboucelar-lhes	esboucelar+V.ele.DAT.3.PL+INF+3+SG
esboucelar-lhes	esboucelar+V.ele.DAT.3.PL+SBJF+1+SG
esboucelar-lhes	esboucelar+V.ele.DAT.3.PL+SBJF+3+SG
esboucelar-lhes-ia	esboucelar+V.ele.DAT.3.PL+COND+1+SG
esboucelar-lhes-ia	esboucelar+V.ele.DAT.3.PL+COND+3+SG
esboucelar-lhes-iam	esboucelar+V.ele.DAT.3.PL+COND+3+PL
esboucelar-lhes-íamos	esboucelar+V.ele.DAT.3.PL+COND+1+PL
esboucelar-lhes-ias	esboucelar+V.ele.DAT.3.PL+COND+2+SG
esboucelar-lhes-íeis	esboucelar+V.ele.DAT.3.PL+COND+2+PL
esboucelar-me-á	esboucelar+V.eu.AD.1.SG+FUT+3+SG
esboucelar-me-ão	esboucelar+V.eu.AD.1.SG+FUT+3+PL
esboucelar-me-ás	esboucelar+V.eu.AD.1.SG+FUT+2+SG
esboucelar-me-ei	esboucelar+V.eu.AD.1.SG+FUT+1+SG
esboucelar-me-eis	esboucelar+V.eu.AD.1.SG+FUT+2+PL
esboucelar-me-emos	esboucelar+V.eu.AD.1.SG+FUT+1+PL
esboucelar-me	esboucelar+V.eu.AD.1.SG+INF
esboucelar-me	esboucelar+V.eu.AD.1.SG+INF+1+SG
esboucelar-me	esboucelar+V.eu.AD.1.SG+INF+3+SG
esboucelar-me	esboucelar+V.eu.AD.1.SG+SBJF+1+SG
esboucelar-me	esboucelar+V.eu.AD.1.SG+SBJF+3+SG
esboucelar-me-ia	esboucelar+V.eu.AD.1.SG+COND+1+SG
esboucelar-me-ia	esboucelar+V.eu.AD.1.SG+COND+3+SG
esboucelar-me-iam	esboucelar+V.eu.AD.1.SG+COND+3+PL
esboucelar-me-íamos	esboucelar+V.eu.AD.1.SG+COND+1+PL
esboucelar-me-ias	esboucelar+V.eu.AD.1.SG+COND+2+SG
esboucelar-me-íeis	esboucelar+V.eu.AD.1.SG+COND+2+PL
esboucelarmo-la	esboucelar+V.ele.ACC.3.F.SG+INF+1+PL
esboucelarmo-la	esboucelar+V.ele.ACC.3.F.SG+SBJF+1+PL
esboucelarmo-las	esboucelar+V.ele.ACC.3.F.PL+INF+1+PL
esboucelarmo-las	esboucelar+V.ele.ACC.3.F.PL+SBJF+1+PL
esboucelarmo-lo	esboucelar+V.ele.ACC.3.M.SG+INF+1+PL
esboucelarmo-lo	esboucelar+V.ele.ACC.3.M.SG+SBJF+1+PL
esboucelarmo-los	esboucelar+V.ele.ACC.3.M.PL+INF+1+PL
esboucelarmo-los	esboucelar+V.ele.ACC.3.M.PL+SBJF+1+PL
esboucelarmo-nos	esboucelar+nós.AD.1.PL+INF+1+PL
esboucelarmo-nos	esboucelar+nós.AD.1.PL+SBJF+1+PL
esboucelarmos-lhe	esboucelar+V.ele.DAT.3.SG+INF+1+PL
esboucelarmos-lhe	esboucelar+V.ele.DAT.3.SG+SBJF+1+PL
esboucelarmos-lhes	esboucelar+V.ele.DAT.3.PL+INF+1+PL
esboucelarmos-lhes	esboucelar+V.ele.DAT.3.PL+SBJF+1+PL
esboucelarmos-me	esboucelar+V.eu.AD.1.SG+INF+1+PL
esboucelarmos-me	esboucelar+V.eu.AD.1.SG+SBJF+1+PL
esboucelarmos-te	esboucelar+V.tu.AD.2.SG+INF+1+PL
esboucelarmos-te	esboucelar+V.tu.AD.2.SG+SBJF+1+PL
esboucelarmos-vos	esboucelar+V.vós.AD.2.PL+INF+1+PL
esboucelarmos-vos	esboucelar+V.vós.AD.2.PL+SBJF+1+PL
esboucelar-nos-á	esboucelar+nós.AD.1.PL+FUT+3+SG
esboucelar-nos-ão	esboucelar+nós.AD.1.PL+FUT+3+PL
esboucelar-nos-ás	esboucelar+nós.AD.1.PL+FUT+2+SG
esboucelar-nos-ei	esboucelar+nós.AD.1.PL+FUT+1+SG
esboucelar-nos-eis	esboucelar+nós.AD.1.PL+FUT+2+PL
esboucelar-nos-emos	esboucelar+nós.AD.1.PL+FUT+1+PL
esboucelar-nos	esboucelar+nós.AD.1.PL+INF
esboucelar-nos	esboucelar+nós.AD.1.PL+INF+1+SG
esboucelar-nos	esboucelar+nós.AD.1.PL+INF+3+SG
esboucelar-nos	esboucelar+nós.AD.1.PL+SBJF+1+SG
esboucelar-nos	esboucelar+nós.AD.1.PL+SBJF+3+SG
esboucelar-nos-ia	esboucelar+nós.AD.1.PL+COND+1+SG
esboucelar-nos-ia	esboucelar+nós.AD.1.PL+COND+3+SG
esboucelar-nos-iam	esboucelar+nós.AD.1.PL+COND+3+PL
esboucelar-nos-íamos	esboucelar+nós.AD.1.PL+COND+1+PL
esboucelar-nos-ias	esboucelar+nós.AD.1.PL+COND+2+SG
esboucelar-nos-íeis	esboucelar+nós.AD.1.PL+COND+2+PL
esboucelar-se-á	esboucelar+V.ele.REFL+FUT+3+SG
esboucelar-se-ão	esboucelar+V.ele.REFL+FUT+3+PL
esboucelar-se	esboucelar+V.ele.REFL+INF
esboucelar-se	esboucelar+V.ele.REFL+INF+3+SG
esboucelar-se	esboucelar+V.ele.REFL+SBJF+3+SG
esboucelar-se-ia	esboucelar+V.ele.REFL+COND+3+SG
esboucelar-se-iam	esboucelar+V.ele.REFL+COND+3+PL
esboucelar-te-á	esboucelar+V.tu.AD.2.SG+FUT+3+SG
esboucelar-te-ão	esboucelar+V.tu.AD.2.SG+FUT+3+PL
esboucelar-te-ás	esboucelar+V.tu.AD.2.SG+FUT+2+SG
esboucelar-te-ei	esboucelar+V.tu.AD.2.SG+FUT+1+SG
esboucelar-te-eis	esboucelar+V.tu.AD.2.SG+FUT+2+PL
esboucelar-te-emos	esboucelar+V.tu.AD.2.SG+FUT+1+PL
esboucelar-te	esboucelar+V.tu.AD.2.SG+INF
esboucelar-te	esboucelar+V.tu.AD.2.SG+INF+1+SG
esboucelar-te	esboucelar+V.tu.AD.2.SG+INF+3+SG
esboucelar-te	esboucelar+V.tu.AD.2.SG+SBJF+1+SG
esboucelar-te	esboucelar+V.tu.AD.2.SG+SBJF+3+SG
esboucelar-te-ia	esboucelar+V.tu.AD.2.SG+COND+1+SG
esboucelar-te-ia	esboucelar+V.tu.AD.2.SG+COND+3+SG
esboucelar-te-iam	esboucelar+V.tu.AD.2.SG+COND+3+PL
esboucelar-te-íamos	esboucelar+V.tu.AD.2.SG+COND+1+PL
esboucelar-te-ias	esboucelar+V.tu.AD.2.SG+COND+2+SG
esboucelar-te-íeis	esboucelar+V.tu.AD.2.SG+COND+2+PL
esboucelar-vos-á	esboucelar+V.vós.AD.2.PL+FUT+3+SG
esboucelar-vos-ão	esboucelar+V.vós.AD.2.PL+FUT+3+PL
esboucelar-vos-ás	esboucelar+V.vós.AD.2.PL+FUT+2+SG
esboucelar-vos-ei	esboucelar+V.vós.AD.2.PL+FUT+1+SG
esboucelar-vos-eis	esboucelar+V.vós.AD.2.PL+FUT+2+PL
esboucelar-vos-emos	esboucelar+V.vós.AD.2.PL+FUT+1+PL
esboucelar-vos	esboucelar+V.vós.AD.2.PL+INF
esboucelar-vos	esboucelar+V.vós.AD.2.PL+INF+1+SG
esboucelar-vos	esboucelar+V.vós.AD.2.PL+INF+3+SG
esboucelar-vos	esboucelar+V.vós.AD.2.PL+SBJF+1+SG
esboucelar-vos	esboucelar+V.vós.AD.2.PL+SBJF+3+SG
esboucelar-vos-ia	esboucelar+V.vós.AD.2.PL+COND+1+SG
esboucelar-vos-ia	esboucelar+V.vós.AD.2.PL+COND+3+SG
esboucelar-vos-iam	esboucelar+V.vós.AD.2.PL+COND+3+PL
esboucelar-vos-íamos	esboucelar+V.vós.AD.2.PL+COND+1+PL
esboucelar-vos-ias	esboucelar+V.vós.AD.2.PL+COND+2+SG
esboucelar-vos-íeis	esboucelar+V.vós.AD.2.PL+COND+2+PL
esboucela-se	esboucelar+V.ele.REFL+PRS+3+SG
esboucelas-lhe	esboucelar+V.ele.DAT.3.SG+PRS+2+SG
esboucelas-lhes	esboucelar+V.ele.DAT.3.PL+PRS+2+SG
esboucelas-me	esboucelar+V.eu.AD.1.SG+PRS+2+SG
esboucelaste-a	esboucelar+V.ele.ACC.3.F.SG+PRF+2+SG
esboucelaste-as	esboucelar+V.ele.ACC.3.F.PL+PRF+2+SG
esboucelas-te	esboucelar+V.tu.AD.2.SG+PRS+2+SG
esboucelaste-la	esboucelar+V.ele.ACC.3.F.SG+PRF+2+PL
esboucelaste-las	esboucelar+V.ele.ACC.3.F.PL+PRF+2+PL
esboucelaste-lhe	esboucelar+V.ele.DAT.3.SG+PRF+2+SG
esboucelaste-lhes	esboucelar+V.ele.DAT.3.PL+PRF+2+SG
esboucelaste-lo	esboucelar+V.ele.ACC.3.M.SG+PRF+2+PL
esboucelaste-los	esboucelar+V.ele.ACC.3.M.PL+PRF+2+PL
esboucelaste-me	esboucelar+V.eu.AD.1.SG+PRF+2+SG
esboucelaste-nos	esboucelar+nós.AD.1.PL+PRF+2+PL
esboucelaste-nos	esboucelar+nós.AD.1.PL+PRF+2+SG
esboucelaste-o	esboucelar+V.ele.ACC.3.M.SG+PRF+2+SG
esboucelaste-os	esboucelar+V.ele.ACC.3.M.PL+PRF+2+SG
esboucelastes-lhe	esboucelar+V.ele.DAT.3.SG+PRF+2+PL
esboucelastes-lhes	esboucelar+V.ele.DAT.3.PL+PRF+2+PL
esboucelastes-me	esboucelar+V.eu.AD.1.SG+PRF+2+PL
esboucelastes-te	esboucelar+V.tu.AD.2.SG+PRF+2+PL
esboucelastes-vos	esboucelar+V.vós.AD.2.PL+PRF+2+PL
esboucelaste-te	esboucelar+V.tu.AD.2.SG+PRF+2+SG
esboucelaste-vos	esboucelar+V.vós.AD.2.PL+PRF+2+SG
esboucelas-vos	esboucelar+V.vós.AD.2.PL+PRS+2+SG
esboucela-te	esboucelar+V.tu.AD.2.SG+PRS+3+SG
esboucelava-a	esboucelar+V.ele.ACC.3.F.SG+IMPF+1+SG
esboucelava-a	esboucelar+V.ele.ACC.3.F.SG+IMPF+3+SG
esboucelava-as	esboucelar+V.ele.ACC.3.F.PL+IMPF+1+SG
esboucelava-as	esboucelar+V.ele.ACC.3.F.PL+IMPF+3+SG
esboucelava-la	esboucelar+V.ele.ACC.3.F.SG+IMPF+2+SG
esboucelava-las	esboucelar+V.ele.ACC.3.F.PL+IMPF+2+SG
esboucelava-lhe	esboucelar+V.ele.DAT.3.SG+IMPF+1+SG
esboucelava-lhe	esboucelar+V.ele.DAT.3.SG+IMPF+3+SG
esboucelava-lhes	esboucelar+V.ele.DAT.3.PL+IMPF+1+SG
esboucelava-lhes	esboucelar+V.ele.DAT.3.PL+IMPF+3+SG
esboucelava-lo	esboucelar+V.ele.ACC.3.M.SG+IMPF+2+SG
esboucelava-los	esboucelar+V.ele.ACC.3.M.PL+IMPF+2+SG
esboucelava-me	esboucelar+V.eu.AD.1.SG+IMPF+1+SG
esboucelava-me	esboucelar+V.eu.AD.1.SG+IMPF+3+SG
esboucelavam-lhe	esboucelar+V.ele.DAT.3.SG+IMPF+3+PL
esboucelavam-lhes	esboucelar+V.ele.DAT.3.PL+IMPF+3+PL
esboucelavam-me	esboucelar+V.eu.AD.1.SG+IMPF+3+PL
esboucelavam-na	esboucelar+V.ele.ACC.3.F.SG+IMPF+3+PL
esboucelavam-nas	esboucelar+V.ele.ACC.3.F.PL+IMPF+3+PL
esboucelavam-no	esboucelar+V.ele.ACC.3.M.SG+IMPF+3+PL
esboucelavam-nos	esboucelar+V.ele.ACC.3.M.PL+IMPF+3+PL
esboucelavam-nos	esboucelar+V.nós.AD.1.PL+IMPF+3+PL
esboucelávamo-la	esboucelar+V.ele.ACC.3.F.SG+IMPF+1+PL
esboucelávamo-las	esboucelar+V.ele.ACC.3.F.PL+IMPF+1+PL
esboucelávamo-lo	esboucelar+V.ele.ACC.3.M.SG+IMPF+1+PL
esboucelávamo-los	esboucelar+V.ele.ACC.3.M.PL+IMPF+1+PL
esboucelávamo-nos	esboucelar+nós.AD.1.PL+IMPF+1+PL
esboucelávamos-lhe	esboucelar+V.ele.DAT.3.SG+IMPF+1+PL
esboucelávamos-lhes	esboucelar+V.ele.DAT.3.PL+IMPF+1+PL
esboucelávamos-me	esboucelar+V.eu.AD.1.SG+IMPF+1+PL
esboucelávamos-te	esboucelar+V.tu.AD.2.SG+IMPF+1+PL
esboucelávamos-vos	esboucelar+V.vós.AD.2.PL+IMPF+1+PL
esboucelavam-se	esboucelar+V.ele.REFL+IMPF+3+PL
esboucelavam-te	esboucelar+V.tu.AD.2.SG+IMPF+3+PL
esboucelavam-vos	esboucelar+V.vós.AD.2.PL+IMPF+3+PL
esboucelava-nos	esboucelar+nós.AD.1.PL+IMPF+1+SG
esboucelava-nos	esboucelar+nós.AD.1.PL+IMPF+2+SG
esboucelava-nos	esboucelar+nós.AD.1.PL+IMPF+3+SG
esboucelava-o	esboucelar+V.ele.ACC.3.M.SG+IMPF+1+SG
esboucelava-o	esboucelar+V.ele.ACC.3.M.SG+IMPF+3+SG
esboucelava-os	esboucelar+V.ele.ACC.3.M.PL+IMPF+1+SG
esboucelava-os	esboucelar+V.ele.ACC.3.M.PL+IMPF+3+SG
esboucelava-se	esboucelar+V.ele.REFL+IMPF+1+SG
esboucelava-se	esboucelar+V.ele.REFL+IMPF+3+SG
esboucelavas-lhe	esboucelar+V.ele.DAT.3.SG+IMPF+2+SG
esboucelavas-lhes	esboucelar+V.ele.DAT.3.PL+IMPF+2+SG
esboucelavas-me	esboucelar+V.eu.AD.1.SG+IMPF+2+SG
esboucelavas-te	esboucelar+V.tu.AD.2.SG+IMPF+2+SG
esboucelavas-vos	esboucelar+V.vós.AD.2.PL+IMPF+2+SG
esboucelava-te	esboucelar+V.tu.AD.2.SG+IMPF+1+SG
esboucelava-te	esboucelar+V.tu.AD.2.SG+IMPF+3+SG
esboucelava-vos	esboucelar+V.vós.AD.2.PL+IMPF+1+SG
esboucelava-vos	esboucelar+V.vós.AD.2.PL+IMPF+3+SG
esboucelávei-la	esboucelar+V.ele.ACC.3.F.SG+IMPF+2+PL
esboucelávei-las	esboucelar+V.ele.ACC.3.F.PL+IMPF+2+PL
esboucelávei-lo	esboucelar+V.ele.ACC.3.M.SG+IMPF+2+PL
esboucelávei-los	esboucelar+V.ele.ACC.3.M.PL+IMPF+2+PL
esboucelávei-nos	esboucelar+nós.AD.1.PL+IMPF+2+PL
esbouceláveis-lhe	esboucelar+V.ele.DAT.3.SG+IMPF+2+PL
esbouceláveis-lhes	esboucelar+V.ele.DAT.3.PL+IMPF+2+PL
esbouceláveis-me	esboucelar+V.eu.AD.1.SG+IMPF+2+PL
esbouceláveis-te	esboucelar+V.tu.AD.2.SG+IMPF+2+PL
esbouceláveis-vos	esboucelar+V.vós.AD.2.PL+IMPF+2+PL
esboucela-vos	esboucelar+V.vós.AD.2.PL+PRS+3+SG
esboucele-a	esboucelar+V.ele.ACC.3.F.SG+IMP+3+SG
esboucele-as	esboucelar+V.ele.ACC.3.F.PL+IMP+3+SG
esboucelei-a	esboucelar+V.ele.ACC.3.F.SG+PRF+1+SG
esboucelei-as	esboucelar+V.ele.ACC.3.F.PL+PRF+1+SG
esboucelei-lhe	esboucelar+V.ele.DAT.3.SG+PRF+1+SG
esboucelei-lhes	esboucelar+V.ele.DAT.3.PL+PRF+1+SG
esboucelei-me	esboucelar+V.eu.AD.1.SG+PRF+1+SG
esboucelei-nos	esboucelar+nós.AD.1.PL+PRF+1+SG
esboucelei-o	esboucelar+V.ele.ACC.3.M.SG+PRF+1+SG
esboucelei-os	esboucelar+V.ele.ACC.3.M.PL+PRF+1+SG
esboucelei-te	esboucelar+V.tu.AD.2.SG+PRF+1+SG
esboucelei-vos	esboucelar+V.vós.AD.2.PL+PRF+1+SG
esboucele-lhe	esboucelar+V.ele.DAT.3.SG+IMP+3+SG
esboucele-lhes	esboucelar+V.ele.DAT.3.PL+IMP+3+SG
esboucele-me	esboucelar+V.eu.AD.1.SG+IMP+3+SG
esboucelem-lhe	esboucelar+V.ele.DAT.3.SG+IMP+3+PL
esboucelem-lhes	esboucelar+V.ele.DAT.3.PL+IMP+3+PL
esboucelem-me	esboucelar+V.eu.AD.1.SG+IMP+3+PL
esboucelem-na	esboucelar+V.ele.ACC.3.F.SG+IMP+3+PL
esboucelem-nas	esboucelar+V.ele.ACC.3.F.PL+IMP+3+PL
esboucelem-no	esboucelar+V.ele.ACC.3.M.SG+IMP+3+PL
esboucelem-nos	esboucelar+V.ele.ACC.3.M.PL+IMP+3+PL
esboucelem-nos	esboucelar+V.nós.AD.1.PL+IMP+3+PL
esboucelemo-la	esboucelar+V.ele.ACC.3.F.SG+IMP+1+PL
esboucelemo-las	esboucelar+V.ele.ACC.3.F.PL+IMP+1+PL
esboucelemo-lo	esboucelar+V.ele.ACC.3.M.SG+IMP+1+PL
esboucelemo-los	esboucelar+V.ele.ACC.3.M.PL+IMP+1+PL
esboucelemo-nos	esboucelar+nós.AD.1.PL+IMP+1+PL
esboucelemos-lhe	esboucelar+V.ele.DAT.3.SG+IMP+1+PL
esboucelemos-lhes	esboucelar+V.ele.DAT.3.PL+IMP+1+PL
esboucelemos-me	esboucelar+V.eu.AD.1.SG+IMP+1+PL
esboucelemos-te	esboucelar+V.tu.AD.2.SG+IMP+1+PL
esboucelemos-vos	esboucelar+V.vós.AD.2.PL+IMP+1+PL
esboucelem-se	esboucelar+V.ele.REFL+IMP+3+PL
esboucelem-te	esboucelar+V.tu.AD.2.SG+IMP+3+PL
esboucelem-vos	esboucelar+V.vós.AD.2.PL+IMP+3+PL
esboucele-nos	esboucelar+nós.AD.1.PL+IMP+3+SG
esboucele-o	esboucelar+V.ele.ACC.3.M.SG+IMP+3+SG
esboucele-os	esboucelar+V.ele.ACC.3.M.PL+IMP+3+SG
esboucele-se	esboucelar+V.ele.REFL+IMP+3+SG
esboucele-te	esboucelar+V.tu.AD.2.SG+IMP+3+SG
esboucele-vos	esboucelar+V.vós.AD.2.PL+IMP+3+SG
esbouce-lhe	esbouçar+V.ele.DAT.3.SG+IMP+3+SG
esbouce-lhes	esbouçar+V.ele.DAT.3.PL+IMP+3+SG
esboucelo-a	esboucelar+V.ele.ACC.3.F.SG+PRS+1+SG
esboucelo-as	esboucelar+V.ele.ACC.3.F.PL+PRS+1+SG
esboucelo-lhe	esboucelar+V.ele.DAT.3.SG+PRS+1+SG
esboucelo-lhes	esboucelar+V.ele.DAT.3.PL+PRS+1+SG
esboucelo-me	esboucelar+V.eu.AD.1.SG+PRS+1+SG
esboucelo-nos	esboucelar+nós.AD.1.PL+PRS+1+SG
esboucelo-o	esboucelar+V.ele.ACC.3.M.SG+PRS+1+SG
esboucelo-os	esboucelar+V.ele.ACC.3.M.PL+PRS+1+SG
esboucelo-te	esboucelar+V.tu.AD.2.SG+PRS+1+SG
esboucelou-a	esboucelar+V.ele.ACC.3.F.SG+PRF+3+SG
esboucelou-as	esboucelar+V.ele.ACC.3.F.PL+PRF+3+SG
esboucelou-lhe	esboucelar+V.ele.DAT.3.SG+PRF+3+SG
esboucelou-lhes	esboucelar+V.ele.DAT.3.PL+PRF+3+SG
esboucelou-me	esboucelar+V.eu.AD.1.SG+PRF+3+SG
esboucelou-nos	esboucelar+nós.AD.1.PL+PRF+3+SG
esboucelou-o	esboucelar+V.ele.ACC.3.M.SG+PRF+3+SG
esboucelou-os	esboucelar+V.ele.ACC.3.M.PL+PRF+3+SG
esboucelou-se	esboucelar+V.ele.REFL+PRF+3+SG
esboucelou-te	esboucelar+V.tu.AD.2.SG+PRF+3+SG
esboucelou-vos	esboucelar+V.vós.AD.2.PL+PRF+3+SG
esboucelo-vos	esboucelar+V.vós.AD.2.PL+PRS+1+SG
esbouce-me	esbouçar+V.eu.AD.1.SG+IMP+3+SG
esboucem-lhe	esbouçar+V.ele.DAT.3.SG+IMP+3+PL
esboucem-lhes	esbouçar+V.ele.DAT.3.PL+IMP+3+PL
esboucem-me	esbouçar+V.eu.AD.1.SG+IMP+3+PL
esboucem-na	esbouçar+V.ele.ACC.3.F.SG+IMP+3+PL
esboucem-nas	esbouçar+V.ele.ACC.3.F.PL+IMP+3+PL
esboucem-no	esbouçar+V.ele.ACC.3.M.SG+IMP+3+PL
esboucem-nos	esbouçar+V.ele.ACC.3.M.PL+IMP+3+PL
esboucem-nos	esbouçar+V.nós.AD.1.PL+IMP+3+PL
esboucemo-la	esbouçar+V.ele.ACC.3.F.SG+IMP+1+PL
esboucemo-las	esbouçar+V.ele.ACC.3.F.PL+IMP+1+PL
esboucemo-lo	esbouçar+V.ele.ACC.3.M.SG+IMP+1+PL
esboucemo-los	esbouçar+V.ele.ACC.3.M.PL+IMP+1+PL
esboucemo-nos	esbouçar+nós.AD.1.PL+IMP+1+PL
esboucemos-lhe	esbouçar+V.ele.DAT.3.SG+IMP+1+PL
esboucemos-lhes	esbouçar+V.ele.DAT.3.PL+IMP+1+PL
esboucemos-me	esbouçar+V.eu.AD.1.SG+IMP+1+PL
esboucemos-te	esbouçar+V.tu.AD.2.SG+IMP+1+PL
esboucemos-vos	esbouçar+V.vós.AD.2.PL+IMP+1+PL
esboucem-se	esbouçar+V.ele.REFL+IMP+3+PL
esboucem-te	esbouçar+V.tu.AD.2.SG+IMP+3+PL
esboucem-vos	esbouçar+V.vós.AD.2.PL+IMP+3+PL
esbouce-nos	esbouçar+nós.AD.1.PL+IMP+3+SG
esbouce-o	esbouçar+V.ele.ACC.3.M.SG+IMP+3+SG
esbouce-os	esbouçar+V.ele.ACC.3.M.PL+IMP+3+SG
esbouce-se	esbouçar+V.ele.REFL+IMP+3+SG
esbouce-te	esbouçar+V.tu.AD.2.SG+IMP+3+SG
esbouce-vos	esbouçar+V.vós.AD.2.PL+IMP+3+SG
esbouço-a	esbouçar+V.ele.ACC.3.F.SG+PRS+1+SG
esbouço-as	esbouçar+V.ele.ACC.3.F.PL+PRS+1+SG
esbouço-lhe	esbouçar+V.ele.DAT.3.SG+PRS+1+SG
esbouço-lhes	esbouçar+V.ele.DAT.3.PL+PRS+1+SG
esbouço-me	esbouçar+V.eu.AD.1.SG+PRS+1+SG
esbouço-nos	esbouçar+nós.AD.1.PL+PRS+1+SG
esbouço-o	esbouçar+V.ele.ACC.3.M.SG+PRS+1+SG
esbouço-os	esbouçar+V.ele.ACC.3.M.PL+PRS+1+SG
esbouço-te	esbouçar+V.tu.AD.2.SG+PRS+1+SG
esbouçou-a	esbouçar+V.ele.ACC.3.F.SG+PRF+3+SG
esbouçou-as	esbouçar+V.ele.ACC.3.F.PL+PRF+3+SG
esbouçou-lhe	esbouçar+V.ele.DAT.3.SG+PRF+3+SG
esbouçou-lhes	esbouçar+V.ele.DAT.3.PL+PRF+3+SG
esbouçou-me	esbouçar+V.eu.AD.1.SG+PRF+3+SG
esbouçou-nos	esbouçar+nós.AD.1.PL+PRF+3+SG
esbouçou-o	esbouçar+V.ele.ACC.3.M.SG+PRF+3+SG
esbouçou-os	esbouçar+V.ele.ACC.3.M.PL+PRF+3+SG
esbouçou-se	esbouçar+V.ele.REFL+PRF+3+SG
esbouçou-te	esbouçar+V.tu.AD.2.SG+PRF+3+SG
esbouçou-vos	esbouçar+V.vós.AD.2.PL+PRF+3+SG
esbouço-vos	esbouçar+V.vós.AD.2.PL+PRS+1+SG
esbraceja-a	esbracejar+V.ele.ACC.3.F.SG+PRS+3+SG
esbraceja-as	esbracejar+V.ele.ACC.3.F.PL+PRS+3+SG
esbracejai-la	esbracejar+V.ele.ACC.3.F.SG+PRS+2+PL
esbracejai-las	esbracejar+V.ele.ACC.3.F.PL+PRS+2+PL
esbracejai-lo	esbracejar+V.ele.ACC.3.M.SG+PRS+2+PL
esbracejai-los	esbracejar+V.ele.ACC.3.M.PL+PRS+2+PL
esbracejai-nos	esbracejar+nós.AD.1.PL+PRS+2+PL
esbracejais-lhe	esbracejar+V.ele.DAT.3.SG+PRS+2+PL
esbracejais-lhes	esbracejar+V.ele.DAT.3.PL+PRS+2+PL
esbracejais-me	esbracejar+V.eu.AD.1.SG+PRS+2+PL
esbracejais-te	esbracejar+V.tu.AD.2.SG+PRS+2+PL
esbracejais-vos	esbracejar+V.vós.AD.2.PL+PRS+2+PL
esbracejá-la-á	esbracejar+V.ele.ACC.3.F.SG+FUT+3+SG
esbracejá-la-ão	esbracejar+V.ele.ACC.3.F.SG+FUT+3+PL
esbracejá-la-ás	esbracejar+V.ele.ACC.3.F.SG+FUT+2+SG
esbracejá-la-ei	esbracejar+V.ele.ACC.3.F.SG+FUT+1+SG
esbracejá-la-eis	esbracejar+V.ele.ACC.3.F.SG+FUT+2+PL
esbracejá-la-emos	esbracejar+V.ele.ACC.3.F.SG+FUT+1+PL
esbracejá-la	esbracejar+V.ele.ACC.3.F.SG+INF+1+SG
esbracejá-la	esbracejar+V.ele.ACC.3.F.SG+INF+3+SG
esbraceja-la	esbracejar+V.ele.ACC.3.F.SG+PRS+2+SG
esbracejá-la	esbracejar+V.ele.ACC.3.F.SG+SBJF+1+SG
esbracejá-la	esbracejar+V.ele.ACC.3.F.SG+SBJF+3+SG
esbracejá-la-ia	esbracejar+V.ele.ACC.3.F.SG+COND+1+SG
esbracejá-la-ia	esbracejar+V.ele.ACC.3.F.SG+COND+3+SG
esbracejá-la-iam	esbracejar+V.ele.ACC.3.F.SG+COND+3+PL
esbracejá-la-íamos	esbracejar+V.ele.ACC.3.F.SG+COND+1+PL
esbracejá-la-ias	esbracejar+V.ele.ACC.3.F.SG+COND+2+SG
esbracejá-la-íeis	esbracejar+V.ele.ACC.3.F.SG+COND+2+PL
esbracejá-las-á	esbracejar+V.ele.ACC.3.F.PL+FUT+3+SG
esbracejá-las-ão	esbracejar+V.ele.ACC.3.F.PL+FUT+3+PL
esbracejá-las-ás	esbracejar+V.ele.ACC.3.F.PL+FUT+2+SG
esbracejá-las-ei	esbracejar+V.ele.ACC.3.F.PL+FUT+1+SG
esbracejá-las-eis	esbracejar+V.ele.ACC.3.F.PL+FUT+2+PL
esbracejá-las-emos	esbracejar+V.ele.ACC.3.F.PL+FUT+1+PL
esbracejá-las	esbracejar+V.ele.ACC.3.F.PL+INF+1+SG
esbracejá-las	esbracejar+V.ele.ACC.3.F.PL+INF+3+SG
esbraceja-las	esbracejar+V.ele.ACC.3.F.PL+PRS+2+SG
esbracejá-las	esbracejar+V.ele.ACC.3.F.PL+SBJF+1+SG
esbracejá-las	esbracejar+V.ele.ACC.3.F.PL+SBJF+3+SG
esbracejá-las-ia	esbracejar+V.ele.ACC.3.F.PL+COND+1+SG
esbracejá-las-ia	esbracejar+V.ele.ACC.3.F.PL+COND+3+SG
esbracejá-las-iam	esbracejar+V.ele.ACC.3.F.PL+COND+3+PL
esbracejá-las-íamos	esbracejar+V.ele.ACC.3.F.PL+COND+1+PL
esbracejá-las-ias	esbracejar+V.ele.ACC.3.F.PL+COND+2+SG
esbracejá-las-íeis	esbracejar+V.ele.ACC.3.F.PL+COND+2+PL
esbraceja-lhe	esbracejar+V.ele.DAT.3.SG+PRS+3+SG
esbraceja-lhes	esbracejar+V.ele.DAT.3.PL+PRS+3+SG
esbracejá-lo-á	esbracejar+V.ele.ACC.3.M.SG+FUT+3+SG
esbracejá-lo-ão	esbracejar+V.ele.ACC.3.M.SG+FUT+3+PL
esbracejá-lo-ás	esbracejar+V.ele.ACC.3.M.SG+FUT+2+SG
esbracejá-lo-ei	esbracejar+V.ele.ACC.3.M.SG+FUT+1+SG
esbracejá-lo-eis	esbracejar+V.ele.ACC.3.M.SG+FUT+2+PL
esbracejá-lo-emos	esbracejar+V.ele.ACC.3.M.SG+FUT+1+PL
esbracejá-lo	esbracejar+V.ele.ACC.3.M.SG+INF+1+SG
esbracejá-lo	esbracejar+V.ele.ACC.3.M.SG+INF+3+SG
esbraceja-lo	esbracejar+V.ele.ACC.3.M.SG+PRS+2+SG
esbracejá-lo	esbracejar+V.ele.ACC.3.M.SG+SBJF+1+SG
esbracejá-lo	esbracejar+V.ele.ACC.3.M.SG+SBJF+3+SG
esbracejá-lo-ia	esbracejar+V.ele.ACC.3.M.SG+COND+1+SG
esbracejá-lo-ia	esbracejar+V.ele.ACC.3.M.SG+COND+3+SG
esbracejá-lo-iam	esbracejar+V.ele.ACC.3.M.SG+COND+3+PL
esbracejá-lo-íamos	esbracejar+V.ele.ACC.3.M.SG+COND+1+PL
esbracejá-lo-ias	esbracejar+V.ele.ACC.3.M.SG+COND+2+SG
esbracejá-lo-íeis	esbracejar+V.ele.ACC.3.M.SG+COND+2+PL
esbracejá-los-á	esbracejar+V.ele.ACC.3.M.PL+FUT+3+SG
esbracejá-los-ão	esbracejar+V.ele.ACC.3.M.PL+FUT+3+PL
esbracejá-los-ás	esbracejar+V.ele.ACC.3.M.PL+FUT+2+SG
esbracejá-los-ei	esbracejar+V.ele.ACC.3.M.PL+FUT+1+SG
esbracejá-los-eis	esbracejar+V.ele.ACC.3.M.PL+FUT+2+PL
esbracejá-los-emos	esbracejar+V.ele.ACC.3.M.PL+FUT+1+PL
esbracejá-los	esbracejar+V.ele.ACC.3.M.PL+INF+1+SG
esbracejá-los	esbracejar+V.ele.ACC.3.M.PL+INF+3+SG
esbraceja-los	esbracejar+V.ele.ACC.3.M.PL+PRS+2+SG
esbracejá-los	esbracejar+V.ele.ACC.3.M.PL+SBJF+1+SG
esbracejá-los	esbracejar+V.ele.ACC.3.M.PL+SBJF+3+SG
esbracejá-los-ia	esbracejar+V.ele.ACC.3.M.PL+COND+1+SG
esbracejá-los-ia	esbracejar+V.ele.ACC.3.M.PL+COND+3+SG
esbracejá-los-iam	esbracejar+V.ele.ACC.3.M.PL+COND+3+PL
esbracejá-los-íamos	esbracejar+V.ele.ACC.3.M.PL+COND+1+PL
esbracejá-los-ias	esbracejar+V.ele.ACC.3.M.PL+COND+2+SG
esbracejá-los-íeis	esbracejar+V.ele.ACC.3.M.PL+COND+2+PL
esbraceja-me	esbracejar+V.eu.AD.1.SG+PRS+3+SG
esbracejam-lhe	esbracejar+V.ele.DAT.3.SG+PRS+3+PL
esbracejam-lhes	esbracejar+V.ele.DAT.3.PL+PRS+3+PL
esbracejam-me	esbracejar+V.eu.AD.1.SG+PRS+3+PL
esbracejam-na	esbracejar+V.ele.ACC.3.F.SG+PRS+3+PL
esbracejam-nas	esbracejar+V.ele.ACC.3.F.PL+PRS+3+PL
esbracejam-no	esbracejar+V.ele.ACC.3.M.SG+PRS+3+PL
esbracejam-nos	esbracejar+V.ele.ACC.3.M.PL+PRS+3+PL
esbracejam-nos	esbracejar+V.nós.AD.1.PL+PRS+3+PL
esbracejamo-la	esbracejar+V.ele.ACC.3.F.SG+PRF+1+PL
esbracejamo-la	esbracejar+V.ele.ACC.3.F.SG+PRS+1+PL
esbracejamo-las	esbracejar+V.ele.ACC.3.F.PL+PRF+1+PL
esbracejamo-las	esbracejar+V.ele.ACC.3.F.PL+PRS+1+PL
esbracejamo-lo	esbracejar+V.ele.ACC.3.M.SG+PRF+1+PL
esbracejamo-lo	esbracejar+V.ele.ACC.3.M.SG+PRS+1+PL
esbracejamo-los	esbracejar+V.ele.ACC.3.M.PL+PRF+1+PL
esbracejamo-los	esbracejar+V.ele.ACC.3.M.PL+PRS+1+PL
esbracejamo-nos	esbracejar+nós.AD.1.PL+PRF+1+PL
esbracejamo-nos	esbracejar+nós.AD.1.PL+PRS+1+PL
esbracejamos-lhe	esbracejar+V.ele.DAT.3.SG+PRF+1+PL
esbracejamos-lhe	esbracejar+V.ele.DAT.3.SG+PRS+1+PL
esbracejamos-lhes	esbracejar+V.ele.DAT.3.PL+PRF+1+PL
esbracejamos-lhes	esbracejar+V.ele.DAT.3.PL+PRS+1+PL
esbracejamos-me	esbracejar+V.eu.AD.1.SG+PRF+1+PL
esbracejamos-me	esbracejar+V.eu.AD.1.SG+PRS+1+PL
esbracejamos-te	esbracejar+V.tu.AD.2.SG+PRF+1+PL
esbracejamos-te	esbracejar+V.tu.AD.2.SG+PRS+1+PL
esbracejamos-vos	esbracejar+V.vós.AD.2.PL+PRF+1+PL
esbracejamos-vos	esbracejar+V.vós.AD.2.PL+PRS+1+PL
esbracejam-se	esbracejar+V.ele.REFL+PRS+3+PL
esbracejam-te	esbracejar+V.tu.AD.2.SG+PRS+3+PL
esbracejam-vos	esbracejar+V.vós.AD.2.PL+PRS+3+PL
esbracejando-a	esbracejar+V.ele.ACC.3.F.SG+GRD
esbracejando-as	esbracejar+V.ele.ACC.3.F.PL+GRD
esbracejando-lhe	esbracejar+V.ele.DAT.3.SG+GRD
esbracejando-lhes	esbracejar+V.ele.DAT.3.PL+GRD
esbracejando-me	esbracejar+V.eu.AD.1.SG+GRD
esbracejando-nos	esbracejar+nós.AD.1.PL+GRD
esbracejando-o	esbracejar+V.ele.ACC.3.M.SG+GRD
esbracejando-os	esbracejar+V.ele.ACC.3.M.PL+GRD
esbracejando-se	esbracejar+V.ele.REFL+GRD
esbracejando-te	esbracejar+V.tu.AD.2.SG+GRD
esbracejando-vos	esbracejar+V.vós.AD.2.PL+GRD
esbraceja-nos	esbracejar+nós.AD.1.PL+PRS+2+SG
esbraceja-nos	esbracejar+nós.AD.1.PL+PRS+3+SG
esbraceja-o	esbracejar+V.ele.ACC.3.M.SG+PRS+3+SG
esbraceja-os	esbracejar+V.ele.ACC.3.M.PL+PRS+3+SG
esbracejara-a	esbracejar+V.ele.ACC.3.F.SG+PQP+1+SG
esbracejara-a	esbracejar+V.ele.ACC.3.F.SG+PQP+3+SG
esbracejara-as	esbracejar+V.ele.ACC.3.F.PL+PQP+1+SG
esbracejara-as	esbracejar+V.ele.ACC.3.F.PL+PQP+3+SG
esbracejara-la	esbracejar+V.ele.ACC.3.F.SG+PQP+2+SG
esbracejara-las	esbracejar+V.ele.ACC.3.F.PL+PQP+2+SG
esbracejara-lhe	esbracejar+V.ele.DAT.3.SG+PQP+1+SG
esbracejara-lhe	esbracejar+V.ele.DAT.3.SG+PQP+3+SG
esbracejara-lhes	esbracejar+V.ele.DAT.3.PL+PQP+1+SG
esbracejara-lhes	esbracejar+V.ele.DAT.3.PL+PQP+3+SG
esbracejara-lo	esbracejar+V.ele.ACC.3.M.SG+PQP+2+SG
esbracejara-los	esbracejar+V.ele.ACC.3.M.PL+PQP+2+SG
esbracejara-me	esbracejar+V.eu.AD.1.SG+PQP+1+SG
esbracejara-me	esbracejar+V.eu.AD.1.SG+PQP+3+SG
esbracejaram-lhe	esbracejar+V.ele.DAT.3.SG+PQP+3+PL
esbracejaram-lhe	esbracejar+V.ele.DAT.3.SG+PRF+3+PL
esbracejaram-lhes	esbracejar+V.ele.DAT.3.PL+PQP+3+PL
esbracejaram-lhes	esbracejar+V.ele.DAT.3.PL+PRF+3+PL
esbracejaram-me	esbracejar+V.eu.AD.1.SG+PQP+3+PL
esbracejaram-me	esbracejar+V.eu.AD.1.SG+PRF+3+PL
esbracejaram-na	esbracejar+V.ele.ACC.3.F.SG+PQP+3+PL
esbracejaram-na	esbracejar+V.ele.ACC.3.F.SG+PRF+3+PL
esbracejaram-nas	esbracejar+V.ele.ACC.3.F.PL+PQP+3+PL
esbracejaram-nas	esbracejar+V.ele.ACC.3.F.PL+PRF+3+PL
esbracejaram-no	esbracejar+V.ele.ACC.3.M.SG+PQP+3+PL
esbracejaram-no	esbracejar+V.ele.ACC.3.M.SG+PRF+3+PL
esbracejaram-nos	esbracejar+V.ele.ACC.3.M.PL+PQP+3+PL
esbracejaram-nos	esbracejar+V.ele.ACC.3.M.PL+PRF+3+PL
esbracejaram-nos	esbracejar+V.nós.AD.1.PL+PQP+3+PL
esbracejaram-nos	esbracejar+V.nós.AD.1.PL+PRF+3+PL
esbracejáramo-la	esbracejar+V.ele.ACC.3.F.SG+PQP+1+PL
esbracejáramo-las	esbracejar+V.ele.ACC.3.F.PL+PQP+1+PL
esbracejáramo-lo	esbracejar+V.ele.ACC.3.M.SG+PQP+1+PL
esbracejáramo-los	esbracejar+V.ele.ACC.3.M.PL+PQP+1+PL
esbracejáramo-nos	esbracejar+nós.AD.1.PL+PQP+1+PL
esbracejáramos-lhe	esbracejar+V.ele.DAT.3.SG+PQP+1+PL
esbracejáramos-lhes	esbracejar+V.ele.DAT.3.PL+PQP+1+PL
esbracejáramos-me	esbracejar+V.eu.AD.1.SG+PQP+1+PL
esbracejáramos-te	esbracejar+V.tu.AD.2.SG+PQP+1+PL
esbracejáramos-vos	esbracejar+V.vós.AD.2.PL+PQP+1+PL
esbracejaram-se	esbracejar+V.ele.REFL+PQP+3+PL
esbracejaram-se	esbracejar+V.ele.REFL+PRF+3+PL
esbracejaram-te	esbracejar+V.tu.AD.2.SG+PQP+3+PL
esbracejaram-te	esbracejar+V.tu.AD.2.SG+PRF+3+PL
esbracejaram-vos	esbracejar+V.vós.AD.2.PL+PQP+3+PL
esbracejaram-vos	esbracejar+V.vós.AD.2.PL+PRF+3+PL
esbracejara-nos	esbracejar+nós.AD.1.PL+PQP+1+SG
esbracejara-nos	esbracejar+nós.AD.1.PL+PQP+2+SG
esbracejara-nos	esbracejar+nós.AD.1.PL+PQP+3+SG
esbracejara-o	esbracejar+V.ele.ACC.3.M.SG+PQP+1+SG
esbracejara-o	esbracejar+V.ele.ACC.3.M.SG+PQP+3+SG
esbracejara-os	esbracejar+V.ele.ACC.3.M.PL+PQP+1+SG
esbracejara-os	esbracejar+V.ele.ACC.3.M.PL+PQP+3+SG
esbracejara-se	esbracejar+V.ele.REFL+PQP+1+SG
esbracejara-se	esbracejar+V.ele.REFL+PQP+3+SG
esbracejaras-lhe	esbracejar+V.ele.DAT.3.SG+PQP+2+SG
esbracejaras-lhes	esbracejar+V.ele.DAT.3.PL+PQP+2+SG
esbracejaras-me	esbracejar+V.eu.AD.1.SG+PQP+2+SG
esbracejaras-te	esbracejar+V.tu.AD.2.SG+PQP+2+SG
esbracejaras-vos	esbracejar+V.vós.AD.2.PL+PQP+2+SG
esbracejara-te	esbracejar+V.tu.AD.2.SG+PQP+1+SG
esbracejara-te	esbracejar+V.tu.AD.2.SG+PQP+3+SG
esbracejara-vos	esbracejar+V.vós.AD.2.PL+PQP+1+SG
esbracejara-vos	esbracejar+V.vós.AD.2.PL+PQP+3+SG
esbracejarde-la	esbracejar+V.ele.ACC.3.F.SG+INF+2+PL
esbracejarde-la	esbracejar+V.ele.ACC.3.F.SG+SBJF+2+PL
esbracejarde-las	esbracejar+V.ele.ACC.3.F.PL+INF+2+PL
esbracejarde-las	esbracejar+V.ele.ACC.3.F.PL+SBJF+2+PL
esbracejarde-lo	esbracejar+V.ele.ACC.3.M.SG+INF+2+PL
esbracejarde-lo	esbracejar+V.ele.ACC.3.M.SG+SBJF+2+PL
esbracejarde-los	esbracejar+V.ele.ACC.3.M.PL+INF+2+PL
esbracejarde-los	esbracejar+V.ele.ACC.3.M.PL+SBJF+2+PL
esbracejarde-nos	esbracejar+nós.AD.1.PL+INF+2+PL
esbracejarde-nos	esbracejar+nós.AD.1.PL+SBJF+2+PL
esbracejardes-lhe	esbracejar+V.ele.DAT.3.SG+INF+2+PL
esbracejardes-lhe	esbracejar+V.ele.DAT.3.SG+SBJF+2+PL
esbracejardes-lhes	esbracejar+V.ele.DAT.3.PL+INF+2+PL
esbracejardes-lhes	esbracejar+V.ele.DAT.3.PL+SBJF+2+PL
esbracejardes-me	esbracejar+V.eu.AD.1.SG+INF+2+PL
esbracejardes-me	esbracejar+V.eu.AD.1.SG+SBJF+2+PL
esbracejardes-te	esbracejar+V.tu.AD.2.SG+INF+2+PL
esbracejardes-te	esbracejar+V.tu.AD.2.SG+SBJF+2+PL
esbracejardes-vos	esbracejar+V.vós.AD.2.PL+INF+2+PL
esbracejardes-vos	esbracejar+V.vós.AD.2.PL+SBJF+2+PL
esbracejárei-la	esbracejar+V.ele.ACC.3.F.SG+PQP+2+PL
esbracejárei-las	esbracejar+V.ele.ACC.3.F.PL+PQP+2+PL
esbracejárei-lo	esbracejar+V.ele.ACC.3.M.SG+PQP+2+PL
esbracejárei-los	esbracejar+V.ele.ACC.3.M.PL+PQP+2+PL
esbracejárei-nos	esbracejar+nós.AD.1.PL+PQP+2+PL
esbracejáreis-lhe	esbracejar+V.ele.DAT.3.SG+PQP+2+PL
esbracejáreis-lhes	esbracejar+V.ele.DAT.3.PL+PQP+2+PL
esbracejáreis-me	esbracejar+V.eu.AD.1.SG+PQP+2+PL
esbracejáreis-te	esbracejar+V.tu.AD.2.SG+PQP+2+PL
esbracejáreis-vos	esbracejar+V.vós.AD.2.PL+PQP+2+PL
esbracejare-la	esbracejar+V.ele.ACC.3.F.SG+INF+2+SG
esbracejare-la	esbracejar+V.ele.ACC.3.F.SG+SBJF+2+SG
esbracejare-las	esbracejar+V.ele.ACC.3.F.PL+INF+2+SG
esbracejare-las	esbracejar+V.ele.ACC.3.F.PL+SBJF+2+SG
esbracejare-lo	esbracejar+V.ele.ACC.3.M.SG+INF+2+SG
esbracejare-lo	esbracejar+V.ele.ACC.3.M.SG+SBJF+2+SG
esbracejare-los	esbracejar+V.ele.ACC.3.M.PL+INF+2+SG
esbracejare-los	esbracejar+V.ele.ACC.3.M.PL+SBJF+2+SG
esbracejarem-lhe	esbracejar+V.ele.DAT.3.SG+INF+3+PL
esbracejarem-lhe	esbracejar+V.ele.DAT.3.SG+SBJF+3+PL
esbracejarem-lhes	esbracejar+V.ele.DAT.3.PL+INF+3+PL
esbracejarem-lhes	esbracejar+V.ele.DAT.3.PL+SBJF+3+PL
esbracejarem-me	esbracejar+V.eu.AD.1.SG+INF+3+PL
esbracejarem-me	esbracejar+V.eu.AD.1.SG+SBJF+3+PL
esbracejarem-na	esbracejar+V.ele.ACC.3.F.SG+INF+3+PL
esbracejarem-na	esbracejar+V.ele.ACC.3.F.SG+SBJF+3+PL
esbracejarem-nas	esbracejar+V.ele.ACC.3.F.PL+INF+3+PL
esbracejarem-nas	esbracejar+V.ele.ACC.3.F.PL+SBJF+3+PL
esbracejarem-no	esbracejar+V.ele.ACC.3.M.SG+INF+3+PL
esbracejarem-no	esbracejar+V.ele.ACC.3.M.SG+SBJF+3+PL
esbracejarem-nos	esbracejar+V.ele.ACC.3.M.PL+INF+3+PL
esbracejarem-nos	esbracejar+V.ele.ACC.3.M.PL+SBJF+3+PL
esbracejarem-nos	esbracejar+V.nós.AD.1.PL+INF+3+PL
esbracejarem-nos	esbracejar+V.nós.AD.1.PL+SBJF+3+PL
esbracejarem-se	esbracejar+V.ele.REFL+INF+3+PL
esbracejarem-se	esbracejar+V.ele.REFL+SBJF+3+PL
esbracejarem-te	esbracejar+V.tu.AD.2.SG+INF+3+PL
esbracejarem-te	esbracejar+V.tu.AD.2.SG+SBJF+3+PL
esbracejarem-vos	esbracejar+V.vós.AD.2.PL+INF+3+PL
esbracejarem-vos	esbracejar+V.vós.AD.2.PL+SBJF+3+PL
esbracejare-nos	esbracejar+nós.AD.1.PL+INF+2+SG
esbracejare-nos	esbracejar+nós.AD.1.PL+SBJF+2+SG
esbracejares-lhe	esbracejar+V.ele.DAT.3.SG+INF+2+SG
esbracejares-lhe	esbracejar+V.ele.DAT.3.SG+SBJF+2+SG
esbracejares-lhes	esbracejar+V.ele.DAT.3.PL+INF+2+SG
esbracejares-lhes	esbracejar+V.ele.DAT.3.PL+SBJF+2+SG
esbracejares-me	esbracejar+V.eu.AD.1.SG+INF+2+SG
esbracejares-me	esbracejar+V.eu.AD.1.SG+SBJF+2+SG
esbracejares-te	esbracejar+V.tu.AD.2.SG+INF+2+SG
esbracejares-te	esbracejar+V.tu.AD.2.SG+SBJF+2+SG
esbracejares-vos	esbracejar+V.vós.AD.2.PL+INF+2+SG
esbracejares-vos	esbracejar+V.vós.AD.2.PL+SBJF+2+SG
esbracejar-lhe-á	esbracejar+V.ele.DAT.3.SG+FUT+3+SG
esbracejar-lhe-ão	esbracejar+V.ele.DAT.3.SG+FUT+3+PL
esbracejar-lhe-ás	esbracejar+V.ele.DAT.3.SG+FUT+2+SG
esbracejar-lhe-ei	esbracejar+V.ele.DAT.3.SG+FUT+1+SG
esbracejar-lhe-eis	esbracejar+V.ele.DAT.3.SG+FUT+2+PL
esbracejar-lhe-emos	esbracejar+V.ele.DAT.3.SG+FUT+1+PL
esbracejar-lhe	esbracejar+V.ele.DAT.3.SG+INF
esbracejar-lhe	esbracejar+V.ele.DAT.3.SG+INF+1+SG
esbracejar-lhe	esbracejar+V.ele.DAT.3.SG+INF+3+SG
esbracejar-lhe	esbracejar+V.ele.DAT.3.SG+SBJF+1+SG
esbracejar-lhe	esbracejar+V.ele.DAT.3.SG+SBJF+3+SG
esbracejar-lhe-ia	esbracejar+V.ele.DAT.3.SG+COND+1+SG
esbracejar-lhe-ia	esbracejar+V.ele.DAT.3.SG+COND+3+SG
esbracejar-lhe-iam	esbracejar+V.ele.DAT.3.SG+COND+3+PL
esbracejar-lhe-íamos	esbracejar+V.ele.DAT.3.SG+COND+1+PL
esbracejar-lhe-ias	esbracejar+V.ele.DAT.3.SG+COND+2+SG
esbracejar-lhe-íeis	esbracejar+V.ele.DAT.3.SG+COND+2+PL
esbracejar-lhes-á	esbracejar+V.ele.DAT.3.PL+FUT+3+SG
esbracejar-lhes-ão	esbracejar+V.ele.DAT.3.PL+FUT+3+PL
esbracejar-lhes-ás	esbracejar+V.ele.DAT.3.PL+FUT+2+SG
esbracejar-lhes-ei	esbracejar+V.ele.DAT.3.PL+FUT+1+SG
esbracejar-lhes-eis	esbracejar+V.ele.DAT.3.PL+FUT+2+PL
esbracejar-lhes-emos	esbracejar+V.ele.DAT.3.PL+FUT+1+PL
esbracejar-lhes	esbracejar+V.ele.DAT.3.PL+INF
esbracejar-lhes	esbracejar+V.ele.DAT.3.PL+INF+1+SG
esbracejar-lhes	esbracejar+V.ele.DAT.3.PL+INF+3+SG
esbracejar-lhes	esbracejar+V.ele.DAT.3.PL+SBJF+1+SG
esbracejar-lhes	esbracejar+V.ele.DAT.3.PL+SBJF+3+SG
esbracejar-lhes-ia	esbracejar+V.ele.DAT.3.PL+COND+1+SG
esbracejar-lhes-ia	esbracejar+V.ele.DAT.3.PL+COND+3+SG
esbracejar-lhes-iam	esbracejar+V.ele.DAT.3.PL+COND+3+PL
esbracejar-lhes-íamos	esbracejar+V.ele.DAT.3.PL+COND+1+PL
esbracejar-lhes-ias	esbracejar+V.ele.DAT.3.PL+COND+2+SG
esbracejar-lhes-íeis	esbracejar+V.ele.DAT.3.PL+COND+2+PL
esbracejar-me-á	esbracejar+V.eu.AD.1.SG+FUT+3+SG
esbracejar-me-ão	esbracejar+V.eu.AD.1.SG+FUT+3+PL
esbracejar-me-ás	esbracejar+V.eu.AD.1.SG+FUT+2+SG
esbracejar-me-ei	esbracejar+V.eu.AD.1.SG+FUT+1+SG
esbracejar-me-eis	esbracejar+V.eu.AD.1.SG+FUT+2+PL
esbracejar-me-emos	esbracejar+V.eu.AD.1.SG+FUT+1+PL
esbracejar-me	esbracejar+V.eu.AD.1.SG+INF
esbracejar-me	esbracejar+V.eu.AD.1.SG+INF+1+SG
esbracejar-me	esbracejar+V.eu.AD.1.SG+INF+3+SG
esbracejar-me	esbracejar+V.eu.AD.1.SG+SBJF+1+SG
esbracejar-me	esbracejar+V.eu.AD.1.SG+SBJF+3+SG
esbracejar-me-ia	esbracejar+V.eu.AD.1.SG+COND+1+SG
esbracejar-me-ia	esbracejar+V.eu.AD.1.SG+COND+3+SG
esbracejar-me-iam	esbracejar+V.eu.AD.1.SG+COND+3+PL
esbracejar-me-íamos	esbracejar+V.eu.AD.1.SG+COND+1+PL
esbracejar-me-ias	esbracejar+V.eu.AD.1.SG+COND+2+SG
esbracejar-me-íeis	esbracejar+V.eu.AD.1.SG+COND+2+PL
esbracejarmo-la	esbracejar+V.ele.ACC.3.F.SG+INF+1+PL
esbracejarmo-la	esbracejar+V.ele.ACC.3.F.SG+SBJF+1+PL
esbracejarmo-las	esbracejar+V.ele.ACC.3.F.PL+INF+1+PL
esbracejarmo-las	esbracejar+V.ele.ACC.3.F.PL+SBJF+1+PL
esbracejarmo-lo	esbracejar+V.ele.ACC.3.M.SG+INF+1+PL
esbracejarmo-lo	esbracejar+V.ele.ACC.3.M.SG+SBJF+1+PL
esbracejarmo-los	esbracejar+V.ele.ACC.3.M.PL+INF+1+PL
esbracejarmo-los	esbracejar+V.ele.ACC.3.M.PL+SBJF+1+PL
esbracejarmo-nos	esbracejar+nós.AD.1.PL+INF+1+PL
esbracejarmo-nos	esbracejar+nós.AD.1.PL+SBJF+1+PL
esbracejarmos-lhe	esbracejar+V.ele.DAT.3.SG+INF+1+PL
esbracejarmos-lhe	esbracejar+V.ele.DAT.3.SG+SBJF+1+PL
esbracejarmos-lhes	esbracejar+V.ele.DAT.3.PL+INF+1+PL
esbracejarmos-lhes	esbracejar+V.ele.DAT.3.PL+SBJF+1+PL
esbracejarmos-me	esbracejar+V.eu.AD.1.SG+INF+1+PL
esbracejarmos-me	esbracejar+V.eu.AD.1.SG+SBJF+1+PL
esbracejarmos-te	esbracejar+V.tu.AD.2.SG+INF+1+PL
esbracejarmos-te	esbracejar+V.tu.AD.2.SG+SBJF+1+PL
esbracejarmos-vos	esbracejar+V.vós.AD.2.PL+INF+1+PL
esbracejarmos-vos	esbracejar+V.vós.AD.2.PL+SBJF+1+PL
esbracejar-nos-á	esbracejar+nós.AD.1.PL+FUT+3+SG
esbracejar-nos-ão	esbracejar+nós.AD.1.PL+FUT+3+PL
esbracejar-nos-ás	esbracejar+nós.AD.1.PL+FUT+2+SG
esbracejar-nos-ei	esbracejar+nós.AD.1.PL+FUT+1+SG
esbracejar-nos-eis	esbracejar+nós.AD.1.PL+FUT+2+PL
esbracejar-nos-emos	esbracejar+nós.AD.1.PL+FUT+1+PL
esbracejar-nos	esbracejar+nós.AD.1.PL+INF
esbracejar-nos	esbracejar+nós.AD.1.PL+INF+1+SG
esbracejar-nos	esbracejar+nós.AD.1.PL+INF+3+SG
esbracejar-nos	esbracejar+nós.AD.1.PL+SBJF+1+SG
esbracejar-nos	esbracejar+nós.AD.1.PL+SBJF+3+SG
esbracejar-nos-ia	esbracejar+nós.AD.1.PL+COND+1+SG
esbracejar-nos-ia	esbracejar+nós.AD.1.PL+COND+3+SG
esbracejar-nos-iam	esbracejar+nós.AD.1.PL+COND+3+PL
esbracejar-nos-íamos	esbracejar+nós.AD.1.PL+COND+1+PL
esbracejar-nos-ias	esbracejar+nós.AD.1.PL+COND+2+SG
esbracejar-nos-íeis	esbracejar+nós.AD.1.PL+COND+2+PL
esbracejar-se-á	esbracejar+V.ele.REFL+FUT+3+SG
esbracejar-se-ão	esbracejar+V.ele.REFL+FUT+3+PL
esbracejar-se	esbracejar+V.ele.REFL+INF
esbracejar-se	esbracejar+V.ele.REFL+INF+3+SG
esbracejar-se	esbracejar+V.ele.REFL+SBJF+3+SG
esbracejar-se-ia	esbracejar+V.ele.REFL+COND+3+SG
esbracejar-se-iam	esbracejar+V.ele.REFL+COND+3+PL
esbracejar-te-á	esbracejar+V.tu.AD.2.SG+FUT+3+SG
esbracejar-te-ão	esbracejar+V.tu.AD.2.SG+FUT+3+PL
esbracejar-te-ás	esbracejar+V.tu.AD.2.SG+FUT+2+SG
esbracejar-te-ei	esbracejar+V.tu.AD.2.SG+FUT+1+SG
esbracejar-te-eis	esbracejar+V.tu.AD.2.SG+FUT+2+PL
esbracejar-te-emos	esbracejar+V.tu.AD.2.SG+FUT+1+PL
esbracejar-te	esbracejar+V.tu.AD.2.SG+INF
esbracejar-te	esbracejar+V.tu.AD.2.SG+INF+1+SG
esbracejar-te	esbracejar+V.tu.AD.2.SG+INF+3+SG
esbracejar-te	esbracejar+V.tu.AD.2.SG+SBJF+1+SG
esbracejar-te	esbracejar+V.tu.AD.2.SG+SBJF+3+SG
esbracejar-te-ia	esbracejar+V.tu.AD.2.SG+COND+1+SG
esbracejar-te-ia	esbracejar+V.tu.AD.2.SG+COND+3+SG
esbracejar-te-iam	esbracejar+V.tu.AD.2.SG+COND+3+PL
esbracejar-te-íamos	esbracejar+V.tu.AD.2.SG+COND+1+PL
esbracejar-te-ias	esbracejar+V.tu.AD.2.SG+COND+2+SG
esbracejar-te-íeis	esbracejar+V.tu.AD.2.SG+COND+2+PL
esbracejar-vos-á	esbracejar+V.vós.AD.2.PL+FUT+3+SG
esbracejar-vos-ão	esbracejar+V.vós.AD.2.PL+FUT+3+PL
esbracejar-vos-ás	esbracejar+V.vós.AD.2.PL+FUT+2+SG
esbracejar-vos-ei	esbracejar+V.vós.AD.2.PL+FUT+1+SG
esbracejar-vos-eis	esbracejar+V.vós.AD.2.PL+FUT+2+PL
esbracejar-vos-emos	esbracejar+V.vós.AD.2.PL+FUT+1+PL
esbracejar-vos	esbracejar+V.vós.AD.2.PL+INF
esbracejar-vos	esbracejar+V.vós.AD.2.PL+INF+1+SG
esbracejar-vos	esbracejar+V.vós.AD.2.PL+INF+3+SG
esbracejar-vos	esbracejar+V.vós.AD.2.PL+SBJF+1+SG
esbracejar-vos	esbracejar+V.vós.AD.2.PL+SBJF+3+SG
esbracejar-vos-ia	esbracejar+V.vós.AD.2.PL+COND+1+SG
esbracejar-vos-ia	esbracejar+V.vós.AD.2.PL+COND+3+SG
esbracejar-vos-iam	esbracejar+V.vós.AD.2.PL+COND+3+PL
esbracejar-vos-íamos	esbracejar+V.vós.AD.2.PL+COND+1+PL
esbracejar-vos-ias	esbracejar+V.vós.AD.2.PL+COND+2+SG
esbracejar-vos-íeis	esbracejar+V.vós.AD.2.PL+COND+2+PL
esbraceja-se	esbracejar+V.ele.REFL+PRS+3+SG
esbracejas-lhe	esbracejar+V.ele.DAT.3.SG+PRS+2+SG
esbracejas-lhes	esbracejar+V.ele.DAT.3.PL+PRS+2+SG
esbracejas-me	esbracejar+V.eu.AD.1.SG+PRS+2+SG
esbracejaste-a	esbracejar+V.ele.ACC.3.F.SG+PRF+2+SG
esbracejaste-as	esbracejar+V.ele.ACC.3.F.PL+PRF+2+SG
esbracejas-te	esbracejar+V.tu.AD.2.SG+PRS+2+SG
esbracejaste-la	esbracejar+V.ele.ACC.3.F.SG+PRF+2+PL
esbracejaste-las	esbracejar+V.ele.ACC.3.F.PL+PRF+2+PL
esbracejaste-lhe	esbracejar+V.ele.DAT.3.SG+PRF+2+SG
esbracejaste-lhes	esbracejar+V.ele.DAT.3.PL+PRF+2+SG
esbracejaste-lo	esbracejar+V.ele.ACC.3.M.SG+PRF+2+PL
esbracejaste-los	esbracejar+V.ele.ACC.3.M.PL+PRF+2+PL
esbracejaste-me	esbracejar+V.eu.AD.1.SG+PRF+2+SG
esbracejaste-nos	esbracejar+nós.AD.1.PL+PRF+2+PL
esbracejaste-nos	esbracejar+nós.AD.1.PL+PRF+2+SG
esbracejaste-o	esbracejar+V.ele.ACC.3.M.SG+PRF+2+SG
esbracejaste-os	esbracejar+V.ele.ACC.3.M.PL+PRF+2+SG
esbracejastes-lhe	esbracejar+V.ele.DAT.3.SG+PRF+2+PL
esbracejastes-lhes	esbracejar+V.ele.DAT.3.PL+PRF+2+PL
esbracejastes-me	esbracejar+V.eu.AD.1.SG+PRF+2+PL
esbracejastes-te	esbracejar+V.tu.AD.2.SG+PRF+2+PL
esbracejastes-vos	esbracejar+V.vós.AD.2.PL+PRF+2+PL
esbracejaste-te	esbracejar+V.tu.AD.2.SG+PRF+2+SG
esbracejaste-vos	esbracejar+V.vós.AD.2.PL+PRF+2+SG
esbracejas-vos	esbracejar+V.vós.AD.2.PL+PRS+2+SG
esbraceja-te	esbracejar+V.tu.AD.2.SG+PRS+3+SG
esbracejava-a	esbracejar+V.ele.ACC.3.F.SG+IMPF+1+SG
esbracejava-a	esbracejar+V.ele.ACC.3.F.SG+IMPF+3+SG
esbracejava-as	esbracejar+V.ele.ACC.3.F.PL+IMPF+1+SG
esbracejava-as	esbracejar+V.ele.ACC.3.F.PL+IMPF+3+SG
esbracejava-la	esbracejar+V.ele.ACC.3.F.SG+IMPF+2+SG
esbracejava-las	esbracejar+V.ele.ACC.3.F.PL+IMPF+2+SG
esbracejava-lhe	esbracejar+V.ele.DAT.3.SG+IMPF+1+SG
esbracejava-lhe	esbracejar+V.ele.DAT.3.SG+IMPF+3+SG
esbracejava-lhes	esbracejar+V.ele.DAT.3.PL+IMPF+1+SG
esbracejava-lhes	esbracejar+V.ele.DAT.3.PL+IMPF+3+SG
esbracejava-lo	esbracejar+V.ele.ACC.3.M.SG+IMPF+2+SG
esbracejava-los	esbracejar+V.ele.ACC.3.M.PL+IMPF+2+SG
esbracejava-me	esbracejar+V.eu.AD.1.SG+IMPF+1+SG
esbracejava-me	esbracejar+V.eu.AD.1.SG+IMPF+3+SG
esbracejavam-lhe	esbracejar+V.ele.DAT.3.SG+IMPF+3+PL
esbracejavam-lhes	esbracejar+V.ele.DAT.3.PL+IMPF+3+PL
esbracejavam-me	esbracejar+V.eu.AD.1.SG+IMPF+3+PL
esbracejavam-na	esbracejar+V.ele.ACC.3.F.SG+IMPF+3+PL
esbracejavam-nas	esbracejar+V.ele.ACC.3.F.PL+IMPF+3+PL
esbracejavam-no	esbracejar+V.ele.ACC.3.M.SG+IMPF+3+PL
esbracejavam-nos	esbracejar+V.ele.ACC.3.M.PL+IMPF+3+PL
esbracejavam-nos	esbracejar+V.nós.AD.1.PL+IMPF+3+PL
esbracejávamo-la	esbracejar+V.ele.ACC.3.F.SG+IMPF+1+PL
esbracejávamo-las	esbracejar+V.ele.ACC.3.F.PL+IMPF+1+PL
esbracejávamo-lo	esbracejar+V.ele.ACC.3.M.SG+IMPF+1+PL
esbracejávamo-los	esbracejar+V.ele.ACC.3.M.PL+IMPF+1+PL
esbracejávamo-nos	esbracejar+nós.AD.1.PL+IMPF+1+PL
esbracejávamos-lhe	esbracejar+V.ele.DAT.3.SG+IMPF+1+PL
esbracejávamos-lhes	esbracejar+V.ele.DAT.3.PL+IMPF+1+PL
esbracejávamos-me	esbracejar+V.eu.AD.1.SG+IMPF+1+PL
esbracejávamos-te	esbracejar+V.tu.AD.2.SG+IMPF+1+PL
esbracejávamos-vos	esbracejar+V.vós.AD.2.PL+IMPF+1+PL
esbracejavam-se	esbracejar+V.ele.REFL+IMPF+3+PL
esbracejavam-te	esbracejar+V.tu.AD.2.SG+IMPF+3+PL
esbracejavam-vos	esbracejar+V.vós.AD.2.PL+IMPF+3+PL
esbracejava-nos	esbracejar+nós.AD.1.PL+IMPF+1+SG
esbracejava-nos	esbracejar+nós.AD.1.PL+IMPF+2+SG
esbracejava-nos	esbracejar+nós.AD.1.PL+IMPF+3+SG
esbracejava-o	esbracejar+V.ele.ACC.3.M.SG+IMPF+1+SG
esbracejava-o	esbracejar+V.ele.ACC.3.M.SG+IMPF+3+SG
esbracejava-os	esbracejar+V.ele.ACC.3.M.PL+IMPF+1+SG
esbracejava-os	esbracejar+V.ele.ACC.3.M.PL+IMPF+3+SG
esbracejava-se	esbracejar+V.ele.REFL+IMPF+1+SG
esbracejava-se	esbracejar+V.ele.REFL+IMPF+3+SG
esbracejavas-lhe	esbracejar+V.ele.DAT.3.SG+IMPF+2+SG
esbracejavas-lhes	esbracejar+V.ele.DAT.3.PL+IMPF+2+SG
esbracejavas-me	esbracejar+V.eu.AD.1.SG+IMPF+2+SG
esbracejavas-te	esbracejar+V.tu.AD.2.SG+IMPF+2+SG
esbracejavas-vos	esbracejar+V.vós.AD.2.PL+IMPF+2+SG
esbracejava-te	esbracejar+V.tu.AD.2.SG+IMPF+1+SG
esbracejava-te	esbracejar+V.tu.AD.2.SG+IMPF+3+SG
esbracejava-vos	esbracejar+V.vós.AD.2.PL+IMPF+1+SG
esbracejava-vos	esbracejar+V.vós.AD.2.PL+IMPF+3+SG
esbracejávei-la	esbracejar+V.ele.ACC.3.F.SG+IMPF+2+PL
esbracejávei-las	esbracejar+V.ele.ACC.3.F.PL+IMPF+2+PL
esbracejávei-lo	esbracejar+V.ele.ACC.3.M.SG+IMPF+2+PL
esbracejávei-los	esbracejar+V.ele.ACC.3.M.PL+IMPF+2+PL
esbracejávei-nos	esbracejar+nós.AD.1.PL+IMPF+2+PL
esbracejáveis-lhe	esbracejar+V.ele.DAT.3.SG+IMPF+2+PL
esbracejáveis-lhes	esbracejar+V.ele.DAT.3.PL+IMPF+2+PL
esbracejáveis-me	esbracejar+V.eu.AD.1.SG+IMPF+2+PL
esbracejáveis-te	esbracejar+V.tu.AD.2.SG+IMPF+2+PL
esbracejáveis-vos	esbracejar+V.vós.AD.2.PL+IMPF+2+PL
esbraceja-vos	esbracejar+V.vós.AD.2.PL+PRS+3+SG
esbraceje-a	esbracejar+V.ele.ACC.3.F.SG+IMP+3+SG
esbraceje-as	esbracejar+V.ele.ACC.3.F.PL+IMP+3+SG
esbracejei-a	esbracejar+V.ele.ACC.3.F.SG+PRF+1+SG
esbracejei-as	esbracejar+V.ele.ACC.3.F.PL+PRF+1+SG
esbracejei-lhe	esbracejar+V.ele.DAT.3.SG+PRF+1+SG
esbracejei-lhes	esbracejar+V.ele.DAT.3.PL+PRF+1+SG
esbracejei-me	esbracejar+V.eu.AD.1.SG+PRF+1+SG
esbracejei-nos	esbracejar+nós.AD.1.PL+PRF+1+SG
esbracejei-o	esbracejar+V.ele.ACC.3.M.SG+PRF+1+SG
esbracejei-os	esbracejar+V.ele.ACC.3.M.PL+PRF+1+SG
esbracejei-te	esbracejar+V.tu.AD.2.SG+PRF+1+SG
esbracejei-vos	esbracejar+V.vós.AD.2.PL+PRF+1+SG
esbraceje-lhe	esbracejar+V.ele.DAT.3.SG+IMP+3+SG
esbraceje-lhes	esbracejar+V.ele.DAT.3.PL+IMP+3+SG
esbraceje-me	esbracejar+V.eu.AD.1.SG+IMP+3+SG
esbracejem-lhe	esbracejar+V.ele.DAT.3.SG+IMP+3+PL
esbracejem-lhes	esbracejar+V.ele.DAT.3.PL+IMP+3+PL
esbracejem-me	esbracejar+V.eu.AD.1.SG+IMP+3+PL
esbracejem-na	esbracejar+V.ele.ACC.3.F.SG+IMP+3+PL
esbracejem-nas	esbracejar+V.ele.ACC.3.F.PL+IMP+3+PL
esbracejem-no	esbracejar+V.ele.ACC.3.M.SG+IMP+3+PL
esbracejem-nos	esbracejar+V.ele.ACC.3.M.PL+IMP+3+PL
esbracejem-nos	esbracejar+V.nós.AD.1.PL+IMP+3+PL
esbracejemo-la	esbracejar+V.ele.ACC.3.F.SG+IMP+1+PL
esbracejemo-las	esbracejar+V.ele.ACC.3.F.PL+IMP+1+PL
esbracejemo-lo	esbracejar+V.ele.ACC.3.M.SG+IMP+1+PL
esbracejemo-los	esbracejar+V.ele.ACC.3.M.PL+IMP+1+PL
esbracejemo-nos	esbracejar+nós.AD.1.PL+IMP+1+PL
esbracejemos-lhe	esbracejar+V.ele.DAT.3.SG+IMP+1+PL
esbracejemos-lhes	esbracejar+V.ele.DAT.3.PL+IMP+1+PL
esbracejemos-me	esbracejar+V.eu.AD.1.SG+IMP+1+PL
esbracejemos-te	esbracejar+V.tu.AD.2.SG+IMP+1+PL
esbracejemos-vos	esbracejar+V.vós.AD.2.PL+IMP+1+PL
esbracejem-se	esbracejar+V.ele.REFL+IMP+3+PL
esbracejem-te	esbracejar+V.tu.AD.2.SG+IMP+3+PL
esbracejem-vos	esbracejar+V.vós.AD.2.PL+IMP+3+PL
esbraceje-nos	esbracejar+nós.AD.1.PL+IMP+3+SG
esbraceje-o	esbracejar+V.ele.ACC.3.M.SG+IMP+3+SG
esbraceje-os	esbracejar+V.ele.ACC.3.M.PL+IMP+3+SG
esbraceje-se	esbracejar+V.ele.REFL+IMP+3+SG
esbraceje-te	esbracejar+V.tu.AD.2.SG+IMP+3+SG
esbraceje-vos	esbracejar+V.vós.AD.2.PL+IMP+3+SG
esbracejo-a	esbracejar+V.ele.ACC.3.F.SG+PRS+1+SG
esbracejo-as	esbracejar+V.ele.ACC.3.F.PL+PRS+1+SG
esbracejo-lhe	esbracejar+V.ele.DAT.3.SG+PRS+1+SG
esbracejo-lhes	esbracejar+V.ele.DAT.3.PL+PRS+1+SG
esbracejo-me	esbracejar+V.eu.AD.1.SG+PRS+1+SG
esbracejo-nos	esbracejar+nós.AD.1.PL+PRS+1+SG
esbracejo-o	esbracejar+V.ele.ACC.3.M.SG+PRS+1+SG
esbracejo-os	esbracejar+V.ele.ACC.3.M.PL+PRS+1+SG
esbracejo-te	esbracejar+V.tu.AD.2.SG+PRS+1+SG
esbracejou-a	esbracejar+V.ele.ACC.3.F.SG+PRF+3+SG
esbracejou-as	esbracejar+V.ele.ACC.3.F.PL+PRF+3+SG
esbracejou-lhe	esbracejar+V.ele.DAT.3.SG+PRF+3+SG
esbracejou-lhes	esbracejar+V.ele.DAT.3.PL+PRF+3+SG
esbracejou-me	esbracejar+V.eu.AD.1.SG+PRF+3+SG
esbracejou-nos	esbracejar+nós.AD.1.PL+PRF+3+SG
esbracejou-o	esbracejar+V.ele.ACC.3.M.SG+PRF+3+SG
esbracejou-os	esbracejar+V.ele.ACC.3.M.PL+PRF+3+SG
esbracejou-se	esbracejar+V.ele.REFL+PRF+3+SG
esbracejou-te	esbracejar+V.tu.AD.2.SG+PRF+3+SG
esbracejou-vos	esbracejar+V.vós.AD.2.PL+PRF+3+SG
esbracejo-vos	esbracejar+V.vós.AD.2.PL+PRS+1+SG
esbranquiça-a	esbranquiçar+V.ele.ACC.3.F.SG+PRS+3+SG
esbranquiça-as	esbranquiçar+V.ele.ACC.3.F.PL+PRS+3+SG
esbranquiçai-la	esbranquiçar+V.ele.ACC.3.F.SG+PRS+2+PL
esbranquiçai-las	esbranquiçar+V.ele.ACC.3.F.PL+PRS+2+PL
esbranquiçai-lo	esbranquiçar+V.ele.ACC.3.M.SG+PRS+2+PL
esbranquiçai-los	esbranquiçar+V.ele.ACC.3.M.PL+PRS+2+PL
esbranquiçai-nos	esbranquiçar+nós.AD.1.PL+PRS+2+PL
esbranquiçais-lhe	esbranquiçar+V.ele.DAT.3.SG+PRS+2+PL
esbranquiçais-lhes	esbranquiçar+V.ele.DAT.3.PL+PRS+2+PL
esbranquiçais-me	esbranquiçar+V.eu.AD.1.SG+PRS+2+PL
esbranquiçais-te	esbranquiçar+V.tu.AD.2.SG+PRS+2+PL
esbranquiçais-vos	esbranquiçar+V.vós.AD.2.PL+PRS+2+PL
esbranquiçá-la-á	esbranquiçar+V.ele.ACC.3.F.SG+FUT+3+SG
esbranquiçá-la-ão	esbranquiçar+V.ele.ACC.3.F.SG+FUT+3+PL
esbranquiçá-la-ás	esbranquiçar+V.ele.ACC.3.F.SG+FUT+2+SG
esbranquiçá-la-ei	esbranquiçar+V.ele.ACC.3.F.SG+FUT+1+SG
esbranquiçá-la-eis	esbranquiçar+V.ele.ACC.3.F.SG+FUT+2+PL
esbranquiçá-la-emos	esbranquiçar+V.ele.ACC.3.F.SG+FUT+1+PL
esbranquiçá-la	esbranquiçar+V.ele.ACC.3.F.SG+INF+1+SG
esbranquiçá-la	esbranquiçar+V.ele.ACC.3.F.SG+INF+3+SG
esbranquiça-la	esbranquiçar+V.ele.ACC.3.F.SG+PRS+2+SG
esbranquiçá-la	esbranquiçar+V.ele.ACC.3.F.SG+SBJF+1+SG
esbranquiçá-la	esbranquiçar+V.ele.ACC.3.F.SG+SBJF+3+SG
esbranquiçá-la-ia	esbranquiçar+V.ele.ACC.3.F.SG+COND+1+SG
esbranquiçá-la-ia	esbranquiçar+V.ele.ACC.3.F.SG+COND+3+SG
esbranquiçá-la-iam	esbranquiçar+V.ele.ACC.3.F.SG+COND+3+PL
esbranquiçá-la-íamos	esbranquiçar+V.ele.ACC.3.F.SG+COND+1+PL
esbranquiçá-la-ias	esbranquiçar+V.ele.ACC.3.F.SG+COND+2+SG
esbranquiçá-la-íeis	esbranquiçar+V.ele.ACC.3.F.SG+COND+2+PL
esbranquiçá-las-á	esbranquiçar+V.ele.ACC.3.F.PL+FUT+3+SG
esbranquiçá-las-ão	esbranquiçar+V.ele.ACC.3.F.PL+FUT+3+PL
esbranquiçá-las-ás	esbranquiçar+V.ele.ACC.3.F.PL+FUT+2+SG
esbranquiçá-las-ei	esbranquiçar+V.ele.ACC.3.F.PL+FUT+1+SG
esbranquiçá-las-eis	esbranquiçar+V.ele.ACC.3.F.PL+FUT+2+PL
esbranquiçá-las-emos	esbranquiçar+V.ele.ACC.3.F.PL+FUT+1+PL
esbranquiçá-las	esbranquiçar+V.ele.ACC.3.F.PL+INF+1+SG
esbranquiçá-las	esbranquiçar+V.ele.ACC.3.F.PL+INF+3+SG
esbranquiça-las	esbranquiçar+V.ele.ACC.3.F.PL+PRS+2+SG
esbranquiçá-las	esbranquiçar+V.ele.ACC.3.F.PL+SBJF+1+SG
esbranquiçá-las	esbranquiçar+V.ele.ACC.3.F.PL+SBJF+3+SG
esbranquiçá-las-ia	esbranquiçar+V.ele.ACC.3.F.PL+COND+1+SG
esbranquiçá-las-ia	esbranquiçar+V.ele.ACC.3.F.PL+COND+3+SG
esbranquiçá-las-iam	esbranquiçar+V.ele.ACC.3.F.PL+COND+3+PL
esbranquiçá-las-íamos	esbranquiçar+V.ele.ACC.3.F.PL+COND+1+PL
esbranquiçá-las-ias	esbranquiçar+V.ele.ACC.3.F.PL+COND+2+SG
esbranquiçá-las-íeis	esbranquiçar+V.ele.ACC.3.F.PL+COND+2+PL
esbranquiça-lhe	esbranquiçar+V.ele.DAT.3.SG+PRS+3+SG
esbranquiça-lhes	esbranquiçar+V.ele.DAT.3.PL+PRS+3+SG
esbranquiçá-lo-á	esbranquiçar+V.ele.ACC.3.M.SG+FUT+3+SG
esbranquiçá-lo-ão	esbranquiçar+V.ele.ACC.3.M.SG+FUT+3+PL
esbranquiçá-lo-ás	esbranquiçar+V.ele.ACC.3.M.SG+FUT+2+SG
esbranquiçá-lo-ei	esbranquiçar+V.ele.ACC.3.M.SG+FUT+1+SG
esbranquiçá-lo-eis	esbranquiçar+V.ele.ACC.3.M.SG+FUT+2+PL
esbranquiçá-lo-emos	esbranquiçar+V.ele.ACC.3.M.SG+FUT+1+PL
esbranquiçá-lo	esbranquiçar+V.ele.ACC.3.M.SG+INF+1+SG
esbranquiçá-lo	esbranquiçar+V.ele.ACC.3.M.SG+INF+3+SG
esbranquiça-lo	esbranquiçar+V.ele.ACC.3.M.SG+PRS+2+SG
esbranquiçá-lo	esbranquiçar+V.ele.ACC.3.M.SG+SBJF+1+SG
esbranquiçá-lo	esbranquiçar+V.ele.ACC.3.M.SG+SBJF+3+SG
esbranquiçá-lo-ia	esbranquiçar+V.ele.ACC.3.M.SG+COND+1+SG
esbranquiçá-lo-ia	esbranquiçar+V.ele.ACC.3.M.SG+COND+3+SG
esbranquiçá-lo-iam	esbranquiçar+V.ele.ACC.3.M.SG+COND+3+PL
esbranquiçá-lo-íamos	esbranquiçar+V.ele.ACC.3.M.SG+COND+1+PL
esbranquiçá-lo-ias	esbranquiçar+V.ele.ACC.3.M.SG+COND+2+SG
esbranquiçá-lo-íeis	esbranquiçar+V.ele.ACC.3.M.SG+COND+2+PL
esbranquiçá-los-á	esbranquiçar+V.ele.ACC.3.M.PL+FUT+3+SG
esbranquiçá-los-ão	esbranquiçar+V.ele.ACC.3.M.PL+FUT+3+PL
esbranquiçá-los-ás	esbranquiçar+V.ele.ACC.3.M.PL+FUT+2+SG
esbranquiçá-los-ei	esbranquiçar+V.ele.ACC.3.M.PL+FUT+1+SG
esbranquiçá-los-eis	esbranquiçar+V.ele.ACC.3.M.PL+FUT+2+PL
esbranquiçá-los-emos	esbranquiçar+V.ele.ACC.3.M.PL+FUT+1+PL
esbranquiçá-los	esbranquiçar+V.ele.ACC.3.M.PL+INF+1+SG
esbranquiçá-los	esbranquiçar+V.ele.ACC.3.M.PL+INF+3+SG
esbranquiça-los	esbranquiçar+V.ele.ACC.3.M.PL+PRS+2+SG
esbranquiçá-los	esbranquiçar+V.ele.ACC.3.M.PL+SBJF+1+SG
esbranquiçá-los	esbranquiçar+V.ele.ACC.3.M.PL+SBJF+3+SG
esbranquiçá-los-ia	esbranquiçar+V.ele.ACC.3.M.PL+COND+1+SG
esbranquiçá-los-ia	esbranquiçar+V.ele.ACC.3.M.PL+COND+3+SG
esbranquiçá-los-iam	esbranquiçar+V.ele.ACC.3.M.PL+COND+3+PL
esbranquiçá-los-íamos	esbranquiçar+V.ele.ACC.3.M.PL+COND+1+PL
esbranquiçá-los-ias	esbranquiçar+V.ele.ACC.3.M.PL+COND+2+SG
esbranquiçá-los-íeis	esbranquiçar+V.ele.ACC.3.M.PL+COND+2+PL
esbranquiça-me	esbranquiçar+V.eu.AD.1.SG+PRS+3+SG
esbranquiçam-lhe	esbranquiçar+V.ele.DAT.3.SG+PRS+3+PL
esbranquiçam-lhes	esbranquiçar+V.ele.DAT.3.PL+PRS+3+PL
esbranquiçam-me	esbranquiçar+V.eu.AD.1.SG+PRS+3+PL
esbranquiçam-na	esbranquiçar+V.ele.ACC.3.F.SG+PRS+3+PL
esbranquiçam-nas	esbranquiçar+V.ele.ACC.3.F.PL+PRS+3+PL
esbranquiçam-no	esbranquiçar+V.ele.ACC.3.M.SG+PRS+3+PL
esbranquiçam-nos	esbranquiçar+nós.AD.1.PL+PRS+3+PL
esbranquiçamo-la	esbranquiçar+V.ele.ACC.3.F.SG+PRF+1+PL
esbranquiçamo-la	esbranquiçar+V.ele.ACC.3.F.SG+PRS+1+PL
esbranquiçamo-las	esbranquiçar+V.ele.ACC.3.F.PL+PRF+1+PL
esbranquiçamo-las	esbranquiçar+V.ele.ACC.3.F.PL+PRS+1+PL
esbranquiçamo-lo	esbranquiçar+V.ele.ACC.3.M.SG+PRF+1+PL
esbranquiçamo-lo	esbranquiçar+V.ele.ACC.3.M.SG+PRS+1+PL
esbranquiçamo-los	esbranquiçar+V.ele.ACC.3.M.PL+PRF+1+PL
esbranquiçamo-los	esbranquiçar+V.ele.ACC.3.M.PL+PRS+1+PL
esbranquiçamo-nos	esbranquiçar+nós.AD.1.PL+PRF+1+PL
esbranquiçamo-nos	esbranquiçar+nós.AD.1.PL+PRS+1+PL
esbranquiçamos-lhe	esbranquiçar+V.ele.DAT.3.SG+PRF+1+PL
esbranquiçamos-lhe	esbranquiçar+V.ele.DAT.3.SG+PRS+1+PL
esbranquiçamos-lhes	esbranquiçar+V.ele.DAT.3.PL+PRF+1+PL
esbranquiçamos-lhes	esbranquiçar+V.ele.DAT.3.PL+PRS+1+PL
esbranquiçamos-me	esbranquiçar+V.eu.AD.1.SG+PRF+1+PL
esbranquiçamos-me	esbranquiçar+V.eu.AD.1.SG+PRS+1+PL
esbranquiçamos-te	esbranquiçar+V.tu.AD.2.SG+PRF+1+PL
esbranquiçamos-te	esbranquiçar+V.tu.AD.2.SG+PRS+1+PL
esbranquiçamos-vos	esbranquiçar+V.vós.AD.2.PL+PRF+1+PL
esbranquiçamos-vos	esbranquiçar+V.vós.AD.2.PL+PRS+1+PL
esbranquiçam-se	esbranquiçar+V.ele.REFL+PRS+3+PL
esbranquiçam-te	esbranquiçar+V.tu.AD.2.SG+PRS+3+PL
esbranquiçam-vos	esbranquiçar+V.vós.AD.2.PL+PRS+3+PL
esbranquiçando-a	esbranquiçar+V.ele.ACC.3.F.SG+GRD
esbranquiçando-as	esbranquiçar+V.ele.ACC.3.F.PL+GRD
esbranquiçando-lhe	esbranquiçar+V.ele.DAT.3.SG+GRD
esbranquiçando-lhes	esbranquiçar+V.ele.DAT.3.PL+GRD
esbranquiçando-me	esbranquiçar+V.eu.AD.1.SG+GRD
esbranquiçando-nos	esbranquiçar+nós.AD.1.PL+GRD
esbranquiçando-o	esbranquiçar+V.ele.ACC.3.M.SG+GRD
