escardilharmo-lo	escardilhar+V.ele.ACC.3.M.SG+SBJF+1+PL
escardilharmo-los	escardilhar+V.ele.ACC.3.M.PL+INF+1+PL
escardilharmo-los	escardilhar+V.ele.ACC.3.M.PL+SBJF+1+PL
escardilharmo-nos	escardilhar+nós.AD.1.PL+INF+1+PL
escardilharmo-nos	escardilhar+nós.AD.1.PL+SBJF+1+PL
escardilharmos-lhe	escardilhar+V.ele.DAT.3.SG+INF+1+PL
escardilharmos-lhe	escardilhar+V.ele.DAT.3.SG+SBJF+1+PL
escardilharmos-lhes	escardilhar+V.ele.DAT.3.PL+INF+1+PL
escardilharmos-lhes	escardilhar+V.ele.DAT.3.PL+SBJF+1+PL
escardilharmos-me	escardilhar+V.eu.AD.1.SG+INF+1+PL
escardilharmos-me	escardilhar+V.eu.AD.1.SG+SBJF+1+PL
escardilharmos-te	escardilhar+V.tu.AD.2.SG+INF+1+PL
escardilharmos-te	escardilhar+V.tu.AD.2.SG+SBJF+1+PL
escardilharmos-vos	escardilhar+V.vós.AD.2.PL+INF+1+PL
escardilharmos-vos	escardilhar+V.vós.AD.2.PL+SBJF+1+PL
escardilhar-nos-á	escardilhar+nós.AD.1.PL+FUT+3+SG
escardilhar-nos-ão	escardilhar+nós.AD.1.PL+FUT+3+PL
escardilhar-nos-ás	escardilhar+nós.AD.1.PL+FUT+2+SG
escardilhar-nos-ei	escardilhar+nós.AD.1.PL+FUT+1+SG
escardilhar-nos-eis	escardilhar+nós.AD.1.PL+FUT+2+PL
escardilhar-nos-emos	escardilhar+nós.AD.1.PL+FUT+1+PL
escardilhar-nos	escardilhar+nós.AD.1.PL+INF
escardilhar-nos	escardilhar+nós.AD.1.PL+INF+1+SG
escardilhar-nos	escardilhar+nós.AD.1.PL+INF+3+SG
escardilhar-nos	escardilhar+nós.AD.1.PL+SBJF+1+SG
escardilhar-nos	escardilhar+nós.AD.1.PL+SBJF+3+SG
escardilhar-nos-ia	escardilhar+nós.AD.1.PL+COND+1+SG
escardilhar-nos-ia	escardilhar+nós.AD.1.PL+COND+3+SG
escardilhar-nos-iam	escardilhar+nós.AD.1.PL+COND+3+PL
escardilhar-nos-íamos	escardilhar+nós.AD.1.PL+COND+1+PL
escardilhar-nos-ias	escardilhar+nós.AD.1.PL+COND+2+SG
escardilhar-nos-íeis	escardilhar+nós.AD.1.PL+COND+2+PL
escardilhar-se-á	escardilhar+V.ele.REFL+FUT+3+SG
escardilhar-se-ão	escardilhar+V.ele.REFL+FUT+3+PL
escardilhar-se	escardilhar+V.ele.REFL+INF
escardilhar-se	escardilhar+V.ele.REFL+INF+3+SG
escardilhar-se	escardilhar+V.ele.REFL+SBJF+3+SG
escardilhar-se-ia	escardilhar+V.ele.REFL+COND+3+SG
escardilhar-se-iam	escardilhar+V.ele.REFL+COND+3+PL
escardilhar-te-á	escardilhar+V.tu.AD.2.SG+FUT+3+SG
escardilhar-te-ão	escardilhar+V.tu.AD.2.SG+FUT+3+PL
escardilhar-te-ás	escardilhar+V.tu.AD.2.SG+FUT+2+SG
escardilhar-te-ei	escardilhar+V.tu.AD.2.SG+FUT+1+SG
escardilhar-te-eis	escardilhar+V.tu.AD.2.SG+FUT+2+PL
escardilhar-te-emos	escardilhar+V.tu.AD.2.SG+FUT+1+PL
escardilhar-te	escardilhar+V.tu.AD.2.SG+INF
escardilhar-te	escardilhar+V.tu.AD.2.SG+INF+1+SG
escardilhar-te	escardilhar+V.tu.AD.2.SG+INF+3+SG
escardilhar-te	escardilhar+V.tu.AD.2.SG+SBJF+1+SG
escardilhar-te	escardilhar+V.tu.AD.2.SG+SBJF+3+SG
escardilhar-te-ia	escardilhar+V.tu.AD.2.SG+COND+1+SG
escardilhar-te-ia	escardilhar+V.tu.AD.2.SG+COND+3+SG
escardilhar-te-iam	escardilhar+V.tu.AD.2.SG+COND+3+PL
escardilhar-te-íamos	escardilhar+V.tu.AD.2.SG+COND+1+PL
escardilhar-te-ias	escardilhar+V.tu.AD.2.SG+COND+2+SG
escardilhar-te-íeis	escardilhar+V.tu.AD.2.SG+COND+2+PL
escardilhar-vos-á	escardilhar+V.vós.AD.2.PL+FUT+3+SG
escardilhar-vos-ão	escardilhar+V.vós.AD.2.PL+FUT+3+PL
escardilhar-vos-ás	escardilhar+V.vós.AD.2.PL+FUT+2+SG
escardilhar-vos-ei	escardilhar+V.vós.AD.2.PL+FUT+1+SG
escardilhar-vos-eis	escardilhar+V.vós.AD.2.PL+FUT+2+PL
escardilhar-vos-emos	escardilhar+V.vós.AD.2.PL+FUT+1+PL
escardilhar-vos	escardilhar+V.vós.AD.2.PL+INF
escardilhar-vos	escardilhar+V.vós.AD.2.PL+INF+1+SG
escardilhar-vos	escardilhar+V.vós.AD.2.PL+INF+3+SG
escardilhar-vos	escardilhar+V.vós.AD.2.PL+SBJF+1+SG
escardilhar-vos	escardilhar+V.vós.AD.2.PL+SBJF+3+SG
escardilhar-vos-ia	escardilhar+V.vós.AD.2.PL+COND+1+SG
escardilhar-vos-ia	escardilhar+V.vós.AD.2.PL+COND+3+SG
escardilhar-vos-iam	escardilhar+V.vós.AD.2.PL+COND+3+PL
escardilhar-vos-íamos	escardilhar+V.vós.AD.2.PL+COND+1+PL
escardilhar-vos-ias	escardilhar+V.vós.AD.2.PL+COND+2+SG
escardilhar-vos-íeis	escardilhar+V.vós.AD.2.PL+COND+2+PL
escardilha-se	escardilhar+V.ele.REFL+PRS+3+SG
escardilhas-lhe	escardilhar+V.ele.DAT.3.SG+PRS+2+SG
escardilhas-lhes	escardilhar+V.ele.DAT.3.PL+PRS+2+SG
escardilhas-me	escardilhar+V.eu.AD.1.SG+PRS+2+SG
escardilhaste-a	escardilhar+V.ele.ACC.3.F.SG+PRF+2+SG
escardilhaste-as	escardilhar+V.ele.ACC.3.F.PL+PRF+2+SG
escardilhas-te	escardilhar+V.tu.AD.2.SG+PRS+2+SG
escardilhaste-la	escardilhar+V.ele.ACC.3.F.SG+PRF+2+PL
escardilhaste-las	escardilhar+V.ele.ACC.3.F.PL+PRF+2+PL
escardilhaste-lhe	escardilhar+V.ele.DAT.3.SG+PRF+2+SG
escardilhaste-lhes	escardilhar+V.ele.DAT.3.PL+PRF+2+SG
escardilhaste-lo	escardilhar+V.ele.ACC.3.M.SG+PRF+2+PL
escardilhaste-los	escardilhar+V.ele.ACC.3.M.PL+PRF+2+PL
escardilhaste-me	escardilhar+V.eu.AD.1.SG+PRF+2+SG
escardilhaste-nos	escardilhar+nós.AD.1.PL+PRF+2+PL
escardilhaste-nos	escardilhar+nós.AD.1.PL+PRF+2+SG
escardilhaste-o	escardilhar+V.ele.ACC.3.M.SG+PRF+2+SG
escardilhaste-os	escardilhar+V.ele.ACC.3.M.PL+PRF+2+SG
escardilhastes-lhe	escardilhar+V.ele.DAT.3.SG+PRF+2+PL
escardilhastes-lhes	escardilhar+V.ele.DAT.3.PL+PRF+2+PL
escardilhastes-me	escardilhar+V.eu.AD.1.SG+PRF+2+PL
escardilhastes-te	escardilhar+V.tu.AD.2.SG+PRF+2+PL
escardilhastes-vos	escardilhar+V.vós.AD.2.PL+PRF+2+PL
escardilhaste-te	escardilhar+V.tu.AD.2.SG+PRF+2+SG
escardilhaste-vos	escardilhar+V.vós.AD.2.PL+PRF+2+SG
escardilhas-vos	escardilhar+V.vós.AD.2.PL+PRS+2+SG
escardilha-te	escardilhar+V.tu.AD.2.SG+PRS+3+SG
escardilhava-a	escardilhar+V.ele.ACC.3.F.SG+IMPF+1+SG
escardilhava-a	escardilhar+V.ele.ACC.3.F.SG+IMPF+3+SG
escardilhava-as	escardilhar+V.ele.ACC.3.F.PL+IMPF+1+SG
escardilhava-as	escardilhar+V.ele.ACC.3.F.PL+IMPF+3+SG
escardilhava-la	escardilhar+V.ele.ACC.3.F.SG+IMPF+2+SG
escardilhava-las	escardilhar+V.ele.ACC.3.F.PL+IMPF+2+SG
escardilhava-lhe	escardilhar+V.ele.DAT.3.SG+IMPF+1+SG
escardilhava-lhe	escardilhar+V.ele.DAT.3.SG+IMPF+3+SG
escardilhava-lhes	escardilhar+V.ele.DAT.3.PL+IMPF+1+SG
escardilhava-lhes	escardilhar+V.ele.DAT.3.PL+IMPF+3+SG
escardilhava-lo	escardilhar+V.ele.ACC.3.M.SG+IMPF+2+SG
escardilhava-los	escardilhar+V.ele.ACC.3.M.PL+IMPF+2+SG
escardilhava-me	escardilhar+V.eu.AD.1.SG+IMPF+1+SG
escardilhava-me	escardilhar+V.eu.AD.1.SG+IMPF+3+SG
escardilhavam-lhe	escardilhar+V.ele.DAT.3.SG+IMPF+3+PL
escardilhavam-lhes	escardilhar+V.ele.DAT.3.PL+IMPF+3+PL
escardilhavam-me	escardilhar+V.eu.AD.1.SG+IMPF+3+PL
escardilhavam-na	escardilhar+V.ele.ACC.3.F.SG+IMPF+3+PL
escardilhavam-nas	escardilhar+V.ele.ACC.3.F.PL+IMPF+3+PL
escardilhavam-no	escardilhar+V.ele.ACC.3.M.SG+IMPF+3+PL
escardilhavam-nos	escardilhar+V.ele.ACC.3.M.PL+IMPF+3+PL
escardilhavam-nos	escardilhar+V.nós.AD.1.PL+IMPF+3+PL
escardilhávamo-la	escardilhar+V.ele.ACC.3.F.SG+IMPF+1+PL
escardilhávamo-las	escardilhar+V.ele.ACC.3.F.PL+IMPF+1+PL
escardilhávamo-lo	escardilhar+V.ele.ACC.3.M.SG+IMPF+1+PL
escardilhávamo-los	escardilhar+V.ele.ACC.3.M.PL+IMPF+1+PL
escardilhávamo-nos	escardilhar+nós.AD.1.PL+IMPF+1+PL
escardilhávamos-lhe	escardilhar+V.ele.DAT.3.SG+IMPF+1+PL
escardilhávamos-lhes	escardilhar+V.ele.DAT.3.PL+IMPF+1+PL
escardilhávamos-me	escardilhar+V.eu.AD.1.SG+IMPF+1+PL
escardilhávamos-te	escardilhar+V.tu.AD.2.SG+IMPF+1+PL
escardilhávamos-vos	escardilhar+V.vós.AD.2.PL+IMPF+1+PL
escardilhavam-se	escardilhar+V.ele.REFL+IMPF+3+PL
escardilhavam-te	escardilhar+V.tu.AD.2.SG+IMPF+3+PL
escardilhavam-vos	escardilhar+V.vós.AD.2.PL+IMPF+3+PL
escardilhava-nos	escardilhar+nós.AD.1.PL+IMPF+1+SG
escardilhava-nos	escardilhar+nós.AD.1.PL+IMPF+2+SG
escardilhava-nos	escardilhar+nós.AD.1.PL+IMPF+3+SG
escardilhava-o	escardilhar+V.ele.ACC.3.M.SG+IMPF+1+SG
escardilhava-o	escardilhar+V.ele.ACC.3.M.SG+IMPF+3+SG
escardilhava-os	escardilhar+V.ele.ACC.3.M.PL+IMPF+1+SG
escardilhava-os	escardilhar+V.ele.ACC.3.M.PL+IMPF+3+SG
escardilhava-se	escardilhar+V.ele.REFL+IMPF+1+SG
escardilhava-se	escardilhar+V.ele.REFL+IMPF+3+SG
escardilhavas-lhe	escardilhar+V.ele.DAT.3.SG+IMPF+2+SG
escardilhavas-lhes	escardilhar+V.ele.DAT.3.PL+IMPF+2+SG
escardilhavas-me	escardilhar+V.eu.AD.1.SG+IMPF+2+SG
escardilhavas-te	escardilhar+V.tu.AD.2.SG+IMPF+2+SG
escardilhavas-vos	escardilhar+V.vós.AD.2.PL+IMPF+2+SG
escardilhava-te	escardilhar+V.tu.AD.2.SG+IMPF+1+SG
escardilhava-te	escardilhar+V.tu.AD.2.SG+IMPF+3+SG
escardilhava-vos	escardilhar+V.vós.AD.2.PL+IMPF+1+SG
escardilhava-vos	escardilhar+V.vós.AD.2.PL+IMPF+3+SG
escardilhávei-la	escardilhar+V.ele.ACC.3.F.SG+IMPF+2+PL
escardilhávei-las	escardilhar+V.ele.ACC.3.F.PL+IMPF+2+PL
escardilhávei-lo	escardilhar+V.ele.ACC.3.M.SG+IMPF+2+PL
escardilhávei-los	escardilhar+V.ele.ACC.3.M.PL+IMPF+2+PL
escardilhávei-nos	escardilhar+nós.AD.1.PL+IMPF+2+PL
escardilháveis-lhe	escardilhar+V.ele.DAT.3.SG+IMPF+2+PL
escardilháveis-lhes	escardilhar+V.ele.DAT.3.PL+IMPF+2+PL
escardilháveis-me	escardilhar+V.eu.AD.1.SG+IMPF+2+PL
escardilháveis-te	escardilhar+V.tu.AD.2.SG+IMPF+2+PL
escardilháveis-vos	escardilhar+V.vós.AD.2.PL+IMPF+2+PL
escardilha-vos	escardilhar+V.vós.AD.2.PL+PRS+3+SG
escardilhe-a	escardilhar+V.ele.ACC.3.F.SG+IMP+3+SG
escardilhe-as	escardilhar+V.ele.ACC.3.F.PL+IMP+3+SG
escardilhei-a	escardilhar+V.ele.ACC.3.F.SG+PRF+1+SG
escardilhei-as	escardilhar+V.ele.ACC.3.F.PL+PRF+1+SG
escardilhei-lhe	escardilhar+V.ele.DAT.3.SG+PRF+1+SG
escardilhei-lhes	escardilhar+V.ele.DAT.3.PL+PRF+1+SG
escardilhei-me	escardilhar+V.eu.AD.1.SG+PRF+1+SG
escardilhei-nos	escardilhar+nós.AD.1.PL+PRF+1+SG
escardilhei-o	escardilhar+V.ele.ACC.3.M.SG+PRF+1+SG
escardilhei-os	escardilhar+V.ele.ACC.3.M.PL+PRF+1+SG
escardilhei-te	escardilhar+V.tu.AD.2.SG+PRF+1+SG
escardilhei-vos	escardilhar+V.vós.AD.2.PL+PRF+1+SG
escardilhe-lhe	escardilhar+V.ele.DAT.3.SG+IMP+3+SG
escardilhe-lhes	escardilhar+V.ele.DAT.3.PL+IMP+3+SG
escardilhe-me	escardilhar+V.eu.AD.1.SG+IMP+3+SG
escardilhem-lhe	escardilhar+V.ele.DAT.3.SG+IMP+3+PL
escardilhem-lhes	escardilhar+V.ele.DAT.3.PL+IMP+3+PL
escardilhem-me	escardilhar+V.eu.AD.1.SG+IMP+3+PL
escardilhem-na	escardilhar+V.ele.ACC.3.F.SG+IMP+3+PL
escardilhem-nas	escardilhar+V.ele.ACC.3.F.PL+IMP+3+PL
escardilhem-no	escardilhar+V.ele.ACC.3.M.SG+IMP+3+PL
escardilhem-nos	escardilhar+V.ele.ACC.3.M.PL+IMP+3+PL
escardilhem-nos	escardilhar+V.nós.AD.1.PL+IMP+3+PL
escardilhemo-la	escardilhar+V.ele.ACC.3.F.SG+IMP+1+PL
escardilhemo-las	escardilhar+V.ele.ACC.3.F.PL+IMP+1+PL
escardilhemo-lo	escardilhar+V.ele.ACC.3.M.SG+IMP+1+PL
escardilhemo-los	escardilhar+V.ele.ACC.3.M.PL+IMP+1+PL
escardilhemo-nos	escardilhar+nós.AD.1.PL+IMP+1+PL
escardilhemos-lhe	escardilhar+V.ele.DAT.3.SG+IMP+1+PL
escardilhemos-lhes	escardilhar+V.ele.DAT.3.PL+IMP+1+PL
escardilhemos-me	escardilhar+V.eu.AD.1.SG+IMP+1+PL
escardilhemos-te	escardilhar+V.tu.AD.2.SG+IMP+1+PL
escardilhemos-vos	escardilhar+V.vós.AD.2.PL+IMP+1+PL
escardilhem-se	escardilhar+V.ele.REFL+IMP+3+PL
escardilhem-te	escardilhar+V.tu.AD.2.SG+IMP+3+PL
escardilhem-vos	escardilhar+V.vós.AD.2.PL+IMP+3+PL
escardilhe-nos	escardilhar+nós.AD.1.PL+IMP+3+SG
escardilhe-o	escardilhar+V.ele.ACC.3.M.SG+IMP+3+SG
escardilhe-os	escardilhar+V.ele.ACC.3.M.PL+IMP+3+SG
escardilhe-se	escardilhar+V.ele.REFL+IMP+3+SG
escardilhe-te	escardilhar+V.tu.AD.2.SG+IMP+3+SG
escardilhe-vos	escardilhar+V.vós.AD.2.PL+IMP+3+SG
escardilho-a	escardilhar+V.ele.ACC.3.F.SG+PRS+1+SG
escardilho-as	escardilhar+V.ele.ACC.3.F.PL+PRS+1+SG
escardilho-lhe	escardilhar+V.ele.DAT.3.SG+PRS+1+SG
escardilho-lhes	escardilhar+V.ele.DAT.3.PL+PRS+1+SG
escardilho-me	escardilhar+V.eu.AD.1.SG+PRS+1+SG
escardilho-nos	escardilhar+nós.AD.1.PL+PRS+1+SG
escardilho-o	escardilhar+V.ele.ACC.3.M.SG+PRS+1+SG
escardilho-os	escardilhar+V.ele.ACC.3.M.PL+PRS+1+SG
escardilho-te	escardilhar+V.tu.AD.2.SG+PRS+1+SG
escardilhou-a	escardilhar+V.ele.ACC.3.F.SG+PRF+3+SG
escardilhou-as	escardilhar+V.ele.ACC.3.F.PL+PRF+3+SG
escardilhou-lhe	escardilhar+V.ele.DAT.3.SG+PRF+3+SG
escardilhou-lhes	escardilhar+V.ele.DAT.3.PL+PRF+3+SG
escardilhou-me	escardilhar+V.eu.AD.1.SG+PRF+3+SG
escardilhou-nos	escardilhar+nós.AD.1.PL+PRF+3+SG
escardilhou-o	escardilhar+V.ele.ACC.3.M.SG+PRF+3+SG
escardilhou-os	escardilhar+V.ele.ACC.3.M.PL+PRF+3+SG
escardilhou-se	escardilhar+V.ele.REFL+PRF+3+SG
escardilhou-te	escardilhar+V.tu.AD.2.SG+PRF+3+SG
escardilhou-vos	escardilhar+V.vós.AD.2.PL+PRF+3+SG
escardilho-vos	escardilhar+V.vós.AD.2.PL+PRS+1+SG
escardo-a	escardar+V.ele.ACC.3.F.SG+PRS+1+SG
escardo-as	escardar+V.ele.ACC.3.F.PL+PRS+1+SG
escardo-lhe	escardar+V.ele.DAT.3.SG+PRS+1+SG
escardo-lhes	escardar+V.ele.DAT.3.PL+PRS+1+SG
escardo-me	escardar+V.eu.AD.1.SG+PRS+1+SG
escardo-nos	escardar+nós.AD.1.PL+PRS+1+SG
escardo-o	escardar+V.ele.ACC.3.M.SG+PRS+1+SG
escardo-os	escardar+V.ele.ACC.3.M.PL+PRS+1+SG
escardo-te	escardar+V.tu.AD.2.SG+PRS+1+SG
escardou-a	escardar+V.ele.ACC.3.F.SG+PRF+3+SG
escardou-as	escardar+V.ele.ACC.3.F.PL+PRF+3+SG
escardou-lhe	escardar+V.ele.DAT.3.SG+PRF+3+SG
escardou-lhes	escardar+V.ele.DAT.3.PL+PRF+3+SG
escardou-me	escardar+V.eu.AD.1.SG+PRF+3+SG
escardou-nos	escardar+nós.AD.1.PL+PRF+3+SG
escardou-o	escardar+V.ele.ACC.3.M.SG+PRF+3+SG
escardou-os	escardar+V.ele.ACC.3.M.PL+PRF+3+SG
escardou-se	escardar+V.ele.REFL+PRF+3+SG
escardou-te	escardar+V.tu.AD.2.SG+PRF+3+SG
escardou-vos	escardar+V.vós.AD.2.PL+PRF+3+SG
escardo-vos	escardar+V.vós.AD.2.PL+PRS+1+SG
escarduça-a	escarduçar+V.ele.ACC.3.F.SG+PRS+3+SG
escarduça-as	escarduçar+V.ele.ACC.3.F.PL+PRS+3+SG
escarduçai-la	escarduçar+V.ele.ACC.3.F.SG+PRS+2+PL
escarduçai-las	escarduçar+V.ele.ACC.3.F.PL+PRS+2+PL
escarduçai-lo	escarduçar+V.ele.ACC.3.M.SG+PRS+2+PL
escarduçai-los	escarduçar+V.ele.ACC.3.M.PL+PRS+2+PL
escarduçai-nos	escarduçar+nós.AD.1.PL+PRS+2+PL
escarduçais-lhe	escarduçar+V.ele.DAT.3.SG+PRS+2+PL
escarduçais-lhes	escarduçar+V.ele.DAT.3.PL+PRS+2+PL
escarduçais-me	escarduçar+V.eu.AD.1.SG+PRS+2+PL
escarduçais-te	escarduçar+V.tu.AD.2.SG+PRS+2+PL
escarduçais-vos	escarduçar+V.vós.AD.2.PL+PRS+2+PL
escarduçá-la-á	escarduçar+V.ele.ACC.3.F.SG+FUT+3+SG
escarduçá-la-ão	escarduçar+V.ele.ACC.3.F.SG+FUT+3+PL
escarduçá-la-ás	escarduçar+V.ele.ACC.3.F.SG+FUT+2+SG
escarduçá-la-ei	escarduçar+V.ele.ACC.3.F.SG+FUT+1+SG
escarduçá-la-eis	escarduçar+V.ele.ACC.3.F.SG+FUT+2+PL
escarduçá-la-emos	escarduçar+V.ele.ACC.3.F.SG+FUT+1+PL
escarduçá-la	escarduçar+V.ele.ACC.3.F.SG+INF+1+SG
escarduçá-la	escarduçar+V.ele.ACC.3.F.SG+INF+3+SG
escarduça-la	escarduçar+V.ele.ACC.3.F.SG+PRS+2+SG
escarduçá-la	escarduçar+V.ele.ACC.3.F.SG+SBJF+1+SG
escarduçá-la	escarduçar+V.ele.ACC.3.F.SG+SBJF+3+SG
escarduçá-la-ia	escarduçar+V.ele.ACC.3.F.SG+COND+1+SG
escarduçá-la-ia	escarduçar+V.ele.ACC.3.F.SG+COND+3+SG
escarduçá-la-iam	escarduçar+V.ele.ACC.3.F.SG+COND+3+PL
escarduçá-la-íamos	escarduçar+V.ele.ACC.3.F.SG+COND+1+PL
escarduçá-la-ias	escarduçar+V.ele.ACC.3.F.SG+COND+2+SG
escarduçá-la-íeis	escarduçar+V.ele.ACC.3.F.SG+COND+2+PL
escarduçá-las-á	escarduçar+V.ele.ACC.3.F.PL+FUT+3+SG
escarduçá-las-ão	escarduçar+V.ele.ACC.3.F.PL+FUT+3+PL
escarduçá-las-ás	escarduçar+V.ele.ACC.3.F.PL+FUT+2+SG
escarduçá-las-ei	escarduçar+V.ele.ACC.3.F.PL+FUT+1+SG
escarduçá-las-eis	escarduçar+V.ele.ACC.3.F.PL+FUT+2+PL
escarduçá-las-emos	escarduçar+V.ele.ACC.3.F.PL+FUT+1+PL
escarduçá-las	escarduçar+V.ele.ACC.3.F.PL+INF+1+SG
escarduçá-las	escarduçar+V.ele.ACC.3.F.PL+INF+3+SG
escarduça-las	escarduçar+V.ele.ACC.3.F.PL+PRS+2+SG
escarduçá-las	escarduçar+V.ele.ACC.3.F.PL+SBJF+1+SG
escarduçá-las	escarduçar+V.ele.ACC.3.F.PL+SBJF+3+SG
escarduçá-las-ia	escarduçar+V.ele.ACC.3.F.PL+COND+1+SG
escarduçá-las-ia	escarduçar+V.ele.ACC.3.F.PL+COND+3+SG
escarduçá-las-iam	escarduçar+V.ele.ACC.3.F.PL+COND+3+PL
escarduçá-las-íamos	escarduçar+V.ele.ACC.3.F.PL+COND+1+PL
escarduçá-las-ias	escarduçar+V.ele.ACC.3.F.PL+COND+2+SG
escarduçá-las-íeis	escarduçar+V.ele.ACC.3.F.PL+COND+2+PL
escarduça-lhe	escarduçar+V.ele.DAT.3.SG+PRS+3+SG
escarduça-lhes	escarduçar+V.ele.DAT.3.PL+PRS+3+SG
escarduçá-lo-á	escarduçar+V.ele.ACC.3.M.SG+FUT+3+SG
escarduçá-lo-ão	escarduçar+V.ele.ACC.3.M.SG+FUT+3+PL
escarduçá-lo-ás	escarduçar+V.ele.ACC.3.M.SG+FUT+2+SG
escarduçá-lo-ei	escarduçar+V.ele.ACC.3.M.SG+FUT+1+SG
escarduçá-lo-eis	escarduçar+V.ele.ACC.3.M.SG+FUT+2+PL
escarduçá-lo-emos	escarduçar+V.ele.ACC.3.M.SG+FUT+1+PL
escarduçá-lo	escarduçar+V.ele.ACC.3.M.SG+INF+1+SG
escarduçá-lo	escarduçar+V.ele.ACC.3.M.SG+INF+3+SG
escarduça-lo	escarduçar+V.ele.ACC.3.M.SG+PRS+2+SG
escarduçá-lo	escarduçar+V.ele.ACC.3.M.SG+SBJF+1+SG
escarduçá-lo	escarduçar+V.ele.ACC.3.M.SG+SBJF+3+SG
escarduçá-lo-ia	escarduçar+V.ele.ACC.3.M.SG+COND+1+SG
escarduçá-lo-ia	escarduçar+V.ele.ACC.3.M.SG+COND+3+SG
escarduçá-lo-iam	escarduçar+V.ele.ACC.3.M.SG+COND+3+PL
escarduçá-lo-íamos	escarduçar+V.ele.ACC.3.M.SG+COND+1+PL
escarduçá-lo-ias	escarduçar+V.ele.ACC.3.M.SG+COND+2+SG
escarduçá-lo-íeis	escarduçar+V.ele.ACC.3.M.SG+COND+2+PL
escarduçá-los-á	escarduçar+V.ele.ACC.3.M.PL+FUT+3+SG
escarduçá-los-ão	escarduçar+V.ele.ACC.3.M.PL+FUT+3+PL
escarduçá-los-ás	escarduçar+V.ele.ACC.3.M.PL+FUT+2+SG
escarduçá-los-ei	escarduçar+V.ele.ACC.3.M.PL+FUT+1+SG
escarduçá-los-eis	escarduçar+V.ele.ACC.3.M.PL+FUT+2+PL
escarduçá-los-emos	escarduçar+V.ele.ACC.3.M.PL+FUT+1+PL
escarduçá-los	escarduçar+V.ele.ACC.3.M.PL+INF+1+SG
escarduçá-los	escarduçar+V.ele.ACC.3.M.PL+INF+3+SG
escarduça-los	escarduçar+V.ele.ACC.3.M.PL+PRS+2+SG
escarduçá-los	escarduçar+V.ele.ACC.3.M.PL+SBJF+1+SG
escarduçá-los	escarduçar+V.ele.ACC.3.M.PL+SBJF+3+SG
escarduçá-los-ia	escarduçar+V.ele.ACC.3.M.PL+COND+1+SG
escarduçá-los-ia	escarduçar+V.ele.ACC.3.M.PL+COND+3+SG
escarduçá-los-iam	escarduçar+V.ele.ACC.3.M.PL+COND+3+PL
escarduçá-los-íamos	escarduçar+V.ele.ACC.3.M.PL+COND+1+PL
escarduçá-los-ias	escarduçar+V.ele.ACC.3.M.PL+COND+2+SG
escarduçá-los-íeis	escarduçar+V.ele.ACC.3.M.PL+COND+2+PL
escarduça-me	escarduçar+V.eu.AD.1.SG+PRS+3+SG
escarduçam-lhe	escarduçar+V.ele.DAT.3.SG+PRS+3+PL
escarduçam-lhes	escarduçar+V.ele.DAT.3.PL+PRS+3+PL
escarduçam-me	escarduçar+V.eu.AD.1.SG+PRS+3+PL
escarduçam-na	escarduçar+V.ele.ACC.3.F.SG+PRS+3+PL
escarduçam-nas	escarduçar+V.ele.ACC.3.F.PL+PRS+3+PL
escarduçam-no	escarduçar+V.ele.ACC.3.M.SG+PRS+3+PL
escarduçam-nos	escarduçar+nós.AD.1.PL+PRS+3+PL
escarduçamo-la	escarduçar+V.ele.ACC.3.F.SG+PRF+1+PL
escarduçamo-la	escarduçar+V.ele.ACC.3.F.SG+PRS+1+PL
escarduçamo-las	escarduçar+V.ele.ACC.3.F.PL+PRF+1+PL
escarduçamo-las	escarduçar+V.ele.ACC.3.F.PL+PRS+1+PL
escarduçamo-lo	escarduçar+V.ele.ACC.3.M.SG+PRF+1+PL
escarduçamo-lo	escarduçar+V.ele.ACC.3.M.SG+PRS+1+PL
escarduçamo-los	escarduçar+V.ele.ACC.3.M.PL+PRF+1+PL
escarduçamo-los	escarduçar+V.ele.ACC.3.M.PL+PRS+1+PL
escarduçamo-nos	escarduçar+nós.AD.1.PL+PRF+1+PL
escarduçamo-nos	escarduçar+nós.AD.1.PL+PRS+1+PL
escarduçamos-lhe	escarduçar+V.ele.DAT.3.SG+PRF+1+PL
escarduçamos-lhe	escarduçar+V.ele.DAT.3.SG+PRS+1+PL
escarduçamos-lhes	escarduçar+V.ele.DAT.3.PL+PRF+1+PL
escarduçamos-lhes	escarduçar+V.ele.DAT.3.PL+PRS+1+PL
escarduçamos-me	escarduçar+V.eu.AD.1.SG+PRF+1+PL
escarduçamos-me	escarduçar+V.eu.AD.1.SG+PRS+1+PL
escarduçamos-te	escarduçar+V.tu.AD.2.SG+PRF+1+PL
escarduçamos-te	escarduçar+V.tu.AD.2.SG+PRS+1+PL
escarduçamos-vos	escarduçar+V.vós.AD.2.PL+PRF+1+PL
escarduçamos-vos	escarduçar+V.vós.AD.2.PL+PRS+1+PL
escarduçam-se	escarduçar+V.ele.REFL+PRS+3+PL
escarduçam-te	escarduçar+V.tu.AD.2.SG+PRS+3+PL
escarduçam-vos	escarduçar+V.vós.AD.2.PL+PRS+3+PL
escarduçando-a	escarduçar+V.ele.ACC.3.F.SG+GRD
escarduçando-as	escarduçar+V.ele.ACC.3.F.PL+GRD
escarduçando-lhe	escarduçar+V.ele.DAT.3.SG+GRD
escarduçando-lhes	escarduçar+V.ele.DAT.3.PL+GRD
escarduçando-me	escarduçar+V.eu.AD.1.SG+GRD
escarduçando-nos	escarduçar+nós.AD.1.PL+GRD
escarduçando-o	escarduçar+V.ele.ACC.3.M.SG+GRD
escarduçando-os	escarduçar+V.ele.ACC.3.M.PL+GRD
escarduçando-se	escarduçar+V.ele.REFL+GRD
escarduçando-te	escarduçar+V.tu.AD.2.SG+GRD
escarduçando-vos	escarduçar+V.vós.AD.2.PL+GRD
escarduça-nos	escarduçar+nós.AD.1.PL+PRS+2+SG
escarduça-nos	escarduçar+nós.AD.1.PL+PRS+3+SG
escarduça-o	escarduçar+V.ele.ACC.3.M.SG+PRS+3+SG
escarduça-os	escarduçar+V.ele.ACC.3.M.PL+PRS+3+SG
escarduçara-a	escarduçar+V.ele.ACC.3.F.SG+PQP+1+SG
escarduçara-a	escarduçar+V.ele.ACC.3.F.SG+PQP+3+SG
escarduçara-as	escarduçar+V.ele.ACC.3.F.PL+PQP+1+SG
escarduçara-as	escarduçar+V.ele.ACC.3.F.PL+PQP+3+SG
escarduçara-la	escarduçar+V.ele.ACC.3.F.SG+PQP+2+SG
escarduçara-las	escarduçar+V.ele.ACC.3.F.PL+PQP+2+SG
escarduçara-lhe	escarduçar+V.ele.DAT.3.SG+PQP+1+SG
escarduçara-lhe	escarduçar+V.ele.DAT.3.SG+PQP+3+SG
escarduçara-lhes	escarduçar+V.ele.DAT.3.PL+PQP+1+SG
escarduçara-lhes	escarduçar+V.ele.DAT.3.PL+PQP+3+SG
escarduçara-lo	escarduçar+V.ele.ACC.3.M.SG+PQP+2+SG
escarduçara-los	escarduçar+V.ele.ACC.3.M.PL+PQP+2+SG
escarduçara-me	escarduçar+V.eu.AD.1.SG+PQP+1+SG
escarduçara-me	escarduçar+V.eu.AD.1.SG+PQP+3+SG
escarduçaram-lhe	escarduçar+V.ele.DAT.3.SG+PQP+3+PL
escarduçaram-lhe	escarduçar+V.ele.DAT.3.SG+PRF+3+PL
escarduçaram-lhes	escarduçar+V.ele.DAT.3.PL+PQP+3+PL
escarduçaram-lhes	escarduçar+V.ele.DAT.3.PL+PRF+3+PL
escarduçaram-me	escarduçar+V.eu.AD.1.SG+PQP+3+PL
escarduçaram-me	escarduçar+V.eu.AD.1.SG+PRF+3+PL
escarduçaram-na	escarduçar+V.ele.ACC.3.F.SG+PQP+3+PL
escarduçaram-na	escarduçar+V.ele.ACC.3.F.SG+PRF+3+PL
escarduçaram-nas	escarduçar+V.ele.ACC.3.F.PL+PQP+3+PL
escarduçaram-nas	escarduçar+V.ele.ACC.3.F.PL+PRF+3+PL
escarduçaram-no	escarduçar+V.ele.ACC.3.M.SG+PQP+3+PL
escarduçaram-no	escarduçar+V.ele.ACC.3.M.SG+PRF+3+PL
escarduçaram-nos	escarduçar+nós.AD.1.PL+PQP+3+PL
escarduçaram-nos	escarduçar+nós.AD.1.PL+PRF+3+PL
escarduçáramo-la	escarduçar+V.ele.ACC.3.F.SG+PQP+1+PL
escarduçáramo-las	escarduçar+V.ele.ACC.3.F.PL+PQP+1+PL
escarduçáramo-lo	escarduçar+V.ele.ACC.3.M.SG+PQP+1+PL
escarduçáramo-los	escarduçar+V.ele.ACC.3.M.PL+PQP+1+PL
escarduçáramo-nos	escarduçar+nós.AD.1.PL+PQP+1+PL
escarduçáramos-lhe	escarduçar+V.ele.DAT.3.SG+PQP+1+PL
escarduçáramos-lhes	escarduçar+V.ele.DAT.3.PL+PQP+1+PL
escarduçáramos-me	escarduçar+V.eu.AD.1.SG+PQP+1+PL
escarduçáramos-te	escarduçar+V.tu.AD.2.SG+PQP+1+PL
escarduçáramos-vos	escarduçar+V.vós.AD.2.PL+PQP+1+PL
escarduçaram-se	escarduçar+V.ele.REFL+PQP+3+PL
escarduçaram-te	escarduçar+V.tu.AD.2.SG+PQP+3+PL
escarduçaram-te	escarduçar+V.tu.AD.2.SG+PRF+3+PL
escarduçaram-vos	escarduçar+V.vós.AD.2.PL+PQP+3+PL
escarduçaram-vos	escarduçar+V.vós.AD.2.PL+PRF+3+PL
escarduçara-nos	escarduçar+nós.AD.1.PL+PQP+1+SG
escarduçara-nos	escarduçar+nós.AD.1.PL+PQP+2+SG
escarduçara-nos	escarduçar+nós.AD.1.PL+PQP+3+SG
escarduçara-o	escarduçar+V.ele.ACC.3.M.SG+PQP+1+SG
escarduçara-o	escarduçar+V.ele.ACC.3.M.SG+PQP+3+SG
escarduçara-os	escarduçar+V.ele.ACC.3.M.PL+PQP+1+SG
escarduçara-os	escarduçar+V.ele.ACC.3.M.PL+PQP+3+SG
escarduçara-se	escarduçar+V.ele.REFL+PQP+1+SG
escarduçara-se	escarduçar+V.ele.REFL+PQP+3+SG
escarduçaras-lhe	escarduçar+V.ele.DAT.3.SG+PQP+2+SG
escarduçaras-lhes	escarduçar+V.ele.DAT.3.PL+PQP+2+SG
escarduçaras-me	escarduçar+V.eu.AD.1.SG+PQP+2+SG
escarduçaras-te	escarduçar+V.tu.AD.2.SG+PQP+2+SG
escarduçaras-vos	escarduçar+V.vós.AD.2.PL+PQP+2+SG
escarduçara-te	escarduçar+V.tu.AD.2.SG+PQP+1+SG
escarduçara-te	escarduçar+V.tu.AD.2.SG+PQP+3+SG
escarduçara-vos	escarduçar+V.vós.AD.2.PL+PQP+1+SG
escarduçara-vos	escarduçar+V.vós.AD.2.PL+PQP+3+SG
escarduçarde-la	escarduçar+V.ele.ACC.3.F.SG+INF+2+PL
escarduçarde-la	escarduçar+V.ele.ACC.3.F.SG+SBJF+2+PL
escarduçarde-las	escarduçar+V.ele.ACC.3.F.PL+INF+2+PL
escarduçarde-las	escarduçar+V.ele.ACC.3.F.PL+SBJF+2+PL
escarduçarde-lo	escarduçar+V.ele.ACC.3.M.SG+INF+2+PL
escarduçarde-lo	escarduçar+V.ele.ACC.3.M.SG+SBJF+2+PL
escarduçarde-los	escarduçar+V.ele.ACC.3.M.PL+INF+2+PL
escarduçarde-los	escarduçar+V.ele.ACC.3.M.PL+SBJF+2+PL
escarduçarde-nos	escarduçar+nós.AD.1.PL+INF+2+PL
escarduçarde-nos	escarduçar+nós.AD.1.PL+SBJF+2+PL
escarduçardes-lhe	escarduçar+V.ele.DAT.3.SG+INF+2+PL
escarduçardes-lhe	escarduçar+V.ele.DAT.3.SG+SBJF+2+PL
escarduçardes-lhes	escarduçar+V.ele.DAT.3.PL+INF+2+PL
escarduçardes-lhes	escarduçar+V.ele.DAT.3.PL+SBJF+2+PL
escarduçardes-me	escarduçar+V.eu.AD.1.SG+INF+2+PL
escarduçardes-me	escarduçar+V.eu.AD.1.SG+SBJF+2+PL
escarduçardes-te	escarduçar+V.tu.AD.2.SG+INF+2+PL
escarduçardes-te	escarduçar+V.tu.AD.2.SG+SBJF+2+PL
escarduçardes-vos	escarduçar+V.vós.AD.2.PL+INF+2+PL
escarduçardes-vos	escarduçar+V.vós.AD.2.PL+SBJF+2+PL
escarduçárei-la	escarduçar+V.ele.ACC.3.F.SG+PQP+2+PL
escarduçárei-las	escarduçar+V.ele.ACC.3.F.PL+PQP+2+PL
escarduçárei-lo	escarduçar+V.ele.ACC.3.M.SG+PQP+2+PL
escarduçárei-los	escarduçar+V.ele.ACC.3.M.PL+PQP+2+PL
escarduçárei-nos	escarduçar+nós.AD.1.PL+PQP+2+PL
escarduçáreis-lhe	escarduçar+V.ele.DAT.3.SG+PQP+2+PL
escarduçáreis-lhes	escarduçar+V.ele.DAT.3.PL+PQP+2+PL
escarduçáreis-me	escarduçar+V.eu.AD.1.SG+PQP+2+PL
escarduçáreis-te	escarduçar+V.tu.AD.2.SG+PQP+2+PL
escarduçáreis-vos	escarduçar+V.vós.AD.2.PL+PQP+2+PL
escarduçare-la	escarduçar+V.ele.ACC.3.F.SG+INF+2+SG
escarduçare-la	escarduçar+V.ele.ACC.3.F.SG+SBJF+2+SG
escarduçare-las	escarduçar+V.ele.ACC.3.F.PL+INF+2+SG
escarduçare-las	escarduçar+V.ele.ACC.3.F.PL+SBJF+2+SG
escarduçare-lo	escarduçar+V.ele.ACC.3.M.SG+INF+2+SG
escarduçare-lo	escarduçar+V.ele.ACC.3.M.SG+SBJF+2+SG
escarduçare-los	escarduçar+V.ele.ACC.3.M.PL+INF+2+SG
escarduçare-los	escarduçar+V.ele.ACC.3.M.PL+SBJF+2+SG
escarduçarem-lhe	escarduçar+V.ele.DAT.3.SG+INF+3+PL
escarduçarem-lhe	escarduçar+V.ele.DAT.3.SG+SBJF+3+PL
escarduçarem-lhes	escarduçar+V.ele.DAT.3.PL+INF+3+PL
escarduçarem-lhes	escarduçar+V.ele.DAT.3.PL+SBJF+3+PL
escarduçarem-me	escarduçar+V.eu.AD.1.SG+INF+3+PL
escarduçarem-me	escarduçar+V.eu.AD.1.SG+SBJF+3+PL
escarduçarem-na	escarduçar+V.ele.ACC.3.F.SG+INF+3+PL
escarduçarem-na	escarduçar+V.ele.ACC.3.F.SG+SBJF+3+PL
escarduçarem-nas	escarduçar+V.ele.ACC.3.F.PL+INF+3+PL
escarduçarem-nas	escarduçar+V.ele.ACC.3.F.PL+SBJF+3+PL
escarduçarem-no	escarduçar+V.ele.ACC.3.M.SG+INF+3+PL
escarduçarem-no	escarduçar+V.ele.ACC.3.M.SG+SBJF+3+PL
escarduçarem-nos	escarduçar+nós.AD.1.PL+INF+3+PL
escarduçarem-nos	escarduçar+nós.AD.1.PL+SBJF+3+PL
escarduçarem-se	escarduçar+V.ele.REFL+INF+3+PL
escarduçarem-se	escarduçar+V.ele.REFL+SBJF+3+PL
escarduçarem-te	escarduçar+V.tu.AD.2.SG+INF+3+PL
escarduçarem-te	escarduçar+V.tu.AD.2.SG+SBJF+3+PL
escarduçarem-vos	escarduçar+V.vós.AD.2.PL+INF+3+PL
escarduçarem-vos	escarduçar+V.vós.AD.2.PL+SBJF+3+PL
escarduçare-nos	escarduçar+nós.AD.1.PL+INF+2+SG
escarduçare-nos	escarduçar+nós.AD.1.PL+SBJF+2+SG
escarduçares-lhe	escarduçar+V.ele.DAT.3.SG+INF+2+SG
escarduçares-lhe	escarduçar+V.ele.DAT.3.SG+SBJF+2+SG
escarduçares-lhes	escarduçar+V.ele.DAT.3.PL+INF+2+SG
escarduçares-lhes	escarduçar+V.ele.DAT.3.PL+SBJF+2+SG
escarduçares-me	escarduçar+V.eu.AD.1.SG+INF+2+SG
escarduçares-me	escarduçar+V.eu.AD.1.SG+SBJF+2+SG
escarduçares-te	escarduçar+V.tu.AD.2.SG+INF+2+SG
escarduçares-te	escarduçar+V.tu.AD.2.SG+SBJF+2+SG
escarduçares-vos	escarduçar+V.vós.AD.2.PL+INF+2+SG
escarduçares-vos	escarduçar+V.vós.AD.2.PL+SBJF+2+SG
escarduçar-lhe-á	escarduçar+V.ele.DAT.3.SG+FUT+3+SG
escarduçar-lhe-ão	escarduçar+V.ele.DAT.3.SG+FUT+3+PL
escarduçar-lhe-ás	escarduçar+V.ele.DAT.3.SG+FUT+2+SG
escarduçar-lhe-ei	escarduçar+V.ele.DAT.3.SG+FUT+1+SG
escarduçar-lhe-eis	escarduçar+V.ele.DAT.3.SG+FUT+2+PL
escarduçar-lhe-emos	escarduçar+V.ele.DAT.3.SG+FUT+1+PL
escarduçar-lhe	escarduçar+V.ele.DAT.3.SG+INF
escarduçar-lhe	escarduçar+V.ele.DAT.3.SG+INF+1+SG
escarduçar-lhe	escarduçar+V.ele.DAT.3.SG+INF+3+SG
escarduçar-lhe	escarduçar+V.ele.DAT.3.SG+SBJF+1+SG
escarduçar-lhe	escarduçar+V.ele.DAT.3.SG+SBJF+3+SG
escarduçar-lhe-ia	escarduçar+V.ele.DAT.3.SG+COND+1+SG
escarduçar-lhe-ia	escarduçar+V.ele.DAT.3.SG+COND+3+SG
escarduçar-lhe-iam	escarduçar+V.ele.DAT.3.SG+COND+3+PL
escarduçar-lhe-íamos	escarduçar+V.ele.DAT.3.SG+COND+1+PL
escarduçar-lhe-ias	escarduçar+V.ele.DAT.3.SG+COND+2+SG
escarduçar-lhe-íeis	escarduçar+V.ele.DAT.3.SG+COND+2+PL
escarduçar-lhes-á	escarduçar+V.ele.DAT.3.PL+FUT+3+SG
escarduçar-lhes-ão	escarduçar+V.ele.DAT.3.PL+FUT+3+PL
escarduçar-lhes-ás	escarduçar+V.ele.DAT.3.PL+FUT+2+SG
escarduçar-lhes-ei	escarduçar+V.ele.DAT.3.PL+FUT+1+SG
escarduçar-lhes-eis	escarduçar+V.ele.DAT.3.PL+FUT+2+PL
escarduçar-lhes-emos	escarduçar+V.ele.DAT.3.PL+FUT+1+PL
escarduçar-lhes	escarduçar+V.ele.DAT.3.PL+INF
escarduçar-lhes	escarduçar+V.ele.DAT.3.PL+INF+1+SG
escarduçar-lhes	escarduçar+V.ele.DAT.3.PL+INF+3+SG
escarduçar-lhes	escarduçar+V.ele.DAT.3.PL+SBJF+1+SG
escarduçar-lhes	escarduçar+V.ele.DAT.3.PL+SBJF+3+SG
escarduçar-lhes-ia	escarduçar+V.ele.DAT.3.PL+COND+1+SG
escarduçar-lhes-ia	escarduçar+V.ele.DAT.3.PL+COND+3+SG
escarduçar-lhes-iam	escarduçar+V.ele.DAT.3.PL+COND+3+PL
escarduçar-lhes-íamos	escarduçar+V.ele.DAT.3.PL+COND+1+PL
escarduçar-lhes-ias	escarduçar+V.ele.DAT.3.PL+COND+2+SG
escarduçar-lhes-íeis	escarduçar+V.ele.DAT.3.PL+COND+2+PL
escarduçar-me-á	escarduçar+V.eu.AD.1.SG+FUT+3+SG
escarduçar-me-ão	escarduçar+V.eu.AD.1.SG+FUT+3+PL
escarduçar-me-ás	escarduçar+V.eu.AD.1.SG+FUT+2+SG
escarduçar-me-ei	escarduçar+V.eu.AD.1.SG+FUT+1+SG
escarduçar-me-eis	escarduçar+V.eu.AD.1.SG+FUT+2+PL
escarduçar-me-emos	escarduçar+V.eu.AD.1.SG+FUT+1+PL
escarduçar-me	escarduçar+V.eu.AD.1.SG+INF
escarduçar-me	escarduçar+V.eu.AD.1.SG+INF+1+SG
escarduçar-me	escarduçar+V.eu.AD.1.SG+INF+3+SG
escarduçar-me	escarduçar+V.eu.AD.1.SG+SBJF+1+SG
escarduçar-me	escarduçar+V.eu.AD.1.SG+SBJF+3+SG
escarduçar-me-ia	escarduçar+V.eu.AD.1.SG+COND+1+SG
escarduçar-me-ia	escarduçar+V.eu.AD.1.SG+COND+3+SG
escarduçar-me-iam	escarduçar+V.eu.AD.1.SG+COND+3+PL
escarduçar-me-íamos	escarduçar+V.eu.AD.1.SG+COND+1+PL
escarduçar-me-ias	escarduçar+V.eu.AD.1.SG+COND+2+SG
escarduçar-me-íeis	escarduçar+V.eu.AD.1.SG+COND+2+PL
escarduçarmo-la	escarduçar+V.ele.ACC.3.F.SG+INF+1+PL
escarduçarmo-la	escarduçar+V.ele.ACC.3.F.SG+SBJF+1+PL
escarduçarmo-las	escarduçar+V.ele.ACC.3.F.PL+INF+1+PL
escarduçarmo-las	escarduçar+V.ele.ACC.3.F.PL+SBJF+1+PL
escarduçarmo-lo	escarduçar+V.ele.ACC.3.M.SG+INF+1+PL
escarduçarmo-lo	escarduçar+V.ele.ACC.3.M.SG+SBJF+1+PL
escarduçarmo-los	escarduçar+V.ele.ACC.3.M.PL+INF+1+PL
escarduçarmo-los	escarduçar+V.ele.ACC.3.M.PL+SBJF+1+PL
escarduçarmo-nos	escarduçar+nós.AD.1.PL+INF+1+PL
escarduçarmo-nos	escarduçar+nós.AD.1.PL+SBJF+1+PL
escarduçarmos-lhe	escarduçar+V.ele.DAT.3.SG+INF+1+PL
escarduçarmos-lhe	escarduçar+V.ele.DAT.3.SG+SBJF+1+PL
escarduçarmos-lhes	escarduçar+V.ele.DAT.3.PL+INF+1+PL
escarduçarmos-lhes	escarduçar+V.ele.DAT.3.PL+SBJF+1+PL
escarduçarmos-me	escarduçar+V.eu.AD.1.SG+INF+1+PL
escarduçarmos-me	escarduçar+V.eu.AD.1.SG+SBJF+1+PL
escarduçarmos-te	escarduçar+V.tu.AD.2.SG+INF+1+PL
escarduçarmos-te	escarduçar+V.tu.AD.2.SG+SBJF+1+PL
escarduçarmos-vos	escarduçar+V.vós.AD.2.PL+INF+1+PL
escarduçarmos-vos	escarduçar+V.vós.AD.2.PL+SBJF+1+PL
escarduçar-nos-á	escarduçar+nós.AD.1.PL+FUT+3+SG
escarduçar-nos-ão	escarduçar+nós.AD.1.PL+FUT+3+PL
escarduçar-nos-ás	escarduçar+nós.AD.1.PL+FUT+2+SG
escarduçar-nos-ei	escarduçar+nós.AD.1.PL+FUT+1+SG
escarduçar-nos-eis	escarduçar+nós.AD.1.PL+FUT+2+PL
escarduçar-nos-emos	escarduçar+nós.AD.1.PL+FUT+1+PL
escarduçar-nos	escarduçar+nós.AD.1.PL+INF
escarduçar-nos	escarduçar+nós.AD.1.PL+INF+1+SG
escarduçar-nos	escarduçar+nós.AD.1.PL+INF+3+SG
escarduçar-nos	escarduçar+nós.AD.1.PL+SBJF+1+SG
escarduçar-nos	escarduçar+nós.AD.1.PL+SBJF+3+SG
escarduçar-nos-ia	escarduçar+nós.AD.1.PL+COND+1+SG
escarduçar-nos-ia	escarduçar+nós.AD.1.PL+COND+3+SG
escarduçar-nos-iam	escarduçar+nós.AD.1.PL+COND+3+PL
escarduçar-nos-íamos	escarduçar+nós.AD.1.PL+COND+1+PL
escarduçar-nos-ias	escarduçar+nós.AD.1.PL+COND+2+SG
escarduçar-nos-íeis	escarduçar+nós.AD.1.PL+COND+2+PL
escarduçar-se-á	escarduçar+V.ele.REFL+FUT+3+SG
escarduçar-se-ão	escarduçar+V.ele.REFL+FUT+3+PL
escarduçar-se	escarduçar+V.ele.REFL+INF
escarduçar-se	escarduçar+V.ele.REFL+INF+3+SG
escarduçar-se	escarduçar+V.ele.REFL+SBJF+3+SG
escarduçar-se-ia	escarduçar+V.ele.REFL+COND+3+SG
escarduçar-se-iam	escarduçar+V.ele.REFL+COND+3+PL
escarduçar-te-á	escarduçar+V.tu.AD.2.SG+FUT+3+SG
escarduçar-te-ão	escarduçar+V.tu.AD.2.SG+FUT+3+PL
escarduçar-te-ás	escarduçar+V.tu.AD.2.SG+FUT+2+SG
escarduçar-te-ei	escarduçar+V.tu.AD.2.SG+FUT+1+SG
escarduçar-te-eis	escarduçar+V.tu.AD.2.SG+FUT+2+PL
escarduçar-te-emos	escarduçar+V.tu.AD.2.SG+FUT+1+PL
escarduçar-te	escarduçar+V.tu.AD.2.SG+INF
escarduçar-te	escarduçar+V.tu.AD.2.SG+INF+1+SG
escarduçar-te	escarduçar+V.tu.AD.2.SG+INF+3+SG
escarduçar-te	escarduçar+V.tu.AD.2.SG+SBJF+1+SG
escarduçar-te	escarduçar+V.tu.AD.2.SG+SBJF+3+SG
escarduçar-te-ia	escarduçar+V.tu.AD.2.SG+COND+1+SG
escarduçar-te-ia	escarduçar+V.tu.AD.2.SG+COND+3+SG
escarduçar-te-iam	escarduçar+V.tu.AD.2.SG+COND+3+PL
escarduçar-te-íamos	escarduçar+V.tu.AD.2.SG+COND+1+PL
escarduçar-te-ias	escarduçar+V.tu.AD.2.SG+COND+2+SG
escarduçar-te-íeis	escarduçar+V.tu.AD.2.SG+COND+2+PL
escarduçar-vos-á	escarduçar+V.vós.AD.2.PL+FUT+3+SG
escarduçar-vos-ão	escarduçar+V.vós.AD.2.PL+FUT+3+PL
escarduçar-vos-ás	escarduçar+V.vós.AD.2.PL+FUT+2+SG
escarduçar-vos-ei	escarduçar+V.vós.AD.2.PL+FUT+1+SG
escarduçar-vos-eis	escarduçar+V.vós.AD.2.PL+FUT+2+PL
escarduçar-vos-emos	escarduçar+V.vós.AD.2.PL+FUT+1+PL
escarduçar-vos	escarduçar+V.vós.AD.2.PL+INF
escarduçar-vos	escarduçar+V.vós.AD.2.PL+INF+1+SG
escarduçar-vos	escarduçar+V.vós.AD.2.PL+INF+3+SG
escarduçar-vos	escarduçar+V.vós.AD.2.PL+SBJF+1+SG
escarduçar-vos	escarduçar+V.vós.AD.2.PL+SBJF+3+SG
escarduçar-vos-ia	escarduçar+V.vós.AD.2.PL+COND+1+SG
escarduçar-vos-ia	escarduçar+V.vós.AD.2.PL+COND+3+SG
escarduçar-vos-iam	escarduçar+V.vós.AD.2.PL+COND+3+PL
escarduçar-vos-íamos	escarduçar+V.vós.AD.2.PL+COND+1+PL
escarduçar-vos-ias	escarduçar+V.vós.AD.2.PL+COND+2+SG
escarduçar-vos-íeis	escarduçar+V.vós.AD.2.PL+COND+2+PL
escarduça-se	escarduçar+V.ele.REFL+PRS+3+SG
escarduças-lhe	escarduçar+V.ele.DAT.3.SG+PRS+2+SG
escarduças-lhes	escarduçar+V.ele.DAT.3.PL+PRS+2+SG
escarduças-me	escarduçar+V.eu.AD.1.SG+PRS+2+SG
escarduças-te	escarduçar+V.tu.AD.2.SG+PRS+2+SG
escarduçaste-la	escarduçar+V.ele.ACC.3.F.SG+PRF+2+PL
escarduçaste-las	escarduçar+V.ele.ACC.3.F.PL+PRF+2+PL
escarduçaste-lo	escarduçar+V.ele.ACC.3.M.SG+PRF+2+PL
escarduçaste-los	escarduçar+V.ele.ACC.3.M.PL+PRF+2+PL
escarduçaste-nos	escarduçar+nós.AD.1.PL+PRF+2+PL
escarduçastes-lhe	escarduçar+V.ele.DAT.3.SG+PRF+2+PL
escarduçastes-lhes	escarduçar+V.ele.DAT.3.PL+PRF+2+PL
escarduçastes-me	escarduçar+V.eu.AD.1.SG+PRF+2+PL
escarduçastes-te	escarduçar+V.tu.AD.2.SG+PRF+2+PL
escarduçastes-vos	escarduçar+V.vós.AD.2.PL+PRF+2+PL
escarduças-vos	escarduçar+V.vós.AD.2.PL+PRS+2+SG
escarduça-te	escarduçar+V.tu.AD.2.SG+PRS+3+SG
escarduçava-a	escarduçar+V.ele.ACC.3.F.SG+IMPF+1+SG
escarduçava-a	escarduçar+V.ele.ACC.3.F.SG+IMPF+3+SG
escarduçava-as	escarduçar+V.ele.ACC.3.F.PL+IMPF+1+SG
escarduçava-as	escarduçar+V.ele.ACC.3.F.PL+IMPF+3+SG
escarduçava-la	escarduçar+V.ele.ACC.3.F.SG+IMPF+2+SG
escarduçava-las	escarduçar+V.ele.ACC.3.F.PL+IMPF+2+SG
escarduçava-lhe	escarduçar+V.ele.DAT.3.SG+IMPF+1+SG
escarduçava-lhe	escarduçar+V.ele.DAT.3.SG+IMPF+3+SG
escarduçava-lhes	escarduçar+V.ele.DAT.3.PL+IMPF+1+SG
escarduçava-lhes	escarduçar+V.ele.DAT.3.PL+IMPF+3+SG
escarduçava-lo	escarduçar+V.ele.ACC.3.M.SG+IMPF+2+SG
escarduçava-los	escarduçar+V.ele.ACC.3.M.PL+IMPF+2+SG
escarduçava-me	escarduçar+V.eu.AD.1.SG+IMPF+1+SG
escarduçava-me	escarduçar+V.eu.AD.1.SG+IMPF+3+SG
escarduçavam-lhe	escarduçar+V.ele.DAT.3.SG+IMPF+3+PL
escarduçavam-lhes	escarduçar+V.ele.DAT.3.PL+IMPF+3+PL
escarduçavam-me	escarduçar+V.eu.AD.1.SG+IMPF+3+PL
escarduçavam-na	escarduçar+V.ele.ACC.3.F.SG+IMPF+3+PL
escarduçavam-nas	escarduçar+V.ele.ACC.3.F.PL+IMPF+3+PL
escarduçavam-no	escarduçar+V.ele.ACC.3.M.SG+IMPF+3+PL
escarduçavam-nos	escarduçar+nós.AD.1.PL+IMPF+3+PL
escarduçávamo-la	escarduçar+V.ele.ACC.3.F.SG+IMPF+1+PL
escarduçávamo-las	escarduçar+V.ele.ACC.3.F.PL+IMPF+1+PL
escarduçávamo-lo	escarduçar+V.ele.ACC.3.M.SG+IMPF+1+PL
escarduçávamo-los	escarduçar+V.ele.ACC.3.M.PL+IMPF+1+PL
escarduçávamo-nos	escarduçar+nós.AD.1.PL+IMPF+1+PL
escarduçávamos-lhe	escarduçar+V.ele.DAT.3.SG+IMPF+1+PL
escarduçávamos-lhes	escarduçar+V.ele.DAT.3.PL+IMPF+1+PL
escarduçávamos-me	escarduçar+V.eu.AD.1.SG+IMPF+1+PL
escarduçávamos-te	escarduçar+V.tu.AD.2.SG+IMPF+1+PL
escarduçávamos-vos	escarduçar+V.vós.AD.2.PL+IMPF+1+PL
escarduçavam-se	escarduçar+V.ele.REFL+IMPF+3+PL
escarduçavam-te	escarduçar+V.tu.AD.2.SG+IMPF+3+PL
escarduçavam-vos	escarduçar+V.vós.AD.2.PL+IMPF+3+PL
escarduçava-nos	escarduçar+nós.AD.1.PL+IMPF+1+SG
escarduçava-nos	escarduçar+nós.AD.1.PL+IMPF+2+SG
escarduçava-nos	escarduçar+nós.AD.1.PL+IMPF+3+SG
escarduçava-o	escarduçar+V.ele.ACC.3.M.SG+IMPF+1+SG
escarduçava-o	escarduçar+V.ele.ACC.3.M.SG+IMPF+3+SG
escarduçava-os	escarduçar+V.ele.ACC.3.M.PL+IMPF+1+SG
escarduçava-os	escarduçar+V.ele.ACC.3.M.PL+IMPF+3+SG
escarduçava-se	escarduçar+V.ele.REFL+IMPF+1+SG
escarduçava-se	escarduçar+V.ele.REFL+IMPF+3+SG
escarduçavas-lhe	escarduçar+V.ele.DAT.3.SG+IMPF+2+SG
escarduçavas-lhes	escarduçar+V.ele.DAT.3.PL+IMPF+2+SG
escarduçavas-me	escarduçar+V.eu.AD.1.SG+IMPF+2+SG
escarduçavas-te	escarduçar+V.tu.AD.2.SG+IMPF+2+SG
escarduçavas-vos	escarduçar+V.vós.AD.2.PL+IMPF+2+SG
escarduçava-te	escarduçar+V.tu.AD.2.SG+IMPF+1+SG
escarduçava-te	escarduçar+V.tu.AD.2.SG+IMPF+3+SG
escarduçava-vos	escarduçar+V.vós.AD.2.PL+IMPF+1+SG
escarduçava-vos	escarduçar+V.vós.AD.2.PL+IMPF+3+SG
escarduçávei-la	escarduçar+V.ele.ACC.3.F.SG+IMPF+2+PL
escarduçávei-las	escarduçar+V.ele.ACC.3.F.PL+IMPF+2+PL
escarduçávei-lo	escarduçar+V.ele.ACC.3.M.SG+IMPF+2+PL
escarduçávei-los	escarduçar+V.ele.ACC.3.M.PL+IMPF+2+PL
escarduçávei-nos	escarduçar+nós.AD.1.PL+IMPF+2+PL
escarduçáveis-lhe	escarduçar+V.ele.DAT.3.SG+IMPF+2+PL
escarduçáveis-lhes	escarduçar+V.ele.DAT.3.PL+IMPF+2+PL
escarduçáveis-me	escarduçar+V.eu.AD.1.SG+IMPF+2+PL
escarduçáveis-te	escarduçar+V.tu.AD.2.SG+IMPF+2+PL
escarduçáveis-vos	escarduçar+V.vós.AD.2.PL+IMPF+2+PL
escarduça-vos	escarduçar+V.vós.AD.2.PL+PRS+3+SG
escarduce-a	escarduçar+V.ele.ACC.3.F.SG+IMP+3+SG
escarduce-as	escarduçar+V.ele.ACC.3.F.PL+IMP+3+SG
escarducei-a	escarduçar+V.ele.ACC.3.F.SG+PRF+1+SG
escarducei-as	escarduçar+V.ele.ACC.3.F.PL+PRF+1+SG
escarducei-lhe	escarduçar+V.ele.DAT.3.SG+PRF+1+SG
escarducei-lhes	escarduçar+V.ele.DAT.3.PL+PRF+1+SG
escarducei-me	escarduçar+V.eu.AD.1.SG+PRF+1+SG
escarducei-nos	escarduçar+nós.AD.1.PL+PRF+1+SG
escarducei-o	escarduçar+V.ele.ACC.3.M.SG+PRF+1+SG
escarducei-os	escarduçar+V.ele.ACC.3.M.PL+PRF+1+SG
escarducei-te	escarduçar+V.tu.AD.2.SG+PRF+1+SG
escarducei-vos	escarduçar+V.vós.AD.2.PL+PRF+1+SG
escarduce-lhe	escarduçar+V.ele.DAT.3.SG+IMP+3+SG
escarduce-lhes	escarduçar+V.ele.DAT.3.PL+IMP+3+SG
escarduce-me	escarduçar+V.eu.AD.1.SG+IMP+3+SG
escarducem-lhe	escarduçar+V.ele.DAT.3.SG+IMP+3+PL
escarducem-lhes	escarduçar+V.ele.DAT.3.PL+IMP+3+PL
escarducem-me	escarduçar+V.eu.AD.1.SG+IMP+3+PL
escarducem-na	escarduçar+V.ele.ACC.3.F.SG+IMP+3+PL
escarducem-nas	escarduçar+V.ele.ACC.3.F.PL+IMP+3+PL
escarducem-no	escarduçar+V.ele.ACC.3.M.SG+IMP+3+PL
escarducem-nos	escarduçar+V.ele.ACC.3.M.PL+IMP+3+PL
escarducem-nos	escarduçar+V.nós.AD.1.PL+IMP+3+PL
escarducemo-la	escarduçar+V.ele.ACC.3.F.SG+IMP+1+PL
escarducemo-las	escarduçar+V.ele.ACC.3.F.PL+IMP+1+PL
escarducemo-lo	escarduçar+V.ele.ACC.3.M.SG+IMP+1+PL
escarducemo-los	escarduçar+V.ele.ACC.3.M.PL+IMP+1+PL
escarducemo-nos	escarduçar+nós.AD.1.PL+IMP+1+PL
escarducemos-lhe	escarduçar+V.ele.DAT.3.SG+IMP+1+PL
escarducemos-lhes	escarduçar+V.ele.DAT.3.PL+IMP+1+PL
escarducemos-me	escarduçar+V.eu.AD.1.SG+IMP+1+PL
escarducemos-te	escarduçar+V.tu.AD.2.SG+IMP+1+PL
escarducemos-vos	escarduçar+V.vós.AD.2.PL+IMP+1+PL
escarducem-se	escarduçar+V.ele.REFL+IMP+3+PL
escarducem-te	escarduçar+V.tu.AD.2.SG+IMP+3+PL
escarducem-vos	escarduçar+V.vós.AD.2.PL+IMP+3+PL
escarduce-nos	escarduçar+nós.AD.1.PL+IMP+3+SG
escarduce-o	escarduçar+V.ele.ACC.3.M.SG+IMP+3+SG
escarduce-os	escarduçar+V.ele.ACC.3.M.PL+IMP+3+SG
escarduce-se	escarduçar+V.ele.REFL+IMP+3+SG
escarduce-te	escarduçar+V.tu.AD.2.SG+IMP+3+SG
escarduce-vos	escarduçar+V.vós.AD.2.PL+IMP+3+SG
escarduço-a	escarduçar+V.ele.ACC.3.F.SG+PRS+1+SG
escarduço-as	escarduçar+V.ele.ACC.3.F.PL+PRS+1+SG
escarduço-lhe	escarduçar+V.ele.DAT.3.SG+PRS+1+SG
escarduço-lhes	escarduçar+V.ele.DAT.3.PL+PRS+1+SG
escarduço-me	escarduçar+V.eu.AD.1.SG+PRS+1+SG
escarduço-nos	escarduçar+nós.AD.1.PL+PRS+1+SG
escarduço-o	escarduçar+V.ele.ACC.3.M.SG+PRS+1+SG
escarduço-os	escarduçar+V.ele.ACC.3.M.PL+PRS+1+SG
escarduço-te	escarduçar+V.tu.AD.2.SG+PRS+1+SG
escarduçou-a	escarduçar+V.ele.ACC.3.F.SG+PRF+3+SG
escarduçou-as	escarduçar+V.ele.ACC.3.F.PL+PRF+3+SG
escarduçou-lhe	escarduçar+V.ele.DAT.3.SG+PRF+3+SG
escarduçou-lhes	escarduçar+V.ele.DAT.3.PL+PRF+3+SG
escarduçou-me	escarduçar+V.eu.AD.1.SG+PRF+3+SG
escarduçou-nos	escarduçar+nós.AD.1.PL+PRF+3+SG
escarduçou-o	escarduçar+V.ele.ACC.3.M.SG+PRF+3+SG
escarduçou-os	escarduçar+V.ele.ACC.3.M.PL+PRF+3+SG
escarduçou-se	escarduçar+V.ele.REFL+PRF+3+SG
escarduçou-te	escarduçar+V.tu.AD.2.SG+PRF+3+SG
escarduçou-vos	escarduçar+V.vós.AD.2.PL+PRF+3+SG
escarduço-vos	escarduçar+V.vós.AD.2.PL+PRS+1+SG
escareai-la	escarear+V.ele.ACC.3.F.SG+PRS+2+PL
escareai-las	escarear+V.ele.ACC.3.F.PL+PRS+2+PL
escareai-lo	escarear+V.ele.ACC.3.M.SG+PRS+2+PL
escareai-los	escarear+V.ele.ACC.3.M.PL+PRS+2+PL
escareai-nos	escarear+nós.AD.1.PL+PRS+2+PL
escareais-lhe	escarear+V.ele.DAT.3.SG+PRS+2+PL
escareais-lhes	escarear+V.ele.DAT.3.PL+PRS+2+PL
escareais-me	escarear+V.eu.AD.1.SG+PRS+2+PL
escareais-te	escarear+V.tu.AD.2.SG+PRS+2+PL
escareais-vos	escarear+V.vós.AD.2.PL+PRS+2+PL
escareá-la-á	escarear+V.ele.ACC.3.F.SG+FUT+3+SG
escareá-la-ão	escarear+V.ele.ACC.3.F.SG+FUT+3+PL
escareá-la-ás	escarear+V.ele.ACC.3.F.SG+FUT+2+SG
escareá-la-ei	escarear+V.ele.ACC.3.F.SG+FUT+1+SG
escareá-la-eis	escarear+V.ele.ACC.3.F.SG+FUT+2+PL
escareá-la-emos	escarear+V.ele.ACC.3.F.SG+FUT+1+PL
escareá-la	escarear+V.ele.ACC.3.F.SG+INF+1+SG
escareá-la	escarear+V.ele.ACC.3.F.SG+INF+3+SG
escareá-la	escarear+V.ele.ACC.3.F.SG+SBJF+1+SG
escareá-la	escarear+V.ele.ACC.3.F.SG+SBJF+3+SG
escareá-la-ia	escarear+V.ele.ACC.3.F.SG+COND+1+SG
escareá-la-ia	escarear+V.ele.ACC.3.F.SG+COND+3+SG
escareá-la-iam	escarear+V.ele.ACC.3.F.SG+COND+3+PL
escareá-la-íamos	escarear+V.ele.ACC.3.F.SG+COND+1+PL
escareá-la-ias	escarear+V.ele.ACC.3.F.SG+COND+2+SG
escareá-la-íeis	escarear+V.ele.ACC.3.F.SG+COND+2+PL
escareá-las-á	escarear+V.ele.ACC.3.F.PL+FUT+3+SG
escareá-las-ão	escarear+V.ele.ACC.3.F.PL+FUT+3+PL
escareá-las-ás	escarear+V.ele.ACC.3.F.PL+FUT+2+SG
escareá-las-ei	escarear+V.ele.ACC.3.F.PL+FUT+1+SG
escareá-las-eis	escarear+V.ele.ACC.3.F.PL+FUT+2+PL
escareá-las-emos	escarear+V.ele.ACC.3.F.PL+FUT+1+PL
escareá-las	escarear+V.ele.ACC.3.F.PL+INF+1+SG
escareá-las	escarear+V.ele.ACC.3.F.PL+INF+3+SG
escareá-las	escarear+V.ele.ACC.3.F.PL+SBJF+1+SG
escareá-las	escarear+V.ele.ACC.3.F.PL+SBJF+3+SG
escareá-las-ia	escarear+V.ele.ACC.3.F.PL+COND+1+SG
escareá-las-ia	escarear+V.ele.ACC.3.F.PL+COND+3+SG
escareá-las-iam	escarear+V.ele.ACC.3.F.PL+COND+3+PL
escareá-las-íamos	escarear+V.ele.ACC.3.F.PL+COND+1+PL
escareá-las-ias	escarear+V.ele.ACC.3.F.PL+COND+2+SG
escareá-las-íeis	escarear+V.ele.ACC.3.F.PL+COND+2+PL
escareá-lo-á	escarear+V.ele.ACC.3.M.SG+FUT+3+SG
escareá-lo-ão	escarear+V.ele.ACC.3.M.SG+FUT+3+PL
escareá-lo-ás	escarear+V.ele.ACC.3.M.SG+FUT+2+SG
escareá-lo-ei	escarear+V.ele.ACC.3.M.SG+FUT+1+SG
escareá-lo-eis	escarear+V.ele.ACC.3.M.SG+FUT+2+PL
escareá-lo-emos	escarear+V.ele.ACC.3.M.SG+FUT+1+PL
escareá-lo	escarear+V.ele.ACC.3.M.SG+INF+1+SG
escareá-lo	escarear+V.ele.ACC.3.M.SG+INF+3+SG
escareá-lo	escarear+V.ele.ACC.3.M.SG+SBJF+1+SG
escareá-lo	escarear+V.ele.ACC.3.M.SG+SBJF+3+SG
escareá-lo-ia	escarear+V.ele.ACC.3.M.SG+COND+1+SG
escareá-lo-ia	escarear+V.ele.ACC.3.M.SG+COND+3+SG
escareá-lo-iam	escarear+V.ele.ACC.3.M.SG+COND+3+PL
escareá-lo-íamos	escarear+V.ele.ACC.3.M.SG+COND+1+PL
escareá-lo-ias	escarear+V.ele.ACC.3.M.SG+COND+2+SG
escareá-lo-íeis	escarear+V.ele.ACC.3.M.SG+COND+2+PL
escareá-los-á	escarear+V.ele.ACC.3.M.PL+FUT+3+SG
escareá-los-ão	escarear+V.ele.ACC.3.M.PL+FUT+3+PL
escareá-los-ás	escarear+V.ele.ACC.3.M.PL+FUT+2+SG
escareá-los-ei	escarear+V.ele.ACC.3.M.PL+FUT+1+SG
escareá-los-eis	escarear+V.ele.ACC.3.M.PL+FUT+2+PL
escareá-los-emos	escarear+V.ele.ACC.3.M.PL+FUT+1+PL
escareá-los	escarear+V.ele.ACC.3.M.PL+INF+1+SG
escareá-los	escarear+V.ele.ACC.3.M.PL+INF+3+SG
escareá-los	escarear+V.ele.ACC.3.M.PL+SBJF+1+SG
escareá-los	escarear+V.ele.ACC.3.M.PL+SBJF+3+SG
escareá-los-ia	escarear+V.ele.ACC.3.M.PL+COND+1+SG
escareá-los-ia	escarear+V.ele.ACC.3.M.PL+COND+3+SG
escareá-los-iam	escarear+V.ele.ACC.3.M.PL+COND+3+PL
escareá-los-íamos	escarear+V.ele.ACC.3.M.PL+COND+1+PL
escareá-los-ias	escarear+V.ele.ACC.3.M.PL+COND+2+SG
escareá-los-íeis	escarear+V.ele.ACC.3.M.PL+COND+2+PL
escareamo-la	escarear+V.ele.ACC.3.F.SG+PRF+1+PL
escareamo-la	escarear+V.ele.ACC.3.F.SG+PRS+1+PL
escareamo-las	escarear+V.ele.ACC.3.F.PL+PRF+1+PL
escareamo-las	escarear+V.ele.ACC.3.F.PL+PRS+1+PL
escareamo-lo	escarear+V.ele.ACC.3.M.SG+PRF+1+PL
escareamo-lo	escarear+V.ele.ACC.3.M.SG+PRS+1+PL
escareamo-los	escarear+V.ele.ACC.3.M.PL+PRF+1+PL
escareamo-los	escarear+V.ele.ACC.3.M.PL+PRS+1+PL
escareamo-nos	escarear+nós.AD.1.PL+PRF+1+PL
escareamo-nos	escarear+nós.AD.1.PL+PRS+1+PL
escareamos-lhe	escarear+V.ele.DAT.3.SG+PRF+1+PL
escareamos-lhe	escarear+V.ele.DAT.3.SG+PRS+1+PL
escareamos-lhes	escarear+V.ele.DAT.3.PL+PRF+1+PL
escareamos-lhes	escarear+V.ele.DAT.3.PL+PRS+1+PL
escareamos-me	escarear+V.eu.AD.1.SG+PRF+1+PL
escareamos-me	escarear+V.eu.AD.1.SG+PRS+1+PL
escareamos-te	escarear+V.tu.AD.2.SG+PRF+1+PL
escareamos-te	escarear+V.tu.AD.2.SG+PRS+1+PL
escareamos-vos	escarear+V.vós.AD.2.PL+PRF+1+PL
escareamos-vos	escarear+V.vós.AD.2.PL+PRS+1+PL
escareando-a	escarear+V.ele.ACC.3.F.SG+GRD
escareando-as	escarear+V.ele.ACC.3.F.PL+GRD
escareando-lhe	escarear+V.ele.DAT.3.SG+GRD
escareando-lhes	escarear+V.ele.DAT.3.PL+GRD
escareando-me	escarear+V.eu.AD.1.SG+GRD
escareando-nos	escarear+nós.AD.1.PL+GRD
escareando-o	escarear+V.ele.ACC.3.M.SG+GRD
escareando-os	escarear+V.ele.ACC.3.M.PL+GRD
escareando-se	escarear+V.ele.REFL+GRD
escareando-te	escarear+V.tu.AD.2.SG+GRD
escareando-vos	escarear+V.vós.AD.2.PL+GRD
escareara-a	escarear+V.ele.ACC.3.F.SG+PQP+1+SG
escareara-a	escarear+V.ele.ACC.3.F.SG+PQP+3+SG
escareara-as	escarear+V.ele.ACC.3.F.PL+PQP+1+SG
escareara-as	escarear+V.ele.ACC.3.F.PL+PQP+3+SG
escareara-la	escarear+V.ele.ACC.3.F.SG+PQP+2+SG
escareara-las	escarear+V.ele.ACC.3.F.PL+PQP+2+SG
escareara-lhe	escarear+V.ele.DAT.3.SG+PQP+1+SG
escareara-lhe	escarear+V.ele.DAT.3.SG+PQP+3+SG
escareara-lhes	escarear+V.ele.DAT.3.PL+PQP+1+SG
escareara-lhes	escarear+V.ele.DAT.3.PL+PQP+3+SG
escareara-lo	escarear+V.ele.ACC.3.M.SG+PQP+2+SG
escareara-los	escarear+V.ele.ACC.3.M.PL+PQP+2+SG
escareara-me	escarear+V.eu.AD.1.SG+PQP+1+SG
escareara-me	escarear+V.eu.AD.1.SG+PQP+3+SG
escarearam-lhe	escarear+V.ele.DAT.3.SG+PQP+3+PL
escarearam-lhe	escarear+V.ele.DAT.3.SG+PRF+3+PL
escarearam-lhes	escarear+V.ele.DAT.3.PL+PQP+3+PL
escarearam-lhes	escarear+V.ele.DAT.3.PL+PRF+3+PL
escarearam-me	escarear+V.eu.AD.1.SG+PQP+3+PL
escarearam-me	escarear+V.eu.AD.1.SG+PRF+3+PL
escarearam-na	escarear+V.ele.ACC.3.F.SG+PQP+3+PL
escarearam-na	escarear+V.ele.ACC.3.F.SG+PRF+3+PL
escarearam-nas	escarear+V.ele.ACC.3.F.PL+PQP+3+PL
escarearam-nas	escarear+V.ele.ACC.3.F.PL+PRF+3+PL
escarearam-no	escarear+V.ele.ACC.3.M.SG+PQP+3+PL
escarearam-no	escarear+V.ele.ACC.3.M.SG+PRF+3+PL
escarearam-nos	escarear+V.ele.ACC.3.M.PL+PQP+3+PL
escarearam-nos	escarear+V.ele.ACC.3.M.PL+PRF+3+PL
escarearam-nos	escarear+V.nós.AD.1.PL+PQP+3+PL
escarearam-nos	escarear+V.nós.AD.1.PL+PRF+3+PL
escareáramo-la	escarear+V.ele.ACC.3.F.SG+PQP+1+PL
escareáramo-las	escarear+V.ele.ACC.3.F.PL+PQP+1+PL
escareáramo-lo	escarear+V.ele.ACC.3.M.SG+PQP+1+PL
escareáramo-los	escarear+V.ele.ACC.3.M.PL+PQP+1+PL
escareáramo-nos	escarear+nós.AD.1.PL+PQP+1+PL
escareáramos-lhe	escarear+V.ele.DAT.3.SG+PQP+1+PL
escareáramos-lhes	escarear+V.ele.DAT.3.PL+PQP+1+PL
escareáramos-me	escarear+V.eu.AD.1.SG+PQP+1+PL
escareáramos-te	escarear+V.tu.AD.2.SG+PQP+1+PL
escareáramos-vos	escarear+V.vós.AD.2.PL+PQP+1+PL
escarearam-se	escarear+V.ele.REFL+PQP+3+PL
escarearam-se	escarear+V.ele.REFL+PRF+3+PL
escarearam-te	escarear+V.tu.AD.2.SG+PQP+3+PL
escarearam-te	escarear+V.tu.AD.2.SG+PRF+3+PL
escarearam-vos	escarear+V.vós.AD.2.PL+PQP+3+PL
escarearam-vos	escarear+V.vós.AD.2.PL+PRF+3+PL
escareara-nos	escarear+nós.AD.1.PL+PQP+1+SG
escareara-nos	escarear+nós.AD.1.PL+PQP+2+SG
escareara-nos	escarear+nós.AD.1.PL+PQP+3+SG
escareara-o	escarear+V.ele.ACC.3.M.SG+PQP+1+SG
escareara-o	escarear+V.ele.ACC.3.M.SG+PQP+3+SG
escareara-os	escarear+V.ele.ACC.3.M.PL+PQP+1+SG
escareara-os	escarear+V.ele.ACC.3.M.PL+PQP+3+SG
escareara-se	escarear+V.ele.REFL+PQP+1+SG
escareara-se	escarear+V.ele.REFL+PQP+3+SG
escarearas-lhe	escarear+V.ele.DAT.3.SG+PQP+2+SG
escarearas-lhes	escarear+V.ele.DAT.3.PL+PQP+2+SG
escarearas-me	escarear+V.eu.AD.1.SG+PQP+2+SG
escarearas-te	escarear+V.tu.AD.2.SG+PQP+2+SG
escarearas-vos	escarear+V.vós.AD.2.PL+PQP+2+SG
escareara-te	escarear+V.tu.AD.2.SG+PQP+1+SG
escareara-te	escarear+V.tu.AD.2.SG+PQP+3+SG
escareara-vos	escarear+V.vós.AD.2.PL+PQP+1+SG
escareara-vos	escarear+V.vós.AD.2.PL+PQP+3+SG
escarearde-la	escarear+V.ele.ACC.3.F.SG+INF+2+PL
escarearde-la	escarear+V.ele.ACC.3.F.SG+SBJF+2+PL
escarearde-las	escarear+V.ele.ACC.3.F.PL+INF+2+PL
escarearde-las	escarear+V.ele.ACC.3.F.PL+SBJF+2+PL
escarearde-lo	escarear+V.ele.ACC.3.M.SG+INF+2+PL
escarearde-lo	escarear+V.ele.ACC.3.M.SG+SBJF+2+PL
escarearde-los	escarear+V.ele.ACC.3.M.PL+INF+2+PL
escarearde-los	escarear+V.ele.ACC.3.M.PL+SBJF+2+PL
escarearde-nos	escarear+nós.AD.1.PL+INF+2+PL
escarearde-nos	escarear+nós.AD.1.PL+SBJF+2+PL
escareardes-lhe	escarear+V.ele.DAT.3.SG+INF+2+PL
escareardes-lhe	escarear+V.ele.DAT.3.SG+SBJF+2+PL
escareardes-lhes	escarear+V.ele.DAT.3.PL+INF+2+PL
escareardes-lhes	escarear+V.ele.DAT.3.PL+SBJF+2+PL
escareardes-me	escarear+V.eu.AD.1.SG+INF+2+PL
escareardes-me	escarear+V.eu.AD.1.SG+SBJF+2+PL
escareardes-te	escarear+V.tu.AD.2.SG+INF+2+PL
escareardes-te	escarear+V.tu.AD.2.SG+SBJF+2+PL
escareardes-vos	escarear+V.vós.AD.2.PL+INF+2+PL
escareardes-vos	escarear+V.vós.AD.2.PL+SBJF+2+PL
escareárei-la	escarear+V.ele.ACC.3.F.SG+PQP+2+PL
escareárei-las	escarear+V.ele.ACC.3.F.PL+PQP+2+PL
escareárei-lo	escarear+V.ele.ACC.3.M.SG+PQP+2+PL
escareárei-los	escarear+V.ele.ACC.3.M.PL+PQP+2+PL
escareárei-nos	escarear+nós.AD.1.PL+PQP+2+PL
escareáreis-lhe	escarear+V.ele.DAT.3.SG+PQP+2+PL
escareáreis-lhes	escarear+V.ele.DAT.3.PL+PQP+2+PL
escareáreis-me	escarear+V.eu.AD.1.SG+PQP+2+PL
escareáreis-te	escarear+V.tu.AD.2.SG+PQP+2+PL
escareáreis-vos	escarear+V.vós.AD.2.PL+PQP+2+PL
escareare-la	escarear+V.ele.ACC.3.F.SG+INF+2+SG
escareare-la	escarear+V.ele.ACC.3.F.SG+SBJF+2+SG
escareare-las	escarear+V.ele.ACC.3.F.PL+INF+2+SG
escareare-las	escarear+V.ele.ACC.3.F.PL+SBJF+2+SG
escareare-lo	escarear+V.ele.ACC.3.M.SG+INF+2+SG
escareare-lo	escarear+V.ele.ACC.3.M.SG+SBJF+2+SG
escareare-los	escarear+V.ele.ACC.3.M.PL+INF+2+SG
escareare-los	escarear+V.ele.ACC.3.M.PL+SBJF+2+SG
escarearem-lhe	escarear+V.ele.DAT.3.SG+INF+3+PL
escarearem-lhe	escarear+V.ele.DAT.3.SG+SBJF+3+PL
escarearem-lhes	escarear+V.ele.DAT.3.PL+INF+3+PL
escarearem-lhes	escarear+V.ele.DAT.3.PL+SBJF+3+PL
escarearem-me	escarear+V.eu.AD.1.SG+INF+3+PL
escarearem-me	escarear+V.eu.AD.1.SG+SBJF+3+PL
escarearem-na	escarear+V.ele.ACC.3.F.SG+INF+3+PL
escarearem-na	escarear+V.ele.ACC.3.F.SG+SBJF+3+PL
escarearem-nas	escarear+V.ele.ACC.3.F.PL+INF+3+PL
escarearem-nas	escarear+V.ele.ACC.3.F.PL+SBJF+3+PL
escarearem-no	escarear+V.ele.ACC.3.M.SG+INF+3+PL
escarearem-no	escarear+V.ele.ACC.3.M.SG+SBJF+3+PL
escarearem-nos	escarear+V.ele.ACC.3.M.PL+INF+3+PL
escarearem-nos	escarear+V.ele.ACC.3.M.PL+SBJF+3+PL
