esfolegar-me-ás	esfolegar+V.eu.AD.1.SG+FUT+2+SG
esfolegar-me-ei	esfolegar+V.eu.AD.1.SG+FUT+1+SG
esfolegar-me-eis	esfolegar+V.eu.AD.1.SG+FUT+2+PL
esfolegar-me-emos	esfolegar+V.eu.AD.1.SG+FUT+1+PL
esfolegar-me	esfolegar+V.eu.AD.1.SG+INF
esfolegar-me	esfolegar+V.eu.AD.1.SG+INF+1+SG
esfolegar-me	esfolegar+V.eu.AD.1.SG+INF+3+SG
esfolegar-me	esfolegar+V.eu.AD.1.SG+SBJF+1+SG
esfolegar-me	esfolegar+V.eu.AD.1.SG+SBJF+3+SG
esfolegar-me-ia	esfolegar+V.eu.AD.1.SG+COND+1+SG
esfolegar-me-ia	esfolegar+V.eu.AD.1.SG+COND+3+SG
esfolegar-me-iam	esfolegar+V.eu.AD.1.SG+COND+3+PL
esfolegar-me-íamos	esfolegar+V.eu.AD.1.SG+COND+1+PL
esfolegar-me-ias	esfolegar+V.eu.AD.1.SG+COND+2+SG
esfolegar-me-íeis	esfolegar+V.eu.AD.1.SG+COND+2+PL
esfolegarmo-la	esfolegar+V.ele.ACC.3.F.SG+INF+1+PL
esfolegarmo-la	esfolegar+V.ele.ACC.3.F.SG+SBJF+1+PL
esfolegarmo-las	esfolegar+V.ele.ACC.3.F.PL+INF+1+PL
esfolegarmo-las	esfolegar+V.ele.ACC.3.F.PL+SBJF+1+PL
esfolegarmo-lo	esfolegar+V.ele.ACC.3.M.SG+INF+1+PL
esfolegarmo-lo	esfolegar+V.ele.ACC.3.M.SG+SBJF+1+PL
esfolegarmo-los	esfolegar+V.ele.ACC.3.M.PL+INF+1+PL
esfolegarmo-los	esfolegar+V.ele.ACC.3.M.PL+SBJF+1+PL
esfolegarmo-nos	esfolegar+nós.AD.1.PL+INF+1+PL
esfolegarmo-nos	esfolegar+nós.AD.1.PL+SBJF+1+PL
esfolegarmos-lhe	esfolegar+V.ele.DAT.3.SG+INF+1+PL
esfolegarmos-lhe	esfolegar+V.ele.DAT.3.SG+SBJF+1+PL
esfolegarmos-lhes	esfolegar+V.ele.DAT.3.PL+INF+1+PL
esfolegarmos-lhes	esfolegar+V.ele.DAT.3.PL+SBJF+1+PL
esfolegarmos-me	esfolegar+V.eu.AD.1.SG+INF+1+PL
esfolegarmos-me	esfolegar+V.eu.AD.1.SG+SBJF+1+PL
esfolegarmos-te	esfolegar+V.tu.AD.2.SG+INF+1+PL
esfolegarmos-te	esfolegar+V.tu.AD.2.SG+SBJF+1+PL
esfolegarmos-vos	esfolegar+V.vós.AD.2.PL+INF+1+PL
esfolegarmos-vos	esfolegar+V.vós.AD.2.PL+SBJF+1+PL
esfolegar-nos-á	esfolegar+nós.AD.1.PL+FUT+3+SG
esfolegar-nos-ão	esfolegar+nós.AD.1.PL+FUT+3+PL
esfolegar-nos-ás	esfolegar+nós.AD.1.PL+FUT+2+SG
esfolegar-nos-ei	esfolegar+nós.AD.1.PL+FUT+1+SG
esfolegar-nos-eis	esfolegar+nós.AD.1.PL+FUT+2+PL
esfolegar-nos-emos	esfolegar+nós.AD.1.PL+FUT+1+PL
esfolegar-nos	esfolegar+nós.AD.1.PL+INF
esfolegar-nos	esfolegar+nós.AD.1.PL+INF+1+SG
esfolegar-nos	esfolegar+nós.AD.1.PL+INF+3+SG
esfolegar-nos	esfolegar+nós.AD.1.PL+SBJF+1+SG
esfolegar-nos	esfolegar+nós.AD.1.PL+SBJF+3+SG
esfolegar-nos-ia	esfolegar+nós.AD.1.PL+COND+1+SG
esfolegar-nos-ia	esfolegar+nós.AD.1.PL+COND+3+SG
esfolegar-nos-iam	esfolegar+nós.AD.1.PL+COND+3+PL
esfolegar-nos-íamos	esfolegar+nós.AD.1.PL+COND+1+PL
esfolegar-nos-ias	esfolegar+nós.AD.1.PL+COND+2+SG
esfolegar-nos-íeis	esfolegar+nós.AD.1.PL+COND+2+PL
esfolegar-se-á	esfolegar+V.ele.REFL+FUT+3+SG
esfolegar-se-ão	esfolegar+V.ele.REFL+FUT+3+PL
esfolegar-se	esfolegar+V.ele.REFL+INF
esfolegar-se	esfolegar+V.ele.REFL+INF+3+SG
esfolegar-se	esfolegar+V.ele.REFL+SBJF+3+SG
esfolegar-se-ia	esfolegar+V.ele.REFL+COND+3+SG
esfolegar-se-iam	esfolegar+V.ele.REFL+COND+3+PL
esfolegar-te-á	esfolegar+V.tu.AD.2.SG+FUT+3+SG
esfolegar-te-ão	esfolegar+V.tu.AD.2.SG+FUT+3+PL
esfolegar-te-ás	esfolegar+V.tu.AD.2.SG+FUT+2+SG
esfolegar-te-ei	esfolegar+V.tu.AD.2.SG+FUT+1+SG
esfolegar-te-eis	esfolegar+V.tu.AD.2.SG+FUT+2+PL
esfolegar-te-emos	esfolegar+V.tu.AD.2.SG+FUT+1+PL
esfolegar-te	esfolegar+V.tu.AD.2.SG+INF
esfolegar-te	esfolegar+V.tu.AD.2.SG+INF+1+SG
esfolegar-te	esfolegar+V.tu.AD.2.SG+INF+3+SG
esfolegar-te	esfolegar+V.tu.AD.2.SG+SBJF+1+SG
esfolegar-te	esfolegar+V.tu.AD.2.SG+SBJF+3+SG
esfolegar-te-ia	esfolegar+V.tu.AD.2.SG+COND+1+SG
esfolegar-te-ia	esfolegar+V.tu.AD.2.SG+COND+3+SG
esfolegar-te-iam	esfolegar+V.tu.AD.2.SG+COND+3+PL
esfolegar-te-íamos	esfolegar+V.tu.AD.2.SG+COND+1+PL
esfolegar-te-ias	esfolegar+V.tu.AD.2.SG+COND+2+SG
esfolegar-te-íeis	esfolegar+V.tu.AD.2.SG+COND+2+PL
esfolegar-vos-á	esfolegar+V.vós.AD.2.PL+FUT+3+SG
esfolegar-vos-ão	esfolegar+V.vós.AD.2.PL+FUT+3+PL
esfolegar-vos-ás	esfolegar+V.vós.AD.2.PL+FUT+2+SG
esfolegar-vos-ei	esfolegar+V.vós.AD.2.PL+FUT+1+SG
esfolegar-vos-eis	esfolegar+V.vós.AD.2.PL+FUT+2+PL
esfolegar-vos-emos	esfolegar+V.vós.AD.2.PL+FUT+1+PL
esfolegar-vos	esfolegar+V.vós.AD.2.PL+INF
esfolegar-vos	esfolegar+V.vós.AD.2.PL+INF+1+SG
esfolegar-vos	esfolegar+V.vós.AD.2.PL+INF+3+SG
esfolegar-vos	esfolegar+V.vós.AD.2.PL+SBJF+1+SG
esfolegar-vos	esfolegar+V.vós.AD.2.PL+SBJF+3+SG
esfolegar-vos-ia	esfolegar+V.vós.AD.2.PL+COND+1+SG
esfolegar-vos-ia	esfolegar+V.vós.AD.2.PL+COND+3+SG
esfolegar-vos-iam	esfolegar+V.vós.AD.2.PL+COND+3+PL
esfolegar-vos-íamos	esfolegar+V.vós.AD.2.PL+COND+1+PL
esfolegar-vos-ias	esfolegar+V.vós.AD.2.PL+COND+2+SG
esfolegar-vos-íeis	esfolegar+V.vós.AD.2.PL+COND+2+PL
esfolega-se	esfolegar+V.ele.REFL+PRS+3+SG
esfolegas-lhe	esfolegar+V.ele.DAT.3.SG+PRS+2+SG
esfolegas-lhes	esfolegar+V.ele.DAT.3.PL+PRS+2+SG
esfolegas-me	esfolegar+V.eu.AD.1.SG+PRS+2+SG
esfolegaste-a	esfolegar+V.ele.ACC.3.F.SG+PRF+2+SG
esfolegaste-as	esfolegar+V.ele.ACC.3.F.PL+PRF+2+SG
esfolegas-te	esfolegar+V.tu.AD.2.SG+PRS+2+SG
esfolegaste-la	esfolegar+V.ele.ACC.3.F.SG+PRF+2+PL
esfolegaste-las	esfolegar+V.ele.ACC.3.F.PL+PRF+2+PL
esfolegaste-lhe	esfolegar+V.ele.DAT.3.SG+PRF+2+SG
esfolegaste-lhes	esfolegar+V.ele.DAT.3.PL+PRF+2+SG
esfolegaste-lo	esfolegar+V.ele.ACC.3.M.SG+PRF+2+PL
esfolegaste-los	esfolegar+V.ele.ACC.3.M.PL+PRF+2+PL
esfolegaste-me	esfolegar+V.eu.AD.1.SG+PRF+2+SG
esfolegaste-nos	esfolegar+nós.AD.1.PL+PRF+2+PL
esfolegaste-nos	esfolegar+nós.AD.1.PL+PRF+2+SG
esfolegaste-o	esfolegar+V.ele.ACC.3.M.SG+PRF+2+SG
esfolegaste-os	esfolegar+V.ele.ACC.3.M.PL+PRF+2+SG
esfolegastes-lhe	esfolegar+V.ele.DAT.3.SG+PRF+2+PL
esfolegastes-lhes	esfolegar+V.ele.DAT.3.PL+PRF+2+PL
esfolegastes-me	esfolegar+V.eu.AD.1.SG+PRF+2+PL
esfolegastes-te	esfolegar+V.tu.AD.2.SG+PRF+2+PL
esfolegastes-vos	esfolegar+V.vós.AD.2.PL+PRF+2+PL
esfolegaste-te	esfolegar+V.tu.AD.2.SG+PRF+2+SG
esfolegaste-vos	esfolegar+V.vós.AD.2.PL+PRF+2+SG
esfolegas-vos	esfolegar+V.vós.AD.2.PL+PRS+2+SG
esfolega-te	esfolegar+V.tu.AD.2.SG+PRS+3+SG
esfolegava-a	esfolegar+V.ele.ACC.3.F.SG+IMPF+1+SG
esfolegava-a	esfolegar+V.ele.ACC.3.F.SG+IMPF+3+SG
esfolegava-as	esfolegar+V.ele.ACC.3.F.PL+IMPF+1+SG
esfolegava-as	esfolegar+V.ele.ACC.3.F.PL+IMPF+3+SG
esfolegava-la	esfolegar+V.ele.ACC.3.F.SG+IMPF+2+SG
esfolegava-las	esfolegar+V.ele.ACC.3.F.PL+IMPF+2+SG
esfolegava-lhe	esfolegar+V.ele.DAT.3.SG+IMPF+1+SG
esfolegava-lhe	esfolegar+V.ele.DAT.3.SG+IMPF+3+SG
esfolegava-lhes	esfolegar+V.ele.DAT.3.PL+IMPF+1+SG
esfolegava-lhes	esfolegar+V.ele.DAT.3.PL+IMPF+3+SG
esfolegava-lo	esfolegar+V.ele.ACC.3.M.SG+IMPF+2+SG
esfolegava-los	esfolegar+V.ele.ACC.3.M.PL+IMPF+2+SG
esfolegava-me	esfolegar+V.eu.AD.1.SG+IMPF+1+SG
esfolegava-me	esfolegar+V.eu.AD.1.SG+IMPF+3+SG
esfolegavam-lhe	esfolegar+V.ele.DAT.3.SG+IMPF+3+PL
esfolegavam-lhes	esfolegar+V.ele.DAT.3.PL+IMPF+3+PL
esfolegavam-me	esfolegar+V.eu.AD.1.SG+IMPF+3+PL
esfolegavam-na	esfolegar+V.ele.ACC.3.F.SG+IMPF+3+PL
esfolegavam-nas	esfolegar+V.ele.ACC.3.F.PL+IMPF+3+PL
esfolegavam-no	esfolegar+V.ele.ACC.3.M.SG+IMPF+3+PL
esfolegavam-nos	esfolegar+V.ele.ACC.3.M.PL+IMPF+3+PL
esfolegavam-nos	esfolegar+V.nós.AD.1.PL+IMPF+3+PL
esfolegávamo-la	esfolegar+V.ele.ACC.3.F.SG+IMPF+1+PL
esfolegávamo-las	esfolegar+V.ele.ACC.3.F.PL+IMPF+1+PL
esfolegávamo-lo	esfolegar+V.ele.ACC.3.M.SG+IMPF+1+PL
esfolegávamo-los	esfolegar+V.ele.ACC.3.M.PL+IMPF+1+PL
esfolegávamo-nos	esfolegar+nós.AD.1.PL+IMPF+1+PL
esfolegávamos-lhe	esfolegar+V.ele.DAT.3.SG+IMPF+1+PL
esfolegávamos-lhes	esfolegar+V.ele.DAT.3.PL+IMPF+1+PL
esfolegávamos-me	esfolegar+V.eu.AD.1.SG+IMPF+1+PL
esfolegávamos-te	esfolegar+V.tu.AD.2.SG+IMPF+1+PL
esfolegávamos-vos	esfolegar+V.vós.AD.2.PL+IMPF+1+PL
esfolegavam-se	esfolegar+V.ele.REFL+IMPF+3+PL
esfolegavam-te	esfolegar+V.tu.AD.2.SG+IMPF+3+PL
esfolegavam-vos	esfolegar+V.vós.AD.2.PL+IMPF+3+PL
esfolegava-nos	esfolegar+nós.AD.1.PL+IMPF+1+SG
esfolegava-nos	esfolegar+nós.AD.1.PL+IMPF+2+SG
esfolegava-nos	esfolegar+nós.AD.1.PL+IMPF+3+SG
esfolegava-o	esfolegar+V.ele.ACC.3.M.SG+IMPF+1+SG
esfolegava-o	esfolegar+V.ele.ACC.3.M.SG+IMPF+3+SG
esfolegava-os	esfolegar+V.ele.ACC.3.M.PL+IMPF+1+SG
esfolegava-os	esfolegar+V.ele.ACC.3.M.PL+IMPF+3+SG
esfolegava-se	esfolegar+V.ele.REFL+IMPF+1+SG
esfolegava-se	esfolegar+V.ele.REFL+IMPF+3+SG
esfolegavas-lhe	esfolegar+V.ele.DAT.3.SG+IMPF+2+SG
esfolegavas-lhes	esfolegar+V.ele.DAT.3.PL+IMPF+2+SG
esfolegavas-me	esfolegar+V.eu.AD.1.SG+IMPF+2+SG
esfolegavas-te	esfolegar+V.tu.AD.2.SG+IMPF+2+SG
esfolegavas-vos	esfolegar+V.vós.AD.2.PL+IMPF+2+SG
esfolegava-te	esfolegar+V.tu.AD.2.SG+IMPF+1+SG
esfolegava-te	esfolegar+V.tu.AD.2.SG+IMPF+3+SG
esfolegava-vos	esfolegar+V.vós.AD.2.PL+IMPF+1+SG
esfolegava-vos	esfolegar+V.vós.AD.2.PL+IMPF+3+SG
esfolegávei-la	esfolegar+V.ele.ACC.3.F.SG+IMPF+2+PL
esfolegávei-las	esfolegar+V.ele.ACC.3.F.PL+IMPF+2+PL
esfolegávei-lo	esfolegar+V.ele.ACC.3.M.SG+IMPF+2+PL
esfolegávei-los	esfolegar+V.ele.ACC.3.M.PL+IMPF+2+PL
esfolegávei-nos	esfolegar+nós.AD.1.PL+IMPF+2+PL
esfolegáveis-lhe	esfolegar+V.ele.DAT.3.SG+IMPF+2+PL
esfolegáveis-lhes	esfolegar+V.ele.DAT.3.PL+IMPF+2+PL
esfolegáveis-me	esfolegar+V.eu.AD.1.SG+IMPF+2+PL
esfolegáveis-te	esfolegar+V.tu.AD.2.SG+IMPF+2+PL
esfolegáveis-vos	esfolegar+V.vós.AD.2.PL+IMPF+2+PL
esfolega-vos	esfolegar+V.vós.AD.2.PL+PRS+3+SG
esfolego-a	esfolegar+V.ele.ACC.3.F.SG+PRS+1+SG
esfolego-as	esfolegar+V.ele.ACC.3.F.PL+PRS+1+SG
esfolego-lhe	esfolegar+V.ele.DAT.3.SG+PRS+1+SG
esfolego-lhes	esfolegar+V.ele.DAT.3.PL+PRS+1+SG
esfolego-me	esfolegar+V.eu.AD.1.SG+PRS+1+SG
esfolego-nos	esfolegar+nós.AD.1.PL+PRS+1+SG
esfolego-o	esfolegar+V.ele.ACC.3.M.SG+PRS+1+SG
esfolego-os	esfolegar+V.ele.ACC.3.M.PL+PRS+1+SG
esfolego-te	esfolegar+V.tu.AD.2.SG+PRS+1+SG
esfolegou-a	esfolegar+V.ele.ACC.3.F.SG+PRF+3+SG
esfolegou-as	esfolegar+V.ele.ACC.3.F.PL+PRF+3+SG
esfolegou-lhe	esfolegar+V.ele.DAT.3.SG+PRF+3+SG
esfolegou-lhes	esfolegar+V.ele.DAT.3.PL+PRF+3+SG
esfolegou-me	esfolegar+V.eu.AD.1.SG+PRF+3+SG
esfolegou-nos	esfolegar+nós.AD.1.PL+PRF+3+SG
esfolegou-o	esfolegar+V.ele.ACC.3.M.SG+PRF+3+SG
esfolegou-os	esfolegar+V.ele.ACC.3.M.PL+PRF+3+SG
esfolegou-se	esfolegar+V.ele.REFL+PRF+3+SG
esfolegou-te	esfolegar+V.tu.AD.2.SG+PRF+3+SG
esfolegou-vos	esfolegar+V.vós.AD.2.PL+PRF+3+SG
esfolego-vos	esfolegar+V.vós.AD.2.PL+PRS+1+SG
esfolegue-a	esfolegar+V.ele.ACC.3.F.SG+IMP+3+SG
esfolegue-as	esfolegar+V.ele.ACC.3.F.PL+IMP+3+SG
esfoleguei-a	esfolegar+V.ele.ACC.3.F.SG+PRF+1+SG
esfoleguei-as	esfolegar+V.ele.ACC.3.F.PL+PRF+1+SG
esfoleguei-lhe	esfolegar+V.ele.DAT.3.SG+PRF+1+SG
esfoleguei-lhes	esfolegar+V.ele.DAT.3.PL+PRF+1+SG
esfoleguei-me	esfolegar+V.eu.AD.1.SG+PRF+1+SG
esfoleguei-nos	esfolegar+nós.AD.1.PL+PRF+1+SG
esfoleguei-o	esfolegar+V.ele.ACC.3.M.SG+PRF+1+SG
esfoleguei-os	esfolegar+V.ele.ACC.3.M.PL+PRF+1+SG
esfoleguei-te	esfolegar+V.tu.AD.2.SG+PRF+1+SG
esfoleguei-vos	esfolegar+V.vós.AD.2.PL+PRF+1+SG
esfolegue-lhe	esfolegar+V.ele.DAT.3.SG+IMP+3+SG
esfolegue-lhes	esfolegar+V.ele.DAT.3.PL+IMP+3+SG
esfolegue-me	esfolegar+V.eu.AD.1.SG+IMP+3+SG
esfoleguem-lhe	esfolegar+V.ele.DAT.3.SG+IMP+3+PL
esfoleguem-lhes	esfolegar+V.ele.DAT.3.PL+IMP+3+PL
esfoleguem-me	esfolegar+V.eu.AD.1.SG+IMP+3+PL
esfoleguem-na	esfolegar+V.ele.ACC.3.F.SG+IMP+3+PL
esfoleguem-nas	esfolegar+V.ele.ACC.3.F.PL+IMP+3+PL
esfoleguem-no	esfolegar+V.ele.ACC.3.M.SG+IMP+3+PL
esfoleguem-nos	esfolegar+V.ele.ACC.3.M.PL+IMP+3+PL
esfoleguem-nos	esfolegar+V.nós.AD.1.PL+IMP+3+PL
esfoleguemo-la	esfolegar+V.ele.ACC.3.F.SG+IMP+1+PL
esfoleguemo-las	esfolegar+V.ele.ACC.3.F.PL+IMP+1+PL
esfoleguemo-lo	esfolegar+V.ele.ACC.3.M.SG+IMP+1+PL
esfoleguemo-los	esfolegar+V.ele.ACC.3.M.PL+IMP+1+PL
esfoleguemo-nos	esfolegar+nós.AD.1.PL+IMP+1+PL
esfoleguemos-lhe	esfolegar+V.ele.DAT.3.SG+IMP+1+PL
esfoleguemos-lhes	esfolegar+V.ele.DAT.3.PL+IMP+1+PL
esfoleguemos-me	esfolegar+V.eu.AD.1.SG+IMP+1+PL
esfoleguemos-te	esfolegar+V.tu.AD.2.SG+IMP+1+PL
esfoleguemos-vos	esfolegar+V.vós.AD.2.PL+IMP+1+PL
esfoleguem-se	esfolegar+V.ele.REFL+IMP+3+PL
esfoleguem-te	esfolegar+V.tu.AD.2.SG+IMP+3+PL
esfoleguem-vos	esfolegar+V.vós.AD.2.PL+IMP+3+PL
esfolegue-nos	esfolegar+nós.AD.1.PL+IMP+3+SG
esfolegue-o	esfolegar+V.ele.ACC.3.M.SG+IMP+3+SG
esfolegue-os	esfolegar+V.ele.ACC.3.M.PL+IMP+3+SG
esfolegue-se	esfolegar+V.ele.REFL+IMP+3+SG
esfolegue-te	esfolegar+V.tu.AD.2.SG+IMP+3+SG
esfolegue-vos	esfolegar+V.vós.AD.2.PL+IMP+3+SG
esfolei-a	esfolar+V.ele.ACC.3.F.SG+PRF+1+SG
esfolei-as	esfolar+V.ele.ACC.3.F.PL+PRF+1+SG
esfolei-lhe	esfolar+V.ele.DAT.3.SG+PRF+1+SG
esfolei-lhes	esfolar+V.ele.DAT.3.PL+PRF+1+SG
esfolei-me	esfolar+V.eu.AD.1.SG+PRF+1+SG
esfolei-nos	esfolar+nós.AD.1.PL+PRF+1+SG
esfolei-o	esfolar+V.ele.ACC.3.M.SG+PRF+1+SG
esfolei-os	esfolar+V.ele.ACC.3.M.PL+PRF+1+SG
esfolei-te	esfolar+V.tu.AD.2.SG+PRF+1+SG
esfolei-vos	esfolar+V.vós.AD.2.PL+PRF+1+SG
esfole-lhe	esfolar+V.ele.DAT.3.SG+IMP+3+SG
esfole-lhes	esfolar+V.ele.DAT.3.PL+IMP+3+SG
esfole-me	esfolar+V.eu.AD.1.SG+IMP+3+SG
esfolem-lhe	esfolar+V.ele.DAT.3.SG+IMP+3+PL
esfolem-lhes	esfolar+V.ele.DAT.3.PL+IMP+3+PL
esfolem-me	esfolar+V.eu.AD.1.SG+IMP+3+PL
esfolem-na	esfolar+V.ele.ACC.3.F.SG+IMP+3+PL
esfolem-nas	esfolar+V.ele.ACC.3.F.PL+IMP+3+PL
esfolem-no	esfolar+V.ele.ACC.3.M.SG+IMP+3+PL
esfolem-nos	esfolar+V.ele.ACC.3.M.PL+IMP+3+PL
esfolem-nos	esfolar+V.nós.AD.1.PL+IMP+3+PL
esfolemo-la	esfolar+V.ele.ACC.3.F.SG+IMP+1+PL
esfolemo-las	esfolar+V.ele.ACC.3.F.PL+IMP+1+PL
esfolemo-lo	esfolar+V.ele.ACC.3.M.SG+IMP+1+PL
esfolemo-los	esfolar+V.ele.ACC.3.M.PL+IMP+1+PL
esfolemo-nos	esfolar+nós.AD.1.PL+IMP+1+PL
esfolemos-lhe	esfolar+V.ele.DAT.3.SG+IMP+1+PL
esfolemos-lhes	esfolar+V.ele.DAT.3.PL+IMP+1+PL
esfolemos-me	esfolar+V.eu.AD.1.SG+IMP+1+PL
esfolemos-te	esfolar+V.tu.AD.2.SG+IMP+1+PL
esfolemos-vos	esfolar+V.vós.AD.2.PL+IMP+1+PL
esfolem-se	esfolar+V.ele.REFL+IMP+3+PL
esfolem-te	esfolar+V.tu.AD.2.SG+IMP+3+PL
esfolem-vos	esfolar+V.vós.AD.2.PL+IMP+3+PL
esfole-nos	esfolar+nós.AD.1.PL+IMP+3+SG
esfole-o	esfolar+V.ele.ACC.3.M.SG+IMP+3+SG
esfole-os	esfolar+V.ele.ACC.3.M.PL+IMP+3+SG
esfole-se	esfolar+V.ele.REFL+IMP+3+SG
esfole-te	esfolar+V.tu.AD.2.SG+IMP+3+SG
esfole-vos	esfolar+V.vós.AD.2.PL+IMP+3+SG
esfolha-a	esfolhar+V.ele.ACC.3.F.SG+PRS+3+SG
esfolha-as	esfolhar+V.ele.ACC.3.F.PL+PRS+3+SG
esfolhaça-a	esfolhaçar+V.ele.ACC.3.F.SG+PRS+3+SG
esfolhaça-as	esfolhaçar+V.ele.ACC.3.F.PL+PRS+3+SG
esfolhaçai-la	esfolhaçar+V.ele.ACC.3.F.SG+PRS+2+PL
esfolhaçai-las	esfolhaçar+V.ele.ACC.3.F.PL+PRS+2+PL
esfolhaçai-lo	esfolhaçar+V.ele.ACC.3.M.SG+PRS+2+PL
esfolhaçai-los	esfolhaçar+V.ele.ACC.3.M.PL+PRS+2+PL
esfolhaçai-nos	esfolhaçar+nós.AD.1.PL+PRS+2+PL
esfolhaçais-lhe	esfolhaçar+V.ele.DAT.3.SG+PRS+2+PL
esfolhaçais-lhes	esfolhaçar+V.ele.DAT.3.PL+PRS+2+PL
esfolhaçais-me	esfolhaçar+V.eu.AD.1.SG+PRS+2+PL
esfolhaçais-te	esfolhaçar+V.tu.AD.2.SG+PRS+2+PL
esfolhaçais-vos	esfolhaçar+V.vós.AD.2.PL+PRS+2+PL
esfolhaçá-la-á	esfolhaçar+V.ele.ACC.3.F.SG+FUT+3+SG
esfolhaçá-la-ão	esfolhaçar+V.ele.ACC.3.F.SG+FUT+3+PL
esfolhaçá-la-ás	esfolhaçar+V.ele.ACC.3.F.SG+FUT+2+SG
esfolhaçá-la-ei	esfolhaçar+V.ele.ACC.3.F.SG+FUT+1+SG
esfolhaçá-la-eis	esfolhaçar+V.ele.ACC.3.F.SG+FUT+2+PL
esfolhaçá-la-emos	esfolhaçar+V.ele.ACC.3.F.SG+FUT+1+PL
esfolhaçá-la	esfolhaçar+V.ele.ACC.3.F.SG+INF+1+SG
esfolhaçá-la	esfolhaçar+V.ele.ACC.3.F.SG+INF+3+SG
esfolhaça-la	esfolhaçar+V.ele.ACC.3.F.SG+PRS+2+SG
esfolhaçá-la	esfolhaçar+V.ele.ACC.3.F.SG+SBJF+1+SG
esfolhaçá-la	esfolhaçar+V.ele.ACC.3.F.SG+SBJF+3+SG
esfolhaçá-la-ia	esfolhaçar+V.ele.ACC.3.F.SG+COND+1+SG
esfolhaçá-la-ia	esfolhaçar+V.ele.ACC.3.F.SG+COND+3+SG
esfolhaçá-la-iam	esfolhaçar+V.ele.ACC.3.F.SG+COND+3+PL
esfolhaçá-la-íamos	esfolhaçar+V.ele.ACC.3.F.SG+COND+1+PL
esfolhaçá-la-ias	esfolhaçar+V.ele.ACC.3.F.SG+COND+2+SG
esfolhaçá-la-íeis	esfolhaçar+V.ele.ACC.3.F.SG+COND+2+PL
esfolhaçá-las-á	esfolhaçar+V.ele.ACC.3.F.PL+FUT+3+SG
esfolhaçá-las-ão	esfolhaçar+V.ele.ACC.3.F.PL+FUT+3+PL
esfolhaçá-las-ás	esfolhaçar+V.ele.ACC.3.F.PL+FUT+2+SG
esfolhaçá-las-ei	esfolhaçar+V.ele.ACC.3.F.PL+FUT+1+SG
esfolhaçá-las-eis	esfolhaçar+V.ele.ACC.3.F.PL+FUT+2+PL
esfolhaçá-las-emos	esfolhaçar+V.ele.ACC.3.F.PL+FUT+1+PL
esfolhaçá-las	esfolhaçar+V.ele.ACC.3.F.PL+INF+1+SG
esfolhaçá-las	esfolhaçar+V.ele.ACC.3.F.PL+INF+3+SG
esfolhaça-las	esfolhaçar+V.ele.ACC.3.F.PL+PRS+2+SG
esfolhaçá-las	esfolhaçar+V.ele.ACC.3.F.PL+SBJF+1+SG
esfolhaçá-las	esfolhaçar+V.ele.ACC.3.F.PL+SBJF+3+SG
esfolhaçá-las-ia	esfolhaçar+V.ele.ACC.3.F.PL+COND+1+SG
esfolhaçá-las-ia	esfolhaçar+V.ele.ACC.3.F.PL+COND+3+SG
esfolhaçá-las-iam	esfolhaçar+V.ele.ACC.3.F.PL+COND+3+PL
esfolhaçá-las-íamos	esfolhaçar+V.ele.ACC.3.F.PL+COND+1+PL
esfolhaçá-las-ias	esfolhaçar+V.ele.ACC.3.F.PL+COND+2+SG
esfolhaçá-las-íeis	esfolhaçar+V.ele.ACC.3.F.PL+COND+2+PL
esfolhaça-lhe	esfolhaçar+V.ele.DAT.3.SG+PRS+3+SG
esfolhaça-lhes	esfolhaçar+V.ele.DAT.3.PL+PRS+3+SG
esfolhaçá-lo-á	esfolhaçar+V.ele.ACC.3.M.SG+FUT+3+SG
esfolhaçá-lo-ão	esfolhaçar+V.ele.ACC.3.M.SG+FUT+3+PL
esfolhaçá-lo-ás	esfolhaçar+V.ele.ACC.3.M.SG+FUT+2+SG
esfolhaçá-lo-ei	esfolhaçar+V.ele.ACC.3.M.SG+FUT+1+SG
esfolhaçá-lo-eis	esfolhaçar+V.ele.ACC.3.M.SG+FUT+2+PL
esfolhaçá-lo-emos	esfolhaçar+V.ele.ACC.3.M.SG+FUT+1+PL
esfolhaçá-lo	esfolhaçar+V.ele.ACC.3.M.SG+INF+1+SG
esfolhaçá-lo	esfolhaçar+V.ele.ACC.3.M.SG+INF+3+SG
esfolhaça-lo	esfolhaçar+V.ele.ACC.3.M.SG+PRS+2+SG
esfolhaçá-lo	esfolhaçar+V.ele.ACC.3.M.SG+SBJF+1+SG
esfolhaçá-lo	esfolhaçar+V.ele.ACC.3.M.SG+SBJF+3+SG
esfolhaçá-lo-ia	esfolhaçar+V.ele.ACC.3.M.SG+COND+1+SG
esfolhaçá-lo-ia	esfolhaçar+V.ele.ACC.3.M.SG+COND+3+SG
esfolhaçá-lo-iam	esfolhaçar+V.ele.ACC.3.M.SG+COND+3+PL
esfolhaçá-lo-íamos	esfolhaçar+V.ele.ACC.3.M.SG+COND+1+PL
esfolhaçá-lo-ias	esfolhaçar+V.ele.ACC.3.M.SG+COND+2+SG
esfolhaçá-lo-íeis	esfolhaçar+V.ele.ACC.3.M.SG+COND+2+PL
esfolhaçá-los-á	esfolhaçar+V.ele.ACC.3.M.PL+FUT+3+SG
esfolhaçá-los-ão	esfolhaçar+V.ele.ACC.3.M.PL+FUT+3+PL
esfolhaçá-los-ás	esfolhaçar+V.ele.ACC.3.M.PL+FUT+2+SG
esfolhaçá-los-ei	esfolhaçar+V.ele.ACC.3.M.PL+FUT+1+SG
esfolhaçá-los-eis	esfolhaçar+V.ele.ACC.3.M.PL+FUT+2+PL
esfolhaçá-los-emos	esfolhaçar+V.ele.ACC.3.M.PL+FUT+1+PL
esfolhaçá-los	esfolhaçar+V.ele.ACC.3.M.PL+INF+1+SG
esfolhaçá-los	esfolhaçar+V.ele.ACC.3.M.PL+INF+3+SG
esfolhaça-los	esfolhaçar+V.ele.ACC.3.M.PL+PRS+2+SG
esfolhaçá-los	esfolhaçar+V.ele.ACC.3.M.PL+SBJF+1+SG
esfolhaçá-los	esfolhaçar+V.ele.ACC.3.M.PL+SBJF+3+SG
esfolhaçá-los-ia	esfolhaçar+V.ele.ACC.3.M.PL+COND+1+SG
esfolhaçá-los-ia	esfolhaçar+V.ele.ACC.3.M.PL+COND+3+SG
esfolhaçá-los-iam	esfolhaçar+V.ele.ACC.3.M.PL+COND+3+PL
esfolhaçá-los-íamos	esfolhaçar+V.ele.ACC.3.M.PL+COND+1+PL
esfolhaçá-los-ias	esfolhaçar+V.ele.ACC.3.M.PL+COND+2+SG
esfolhaçá-los-íeis	esfolhaçar+V.ele.ACC.3.M.PL+COND+2+PL
esfolhaça-me	esfolhaçar+V.eu.AD.1.SG+PRS+3+SG
esfolhaçam-lhe	esfolhaçar+V.ele.DAT.3.SG+PRS+3+PL
esfolhaçam-lhes	esfolhaçar+V.ele.DAT.3.PL+PRS+3+PL
esfolhaçam-me	esfolhaçar+V.eu.AD.1.SG+PRS+3+PL
esfolhaçam-na	esfolhaçar+V.ele.ACC.3.F.SG+PRS+3+PL
esfolhaçam-nas	esfolhaçar+V.ele.ACC.3.F.PL+PRS+3+PL
esfolhaçam-no	esfolhaçar+V.ele.ACC.3.M.SG+PRS+3+PL
esfolhaçam-nos	esfolhaçar+nós.AD.1.PL+PRS+3+PL
esfolhaçamo-la	esfolhaçar+V.ele.ACC.3.F.SG+PRF+1+PL
esfolhaçamo-la	esfolhaçar+V.ele.ACC.3.F.SG+PRS+1+PL
esfolhaçamo-las	esfolhaçar+V.ele.ACC.3.F.PL+PRF+1+PL
esfolhaçamo-las	esfolhaçar+V.ele.ACC.3.F.PL+PRS+1+PL
esfolhaçamo-lo	esfolhaçar+V.ele.ACC.3.M.SG+PRF+1+PL
esfolhaçamo-lo	esfolhaçar+V.ele.ACC.3.M.SG+PRS+1+PL
esfolhaçamo-los	esfolhaçar+V.ele.ACC.3.M.PL+PRF+1+PL
esfolhaçamo-los	esfolhaçar+V.ele.ACC.3.M.PL+PRS+1+PL
esfolhaçamo-nos	esfolhaçar+nós.AD.1.PL+PRF+1+PL
esfolhaçamo-nos	esfolhaçar+nós.AD.1.PL+PRS+1+PL
esfolhaçamos-lhe	esfolhaçar+V.ele.DAT.3.SG+PRF+1+PL
esfolhaçamos-lhe	esfolhaçar+V.ele.DAT.3.SG+PRS+1+PL
esfolhaçamos-lhes	esfolhaçar+V.ele.DAT.3.PL+PRF+1+PL
esfolhaçamos-lhes	esfolhaçar+V.ele.DAT.3.PL+PRS+1+PL
esfolhaçamos-me	esfolhaçar+V.eu.AD.1.SG+PRF+1+PL
esfolhaçamos-me	esfolhaçar+V.eu.AD.1.SG+PRS+1+PL
esfolhaçamos-te	esfolhaçar+V.tu.AD.2.SG+PRF+1+PL
esfolhaçamos-te	esfolhaçar+V.tu.AD.2.SG+PRS+1+PL
esfolhaçamos-vos	esfolhaçar+V.vós.AD.2.PL+PRF+1+PL
esfolhaçamos-vos	esfolhaçar+V.vós.AD.2.PL+PRS+1+PL
esfolhaçam-se	esfolhaçar+V.ele.REFL+PRS+3+PL
esfolhaçam-te	esfolhaçar+V.tu.AD.2.SG+PRS+3+PL
esfolhaçam-vos	esfolhaçar+V.vós.AD.2.PL+PRS+3+PL
esfolhaçando-a	esfolhaçar+V.ele.ACC.3.F.SG+GRD
esfolhaçando-as	esfolhaçar+V.ele.ACC.3.F.PL+GRD
esfolhaçando-lhe	esfolhaçar+V.ele.DAT.3.SG+GRD
esfolhaçando-lhes	esfolhaçar+V.ele.DAT.3.PL+GRD
esfolhaçando-me	esfolhaçar+V.eu.AD.1.SG+GRD
esfolhaçando-nos	esfolhaçar+nós.AD.1.PL+GRD
esfolhaçando-o	esfolhaçar+V.ele.ACC.3.M.SG+GRD
esfolhaçando-os	esfolhaçar+V.ele.ACC.3.M.PL+GRD
esfolhaçando-se	esfolhaçar+V.ele.REFL+GRD
esfolhaçando-te	esfolhaçar+V.tu.AD.2.SG+GRD
esfolhaçando-vos	esfolhaçar+V.vós.AD.2.PL+GRD
esfolhaça-nos	esfolhaçar+nós.AD.1.PL+PRS+2+SG
esfolhaça-nos	esfolhaçar+nós.AD.1.PL+PRS+3+SG
esfolhaça-o	esfolhaçar+V.ele.ACC.3.M.SG+PRS+3+SG
esfolhaça-os	esfolhaçar+V.ele.ACC.3.M.PL+PRS+3+SG
esfolhaçara-a	esfolhaçar+V.ele.ACC.3.F.SG+PQP+1+SG
esfolhaçara-a	esfolhaçar+V.ele.ACC.3.F.SG+PQP+3+SG
esfolhaçara-as	esfolhaçar+V.ele.ACC.3.F.PL+PQP+1+SG
esfolhaçara-as	esfolhaçar+V.ele.ACC.3.F.PL+PQP+3+SG
esfolhaçara-la	esfolhaçar+V.ele.ACC.3.F.SG+PQP+2+SG
esfolhaçara-las	esfolhaçar+V.ele.ACC.3.F.PL+PQP+2+SG
esfolhaçara-lhe	esfolhaçar+V.ele.DAT.3.SG+PQP+1+SG
esfolhaçara-lhe	esfolhaçar+V.ele.DAT.3.SG+PQP+3+SG
esfolhaçara-lhes	esfolhaçar+V.ele.DAT.3.PL+PQP+1+SG
esfolhaçara-lhes	esfolhaçar+V.ele.DAT.3.PL+PQP+3+SG
esfolhaçara-lo	esfolhaçar+V.ele.ACC.3.M.SG+PQP+2+SG
esfolhaçara-los	esfolhaçar+V.ele.ACC.3.M.PL+PQP+2+SG
esfolhaçara-me	esfolhaçar+V.eu.AD.1.SG+PQP+1+SG
esfolhaçara-me	esfolhaçar+V.eu.AD.1.SG+PQP+3+SG
esfolhaçaram-lhe	esfolhaçar+V.ele.DAT.3.SG+PQP+3+PL
esfolhaçaram-lhe	esfolhaçar+V.ele.DAT.3.SG+PRF+3+PL
esfolhaçaram-lhes	esfolhaçar+V.ele.DAT.3.PL+PQP+3+PL
esfolhaçaram-lhes	esfolhaçar+V.ele.DAT.3.PL+PRF+3+PL
esfolhaçaram-me	esfolhaçar+V.eu.AD.1.SG+PQP+3+PL
esfolhaçaram-me	esfolhaçar+V.eu.AD.1.SG+PRF+3+PL
esfolhaçaram-na	esfolhaçar+V.ele.ACC.3.F.SG+PQP+3+PL
esfolhaçaram-na	esfolhaçar+V.ele.ACC.3.F.SG+PRF+3+PL
esfolhaçaram-nas	esfolhaçar+V.ele.ACC.3.F.PL+PQP+3+PL
esfolhaçaram-nas	esfolhaçar+V.ele.ACC.3.F.PL+PRF+3+PL
esfolhaçaram-no	esfolhaçar+V.ele.ACC.3.M.SG+PQP+3+PL
esfolhaçaram-no	esfolhaçar+V.ele.ACC.3.M.SG+PRF+3+PL
esfolhaçaram-nos	esfolhaçar+nós.AD.1.PL+PQP+3+PL
esfolhaçaram-nos	esfolhaçar+nós.AD.1.PL+PRF+3+PL
esfolhaçáramo-la	esfolhaçar+V.ele.ACC.3.F.SG+PQP+1+PL
esfolhaçáramo-las	esfolhaçar+V.ele.ACC.3.F.PL+PQP+1+PL
esfolhaçáramo-lo	esfolhaçar+V.ele.ACC.3.M.SG+PQP+1+PL
esfolhaçáramo-los	esfolhaçar+V.ele.ACC.3.M.PL+PQP+1+PL
esfolhaçáramo-nos	esfolhaçar+nós.AD.1.PL+PQP+1+PL
esfolhaçáramos-lhe	esfolhaçar+V.ele.DAT.3.SG+PQP+1+PL
esfolhaçáramos-lhes	esfolhaçar+V.ele.DAT.3.PL+PQP+1+PL
esfolhaçáramos-me	esfolhaçar+V.eu.AD.1.SG+PQP+1+PL
esfolhaçáramos-te	esfolhaçar+V.tu.AD.2.SG+PQP+1+PL
esfolhaçáramos-vos	esfolhaçar+V.vós.AD.2.PL+PQP+1+PL
esfolhaçaram-se	esfolhaçar+V.ele.REFL+PQP+3+PL
esfolhaçaram-te	esfolhaçar+V.tu.AD.2.SG+PQP+3+PL
esfolhaçaram-te	esfolhaçar+V.tu.AD.2.SG+PRF+3+PL
esfolhaçaram-vos	esfolhaçar+V.vós.AD.2.PL+PQP+3+PL
esfolhaçaram-vos	esfolhaçar+V.vós.AD.2.PL+PRF+3+PL
esfolhaçara-nos	esfolhaçar+nós.AD.1.PL+PQP+1+SG
esfolhaçara-nos	esfolhaçar+nós.AD.1.PL+PQP+2+SG
esfolhaçara-nos	esfolhaçar+nós.AD.1.PL+PQP+3+SG
esfolhaçara-o	esfolhaçar+V.ele.ACC.3.M.SG+PQP+1+SG
esfolhaçara-o	esfolhaçar+V.ele.ACC.3.M.SG+PQP+3+SG
esfolhaçara-os	esfolhaçar+V.ele.ACC.3.M.PL+PQP+1+SG
esfolhaçara-os	esfolhaçar+V.ele.ACC.3.M.PL+PQP+3+SG
esfolhaçara-se	esfolhaçar+V.ele.REFL+PQP+1+SG
esfolhaçara-se	esfolhaçar+V.ele.REFL+PQP+3+SG
esfolhaçaras-lhe	esfolhaçar+V.ele.DAT.3.SG+PQP+2+SG
esfolhaçaras-lhes	esfolhaçar+V.ele.DAT.3.PL+PQP+2+SG
esfolhaçaras-me	esfolhaçar+V.eu.AD.1.SG+PQP+2+SG
esfolhaçaras-te	esfolhaçar+V.tu.AD.2.SG+PQP+2+SG
esfolhaçaras-vos	esfolhaçar+V.vós.AD.2.PL+PQP+2+SG
esfolhaçara-te	esfolhaçar+V.tu.AD.2.SG+PQP+1+SG
esfolhaçara-te	esfolhaçar+V.tu.AD.2.SG+PQP+3+SG
esfolhaçara-vos	esfolhaçar+V.vós.AD.2.PL+PQP+1+SG
esfolhaçara-vos	esfolhaçar+V.vós.AD.2.PL+PQP+3+SG
esfolhaçarde-la	esfolhaçar+V.ele.ACC.3.F.SG+INF+2+PL
esfolhaçarde-la	esfolhaçar+V.ele.ACC.3.F.SG+SBJF+2+PL
esfolhaçarde-las	esfolhaçar+V.ele.ACC.3.F.PL+INF+2+PL
esfolhaçarde-las	esfolhaçar+V.ele.ACC.3.F.PL+SBJF+2+PL
esfolhaçarde-lo	esfolhaçar+V.ele.ACC.3.M.SG+INF+2+PL
esfolhaçarde-lo	esfolhaçar+V.ele.ACC.3.M.SG+SBJF+2+PL
esfolhaçarde-los	esfolhaçar+V.ele.ACC.3.M.PL+INF+2+PL
esfolhaçarde-los	esfolhaçar+V.ele.ACC.3.M.PL+SBJF+2+PL
esfolhaçarde-nos	esfolhaçar+nós.AD.1.PL+INF+2+PL
esfolhaçarde-nos	esfolhaçar+nós.AD.1.PL+SBJF+2+PL
esfolhaçardes-lhe	esfolhaçar+V.ele.DAT.3.SG+INF+2+PL
esfolhaçardes-lhe	esfolhaçar+V.ele.DAT.3.SG+SBJF+2+PL
esfolhaçardes-lhes	esfolhaçar+V.ele.DAT.3.PL+INF+2+PL
esfolhaçardes-lhes	esfolhaçar+V.ele.DAT.3.PL+SBJF+2+PL
esfolhaçardes-me	esfolhaçar+V.eu.AD.1.SG+INF+2+PL
esfolhaçardes-me	esfolhaçar+V.eu.AD.1.SG+SBJF+2+PL
esfolhaçardes-te	esfolhaçar+V.tu.AD.2.SG+INF+2+PL
esfolhaçardes-te	esfolhaçar+V.tu.AD.2.SG+SBJF+2+PL
esfolhaçardes-vos	esfolhaçar+V.vós.AD.2.PL+INF+2+PL
esfolhaçardes-vos	esfolhaçar+V.vós.AD.2.PL+SBJF+2+PL
esfolhaçárei-la	esfolhaçar+V.ele.ACC.3.F.SG+PQP+2+PL
esfolhaçárei-las	esfolhaçar+V.ele.ACC.3.F.PL+PQP+2+PL
esfolhaçárei-lo	esfolhaçar+V.ele.ACC.3.M.SG+PQP+2+PL
esfolhaçárei-los	esfolhaçar+V.ele.ACC.3.M.PL+PQP+2+PL
esfolhaçárei-nos	esfolhaçar+nós.AD.1.PL+PQP+2+PL
esfolhaçáreis-lhe	esfolhaçar+V.ele.DAT.3.SG+PQP+2+PL
esfolhaçáreis-lhes	esfolhaçar+V.ele.DAT.3.PL+PQP+2+PL
esfolhaçáreis-me	esfolhaçar+V.eu.AD.1.SG+PQP+2+PL
esfolhaçáreis-te	esfolhaçar+V.tu.AD.2.SG+PQP+2+PL
esfolhaçáreis-vos	esfolhaçar+V.vós.AD.2.PL+PQP+2+PL
esfolhaçare-la	esfolhaçar+V.ele.ACC.3.F.SG+INF+2+SG
esfolhaçare-la	esfolhaçar+V.ele.ACC.3.F.SG+SBJF+2+SG
esfolhaçare-las	esfolhaçar+V.ele.ACC.3.F.PL+INF+2+SG
esfolhaçare-las	esfolhaçar+V.ele.ACC.3.F.PL+SBJF+2+SG
esfolhaçare-lo	esfolhaçar+V.ele.ACC.3.M.SG+INF+2+SG
esfolhaçare-lo	esfolhaçar+V.ele.ACC.3.M.SG+SBJF+2+SG
esfolhaçare-los	esfolhaçar+V.ele.ACC.3.M.PL+INF+2+SG
esfolhaçare-los	esfolhaçar+V.ele.ACC.3.M.PL+SBJF+2+SG
esfolhaçarem-lhe	esfolhaçar+V.ele.DAT.3.SG+INF+3+PL
esfolhaçarem-lhe	esfolhaçar+V.ele.DAT.3.SG+SBJF+3+PL
esfolhaçarem-lhes	esfolhaçar+V.ele.DAT.3.PL+INF+3+PL
esfolhaçarem-lhes	esfolhaçar+V.ele.DAT.3.PL+SBJF+3+PL
esfolhaçarem-me	esfolhaçar+V.eu.AD.1.SG+INF+3+PL
esfolhaçarem-me	esfolhaçar+V.eu.AD.1.SG+SBJF+3+PL
esfolhaçarem-na	esfolhaçar+V.ele.ACC.3.F.SG+INF+3+PL
esfolhaçarem-na	esfolhaçar+V.ele.ACC.3.F.SG+SBJF+3+PL
esfolhaçarem-nas	esfolhaçar+V.ele.ACC.3.F.PL+INF+3+PL
esfolhaçarem-nas	esfolhaçar+V.ele.ACC.3.F.PL+SBJF+3+PL
esfolhaçarem-no	esfolhaçar+V.ele.ACC.3.M.SG+INF+3+PL
esfolhaçarem-no	esfolhaçar+V.ele.ACC.3.M.SG+SBJF+3+PL
esfolhaçarem-nos	esfolhaçar+nós.AD.1.PL+INF+3+PL
esfolhaçarem-nos	esfolhaçar+nós.AD.1.PL+SBJF+3+PL
esfolhaçarem-se	esfolhaçar+V.ele.REFL+INF+3+PL
esfolhaçarem-se	esfolhaçar+V.ele.REFL+SBJF+3+PL
esfolhaçarem-te	esfolhaçar+V.tu.AD.2.SG+INF+3+PL
esfolhaçarem-te	esfolhaçar+V.tu.AD.2.SG+SBJF+3+PL
esfolhaçarem-vos	esfolhaçar+V.vós.AD.2.PL+INF+3+PL
esfolhaçarem-vos	esfolhaçar+V.vós.AD.2.PL+SBJF+3+PL
esfolhaçare-nos	esfolhaçar+nós.AD.1.PL+INF+2+SG
esfolhaçare-nos	esfolhaçar+nós.AD.1.PL+SBJF+2+SG
esfolhaçares-lhe	esfolhaçar+V.ele.DAT.3.SG+INF+2+SG
esfolhaçares-lhe	esfolhaçar+V.ele.DAT.3.SG+SBJF+2+SG
esfolhaçares-lhes	esfolhaçar+V.ele.DAT.3.PL+INF+2+SG
esfolhaçares-lhes	esfolhaçar+V.ele.DAT.3.PL+SBJF+2+SG
esfolhaçares-me	esfolhaçar+V.eu.AD.1.SG+INF+2+SG
esfolhaçares-me	esfolhaçar+V.eu.AD.1.SG+SBJF+2+SG
esfolhaçares-te	esfolhaçar+V.tu.AD.2.SG+INF+2+SG
esfolhaçares-te	esfolhaçar+V.tu.AD.2.SG+SBJF+2+SG
esfolhaçares-vos	esfolhaçar+V.vós.AD.2.PL+INF+2+SG
esfolhaçares-vos	esfolhaçar+V.vós.AD.2.PL+SBJF+2+SG
esfolhaçar-lhe-á	esfolhaçar+V.ele.DAT.3.SG+FUT+3+SG
esfolhaçar-lhe-ão	esfolhaçar+V.ele.DAT.3.SG+FUT+3+PL
esfolhaçar-lhe-ás	esfolhaçar+V.ele.DAT.3.SG+FUT+2+SG
esfolhaçar-lhe-ei	esfolhaçar+V.ele.DAT.3.SG+FUT+1+SG
esfolhaçar-lhe-eis	esfolhaçar+V.ele.DAT.3.SG+FUT+2+PL
esfolhaçar-lhe-emos	esfolhaçar+V.ele.DAT.3.SG+FUT+1+PL
esfolhaçar-lhe	esfolhaçar+V.ele.DAT.3.SG+INF
esfolhaçar-lhe	esfolhaçar+V.ele.DAT.3.SG+INF+1+SG
esfolhaçar-lhe	esfolhaçar+V.ele.DAT.3.SG+INF+3+SG
esfolhaçar-lhe	esfolhaçar+V.ele.DAT.3.SG+SBJF+1+SG
esfolhaçar-lhe	esfolhaçar+V.ele.DAT.3.SG+SBJF+3+SG
esfolhaçar-lhe-ia	esfolhaçar+V.ele.DAT.3.SG+COND+1+SG
esfolhaçar-lhe-ia	esfolhaçar+V.ele.DAT.3.SG+COND+3+SG
esfolhaçar-lhe-iam	esfolhaçar+V.ele.DAT.3.SG+COND+3+PL
esfolhaçar-lhe-íamos	esfolhaçar+V.ele.DAT.3.SG+COND+1+PL
esfolhaçar-lhe-ias	esfolhaçar+V.ele.DAT.3.SG+COND+2+SG
esfolhaçar-lhe-íeis	esfolhaçar+V.ele.DAT.3.SG+COND+2+PL
esfolhaçar-lhes-á	esfolhaçar+V.ele.DAT.3.PL+FUT+3+SG
esfolhaçar-lhes-ão	esfolhaçar+V.ele.DAT.3.PL+FUT+3+PL
esfolhaçar-lhes-ás	esfolhaçar+V.ele.DAT.3.PL+FUT+2+SG
esfolhaçar-lhes-ei	esfolhaçar+V.ele.DAT.3.PL+FUT+1+SG
esfolhaçar-lhes-eis	esfolhaçar+V.ele.DAT.3.PL+FUT+2+PL
esfolhaçar-lhes-emos	esfolhaçar+V.ele.DAT.3.PL+FUT+1+PL
esfolhaçar-lhes	esfolhaçar+V.ele.DAT.3.PL+INF
esfolhaçar-lhes	esfolhaçar+V.ele.DAT.3.PL+INF+1+SG
esfolhaçar-lhes	esfolhaçar+V.ele.DAT.3.PL+INF+3+SG
esfolhaçar-lhes	esfolhaçar+V.ele.DAT.3.PL+SBJF+1+SG
esfolhaçar-lhes	esfolhaçar+V.ele.DAT.3.PL+SBJF+3+SG
esfolhaçar-lhes-ia	esfolhaçar+V.ele.DAT.3.PL+COND+1+SG
esfolhaçar-lhes-ia	esfolhaçar+V.ele.DAT.3.PL+COND+3+SG
esfolhaçar-lhes-iam	esfolhaçar+V.ele.DAT.3.PL+COND+3+PL
esfolhaçar-lhes-íamos	esfolhaçar+V.ele.DAT.3.PL+COND+1+PL
esfolhaçar-lhes-ias	esfolhaçar+V.ele.DAT.3.PL+COND+2+SG
esfolhaçar-lhes-íeis	esfolhaçar+V.ele.DAT.3.PL+COND+2+PL
esfolhaçar-me-á	esfolhaçar+V.eu.AD.1.SG+FUT+3+SG
esfolhaçar-me-ão	esfolhaçar+V.eu.AD.1.SG+FUT+3+PL
esfolhaçar-me-ás	esfolhaçar+V.eu.AD.1.SG+FUT+2+SG
esfolhaçar-me-ei	esfolhaçar+V.eu.AD.1.SG+FUT+1+SG
esfolhaçar-me-eis	esfolhaçar+V.eu.AD.1.SG+FUT+2+PL
esfolhaçar-me-emos	esfolhaçar+V.eu.AD.1.SG+FUT+1+PL
esfolhaçar-me	esfolhaçar+V.eu.AD.1.SG+INF
esfolhaçar-me	esfolhaçar+V.eu.AD.1.SG+INF+1+SG
esfolhaçar-me	esfolhaçar+V.eu.AD.1.SG+INF+3+SG
esfolhaçar-me	esfolhaçar+V.eu.AD.1.SG+SBJF+1+SG
esfolhaçar-me	esfolhaçar+V.eu.AD.1.SG+SBJF+3+SG
esfolhaçar-me-ia	esfolhaçar+V.eu.AD.1.SG+COND+1+SG
esfolhaçar-me-ia	esfolhaçar+V.eu.AD.1.SG+COND+3+SG
esfolhaçar-me-iam	esfolhaçar+V.eu.AD.1.SG+COND+3+PL
esfolhaçar-me-íamos	esfolhaçar+V.eu.AD.1.SG+COND+1+PL
esfolhaçar-me-ias	esfolhaçar+V.eu.AD.1.SG+COND+2+SG
esfolhaçar-me-íeis	esfolhaçar+V.eu.AD.1.SG+COND+2+PL
esfolhaçarmo-la	esfolhaçar+V.ele.ACC.3.F.SG+INF+1+PL
esfolhaçarmo-la	esfolhaçar+V.ele.ACC.3.F.SG+SBJF+1+PL
esfolhaçarmo-las	esfolhaçar+V.ele.ACC.3.F.PL+INF+1+PL
esfolhaçarmo-las	esfolhaçar+V.ele.ACC.3.F.PL+SBJF+1+PL
esfolhaçarmo-lo	esfolhaçar+V.ele.ACC.3.M.SG+INF+1+PL
esfolhaçarmo-lo	esfolhaçar+V.ele.ACC.3.M.SG+SBJF+1+PL
esfolhaçarmo-los	esfolhaçar+V.ele.ACC.3.M.PL+INF+1+PL
esfolhaçarmo-los	esfolhaçar+V.ele.ACC.3.M.PL+SBJF+1+PL
esfolhaçarmo-nos	esfolhaçar+nós.AD.1.PL+INF+1+PL
esfolhaçarmo-nos	esfolhaçar+nós.AD.1.PL+SBJF+1+PL
esfolhaçarmos-lhe	esfolhaçar+V.ele.DAT.3.SG+INF+1+PL
esfolhaçarmos-lhe	esfolhaçar+V.ele.DAT.3.SG+SBJF+1+PL
esfolhaçarmos-lhes	esfolhaçar+V.ele.DAT.3.PL+INF+1+PL
esfolhaçarmos-lhes	esfolhaçar+V.ele.DAT.3.PL+SBJF+1+PL
esfolhaçarmos-me	esfolhaçar+V.eu.AD.1.SG+INF+1+PL
esfolhaçarmos-me	esfolhaçar+V.eu.AD.1.SG+SBJF+1+PL
esfolhaçarmos-te	esfolhaçar+V.tu.AD.2.SG+INF+1+PL
esfolhaçarmos-te	esfolhaçar+V.tu.AD.2.SG+SBJF+1+PL
esfolhaçarmos-vos	esfolhaçar+V.vós.AD.2.PL+INF+1+PL
esfolhaçarmos-vos	esfolhaçar+V.vós.AD.2.PL+SBJF+1+PL
esfolhaçar-nos-á	esfolhaçar+nós.AD.1.PL+FUT+3+SG
esfolhaçar-nos-ão	esfolhaçar+nós.AD.1.PL+FUT+3+PL
esfolhaçar-nos-ás	esfolhaçar+nós.AD.1.PL+FUT+2+SG
esfolhaçar-nos-ei	esfolhaçar+nós.AD.1.PL+FUT+1+SG
esfolhaçar-nos-eis	esfolhaçar+nós.AD.1.PL+FUT+2+PL
esfolhaçar-nos-emos	esfolhaçar+nós.AD.1.PL+FUT+1+PL
esfolhaçar-nos	esfolhaçar+nós.AD.1.PL+INF
esfolhaçar-nos	esfolhaçar+nós.AD.1.PL+INF+1+SG
esfolhaçar-nos	esfolhaçar+nós.AD.1.PL+INF+3+SG
esfolhaçar-nos	esfolhaçar+nós.AD.1.PL+SBJF+1+SG
esfolhaçar-nos	esfolhaçar+nós.AD.1.PL+SBJF+3+SG
esfolhaçar-nos-ia	esfolhaçar+nós.AD.1.PL+COND+1+SG
esfolhaçar-nos-ia	esfolhaçar+nós.AD.1.PL+COND+3+SG
esfolhaçar-nos-iam	esfolhaçar+nós.AD.1.PL+COND+3+PL
esfolhaçar-nos-íamos	esfolhaçar+nós.AD.1.PL+COND+1+PL
esfolhaçar-nos-ias	esfolhaçar+nós.AD.1.PL+COND+2+SG
esfolhaçar-nos-íeis	esfolhaçar+nós.AD.1.PL+COND+2+PL
esfolhaçar-se-á	esfolhaçar+V.ele.REFL+FUT+3+SG
esfolhaçar-se-ão	esfolhaçar+V.ele.REFL+FUT+3+PL
esfolhaçar-se	esfolhaçar+V.ele.REFL+INF
esfolhaçar-se	esfolhaçar+V.ele.REFL+INF+3+SG
esfolhaçar-se	esfolhaçar+V.ele.REFL+SBJF+3+SG
esfolhaçar-se-ia	esfolhaçar+V.ele.REFL+COND+3+SG
esfolhaçar-se-iam	esfolhaçar+V.ele.REFL+COND+3+PL
esfolhaçar-te-á	esfolhaçar+V.tu.AD.2.SG+FUT+3+SG
esfolhaçar-te-ão	esfolhaçar+V.tu.AD.2.SG+FUT+3+PL
esfolhaçar-te-ás	esfolhaçar+V.tu.AD.2.SG+FUT+2+SG
esfolhaçar-te-ei	esfolhaçar+V.tu.AD.2.SG+FUT+1+SG
esfolhaçar-te-eis	esfolhaçar+V.tu.AD.2.SG+FUT+2+PL
esfolhaçar-te-emos	esfolhaçar+V.tu.AD.2.SG+FUT+1+PL
esfolhaçar-te	esfolhaçar+V.tu.AD.2.SG+INF
esfolhaçar-te	esfolhaçar+V.tu.AD.2.SG+INF+1+SG
esfolhaçar-te	esfolhaçar+V.tu.AD.2.SG+INF+3+SG
esfolhaçar-te	esfolhaçar+V.tu.AD.2.SG+SBJF+1+SG
esfolhaçar-te	esfolhaçar+V.tu.AD.2.SG+SBJF+3+SG
esfolhaçar-te-ia	esfolhaçar+V.tu.AD.2.SG+COND+1+SG
esfolhaçar-te-ia	esfolhaçar+V.tu.AD.2.SG+COND+3+SG
esfolhaçar-te-iam	esfolhaçar+V.tu.AD.2.SG+COND+3+PL
esfolhaçar-te-íamos	esfolhaçar+V.tu.AD.2.SG+COND+1+PL
esfolhaçar-te-ias	esfolhaçar+V.tu.AD.2.SG+COND+2+SG
esfolhaçar-te-íeis	esfolhaçar+V.tu.AD.2.SG+COND+2+PL
esfolhaçar-vos-á	esfolhaçar+V.vós.AD.2.PL+FUT+3+SG
esfolhaçar-vos-ão	esfolhaçar+V.vós.AD.2.PL+FUT+3+PL
esfolhaçar-vos-ás	esfolhaçar+V.vós.AD.2.PL+FUT+2+SG
esfolhaçar-vos-ei	esfolhaçar+V.vós.AD.2.PL+FUT+1+SG
esfolhaçar-vos-eis	esfolhaçar+V.vós.AD.2.PL+FUT+2+PL
esfolhaçar-vos-emos	esfolhaçar+V.vós.AD.2.PL+FUT+1+PL
esfolhaçar-vos	esfolhaçar+V.vós.AD.2.PL+INF
esfolhaçar-vos	esfolhaçar+V.vós.AD.2.PL+INF+1+SG
esfolhaçar-vos	esfolhaçar+V.vós.AD.2.PL+INF+3+SG
esfolhaçar-vos	esfolhaçar+V.vós.AD.2.PL+SBJF+1+SG
esfolhaçar-vos	esfolhaçar+V.vós.AD.2.PL+SBJF+3+SG
esfolhaçar-vos-ia	esfolhaçar+V.vós.AD.2.PL+COND+1+SG
esfolhaçar-vos-ia	esfolhaçar+V.vós.AD.2.PL+COND+3+SG
esfolhaçar-vos-iam	esfolhaçar+V.vós.AD.2.PL+COND+3+PL
esfolhaçar-vos-íamos	esfolhaçar+V.vós.AD.2.PL+COND+1+PL
esfolhaçar-vos-ias	esfolhaçar+V.vós.AD.2.PL+COND+2+SG
esfolhaçar-vos-íeis	esfolhaçar+V.vós.AD.2.PL+COND+2+PL
esfolhaça-se	esfolhaçar+V.ele.REFL+PRS+3+SG
esfolhaças-lhe	esfolhaçar+V.ele.DAT.3.SG+PRS+2+SG
esfolhaças-lhes	esfolhaçar+V.ele.DAT.3.PL+PRS+2+SG
esfolhaças-me	esfolhaçar+V.eu.AD.1.SG+PRS+2+SG
esfolhaças-te	esfolhaçar+V.tu.AD.2.SG+PRS+2+SG
esfolhaçaste-la	esfolhaçar+V.ele.ACC.3.F.SG+PRF+2+PL
esfolhaçaste-las	esfolhaçar+V.ele.ACC.3.F.PL+PRF+2+PL
esfolhaçaste-lo	esfolhaçar+V.ele.ACC.3.M.SG+PRF+2+PL
esfolhaçaste-los	esfolhaçar+V.ele.ACC.3.M.PL+PRF+2+PL
esfolhaçaste-nos	esfolhaçar+nós.AD.1.PL+PRF+2+PL
esfolhaçastes-lhe	esfolhaçar+V.ele.DAT.3.SG+PRF+2+PL
esfolhaçastes-lhes	esfolhaçar+V.ele.DAT.3.PL+PRF+2+PL
esfolhaçastes-me	esfolhaçar+V.eu.AD.1.SG+PRF+2+PL
esfolhaçastes-te	esfolhaçar+V.tu.AD.2.SG+PRF+2+PL
esfolhaçastes-vos	esfolhaçar+V.vós.AD.2.PL+PRF+2+PL
esfolhaças-vos	esfolhaçar+V.vós.AD.2.PL+PRS+2+SG
esfolhaça-te	esfolhaçar+V.tu.AD.2.SG+PRS+3+SG
esfolhaçava-a	esfolhaçar+V.ele.ACC.3.F.SG+IMPF+1+SG
esfolhaçava-a	esfolhaçar+V.ele.ACC.3.F.SG+IMPF+3+SG
esfolhaçava-as	esfolhaçar+V.ele.ACC.3.F.PL+IMPF+1+SG
esfolhaçava-as	esfolhaçar+V.ele.ACC.3.F.PL+IMPF+3+SG
esfolhaçava-la	esfolhaçar+V.ele.ACC.3.F.SG+IMPF+2+SG
esfolhaçava-las	esfolhaçar+V.ele.ACC.3.F.PL+IMPF+2+SG
esfolhaçava-lhe	esfolhaçar+V.ele.DAT.3.SG+IMPF+1+SG
esfolhaçava-lhe	esfolhaçar+V.ele.DAT.3.SG+IMPF+3+SG
esfolhaçava-lhes	esfolhaçar+V.ele.DAT.3.PL+IMPF+1+SG
esfolhaçava-lhes	esfolhaçar+V.ele.DAT.3.PL+IMPF+3+SG
esfolhaçava-lo	esfolhaçar+V.ele.ACC.3.M.SG+IMPF+2+SG
esfolhaçava-los	esfolhaçar+V.ele.ACC.3.M.PL+IMPF+2+SG
esfolhaçava-me	esfolhaçar+V.eu.AD.1.SG+IMPF+1+SG
esfolhaçava-me	esfolhaçar+V.eu.AD.1.SG+IMPF+3+SG
esfolhaçavam-lhe	esfolhaçar+V.ele.DAT.3.SG+IMPF+3+PL
esfolhaçavam-lhes	esfolhaçar+V.ele.DAT.3.PL+IMPF+3+PL
esfolhaçavam-me	esfolhaçar+V.eu.AD.1.SG+IMPF+3+PL
esfolhaçavam-na	esfolhaçar+V.ele.ACC.3.F.SG+IMPF+3+PL
esfolhaçavam-nas	esfolhaçar+V.ele.ACC.3.F.PL+IMPF+3+PL
esfolhaçavam-no	esfolhaçar+V.ele.ACC.3.M.SG+IMPF+3+PL
esfolhaçavam-nos	esfolhaçar+nós.AD.1.PL+IMPF+3+PL
esfolhaçávamo-la	esfolhaçar+V.ele.ACC.3.F.SG+IMPF+1+PL
esfolhaçávamo-las	esfolhaçar+V.ele.ACC.3.F.PL+IMPF+1+PL
esfolhaçávamo-lo	esfolhaçar+V.ele.ACC.3.M.SG+IMPF+1+PL
esfolhaçávamo-los	esfolhaçar+V.ele.ACC.3.M.PL+IMPF+1+PL
esfolhaçávamo-nos	esfolhaçar+nós.AD.1.PL+IMPF+1+PL
esfolhaçávamos-lhe	esfolhaçar+V.ele.DAT.3.SG+IMPF+1+PL
esfolhaçávamos-lhes	esfolhaçar+V.ele.DAT.3.PL+IMPF+1+PL
esfolhaçávamos-me	esfolhaçar+V.eu.AD.1.SG+IMPF+1+PL
esfolhaçávamos-te	esfolhaçar+V.tu.AD.2.SG+IMPF+1+PL
esfolhaçávamos-vos	esfolhaçar+V.vós.AD.2.PL+IMPF+1+PL
esfolhaçavam-se	esfolhaçar+V.ele.REFL+IMPF+3+PL
esfolhaçavam-te	esfolhaçar+V.tu.AD.2.SG+IMPF+3+PL
esfolhaçavam-vos	esfolhaçar+V.vós.AD.2.PL+IMPF+3+PL
esfolhaçava-nos	esfolhaçar+nós.AD.1.PL+IMPF+1+SG
esfolhaçava-nos	esfolhaçar+nós.AD.1.PL+IMPF+2+SG
esfolhaçava-nos	esfolhaçar+nós.AD.1.PL+IMPF+3+SG
esfolhaçava-o	esfolhaçar+V.ele.ACC.3.M.SG+IMPF+1+SG
esfolhaçava-o	esfolhaçar+V.ele.ACC.3.M.SG+IMPF+3+SG
esfolhaçava-os	esfolhaçar+V.ele.ACC.3.M.PL+IMPF+1+SG
esfolhaçava-os	esfolhaçar+V.ele.ACC.3.M.PL+IMPF+3+SG
esfolhaçava-se	esfolhaçar+V.ele.REFL+IMPF+1+SG
esfolhaçava-se	esfolhaçar+V.ele.REFL+IMPF+3+SG
esfolhaçavas-lhe	esfolhaçar+V.ele.DAT.3.SG+IMPF+2+SG
esfolhaçavas-lhes	esfolhaçar+V.ele.DAT.3.PL+IMPF+2+SG
esfolhaçavas-me	esfolhaçar+V.eu.AD.1.SG+IMPF+2+SG
esfolhaçavas-te	esfolhaçar+V.tu.AD.2.SG+IMPF+2+SG
esfolhaçavas-vos	esfolhaçar+V.vós.AD.2.PL+IMPF+2+SG
esfolhaçava-te	esfolhaçar+V.tu.AD.2.SG+IMPF+1+SG
esfolhaçava-te	esfolhaçar+V.tu.AD.2.SG+IMPF+3+SG
esfolhaçava-vos	esfolhaçar+V.vós.AD.2.PL+IMPF+1+SG
esfolhaçava-vos	esfolhaçar+V.vós.AD.2.PL+IMPF+3+SG
esfolhaçávei-la	esfolhaçar+V.ele.ACC.3.F.SG+IMPF+2+PL
esfolhaçávei-las	esfolhaçar+V.ele.ACC.3.F.PL+IMPF+2+PL
esfolhaçávei-lo	esfolhaçar+V.ele.ACC.3.M.SG+IMPF+2+PL
esfolhaçávei-los	esfolhaçar+V.ele.ACC.3.M.PL+IMPF+2+PL
esfolhaçávei-nos	esfolhaçar+nós.AD.1.PL+IMPF+2+PL
esfolhaçáveis-lhe	esfolhaçar+V.ele.DAT.3.SG+IMPF+2+PL
esfolhaçáveis-lhes	esfolhaçar+V.ele.DAT.3.PL+IMPF+2+PL
esfolhaçáveis-me	esfolhaçar+V.eu.AD.1.SG+IMPF+2+PL
esfolhaçáveis-te	esfolhaçar+V.tu.AD.2.SG+IMPF+2+PL
esfolhaçáveis-vos	esfolhaçar+V.vós.AD.2.PL+IMPF+2+PL
esfolhaça-vos	esfolhaçar+V.vós.AD.2.PL+PRS+3+SG
esfolhace-a	esfolhaçar+V.ele.ACC.3.F.SG+IMP+3+SG
esfolhace-as	esfolhaçar+V.ele.ACC.3.F.PL+IMP+3+SG
esfolhacei-a	esfolhaçar+V.ele.ACC.3.F.SG+PRF+1+SG
esfolhacei-as	esfolhaçar+V.ele.ACC.3.F.PL+PRF+1+SG
esfolhacei-lhe	esfolhaçar+V.ele.DAT.3.SG+PRF+1+SG
esfolhacei-lhes	esfolhaçar+V.ele.DAT.3.PL+PRF+1+SG
esfolhacei-me	esfolhaçar+V.eu.AD.1.SG+PRF+1+SG
esfolhacei-nos	esfolhaçar+nós.AD.1.PL+PRF+1+SG
esfolhacei-o	esfolhaçar+V.ele.ACC.3.M.SG+PRF+1+SG
esfolhacei-os	esfolhaçar+V.ele.ACC.3.M.PL+PRF+1+SG
esfolhacei-te	esfolhaçar+V.tu.AD.2.SG+PRF+1+SG
esfolhacei-vos	esfolhaçar+V.vós.AD.2.PL+PRF+1+SG
esfolhace-lhe	esfolhaçar+V.ele.DAT.3.SG+IMP+3+SG
esfolhace-lhes	esfolhaçar+V.ele.DAT.3.PL+IMP+3+SG
esfolhace-me	esfolhaçar+V.eu.AD.1.SG+IMP+3+SG
esfolhacem-lhe	esfolhaçar+V.ele.DAT.3.SG+IMP+3+PL
esfolhacem-lhes	esfolhaçar+V.ele.DAT.3.PL+IMP+3+PL
esfolhacem-me	esfolhaçar+V.eu.AD.1.SG+IMP+3+PL
esfolhacem-na	esfolhaçar+V.ele.ACC.3.F.SG+IMP+3+PL
esfolhacem-nas	esfolhaçar+V.ele.ACC.3.F.PL+IMP+3+PL
esfolhacem-no	esfolhaçar+V.ele.ACC.3.M.SG+IMP+3+PL
esfolhacem-nos	esfolhaçar+V.ele.ACC.3.M.PL+IMP+3+PL
esfolhacem-nos	esfolhaçar+V.nós.AD.1.PL+IMP+3+PL
esfolhacemo-la	esfolhaçar+V.ele.ACC.3.F.SG+IMP+1+PL
esfolhacemo-las	esfolhaçar+V.ele.ACC.3.F.PL+IMP+1+PL
esfolhacemo-lo	esfolhaçar+V.ele.ACC.3.M.SG+IMP+1+PL
esfolhacemo-los	esfolhaçar+V.ele.ACC.3.M.PL+IMP+1+PL
esfolhacemo-nos	esfolhaçar+nós.AD.1.PL+IMP+1+PL
esfolhacemos-lhe	esfolhaçar+V.ele.DAT.3.SG+IMP+1+PL
esfolhacemos-lhes	esfolhaçar+V.ele.DAT.3.PL+IMP+1+PL
esfolhacemos-me	esfolhaçar+V.eu.AD.1.SG+IMP+1+PL
esfolhacemos-te	esfolhaçar+V.tu.AD.2.SG+IMP+1+PL
esfolhacemos-vos	esfolhaçar+V.vós.AD.2.PL+IMP+1+PL
esfolhacem-se	esfolhaçar+V.ele.REFL+IMP+3+PL
esfolhacem-te	esfolhaçar+V.tu.AD.2.SG+IMP+3+PL
esfolhacem-vos	esfolhaçar+V.vós.AD.2.PL+IMP+3+PL
esfolhace-nos	esfolhaçar+nós.AD.1.PL+IMP+3+SG
esfolhace-o	esfolhaçar+V.ele.ACC.3.M.SG+IMP+3+SG
esfolhace-os	esfolhaçar+V.ele.ACC.3.M.PL+IMP+3+SG
esfolhace-se	esfolhaçar+V.ele.REFL+IMP+3+SG
esfolhace-te	esfolhaçar+V.tu.AD.2.SG+IMP+3+SG
esfolhace-vos	esfolhaçar+V.vós.AD.2.PL+IMP+3+SG
esfolhaço-a	esfolhaçar+V.ele.ACC.3.F.SG+PRS+1+SG
esfolhaço-as	esfolhaçar+V.ele.ACC.3.F.PL+PRS+1+SG
esfolhaço-lhe	esfolhaçar+V.ele.DAT.3.SG+PRS+1+SG
esfolhaço-lhes	esfolhaçar+V.ele.DAT.3.PL+PRS+1+SG
esfolhaço-me	esfolhaçar+V.eu.AD.1.SG+PRS+1+SG
esfolhaço-nos	esfolhaçar+nós.AD.1.PL+PRS+1+SG
esfolhaço-o	esfolhaçar+V.ele.ACC.3.M.SG+PRS+1+SG
esfolhaço-os	esfolhaçar+V.ele.ACC.3.M.PL+PRS+1+SG
esfolhaço-te	esfolhaçar+V.tu.AD.2.SG+PRS+1+SG
esfolhaçou-a	esfolhaçar+V.ele.ACC.3.F.SG+PRF+3+SG
esfolhaçou-as	esfolhaçar+V.ele.ACC.3.F.PL+PRF+3+SG
esfolhaçou-lhe	esfolhaçar+V.ele.DAT.3.SG+PRF+3+SG
esfolhaçou-lhes	esfolhaçar+V.ele.DAT.3.PL+PRF+3+SG
esfolhaçou-me	esfolhaçar+V.eu.AD.1.SG+PRF+3+SG
esfolhaçou-nos	esfolhaçar+nós.AD.1.PL+PRF+3+SG
esfolhaçou-o	esfolhaçar+V.ele.ACC.3.M.SG+PRF+3+SG
esfolhaçou-os	esfolhaçar+V.ele.ACC.3.M.PL+PRF+3+SG
esfolhaçou-se	esfolhaçar+V.ele.REFL+PRF+3+SG
esfolhaçou-te	esfolhaçar+V.tu.AD.2.SG+PRF+3+SG
esfolhaçou-vos	esfolhaçar+V.vós.AD.2.PL+PRF+3+SG
esfolhaço-vos	esfolhaçar+V.vós.AD.2.PL+PRS+1+SG
esfolhai-la	esfolhar+V.ele.ACC.3.F.SG+PRS+2+PL
esfolhai-las	esfolhar+V.ele.ACC.3.F.PL+PRS+2+PL
esfolhai-lo	esfolhar+V.ele.ACC.3.M.SG+PRS+2+PL
esfolhai-los	esfolhar+V.ele.ACC.3.M.PL+PRS+2+PL
esfolhai-nos	esfolhar+nós.AD.1.PL+PRS+2+PL
esfolhais-lhe	esfolhar+V.ele.DAT.3.SG+PRS+2+PL
esfolhais-lhes	esfolhar+V.ele.DAT.3.PL+PRS+2+PL
esfolhais-me	esfolhar+V.eu.AD.1.SG+PRS+2+PL
esfolhais-te	esfolhar+V.tu.AD.2.SG+PRS+2+PL
esfolhais-vos	esfolhar+V.vós.AD.2.PL+PRS+2+PL
esfolhá-la-á	esfolhar+V.ele.ACC.3.F.SG+FUT+3+SG
esfolhá-la-ão	esfolhar+V.ele.ACC.3.F.SG+FUT+3+PL
esfolhá-la-ás	esfolhar+V.ele.ACC.3.F.SG+FUT+2+SG
esfolhá-la-ei	esfolhar+V.ele.ACC.3.F.SG+FUT+1+SG
esfolhá-la-eis	esfolhar+V.ele.ACC.3.F.SG+FUT+2+PL
esfolhá-la-emos	esfolhar+V.ele.ACC.3.F.SG+FUT+1+PL
esfolhá-la	esfolhar+V.ele.ACC.3.F.SG+INF+1+SG
esfolhá-la	esfolhar+V.ele.ACC.3.F.SG+INF+3+SG
esfolha-la	esfolhar+V.ele.ACC.3.F.SG+PRS+2+SG
esfolhá-la	esfolhar+V.ele.ACC.3.F.SG+SBJF+1+SG
esfolhá-la	esfolhar+V.ele.ACC.3.F.SG+SBJF+3+SG
esfolhá-la-ia	esfolhar+V.ele.ACC.3.F.SG+COND+1+SG
esfolhá-la-ia	esfolhar+V.ele.ACC.3.F.SG+COND+3+SG
esfolhá-la-iam	esfolhar+V.ele.ACC.3.F.SG+COND+3+PL
esfolhá-la-íamos	esfolhar+V.ele.ACC.3.F.SG+COND+1+PL
esfolhá-la-ias	esfolhar+V.ele.ACC.3.F.SG+COND+2+SG
esfolhá-la-íeis	esfolhar+V.ele.ACC.3.F.SG+COND+2+PL
esfolhá-las-á	esfolhar+V.ele.ACC.3.F.PL+FUT+3+SG
esfolhá-las-ão	esfolhar+V.ele.ACC.3.F.PL+FUT+3+PL
esfolhá-las-ás	esfolhar+V.ele.ACC.3.F.PL+FUT+2+SG
esfolhá-las-ei	esfolhar+V.ele.ACC.3.F.PL+FUT+1+SG
esfolhá-las-eis	esfolhar+V.ele.ACC.3.F.PL+FUT+2+PL
esfolhá-las-emos	esfolhar+V.ele.ACC.3.F.PL+FUT+1+PL
esfolhá-las	esfolhar+V.ele.ACC.3.F.PL+INF+1+SG
esfolhá-las	esfolhar+V.ele.ACC.3.F.PL+INF+3+SG
esfolha-las	esfolhar+V.ele.ACC.3.F.PL+PRS+2+SG
esfolhá-las	esfolhar+V.ele.ACC.3.F.PL+SBJF+1+SG
esfolhá-las	esfolhar+V.ele.ACC.3.F.PL+SBJF+3+SG
esfolhá-las-ia	esfolhar+V.ele.ACC.3.F.PL+COND+1+SG
esfolhá-las-ia	esfolhar+V.ele.ACC.3.F.PL+COND+3+SG
esfolhá-las-iam	esfolhar+V.ele.ACC.3.F.PL+COND+3+PL
esfolhá-las-íamos	esfolhar+V.ele.ACC.3.F.PL+COND+1+PL
esfolhá-las-ias	esfolhar+V.ele.ACC.3.F.PL+COND+2+SG
esfolhá-las-íeis	esfolhar+V.ele.ACC.3.F.PL+COND+2+PL
esfolha-lhe	esfolhar+V.ele.DAT.3.SG+PRS+3+SG
esfolha-lhes	esfolhar+V.ele.DAT.3.PL+PRS+3+SG
esfolhá-lo-á	esfolhar+V.ele.ACC.3.M.SG+FUT+3+SG
esfolhá-lo-ão	esfolhar+V.ele.ACC.3.M.SG+FUT+3+PL
esfolhá-lo-ás	esfolhar+V.ele.ACC.3.M.SG+FUT+2+SG
esfolhá-lo-ei	esfolhar+V.ele.ACC.3.M.SG+FUT+1+SG
esfolhá-lo-eis	esfolhar+V.ele.ACC.3.M.SG+FUT+2+PL
esfolhá-lo-emos	esfolhar+V.ele.ACC.3.M.SG+FUT+1+PL
esfolhá-lo	esfolhar+V.ele.ACC.3.M.SG+INF+1+SG
esfolhá-lo	esfolhar+V.ele.ACC.3.M.SG+INF+3+SG
esfolha-lo	esfolhar+V.ele.ACC.3.M.SG+PRS+2+SG
esfolhá-lo	esfolhar+V.ele.ACC.3.M.SG+SBJF+1+SG
esfolhá-lo	esfolhar+V.ele.ACC.3.M.SG+SBJF+3+SG
esfolhá-lo-ia	esfolhar+V.ele.ACC.3.M.SG+COND+1+SG
esfolhá-lo-ia	esfolhar+V.ele.ACC.3.M.SG+COND+3+SG
esfolhá-lo-iam	esfolhar+V.ele.ACC.3.M.SG+COND+3+PL
esfolhá-lo-íamos	esfolhar+V.ele.ACC.3.M.SG+COND+1+PL
esfolhá-lo-ias	esfolhar+V.ele.ACC.3.M.SG+COND+2+SG
esfolhá-lo-íeis	esfolhar+V.ele.ACC.3.M.SG+COND+2+PL
esfolhá-los-á	esfolhar+V.ele.ACC.3.M.PL+FUT+3+SG
esfolhá-los-ão	esfolhar+V.ele.ACC.3.M.PL+FUT+3+PL
esfolhá-los-ás	esfolhar+V.ele.ACC.3.M.PL+FUT+2+SG
esfolhá-los-ei	esfolhar+V.ele.ACC.3.M.PL+FUT+1+SG
esfolhá-los-eis	esfolhar+V.ele.ACC.3.M.PL+FUT+2+PL
esfolhá-los-emos	esfolhar+V.ele.ACC.3.M.PL+FUT+1+PL
esfolhá-los	esfolhar+V.ele.ACC.3.M.PL+INF+1+SG
esfolhá-los	esfolhar+V.ele.ACC.3.M.PL+INF+3+SG
esfolha-los	esfolhar+V.ele.ACC.3.M.PL+PRS+2+SG
esfolhá-los	esfolhar+V.ele.ACC.3.M.PL+SBJF+1+SG
esfolhá-los	esfolhar+V.ele.ACC.3.M.PL+SBJF+3+SG
esfolhá-los-ia	esfolhar+V.ele.ACC.3.M.PL+COND+1+SG
esfolhá-los-ia	esfolhar+V.ele.ACC.3.M.PL+COND+3+SG
esfolhá-los-iam	esfolhar+V.ele.ACC.3.M.PL+COND+3+PL
esfolhá-los-íamos	esfolhar+V.ele.ACC.3.M.PL+COND+1+PL
esfolhá-los-ias	esfolhar+V.ele.ACC.3.M.PL+COND+2+SG
esfolhá-los-íeis	esfolhar+V.ele.ACC.3.M.PL+COND+2+PL
esfolha-me	esfolhar+V.eu.AD.1.SG+PRS+3+SG
esfolham-lhe	esfolhar+V.ele.DAT.3.SG+PRS+3+PL
esfolham-lhes	esfolhar+V.ele.DAT.3.PL+PRS+3+PL
esfolham-me	esfolhar+V.eu.AD.1.SG+PRS+3+PL
esfolham-na	esfolhar+V.ele.ACC.3.F.SG+PRS+3+PL
esfolham-nas	esfolhar+V.ele.ACC.3.F.PL+PRS+3+PL
esfolham-no	esfolhar+V.ele.ACC.3.M.SG+PRS+3+PL
esfolham-nos	esfolhar+V.ele.ACC.3.M.PL+PRS+3+PL
esfolham-nos	esfolhar+V.nós.AD.1.PL+PRS+3+PL
esfolhamo-la	esfolhar+V.ele.ACC.3.F.SG+PRF+1+PL
esfolhamo-la	esfolhar+V.ele.ACC.3.F.SG+PRS+1+PL
esfolhamo-las	esfolhar+V.ele.ACC.3.F.PL+PRF+1+PL
esfolhamo-las	esfolhar+V.ele.ACC.3.F.PL+PRS+1+PL
esfolhamo-lo	esfolhar+V.ele.ACC.3.M.SG+PRF+1+PL
esfolhamo-lo	esfolhar+V.ele.ACC.3.M.SG+PRS+1+PL
esfolhamo-los	esfolhar+V.ele.ACC.3.M.PL+PRF+1+PL
esfolhamo-los	esfolhar+V.ele.ACC.3.M.PL+PRS+1+PL
esfolhamo-nos	esfolhar+nós.AD.1.PL+PRF+1+PL
esfolhamo-nos	esfolhar+nós.AD.1.PL+PRS+1+PL
esfolhamos-lhe	esfolhar+V.ele.DAT.3.SG+PRF+1+PL
esfolhamos-lhe	esfolhar+V.ele.DAT.3.SG+PRS+1+PL
esfolhamos-lhes	esfolhar+V.ele.DAT.3.PL+PRF+1+PL
esfolhamos-lhes	esfolhar+V.ele.DAT.3.PL+PRS+1+PL
esfolhamos-me	esfolhar+V.eu.AD.1.SG+PRF+1+PL
esfolhamos-me	esfolhar+V.eu.AD.1.SG+PRS+1+PL
esfolhamos-te	esfolhar+V.tu.AD.2.SG+PRF+1+PL
esfolhamos-te	esfolhar+V.tu.AD.2.SG+PRS+1+PL
esfolhamos-vos	esfolhar+V.vós.AD.2.PL+PRF+1+PL
esfolhamos-vos	esfolhar+V.vós.AD.2.PL+PRS+1+PL
esfolham-se	esfolhar+V.ele.REFL+PRS+3+PL
esfolham-te	esfolhar+V.tu.AD.2.SG+PRS+3+PL
esfolham-vos	esfolhar+V.vós.AD.2.PL+PRS+3+PL
esfolhando-a	esfolhar+V.ele.ACC.3.F.SG+GRD
esfolhando-as	esfolhar+V.ele.ACC.3.F.PL+GRD
esfolhando-lhe	esfolhar+V.ele.DAT.3.SG+GRD
esfolhando-lhes	esfolhar+V.ele.DAT.3.PL+GRD
esfolhando-me	esfolhar+V.eu.AD.1.SG+GRD
esfolhando-nos	esfolhar+nós.AD.1.PL+GRD
esfolhando-o	esfolhar+V.ele.ACC.3.M.SG+GRD
esfolhando-os	esfolhar+V.ele.ACC.3.M.PL+GRD
esfolhando-se	esfolhar+V.ele.REFL+GRD
esfolhando-te	esfolhar+V.tu.AD.2.SG+GRD
esfolhando-vos	esfolhar+V.vós.AD.2.PL+GRD
esfolha-nos	esfolhar+nós.AD.1.PL+PRS+2+SG
esfolha-nos	esfolhar+nós.AD.1.PL+PRS+3+SG
esfolha-o	esfolhar+V.ele.ACC.3.M.SG+PRS+3+SG
esfolha-os	esfolhar+V.ele.ACC.3.M.PL+PRS+3+SG
esfolhara-a	esfolhar+V.ele.ACC.3.F.SG+PQP+1+SG
esfolhara-a	esfolhar+V.ele.ACC.3.F.SG+PQP+3+SG
esfolhara-as	esfolhar+V.ele.ACC.3.F.PL+PQP+1+SG
esfolhara-as	esfolhar+V.ele.ACC.3.F.PL+PQP+3+SG
esfolhara-la	esfolhar+V.ele.ACC.3.F.SG+PQP+2+SG
esfolhara-las	esfolhar+V.ele.ACC.3.F.PL+PQP+2+SG
esfolhara-lhe	esfolhar+V.ele.DAT.3.SG+PQP+1+SG
esfolhara-lhe	esfolhar+V.ele.DAT.3.SG+PQP+3+SG
esfolhara-lhes	esfolhar+V.ele.DAT.3.PL+PQP+1+SG
esfolhara-lhes	esfolhar+V.ele.DAT.3.PL+PQP+3+SG
esfolhara-lo	esfolhar+V.ele.ACC.3.M.SG+PQP+2+SG
esfolhara-los	esfolhar+V.ele.ACC.3.M.PL+PQP+2+SG
esfolhara-me	esfolhar+V.eu.AD.1.SG+PQP+1+SG
esfolhara-me	esfolhar+V.eu.AD.1.SG+PQP+3+SG
esfolharam-lhe	esfolhar+V.ele.DAT.3.SG+PQP+3+PL
esfolharam-lhe	esfolhar+V.ele.DAT.3.SG+PRF+3+PL
esfolharam-lhes	esfolhar+V.ele.DAT.3.PL+PQP+3+PL
esfolharam-lhes	esfolhar+V.ele.DAT.3.PL+PRF+3+PL
esfolharam-me	esfolhar+V.eu.AD.1.SG+PQP+3+PL
esfolharam-me	esfolhar+V.eu.AD.1.SG+PRF+3+PL
esfolharam-na	esfolhar+V.ele.ACC.3.F.SG+PQP+3+PL
esfolharam-na	esfolhar+V.ele.ACC.3.F.SG+PRF+3+PL
esfolharam-nas	esfolhar+V.ele.ACC.3.F.PL+PQP+3+PL
esfolharam-nas	esfolhar+V.ele.ACC.3.F.PL+PRF+3+PL
esfolharam-no	esfolhar+V.ele.ACC.3.M.SG+PQP+3+PL
esfolharam-no	esfolhar+V.ele.ACC.3.M.SG+PRF+3+PL
esfolharam-nos	esfolhar+V.ele.ACC.3.M.PL+PQP+3+PL
esfolharam-nos	esfolhar+V.ele.ACC.3.M.PL+PRF+3+PL
esfolharam-nos	esfolhar+V.nós.AD.1.PL+PQP+3+PL
esfolharam-nos	esfolhar+V.nós.AD.1.PL+PRF+3+PL
esfolháramo-la	esfolhar+V.ele.ACC.3.F.SG+PQP+1+PL
esfolháramo-las	esfolhar+V.ele.ACC.3.F.PL+PQP+1+PL
esfolháramo-lo	esfolhar+V.ele.ACC.3.M.SG+PQP+1+PL
esfolháramo-los	esfolhar+V.ele.ACC.3.M.PL+PQP+1+PL
esfolháramo-nos	esfolhar+nós.AD.1.PL+PQP+1+PL
esfolháramos-lhe	esfolhar+V.ele.DAT.3.SG+PQP+1+PL
esfolháramos-lhes	esfolhar+V.ele.DAT.3.PL+PQP+1+PL
esfolháramos-me	esfolhar+V.eu.AD.1.SG+PQP+1+PL
esfolháramos-te	esfolhar+V.tu.AD.2.SG+PQP+1+PL
esfolháramos-vos	esfolhar+V.vós.AD.2.PL+PQP+1+PL
esfolharam-se	esfolhar+V.ele.REFL+PQP+3+PL
esfolharam-se	esfolhar+V.ele.REFL+PRF+3+PL
esfolharam-te	esfolhar+V.tu.AD.2.SG+PQP+3+PL
esfolharam-te	esfolhar+V.tu.AD.2.SG+PRF+3+PL
esfolharam-vos	esfolhar+V.vós.AD.2.PL+PQP+3+PL
esfolharam-vos	esfolhar+V.vós.AD.2.PL+PRF+3+PL
esfolhara-nos	esfolhar+nós.AD.1.PL+PQP+1+SG
esfolhara-nos	esfolhar+nós.AD.1.PL+PQP+2+SG
esfolhara-nos	esfolhar+nós.AD.1.PL+PQP+3+SG
esfolhara-o	esfolhar+V.ele.ACC.3.M.SG+PQP+1+SG
esfolhara-o	esfolhar+V.ele.ACC.3.M.SG+PQP+3+SG
esfolhara-os	esfolhar+V.ele.ACC.3.M.PL+PQP+1+SG
esfolhara-os	esfolhar+V.ele.ACC.3.M.PL+PQP+3+SG
