espaldeirarem-se	espaldeirar+V.ele.REFL+INF+3+PL
espaldeirarem-se	espaldeirar+V.ele.REFL+SBJF+3+PL
espaldeirarem-te	espaldeirar+V.tu.AD.2.SG+INF+3+PL
espaldeirarem-te	espaldeirar+V.tu.AD.2.SG+SBJF+3+PL
espaldeirarem-vos	espaldeirar+V.vós.AD.2.PL+INF+3+PL
espaldeirarem-vos	espaldeirar+V.vós.AD.2.PL+SBJF+3+PL
espaldeirare-nos	espaldeirar+nós.AD.1.PL+INF+2+SG
espaldeirare-nos	espaldeirar+nós.AD.1.PL+SBJF+2+SG
espaldeirares-lhe	espaldeirar+V.ele.DAT.3.SG+INF+2+SG
espaldeirares-lhe	espaldeirar+V.ele.DAT.3.SG+SBJF+2+SG
espaldeirares-lhes	espaldeirar+V.ele.DAT.3.PL+INF+2+SG
espaldeirares-lhes	espaldeirar+V.ele.DAT.3.PL+SBJF+2+SG
espaldeirares-me	espaldeirar+V.eu.AD.1.SG+INF+2+SG
espaldeirares-me	espaldeirar+V.eu.AD.1.SG+SBJF+2+SG
espaldeirares-te	espaldeirar+V.tu.AD.2.SG+INF+2+SG
espaldeirares-te	espaldeirar+V.tu.AD.2.SG+SBJF+2+SG
espaldeirares-vos	espaldeirar+V.vós.AD.2.PL+INF+2+SG
espaldeirares-vos	espaldeirar+V.vós.AD.2.PL+SBJF+2+SG
espaldeirar-lhe-á	espaldeirar+V.ele.DAT.3.SG+FUT+3+SG
espaldeirar-lhe-ão	espaldeirar+V.ele.DAT.3.SG+FUT+3+PL
espaldeirar-lhe-ás	espaldeirar+V.ele.DAT.3.SG+FUT+2+SG
espaldeirar-lhe-ei	espaldeirar+V.ele.DAT.3.SG+FUT+1+SG
espaldeirar-lhe-eis	espaldeirar+V.ele.DAT.3.SG+FUT+2+PL
espaldeirar-lhe-emos	espaldeirar+V.ele.DAT.3.SG+FUT+1+PL
espaldeirar-lhe	espaldeirar+V.ele.DAT.3.SG+INF
espaldeirar-lhe	espaldeirar+V.ele.DAT.3.SG+INF+1+SG
espaldeirar-lhe	espaldeirar+V.ele.DAT.3.SG+INF+3+SG
espaldeirar-lhe	espaldeirar+V.ele.DAT.3.SG+SBJF+1+SG
espaldeirar-lhe	espaldeirar+V.ele.DAT.3.SG+SBJF+3+SG
espaldeirar-lhe-ia	espaldeirar+V.ele.DAT.3.SG+COND+1+SG
espaldeirar-lhe-ia	espaldeirar+V.ele.DAT.3.SG+COND+3+SG
espaldeirar-lhe-iam	espaldeirar+V.ele.DAT.3.SG+COND+3+PL
espaldeirar-lhe-íamos	espaldeirar+V.ele.DAT.3.SG+COND+1+PL
espaldeirar-lhe-ias	espaldeirar+V.ele.DAT.3.SG+COND+2+SG
espaldeirar-lhe-íeis	espaldeirar+V.ele.DAT.3.SG+COND+2+PL
espaldeirar-lhes-á	espaldeirar+V.ele.DAT.3.PL+FUT+3+SG
espaldeirar-lhes-ão	espaldeirar+V.ele.DAT.3.PL+FUT+3+PL
espaldeirar-lhes-ás	espaldeirar+V.ele.DAT.3.PL+FUT+2+SG
espaldeirar-lhes-ei	espaldeirar+V.ele.DAT.3.PL+FUT+1+SG
espaldeirar-lhes-eis	espaldeirar+V.ele.DAT.3.PL+FUT+2+PL
espaldeirar-lhes-emos	espaldeirar+V.ele.DAT.3.PL+FUT+1+PL
espaldeirar-lhes	espaldeirar+V.ele.DAT.3.PL+INF
espaldeirar-lhes	espaldeirar+V.ele.DAT.3.PL+INF+1+SG
espaldeirar-lhes	espaldeirar+V.ele.DAT.3.PL+INF+3+SG
espaldeirar-lhes	espaldeirar+V.ele.DAT.3.PL+SBJF+1+SG
espaldeirar-lhes	espaldeirar+V.ele.DAT.3.PL+SBJF+3+SG
espaldeirar-lhes-ia	espaldeirar+V.ele.DAT.3.PL+COND+1+SG
espaldeirar-lhes-ia	espaldeirar+V.ele.DAT.3.PL+COND+3+SG
espaldeirar-lhes-iam	espaldeirar+V.ele.DAT.3.PL+COND+3+PL
espaldeirar-lhes-íamos	espaldeirar+V.ele.DAT.3.PL+COND+1+PL
espaldeirar-lhes-ias	espaldeirar+V.ele.DAT.3.PL+COND+2+SG
espaldeirar-lhes-íeis	espaldeirar+V.ele.DAT.3.PL+COND+2+PL
espaldeirar-me-á	espaldeirar+V.eu.AD.1.SG+FUT+3+SG
espaldeirar-me-ão	espaldeirar+V.eu.AD.1.SG+FUT+3+PL
espaldeirar-me-ás	espaldeirar+V.eu.AD.1.SG+FUT+2+SG
espaldeirar-me-ei	espaldeirar+V.eu.AD.1.SG+FUT+1+SG
espaldeirar-me-eis	espaldeirar+V.eu.AD.1.SG+FUT+2+PL
espaldeirar-me-emos	espaldeirar+V.eu.AD.1.SG+FUT+1+PL
espaldeirar-me	espaldeirar+V.eu.AD.1.SG+INF
espaldeirar-me	espaldeirar+V.eu.AD.1.SG+INF+1+SG
espaldeirar-me	espaldeirar+V.eu.AD.1.SG+INF+3+SG
espaldeirar-me	espaldeirar+V.eu.AD.1.SG+SBJF+1+SG
espaldeirar-me	espaldeirar+V.eu.AD.1.SG+SBJF+3+SG
espaldeirar-me-ia	espaldeirar+V.eu.AD.1.SG+COND+1+SG
espaldeirar-me-ia	espaldeirar+V.eu.AD.1.SG+COND+3+SG
espaldeirar-me-iam	espaldeirar+V.eu.AD.1.SG+COND+3+PL
espaldeirar-me-íamos	espaldeirar+V.eu.AD.1.SG+COND+1+PL
espaldeirar-me-ias	espaldeirar+V.eu.AD.1.SG+COND+2+SG
espaldeirar-me-íeis	espaldeirar+V.eu.AD.1.SG+COND+2+PL
espaldeirarmo-la	espaldeirar+V.ele.ACC.3.F.SG+INF+1+PL
espaldeirarmo-la	espaldeirar+V.ele.ACC.3.F.SG+SBJF+1+PL
espaldeirarmo-las	espaldeirar+V.ele.ACC.3.F.PL+INF+1+PL
espaldeirarmo-las	espaldeirar+V.ele.ACC.3.F.PL+SBJF+1+PL
espaldeirarmo-lo	espaldeirar+V.ele.ACC.3.M.SG+INF+1+PL
espaldeirarmo-lo	espaldeirar+V.ele.ACC.3.M.SG+SBJF+1+PL
espaldeirarmo-los	espaldeirar+V.ele.ACC.3.M.PL+INF+1+PL
espaldeirarmo-los	espaldeirar+V.ele.ACC.3.M.PL+SBJF+1+PL
espaldeirarmo-nos	espaldeirar+nós.AD.1.PL+INF+1+PL
espaldeirarmo-nos	espaldeirar+nós.AD.1.PL+SBJF+1+PL
espaldeirarmos-lhe	espaldeirar+V.ele.DAT.3.SG+INF+1+PL
espaldeirarmos-lhe	espaldeirar+V.ele.DAT.3.SG+SBJF+1+PL
espaldeirarmos-lhes	espaldeirar+V.ele.DAT.3.PL+INF+1+PL
espaldeirarmos-lhes	espaldeirar+V.ele.DAT.3.PL+SBJF+1+PL
espaldeirarmos-me	espaldeirar+V.eu.AD.1.SG+INF+1+PL
espaldeirarmos-me	espaldeirar+V.eu.AD.1.SG+SBJF+1+PL
espaldeirarmos-te	espaldeirar+V.tu.AD.2.SG+INF+1+PL
espaldeirarmos-te	espaldeirar+V.tu.AD.2.SG+SBJF+1+PL
espaldeirarmos-vos	espaldeirar+V.vós.AD.2.PL+INF+1+PL
espaldeirarmos-vos	espaldeirar+V.vós.AD.2.PL+SBJF+1+PL
espaldeirar-nos-á	espaldeirar+nós.AD.1.PL+FUT+3+SG
espaldeirar-nos-ão	espaldeirar+nós.AD.1.PL+FUT+3+PL
espaldeirar-nos-ás	espaldeirar+nós.AD.1.PL+FUT+2+SG
espaldeirar-nos-ei	espaldeirar+nós.AD.1.PL+FUT+1+SG
espaldeirar-nos-eis	espaldeirar+nós.AD.1.PL+FUT+2+PL
espaldeirar-nos-emos	espaldeirar+nós.AD.1.PL+FUT+1+PL
espaldeirar-nos	espaldeirar+nós.AD.1.PL+INF
espaldeirar-nos	espaldeirar+nós.AD.1.PL+INF+1+SG
espaldeirar-nos	espaldeirar+nós.AD.1.PL+INF+3+SG
espaldeirar-nos	espaldeirar+nós.AD.1.PL+SBJF+1+SG
espaldeirar-nos	espaldeirar+nós.AD.1.PL+SBJF+3+SG
espaldeirar-nos-ia	espaldeirar+nós.AD.1.PL+COND+1+SG
espaldeirar-nos-ia	espaldeirar+nós.AD.1.PL+COND+3+SG
espaldeirar-nos-iam	espaldeirar+nós.AD.1.PL+COND+3+PL
espaldeirar-nos-íamos	espaldeirar+nós.AD.1.PL+COND+1+PL
espaldeirar-nos-ias	espaldeirar+nós.AD.1.PL+COND+2+SG
espaldeirar-nos-íeis	espaldeirar+nós.AD.1.PL+COND+2+PL
espaldeirar-se-á	espaldeirar+V.ele.REFL+FUT+3+SG
espaldeirar-se-ão	espaldeirar+V.ele.REFL+FUT+3+PL
espaldeirar-se	espaldeirar+V.ele.REFL+INF
espaldeirar-se	espaldeirar+V.ele.REFL+INF+3+SG
espaldeirar-se	espaldeirar+V.ele.REFL+SBJF+3+SG
espaldeirar-se-ia	espaldeirar+V.ele.REFL+COND+3+SG
espaldeirar-se-iam	espaldeirar+V.ele.REFL+COND+3+PL
espaldeirar-te-á	espaldeirar+V.tu.AD.2.SG+FUT+3+SG
espaldeirar-te-ão	espaldeirar+V.tu.AD.2.SG+FUT+3+PL
espaldeirar-te-ás	espaldeirar+V.tu.AD.2.SG+FUT+2+SG
espaldeirar-te-ei	espaldeirar+V.tu.AD.2.SG+FUT+1+SG
espaldeirar-te-eis	espaldeirar+V.tu.AD.2.SG+FUT+2+PL
espaldeirar-te-emos	espaldeirar+V.tu.AD.2.SG+FUT+1+PL
espaldeirar-te	espaldeirar+V.tu.AD.2.SG+INF
espaldeirar-te	espaldeirar+V.tu.AD.2.SG+INF+1+SG
espaldeirar-te	espaldeirar+V.tu.AD.2.SG+INF+3+SG
espaldeirar-te	espaldeirar+V.tu.AD.2.SG+SBJF+1+SG
espaldeirar-te	espaldeirar+V.tu.AD.2.SG+SBJF+3+SG
espaldeirar-te-ia	espaldeirar+V.tu.AD.2.SG+COND+1+SG
espaldeirar-te-ia	espaldeirar+V.tu.AD.2.SG+COND+3+SG
espaldeirar-te-iam	espaldeirar+V.tu.AD.2.SG+COND+3+PL
espaldeirar-te-íamos	espaldeirar+V.tu.AD.2.SG+COND+1+PL
espaldeirar-te-ias	espaldeirar+V.tu.AD.2.SG+COND+2+SG
espaldeirar-te-íeis	espaldeirar+V.tu.AD.2.SG+COND+2+PL
espaldeirar-vos-á	espaldeirar+V.vós.AD.2.PL+FUT+3+SG
espaldeirar-vos-ão	espaldeirar+V.vós.AD.2.PL+FUT+3+PL
espaldeirar-vos-ás	espaldeirar+V.vós.AD.2.PL+FUT+2+SG
espaldeirar-vos-ei	espaldeirar+V.vós.AD.2.PL+FUT+1+SG
espaldeirar-vos-eis	espaldeirar+V.vós.AD.2.PL+FUT+2+PL
espaldeirar-vos-emos	espaldeirar+V.vós.AD.2.PL+FUT+1+PL
espaldeirar-vos	espaldeirar+V.vós.AD.2.PL+INF
espaldeirar-vos	espaldeirar+V.vós.AD.2.PL+INF+1+SG
espaldeirar-vos	espaldeirar+V.vós.AD.2.PL+INF+3+SG
espaldeirar-vos	espaldeirar+V.vós.AD.2.PL+SBJF+1+SG
espaldeirar-vos	espaldeirar+V.vós.AD.2.PL+SBJF+3+SG
espaldeirar-vos-ia	espaldeirar+V.vós.AD.2.PL+COND+1+SG
espaldeirar-vos-ia	espaldeirar+V.vós.AD.2.PL+COND+3+SG
espaldeirar-vos-iam	espaldeirar+V.vós.AD.2.PL+COND+3+PL
espaldeirar-vos-íamos	espaldeirar+V.vós.AD.2.PL+COND+1+PL
espaldeirar-vos-ias	espaldeirar+V.vós.AD.2.PL+COND+2+SG
espaldeirar-vos-íeis	espaldeirar+V.vós.AD.2.PL+COND+2+PL
espaldeira-se	espaldeirar+V.ele.REFL+PRS+3+SG
espaldeiras-lhe	espaldeirar+V.ele.DAT.3.SG+PRS+2+SG
espaldeiras-lhes	espaldeirar+V.ele.DAT.3.PL+PRS+2+SG
espaldeiras-me	espaldeirar+V.eu.AD.1.SG+PRS+2+SG
espaldeiraste-a	espaldeirar+V.ele.ACC.3.F.SG+PRF+2+SG
espaldeiraste-as	espaldeirar+V.ele.ACC.3.F.PL+PRF+2+SG
espaldeiras-te	espaldeirar+V.tu.AD.2.SG+PRS+2+SG
espaldeiraste-la	espaldeirar+V.ele.ACC.3.F.SG+PRF+2+PL
espaldeiraste-las	espaldeirar+V.ele.ACC.3.F.PL+PRF+2+PL
espaldeiraste-lhe	espaldeirar+V.ele.DAT.3.SG+PRF+2+SG
espaldeiraste-lhes	espaldeirar+V.ele.DAT.3.PL+PRF+2+SG
espaldeiraste-lo	espaldeirar+V.ele.ACC.3.M.SG+PRF+2+PL
espaldeiraste-los	espaldeirar+V.ele.ACC.3.M.PL+PRF+2+PL
espaldeiraste-me	espaldeirar+V.eu.AD.1.SG+PRF+2+SG
espaldeiraste-nos	espaldeirar+nós.AD.1.PL+PRF+2+PL
espaldeiraste-nos	espaldeirar+nós.AD.1.PL+PRF+2+SG
espaldeiraste-o	espaldeirar+V.ele.ACC.3.M.SG+PRF+2+SG
espaldeiraste-os	espaldeirar+V.ele.ACC.3.M.PL+PRF+2+SG
espaldeirastes-lhe	espaldeirar+V.ele.DAT.3.SG+PRF+2+PL
espaldeirastes-lhes	espaldeirar+V.ele.DAT.3.PL+PRF+2+PL
espaldeirastes-me	espaldeirar+V.eu.AD.1.SG+PRF+2+PL
espaldeirastes-te	espaldeirar+V.tu.AD.2.SG+PRF+2+PL
espaldeirastes-vos	espaldeirar+V.vós.AD.2.PL+PRF+2+PL
espaldeiraste-te	espaldeirar+V.tu.AD.2.SG+PRF+2+SG
espaldeiraste-vos	espaldeirar+V.vós.AD.2.PL+PRF+2+SG
espaldeiras-vos	espaldeirar+V.vós.AD.2.PL+PRS+2+SG
espaldeira-te	espaldeirar+V.tu.AD.2.SG+PRS+3+SG
espaldeirava-a	espaldeirar+V.ele.ACC.3.F.SG+IMPF+1+SG
espaldeirava-a	espaldeirar+V.ele.ACC.3.F.SG+IMPF+3+SG
espaldeirava-as	espaldeirar+V.ele.ACC.3.F.PL+IMPF+1+SG
espaldeirava-as	espaldeirar+V.ele.ACC.3.F.PL+IMPF+3+SG
espaldeirava-la	espaldeirar+V.ele.ACC.3.F.SG+IMPF+2+SG
espaldeirava-las	espaldeirar+V.ele.ACC.3.F.PL+IMPF+2+SG
espaldeirava-lhe	espaldeirar+V.ele.DAT.3.SG+IMPF+1+SG
espaldeirava-lhe	espaldeirar+V.ele.DAT.3.SG+IMPF+3+SG
espaldeirava-lhes	espaldeirar+V.ele.DAT.3.PL+IMPF+1+SG
espaldeirava-lhes	espaldeirar+V.ele.DAT.3.PL+IMPF+3+SG
espaldeirava-lo	espaldeirar+V.ele.ACC.3.M.SG+IMPF+2+SG
espaldeirava-los	espaldeirar+V.ele.ACC.3.M.PL+IMPF+2+SG
espaldeirava-me	espaldeirar+V.eu.AD.1.SG+IMPF+1+SG
espaldeirava-me	espaldeirar+V.eu.AD.1.SG+IMPF+3+SG
espaldeiravam-lhe	espaldeirar+V.ele.DAT.3.SG+IMPF+3+PL
espaldeiravam-lhes	espaldeirar+V.ele.DAT.3.PL+IMPF+3+PL
espaldeiravam-me	espaldeirar+V.eu.AD.1.SG+IMPF+3+PL
espaldeiravam-na	espaldeirar+V.ele.ACC.3.F.SG+IMPF+3+PL
espaldeiravam-nas	espaldeirar+V.ele.ACC.3.F.PL+IMPF+3+PL
espaldeiravam-no	espaldeirar+V.ele.ACC.3.M.SG+IMPF+3+PL
espaldeiravam-nos	espaldeirar+V.ele.ACC.3.M.PL+IMPF+3+PL
espaldeiravam-nos	espaldeirar+V.nós.AD.1.PL+IMPF+3+PL
espaldeirávamo-la	espaldeirar+V.ele.ACC.3.F.SG+IMPF+1+PL
espaldeirávamo-las	espaldeirar+V.ele.ACC.3.F.PL+IMPF+1+PL
espaldeirávamo-lo	espaldeirar+V.ele.ACC.3.M.SG+IMPF+1+PL
espaldeirávamo-los	espaldeirar+V.ele.ACC.3.M.PL+IMPF+1+PL
espaldeirávamo-nos	espaldeirar+nós.AD.1.PL+IMPF+1+PL
espaldeirávamos-lhe	espaldeirar+V.ele.DAT.3.SG+IMPF+1+PL
espaldeirávamos-lhes	espaldeirar+V.ele.DAT.3.PL+IMPF+1+PL
espaldeirávamos-me	espaldeirar+V.eu.AD.1.SG+IMPF+1+PL
espaldeirávamos-te	espaldeirar+V.tu.AD.2.SG+IMPF+1+PL
espaldeirávamos-vos	espaldeirar+V.vós.AD.2.PL+IMPF+1+PL
espaldeiravam-se	espaldeirar+V.ele.REFL+IMPF+3+PL
espaldeiravam-te	espaldeirar+V.tu.AD.2.SG+IMPF+3+PL
espaldeiravam-vos	espaldeirar+V.vós.AD.2.PL+IMPF+3+PL
espaldeirava-nos	espaldeirar+nós.AD.1.PL+IMPF+1+SG
espaldeirava-nos	espaldeirar+nós.AD.1.PL+IMPF+2+SG
espaldeirava-nos	espaldeirar+nós.AD.1.PL+IMPF+3+SG
espaldeirava-o	espaldeirar+V.ele.ACC.3.M.SG+IMPF+1+SG
espaldeirava-o	espaldeirar+V.ele.ACC.3.M.SG+IMPF+3+SG
espaldeirava-os	espaldeirar+V.ele.ACC.3.M.PL+IMPF+1+SG
espaldeirava-os	espaldeirar+V.ele.ACC.3.M.PL+IMPF+3+SG
espaldeirava-se	espaldeirar+V.ele.REFL+IMPF+1+SG
espaldeirava-se	espaldeirar+V.ele.REFL+IMPF+3+SG
espaldeiravas-lhe	espaldeirar+V.ele.DAT.3.SG+IMPF+2+SG
espaldeiravas-lhes	espaldeirar+V.ele.DAT.3.PL+IMPF+2+SG
espaldeiravas-me	espaldeirar+V.eu.AD.1.SG+IMPF+2+SG
espaldeiravas-te	espaldeirar+V.tu.AD.2.SG+IMPF+2+SG
espaldeiravas-vos	espaldeirar+V.vós.AD.2.PL+IMPF+2+SG
espaldeirava-te	espaldeirar+V.tu.AD.2.SG+IMPF+1+SG
espaldeirava-te	espaldeirar+V.tu.AD.2.SG+IMPF+3+SG
espaldeirava-vos	espaldeirar+V.vós.AD.2.PL+IMPF+1+SG
espaldeirava-vos	espaldeirar+V.vós.AD.2.PL+IMPF+3+SG
espaldeirávei-la	espaldeirar+V.ele.ACC.3.F.SG+IMPF+2+PL
espaldeirávei-las	espaldeirar+V.ele.ACC.3.F.PL+IMPF+2+PL
espaldeirávei-lo	espaldeirar+V.ele.ACC.3.M.SG+IMPF+2+PL
espaldeirávei-los	espaldeirar+V.ele.ACC.3.M.PL+IMPF+2+PL
espaldeirávei-nos	espaldeirar+nós.AD.1.PL+IMPF+2+PL
espaldeiráveis-lhe	espaldeirar+V.ele.DAT.3.SG+IMPF+2+PL
espaldeiráveis-lhes	espaldeirar+V.ele.DAT.3.PL+IMPF+2+PL
espaldeiráveis-me	espaldeirar+V.eu.AD.1.SG+IMPF+2+PL
espaldeiráveis-te	espaldeirar+V.tu.AD.2.SG+IMPF+2+PL
espaldeiráveis-vos	espaldeirar+V.vós.AD.2.PL+IMPF+2+PL
espaldeira-vos	espaldeirar+V.vós.AD.2.PL+PRS+3+SG
espaldeire-a	espaldeirar+V.ele.ACC.3.F.SG+IMP+3+SG
espaldeire-as	espaldeirar+V.ele.ACC.3.F.PL+IMP+3+SG
espaldeirei-a	espaldeirar+V.ele.ACC.3.F.SG+PRF+1+SG
espaldeirei-as	espaldeirar+V.ele.ACC.3.F.PL+PRF+1+SG
espaldeirei-lhe	espaldeirar+V.ele.DAT.3.SG+PRF+1+SG
espaldeirei-lhes	espaldeirar+V.ele.DAT.3.PL+PRF+1+SG
espaldeirei-me	espaldeirar+V.eu.AD.1.SG+PRF+1+SG
espaldeirei-nos	espaldeirar+nós.AD.1.PL+PRF+1+SG
espaldeirei-o	espaldeirar+V.ele.ACC.3.M.SG+PRF+1+SG
espaldeirei-os	espaldeirar+V.ele.ACC.3.M.PL+PRF+1+SG
espaldeirei-te	espaldeirar+V.tu.AD.2.SG+PRF+1+SG
espaldeirei-vos	espaldeirar+V.vós.AD.2.PL+PRF+1+SG
espaldeire-lhe	espaldeirar+V.ele.DAT.3.SG+IMP+3+SG
espaldeire-lhes	espaldeirar+V.ele.DAT.3.PL+IMP+3+SG
espaldeire-me	espaldeirar+V.eu.AD.1.SG+IMP+3+SG
espaldeirem-lhe	espaldeirar+V.ele.DAT.3.SG+IMP+3+PL
espaldeirem-lhes	espaldeirar+V.ele.DAT.3.PL+IMP+3+PL
espaldeirem-me	espaldeirar+V.eu.AD.1.SG+IMP+3+PL
espaldeirem-na	espaldeirar+V.ele.ACC.3.F.SG+IMP+3+PL
espaldeirem-nas	espaldeirar+V.ele.ACC.3.F.PL+IMP+3+PL
espaldeirem-no	espaldeirar+V.ele.ACC.3.M.SG+IMP+3+PL
espaldeirem-nos	espaldeirar+V.ele.ACC.3.M.PL+IMP+3+PL
espaldeirem-nos	espaldeirar+V.nós.AD.1.PL+IMP+3+PL
espaldeiremo-la	espaldeirar+V.ele.ACC.3.F.SG+IMP+1+PL
espaldeiremo-las	espaldeirar+V.ele.ACC.3.F.PL+IMP+1+PL
espaldeiremo-lo	espaldeirar+V.ele.ACC.3.M.SG+IMP+1+PL
espaldeiremo-los	espaldeirar+V.ele.ACC.3.M.PL+IMP+1+PL
espaldeiremo-nos	espaldeirar+nós.AD.1.PL+IMP+1+PL
espaldeiremos-lhe	espaldeirar+V.ele.DAT.3.SG+IMP+1+PL
espaldeiremos-lhes	espaldeirar+V.ele.DAT.3.PL+IMP+1+PL
espaldeiremos-me	espaldeirar+V.eu.AD.1.SG+IMP+1+PL
espaldeiremos-te	espaldeirar+V.tu.AD.2.SG+IMP+1+PL
espaldeiremos-vos	espaldeirar+V.vós.AD.2.PL+IMP+1+PL
espaldeirem-se	espaldeirar+V.ele.REFL+IMP+3+PL
espaldeirem-te	espaldeirar+V.tu.AD.2.SG+IMP+3+PL
espaldeirem-vos	espaldeirar+V.vós.AD.2.PL+IMP+3+PL
espaldeire-nos	espaldeirar+nós.AD.1.PL+IMP+3+SG
espaldeire-o	espaldeirar+V.ele.ACC.3.M.SG+IMP+3+SG
espaldeire-os	espaldeirar+V.ele.ACC.3.M.PL+IMP+3+SG
espaldeire-se	espaldeirar+V.ele.REFL+IMP+3+SG
espaldeire-te	espaldeirar+V.tu.AD.2.SG+IMP+3+SG
espaldeire-vos	espaldeirar+V.vós.AD.2.PL+IMP+3+SG
espaldeiro-a	espaldeirar+V.ele.ACC.3.F.SG+PRS+1+SG
espaldeiro-as	espaldeirar+V.ele.ACC.3.F.PL+PRS+1+SG
espaldeiro-lhe	espaldeirar+V.ele.DAT.3.SG+PRS+1+SG
espaldeiro-lhes	espaldeirar+V.ele.DAT.3.PL+PRS+1+SG
espaldeiro-me	espaldeirar+V.eu.AD.1.SG+PRS+1+SG
espaldeiro-nos	espaldeirar+nós.AD.1.PL+PRS+1+SG
espaldeiro-o	espaldeirar+V.ele.ACC.3.M.SG+PRS+1+SG
espaldeiro-os	espaldeirar+V.ele.ACC.3.M.PL+PRS+1+SG
espaldeiro-te	espaldeirar+V.tu.AD.2.SG+PRS+1+SG
espaldeirou-a	espaldeirar+V.ele.ACC.3.F.SG+PRF+3+SG
espaldeirou-as	espaldeirar+V.ele.ACC.3.F.PL+PRF+3+SG
espaldeirou-lhe	espaldeirar+V.ele.DAT.3.SG+PRF+3+SG
espaldeirou-lhes	espaldeirar+V.ele.DAT.3.PL+PRF+3+SG
espaldeirou-me	espaldeirar+V.eu.AD.1.SG+PRF+3+SG
espaldeirou-nos	espaldeirar+nós.AD.1.PL+PRF+3+SG
espaldeirou-o	espaldeirar+V.ele.ACC.3.M.SG+PRF+3+SG
espaldeirou-os	espaldeirar+V.ele.ACC.3.M.PL+PRF+3+SG
espaldeirou-se	espaldeirar+V.ele.REFL+PRF+3+SG
espaldeirou-te	espaldeirar+V.tu.AD.2.SG+PRF+3+SG
espaldeirou-vos	espaldeirar+V.vós.AD.2.PL+PRF+3+SG
espaldeiro-vos	espaldeirar+V.vós.AD.2.PL+PRS+1+SG
espaldei-te	espaldar+V.tu.AD.2.SG+PRF+1+SG
espaldei-vos	espaldar+V.vós.AD.2.PL+PRF+1+SG
espalde-lhe	espaldar+V.ele.DAT.3.SG+IMP+3+SG
espalde-lhes	espaldar+V.ele.DAT.3.PL+IMP+3+SG
espalde-me	espaldar+V.eu.AD.1.SG+IMP+3+SG
espaldem-lhe	espaldar+V.ele.DAT.3.SG+IMP+3+PL
espaldem-lhes	espaldar+V.ele.DAT.3.PL+IMP+3+PL
espaldem-me	espaldar+V.eu.AD.1.SG+IMP+3+PL
espaldem-na	espaldar+V.ele.ACC.3.F.SG+IMP+3+PL
espaldem-nas	espaldar+V.ele.ACC.3.F.PL+IMP+3+PL
espaldem-no	espaldar+V.ele.ACC.3.M.SG+IMP+3+PL
espaldem-nos	espaldar+V.ele.ACC.3.M.PL+IMP+3+PL
espaldem-nos	espaldar+V.nós.AD.1.PL+IMP+3+PL
espaldemo-la	espaldar+V.ele.ACC.3.F.SG+IMP+1+PL
espaldemo-las	espaldar+V.ele.ACC.3.F.PL+IMP+1+PL
espaldemo-lo	espaldar+V.ele.ACC.3.M.SG+IMP+1+PL
espaldemo-los	espaldar+V.ele.ACC.3.M.PL+IMP+1+PL
espaldemo-nos	espaldar+nós.AD.1.PL+IMP+1+PL
espaldemos-lhe	espaldar+V.ele.DAT.3.SG+IMP+1+PL
espaldemos-lhes	espaldar+V.ele.DAT.3.PL+IMP+1+PL
espaldemos-me	espaldar+V.eu.AD.1.SG+IMP+1+PL
espaldemos-te	espaldar+V.tu.AD.2.SG+IMP+1+PL
espaldemos-vos	espaldar+V.vós.AD.2.PL+IMP+1+PL
espaldem-se	espaldar+V.ele.REFL+IMP+3+PL
espaldem-te	espaldar+V.tu.AD.2.SG+IMP+3+PL
espaldem-vos	espaldar+V.vós.AD.2.PL+IMP+3+PL
espalde-nos	espaldar+nós.AD.1.PL+IMP+3+SG
espalde-o	espaldar+V.ele.ACC.3.M.SG+IMP+3+SG
espalde-os	espaldar+V.ele.ACC.3.M.PL+IMP+3+SG
espaldeou-a	espaldear+V.ele.ACC.3.F.SG+PRF+3+SG
espaldeou-as	espaldear+V.ele.ACC.3.F.PL+PRF+3+SG
espaldeou-lhe	espaldear+V.ele.DAT.3.SG+PRF+3+SG
espaldeou-lhes	espaldear+V.ele.DAT.3.PL+PRF+3+SG
espaldeou-me	espaldear+V.eu.AD.1.SG+PRF+3+SG
espaldeou-nos	espaldear+nós.AD.1.PL+PRF+3+SG
espaldeou-o	espaldear+V.ele.ACC.3.M.SG+PRF+3+SG
espaldeou-os	espaldear+V.ele.ACC.3.M.PL+PRF+3+SG
espaldeou-se	espaldear+V.ele.REFL+PRF+3+SG
espaldeou-te	espaldear+V.tu.AD.2.SG+PRF+3+SG
espaldeou-vos	espaldear+V.vós.AD.2.PL+PRF+3+SG
espalde-se	espaldar+V.ele.REFL+IMP+3+SG
espalde-te	espaldar+V.tu.AD.2.SG+IMP+3+SG
espalde-vos	espaldar+V.vós.AD.2.PL+IMP+3+SG
espaldo-a	espaldar+V.ele.ACC.3.F.SG+PRS+1+SG
espaldo-as	espaldar+V.ele.ACC.3.F.PL+PRS+1+SG
espaldo-lhe	espaldar+V.ele.DAT.3.SG+PRS+1+SG
espaldo-lhes	espaldar+V.ele.DAT.3.PL+PRS+1+SG
espaldo-me	espaldar+V.eu.AD.1.SG+PRS+1+SG
espaldo-nos	espaldar+nós.AD.1.PL+PRS+1+SG
espaldo-o	espaldar+V.ele.ACC.3.M.SG+PRS+1+SG
espaldo-os	espaldar+V.ele.ACC.3.M.PL+PRS+1+SG
espaldo-te	espaldar+V.tu.AD.2.SG+PRS+1+SG
espaldou-a	espaldar+V.ele.ACC.3.F.SG+PRF+3+SG
espaldou-as	espaldar+V.ele.ACC.3.F.PL+PRF+3+SG
espaldou-lhe	espaldar+V.ele.DAT.3.SG+PRF+3+SG
espaldou-lhes	espaldar+V.ele.DAT.3.PL+PRF+3+SG
espaldou-me	espaldar+V.eu.AD.1.SG+PRF+3+SG
espaldou-nos	espaldar+nós.AD.1.PL+PRF+3+SG
espaldou-o	espaldar+V.ele.ACC.3.M.SG+PRF+3+SG
espaldou-os	espaldar+V.ele.ACC.3.M.PL+PRF+3+SG
espaldou-se	espaldar+V.ele.REFL+PRF+3+SG
espaldou-te	espaldar+V.tu.AD.2.SG+PRF+3+SG
espaldou-vos	espaldar+V.vós.AD.2.PL+PRF+3+SG
espaldo-vos	espaldar+V.vós.AD.2.PL+PRS+1+SG
espalha-a	espalhar+V.ele.ACC.3.F.SG+PRS+3+SG
espalha-as	espalhar+V.ele.ACC.3.F.PL+PRS+3+SG
espalhafata-a	espalhafatar+V.ele.ACC.3.F.SG+PRS+3+SG
espalhafata-as	espalhafatar+V.ele.ACC.3.F.PL+PRS+3+SG
espalhafatai-la	espalhafatar+V.ele.ACC.3.F.SG+PRS+2+PL
espalhafatai-las	espalhafatar+V.ele.ACC.3.F.PL+PRS+2+PL
espalhafatai-lo	espalhafatar+V.ele.ACC.3.M.SG+PRS+2+PL
espalhafatai-los	espalhafatar+V.ele.ACC.3.M.PL+PRS+2+PL
espalhafatai-nos	espalhafatar+nós.AD.1.PL+PRS+2+PL
espalhafatais-lhe	espalhafatar+V.ele.DAT.3.SG+PRS+2+PL
espalhafatais-lhes	espalhafatar+V.ele.DAT.3.PL+PRS+2+PL
espalhafatais-me	espalhafatar+V.eu.AD.1.SG+PRS+2+PL
espalhafatais-te	espalhafatar+V.tu.AD.2.SG+PRS+2+PL
espalhafatais-vos	espalhafatar+V.vós.AD.2.PL+PRS+2+PL
espalhafatá-la-á	espalhafatar+V.ele.ACC.3.F.SG+FUT+3+SG
espalhafatá-la-ão	espalhafatar+V.ele.ACC.3.F.SG+FUT+3+PL
espalhafatá-la-ás	espalhafatar+V.ele.ACC.3.F.SG+FUT+2+SG
espalhafatá-la-ei	espalhafatar+V.ele.ACC.3.F.SG+FUT+1+SG
espalhafatá-la-eis	espalhafatar+V.ele.ACC.3.F.SG+FUT+2+PL
espalhafatá-la-emos	espalhafatar+V.ele.ACC.3.F.SG+FUT+1+PL
espalhafatá-la	espalhafatar+V.ele.ACC.3.F.SG+INF+1+SG
espalhafatá-la	espalhafatar+V.ele.ACC.3.F.SG+INF+3+SG
espalhafata-la	espalhafatar+V.ele.ACC.3.F.SG+PRS+2+SG
espalhafatá-la	espalhafatar+V.ele.ACC.3.F.SG+SBJF+1+SG
espalhafatá-la	espalhafatar+V.ele.ACC.3.F.SG+SBJF+3+SG
espalhafatá-la-ia	espalhafatar+V.ele.ACC.3.F.SG+COND+1+SG
espalhafatá-la-ia	espalhafatar+V.ele.ACC.3.F.SG+COND+3+SG
espalhafatá-la-iam	espalhafatar+V.ele.ACC.3.F.SG+COND+3+PL
espalhafatá-la-íamos	espalhafatar+V.ele.ACC.3.F.SG+COND+1+PL
espalhafatá-la-ias	espalhafatar+V.ele.ACC.3.F.SG+COND+2+SG
espalhafatá-la-íeis	espalhafatar+V.ele.ACC.3.F.SG+COND+2+PL
espalhafatá-las-á	espalhafatar+V.ele.ACC.3.F.PL+FUT+3+SG
espalhafatá-las-ão	espalhafatar+V.ele.ACC.3.F.PL+FUT+3+PL
espalhafatá-las-ás	espalhafatar+V.ele.ACC.3.F.PL+FUT+2+SG
espalhafatá-las-ei	espalhafatar+V.ele.ACC.3.F.PL+FUT+1+SG
espalhafatá-las-eis	espalhafatar+V.ele.ACC.3.F.PL+FUT+2+PL
espalhafatá-las-emos	espalhafatar+V.ele.ACC.3.F.PL+FUT+1+PL
espalhafatá-las	espalhafatar+V.ele.ACC.3.F.PL+INF+1+SG
espalhafatá-las	espalhafatar+V.ele.ACC.3.F.PL+INF+3+SG
espalhafata-las	espalhafatar+V.ele.ACC.3.F.PL+PRS+2+SG
espalhafatá-las	espalhafatar+V.ele.ACC.3.F.PL+SBJF+1+SG
espalhafatá-las	espalhafatar+V.ele.ACC.3.F.PL+SBJF+3+SG
espalhafatá-las-ia	espalhafatar+V.ele.ACC.3.F.PL+COND+1+SG
espalhafatá-las-ia	espalhafatar+V.ele.ACC.3.F.PL+COND+3+SG
espalhafatá-las-iam	espalhafatar+V.ele.ACC.3.F.PL+COND+3+PL
espalhafatá-las-íamos	espalhafatar+V.ele.ACC.3.F.PL+COND+1+PL
espalhafatá-las-ias	espalhafatar+V.ele.ACC.3.F.PL+COND+2+SG
espalhafatá-las-íeis	espalhafatar+V.ele.ACC.3.F.PL+COND+2+PL
espalhafata-lhe	espalhafatar+V.ele.DAT.3.SG+PRS+3+SG
espalhafata-lhes	espalhafatar+V.ele.DAT.3.PL+PRS+3+SG
espalhafatá-lo-á	espalhafatar+V.ele.ACC.3.M.SG+FUT+3+SG
espalhafatá-lo-ão	espalhafatar+V.ele.ACC.3.M.SG+FUT+3+PL
espalhafatá-lo-ás	espalhafatar+V.ele.ACC.3.M.SG+FUT+2+SG
espalhafatá-lo-ei	espalhafatar+V.ele.ACC.3.M.SG+FUT+1+SG
espalhafatá-lo-eis	espalhafatar+V.ele.ACC.3.M.SG+FUT+2+PL
espalhafatá-lo-emos	espalhafatar+V.ele.ACC.3.M.SG+FUT+1+PL
espalhafatá-lo	espalhafatar+V.ele.ACC.3.M.SG+INF+1+SG
espalhafatá-lo	espalhafatar+V.ele.ACC.3.M.SG+INF+3+SG
espalhafata-lo	espalhafatar+V.ele.ACC.3.M.SG+PRS+2+SG
espalhafatá-lo	espalhafatar+V.ele.ACC.3.M.SG+SBJF+1+SG
espalhafatá-lo	espalhafatar+V.ele.ACC.3.M.SG+SBJF+3+SG
espalhafatá-lo-ia	espalhafatar+V.ele.ACC.3.M.SG+COND+1+SG
espalhafatá-lo-ia	espalhafatar+V.ele.ACC.3.M.SG+COND+3+SG
espalhafatá-lo-iam	espalhafatar+V.ele.ACC.3.M.SG+COND+3+PL
espalhafatá-lo-íamos	espalhafatar+V.ele.ACC.3.M.SG+COND+1+PL
espalhafatá-lo-ias	espalhafatar+V.ele.ACC.3.M.SG+COND+2+SG
espalhafatá-lo-íeis	espalhafatar+V.ele.ACC.3.M.SG+COND+2+PL
espalhafatá-los-á	espalhafatar+V.ele.ACC.3.M.PL+FUT+3+SG
espalhafatá-los-ão	espalhafatar+V.ele.ACC.3.M.PL+FUT+3+PL
espalhafatá-los-ás	espalhafatar+V.ele.ACC.3.M.PL+FUT+2+SG
espalhafatá-los-ei	espalhafatar+V.ele.ACC.3.M.PL+FUT+1+SG
espalhafatá-los-eis	espalhafatar+V.ele.ACC.3.M.PL+FUT+2+PL
espalhafatá-los-emos	espalhafatar+V.ele.ACC.3.M.PL+FUT+1+PL
espalhafatá-los	espalhafatar+V.ele.ACC.3.M.PL+INF+1+SG
espalhafatá-los	espalhafatar+V.ele.ACC.3.M.PL+INF+3+SG
espalhafata-los	espalhafatar+V.ele.ACC.3.M.PL+PRS+2+SG
espalhafatá-los	espalhafatar+V.ele.ACC.3.M.PL+SBJF+1+SG
espalhafatá-los	espalhafatar+V.ele.ACC.3.M.PL+SBJF+3+SG
espalhafatá-los-ia	espalhafatar+V.ele.ACC.3.M.PL+COND+1+SG
espalhafatá-los-ia	espalhafatar+V.ele.ACC.3.M.PL+COND+3+SG
espalhafatá-los-iam	espalhafatar+V.ele.ACC.3.M.PL+COND+3+PL
espalhafatá-los-íamos	espalhafatar+V.ele.ACC.3.M.PL+COND+1+PL
espalhafatá-los-ias	espalhafatar+V.ele.ACC.3.M.PL+COND+2+SG
espalhafatá-los-íeis	espalhafatar+V.ele.ACC.3.M.PL+COND+2+PL
espalhafata-me	espalhafatar+V.eu.AD.1.SG+PRS+3+SG
espalhafatam-lhe	espalhafatar+V.ele.DAT.3.SG+PRS+3+PL
espalhafatam-lhes	espalhafatar+V.ele.DAT.3.PL+PRS+3+PL
espalhafatam-me	espalhafatar+V.eu.AD.1.SG+PRS+3+PL
espalhafatam-na	espalhafatar+V.ele.ACC.3.F.SG+PRS+3+PL
espalhafatam-nas	espalhafatar+V.ele.ACC.3.F.PL+PRS+3+PL
espalhafatam-no	espalhafatar+V.ele.ACC.3.M.SG+PRS+3+PL
espalhafatam-nos	espalhafatar+V.ele.ACC.3.M.PL+PRS+3+PL
espalhafatam-nos	espalhafatar+V.nós.AD.1.PL+PRS+3+PL
espalhafatamo-la	espalhafatar+V.ele.ACC.3.F.SG+PRF+1+PL
espalhafatamo-la	espalhafatar+V.ele.ACC.3.F.SG+PRS+1+PL
espalhafatamo-las	espalhafatar+V.ele.ACC.3.F.PL+PRF+1+PL
espalhafatamo-las	espalhafatar+V.ele.ACC.3.F.PL+PRS+1+PL
espalhafatamo-lo	espalhafatar+V.ele.ACC.3.M.SG+PRF+1+PL
espalhafatamo-lo	espalhafatar+V.ele.ACC.3.M.SG+PRS+1+PL
espalhafatamo-los	espalhafatar+V.ele.ACC.3.M.PL+PRF+1+PL
espalhafatamo-los	espalhafatar+V.ele.ACC.3.M.PL+PRS+1+PL
espalhafatamo-nos	espalhafatar+nós.AD.1.PL+PRF+1+PL
espalhafatamo-nos	espalhafatar+nós.AD.1.PL+PRS+1+PL
espalhafatamos-lhe	espalhafatar+V.ele.DAT.3.SG+PRF+1+PL
espalhafatamos-lhe	espalhafatar+V.ele.DAT.3.SG+PRS+1+PL
espalhafatamos-lhes	espalhafatar+V.ele.DAT.3.PL+PRF+1+PL
espalhafatamos-lhes	espalhafatar+V.ele.DAT.3.PL+PRS+1+PL
espalhafatamos-me	espalhafatar+V.eu.AD.1.SG+PRF+1+PL
espalhafatamos-me	espalhafatar+V.eu.AD.1.SG+PRS+1+PL
espalhafatamos-te	espalhafatar+V.tu.AD.2.SG+PRF+1+PL
espalhafatamos-te	espalhafatar+V.tu.AD.2.SG+PRS+1+PL
espalhafatamos-vos	espalhafatar+V.vós.AD.2.PL+PRF+1+PL
espalhafatamos-vos	espalhafatar+V.vós.AD.2.PL+PRS+1+PL
espalhafatam-se	espalhafatar+V.ele.REFL+PRS+3+PL
espalhafatam-te	espalhafatar+V.tu.AD.2.SG+PRS+3+PL
espalhafatam-vos	espalhafatar+V.vós.AD.2.PL+PRS+3+PL
espalhafatando-a	espalhafatar+V.ele.ACC.3.F.SG+GRD
espalhafatando-as	espalhafatar+V.ele.ACC.3.F.PL+GRD
espalhafatando-lhe	espalhafatar+V.ele.DAT.3.SG+GRD
espalhafatando-lhes	espalhafatar+V.ele.DAT.3.PL+GRD
espalhafatando-me	espalhafatar+V.eu.AD.1.SG+GRD
espalhafatando-nos	espalhafatar+nós.AD.1.PL+GRD
espalhafatando-o	espalhafatar+V.ele.ACC.3.M.SG+GRD
espalhafatando-os	espalhafatar+V.ele.ACC.3.M.PL+GRD
espalhafatando-se	espalhafatar+V.ele.REFL+GRD
espalhafatando-te	espalhafatar+V.tu.AD.2.SG+GRD
espalhafatando-vos	espalhafatar+V.vós.AD.2.PL+GRD
espalhafata-nos	espalhafatar+nós.AD.1.PL+PRS+2+SG
espalhafata-nos	espalhafatar+nós.AD.1.PL+PRS+3+SG
espalhafata-o	espalhafatar+V.ele.ACC.3.M.SG+PRS+3+SG
espalhafata-os	espalhafatar+V.ele.ACC.3.M.PL+PRS+3+SG
espalhafatara-a	espalhafatar+V.ele.ACC.3.F.SG+PQP+1+SG
espalhafatara-a	espalhafatar+V.ele.ACC.3.F.SG+PQP+3+SG
espalhafatara-as	espalhafatar+V.ele.ACC.3.F.PL+PQP+1+SG
espalhafatara-as	espalhafatar+V.ele.ACC.3.F.PL+PQP+3+SG
espalhafatara-la	espalhafatar+V.ele.ACC.3.F.SG+PQP+2+SG
espalhafatara-las	espalhafatar+V.ele.ACC.3.F.PL+PQP+2+SG
espalhafatara-lhe	espalhafatar+V.ele.DAT.3.SG+PQP+1+SG
espalhafatara-lhe	espalhafatar+V.ele.DAT.3.SG+PQP+3+SG
espalhafatara-lhes	espalhafatar+V.ele.DAT.3.PL+PQP+1+SG
espalhafatara-lhes	espalhafatar+V.ele.DAT.3.PL+PQP+3+SG
espalhafatara-lo	espalhafatar+V.ele.ACC.3.M.SG+PQP+2+SG
espalhafatara-los	espalhafatar+V.ele.ACC.3.M.PL+PQP+2+SG
espalhafatara-me	espalhafatar+V.eu.AD.1.SG+PQP+1+SG
espalhafatara-me	espalhafatar+V.eu.AD.1.SG+PQP+3+SG
espalhafataram-lhe	espalhafatar+V.ele.DAT.3.SG+PQP+3+PL
espalhafataram-lhe	espalhafatar+V.ele.DAT.3.SG+PRF+3+PL
espalhafataram-lhes	espalhafatar+V.ele.DAT.3.PL+PQP+3+PL
espalhafataram-lhes	espalhafatar+V.ele.DAT.3.PL+PRF+3+PL
espalhafataram-me	espalhafatar+V.eu.AD.1.SG+PQP+3+PL
espalhafataram-me	espalhafatar+V.eu.AD.1.SG+PRF+3+PL
espalhafataram-na	espalhafatar+V.ele.ACC.3.F.SG+PQP+3+PL
espalhafataram-na	espalhafatar+V.ele.ACC.3.F.SG+PRF+3+PL
espalhafataram-nas	espalhafatar+V.ele.ACC.3.F.PL+PQP+3+PL
espalhafataram-nas	espalhafatar+V.ele.ACC.3.F.PL+PRF+3+PL
espalhafataram-no	espalhafatar+V.ele.ACC.3.M.SG+PQP+3+PL
espalhafataram-no	espalhafatar+V.ele.ACC.3.M.SG+PRF+3+PL
espalhafataram-nos	espalhafatar+V.ele.ACC.3.M.PL+PQP+3+PL
espalhafataram-nos	espalhafatar+V.ele.ACC.3.M.PL+PRF+3+PL
espalhafataram-nos	espalhafatar+V.nós.AD.1.PL+PQP+3+PL
espalhafataram-nos	espalhafatar+V.nós.AD.1.PL+PRF+3+PL
espalhafatáramo-la	espalhafatar+V.ele.ACC.3.F.SG+PQP+1+PL
espalhafatáramo-las	espalhafatar+V.ele.ACC.3.F.PL+PQP+1+PL
espalhafatáramo-lo	espalhafatar+V.ele.ACC.3.M.SG+PQP+1+PL
espalhafatáramo-los	espalhafatar+V.ele.ACC.3.M.PL+PQP+1+PL
espalhafatáramo-nos	espalhafatar+nós.AD.1.PL+PQP+1+PL
espalhafatáramos-lhe	espalhafatar+V.ele.DAT.3.SG+PQP+1+PL
espalhafatáramos-lhes	espalhafatar+V.ele.DAT.3.PL+PQP+1+PL
espalhafatáramos-me	espalhafatar+V.eu.AD.1.SG+PQP+1+PL
espalhafatáramos-te	espalhafatar+V.tu.AD.2.SG+PQP+1+PL
espalhafatáramos-vos	espalhafatar+V.vós.AD.2.PL+PQP+1+PL
espalhafataram-se	espalhafatar+V.ele.REFL+PQP+3+PL
espalhafataram-se	espalhafatar+V.ele.REFL+PRF+3+PL
espalhafataram-te	espalhafatar+V.tu.AD.2.SG+PQP+3+PL
espalhafataram-te	espalhafatar+V.tu.AD.2.SG+PRF+3+PL
espalhafataram-vos	espalhafatar+V.vós.AD.2.PL+PQP+3+PL
espalhafataram-vos	espalhafatar+V.vós.AD.2.PL+PRF+3+PL
espalhafatara-nos	espalhafatar+nós.AD.1.PL+PQP+1+SG
espalhafatara-nos	espalhafatar+nós.AD.1.PL+PQP+2+SG
espalhafatara-nos	espalhafatar+nós.AD.1.PL+PQP+3+SG
espalhafatara-o	espalhafatar+V.ele.ACC.3.M.SG+PQP+1+SG
espalhafatara-o	espalhafatar+V.ele.ACC.3.M.SG+PQP+3+SG
espalhafatara-os	espalhafatar+V.ele.ACC.3.M.PL+PQP+1+SG
espalhafatara-os	espalhafatar+V.ele.ACC.3.M.PL+PQP+3+SG
espalhafatara-se	espalhafatar+V.ele.REFL+PQP+1+SG
espalhafatara-se	espalhafatar+V.ele.REFL+PQP+3+SG
espalhafataras-lhe	espalhafatar+V.ele.DAT.3.SG+PQP+2+SG
espalhafataras-lhes	espalhafatar+V.ele.DAT.3.PL+PQP+2+SG
espalhafataras-me	espalhafatar+V.eu.AD.1.SG+PQP+2+SG
espalhafataras-te	espalhafatar+V.tu.AD.2.SG+PQP+2+SG
espalhafataras-vos	espalhafatar+V.vós.AD.2.PL+PQP+2+SG
espalhafatara-te	espalhafatar+V.tu.AD.2.SG+PQP+1+SG
espalhafatara-te	espalhafatar+V.tu.AD.2.SG+PQP+3+SG
espalhafatara-vos	espalhafatar+V.vós.AD.2.PL+PQP+1+SG
espalhafatara-vos	espalhafatar+V.vós.AD.2.PL+PQP+3+SG
espalhafatarde-la	espalhafatar+V.ele.ACC.3.F.SG+INF+2+PL
espalhafatarde-la	espalhafatar+V.ele.ACC.3.F.SG+SBJF+2+PL
espalhafatarde-las	espalhafatar+V.ele.ACC.3.F.PL+INF+2+PL
espalhafatarde-las	espalhafatar+V.ele.ACC.3.F.PL+SBJF+2+PL
espalhafatarde-lo	espalhafatar+V.ele.ACC.3.M.SG+INF+2+PL
espalhafatarde-lo	espalhafatar+V.ele.ACC.3.M.SG+SBJF+2+PL
espalhafatarde-los	espalhafatar+V.ele.ACC.3.M.PL+INF+2+PL
espalhafatarde-los	espalhafatar+V.ele.ACC.3.M.PL+SBJF+2+PL
espalhafatarde-nos	espalhafatar+nós.AD.1.PL+INF+2+PL
espalhafatarde-nos	espalhafatar+nós.AD.1.PL+SBJF+2+PL
espalhafatardes-lhe	espalhafatar+V.ele.DAT.3.SG+INF+2+PL
espalhafatardes-lhe	espalhafatar+V.ele.DAT.3.SG+SBJF+2+PL
espalhafatardes-lhes	espalhafatar+V.ele.DAT.3.PL+INF+2+PL
espalhafatardes-lhes	espalhafatar+V.ele.DAT.3.PL+SBJF+2+PL
espalhafatardes-me	espalhafatar+V.eu.AD.1.SG+INF+2+PL
espalhafatardes-me	espalhafatar+V.eu.AD.1.SG+SBJF+2+PL
espalhafatardes-te	espalhafatar+V.tu.AD.2.SG+INF+2+PL
espalhafatardes-te	espalhafatar+V.tu.AD.2.SG+SBJF+2+PL
espalhafatardes-vos	espalhafatar+V.vós.AD.2.PL+INF+2+PL
espalhafatardes-vos	espalhafatar+V.vós.AD.2.PL+SBJF+2+PL
espalhafatárei-la	espalhafatar+V.ele.ACC.3.F.SG+PQP+2+PL
espalhafatárei-las	espalhafatar+V.ele.ACC.3.F.PL+PQP+2+PL
espalhafatárei-lo	espalhafatar+V.ele.ACC.3.M.SG+PQP+2+PL
espalhafatárei-los	espalhafatar+V.ele.ACC.3.M.PL+PQP+2+PL
espalhafatárei-nos	espalhafatar+nós.AD.1.PL+PQP+2+PL
espalhafatáreis-lhe	espalhafatar+V.ele.DAT.3.SG+PQP+2+PL
espalhafatáreis-lhes	espalhafatar+V.ele.DAT.3.PL+PQP+2+PL
espalhafatáreis-me	espalhafatar+V.eu.AD.1.SG+PQP+2+PL
espalhafatáreis-te	espalhafatar+V.tu.AD.2.SG+PQP+2+PL
espalhafatáreis-vos	espalhafatar+V.vós.AD.2.PL+PQP+2+PL
espalhafatare-la	espalhafatar+V.ele.ACC.3.F.SG+INF+2+SG
espalhafatare-la	espalhafatar+V.ele.ACC.3.F.SG+SBJF+2+SG
espalhafatare-las	espalhafatar+V.ele.ACC.3.F.PL+INF+2+SG
espalhafatare-las	espalhafatar+V.ele.ACC.3.F.PL+SBJF+2+SG
espalhafatare-lo	espalhafatar+V.ele.ACC.3.M.SG+INF+2+SG
espalhafatare-lo	espalhafatar+V.ele.ACC.3.M.SG+SBJF+2+SG
espalhafatare-los	espalhafatar+V.ele.ACC.3.M.PL+INF+2+SG
espalhafatare-los	espalhafatar+V.ele.ACC.3.M.PL+SBJF+2+SG
espalhafatarem-lhe	espalhafatar+V.ele.DAT.3.SG+INF+3+PL
espalhafatarem-lhe	espalhafatar+V.ele.DAT.3.SG+SBJF+3+PL
espalhafatarem-lhes	espalhafatar+V.ele.DAT.3.PL+INF+3+PL
espalhafatarem-lhes	espalhafatar+V.ele.DAT.3.PL+SBJF+3+PL
espalhafatarem-me	espalhafatar+V.eu.AD.1.SG+INF+3+PL
espalhafatarem-me	espalhafatar+V.eu.AD.1.SG+SBJF+3+PL
espalhafatarem-na	espalhafatar+V.ele.ACC.3.F.SG+INF+3+PL
espalhafatarem-na	espalhafatar+V.ele.ACC.3.F.SG+SBJF+3+PL
espalhafatarem-nas	espalhafatar+V.ele.ACC.3.F.PL+INF+3+PL
espalhafatarem-nas	espalhafatar+V.ele.ACC.3.F.PL+SBJF+3+PL
espalhafatarem-no	espalhafatar+V.ele.ACC.3.M.SG+INF+3+PL
espalhafatarem-no	espalhafatar+V.ele.ACC.3.M.SG+SBJF+3+PL
espalhafatarem-nos	espalhafatar+V.ele.ACC.3.M.PL+INF+3+PL
espalhafatarem-nos	espalhafatar+V.ele.ACC.3.M.PL+SBJF+3+PL
espalhafatarem-nos	espalhafatar+V.nós.AD.1.PL+INF+3+PL
espalhafatarem-nos	espalhafatar+V.nós.AD.1.PL+SBJF+3+PL
espalhafatarem-se	espalhafatar+V.ele.REFL+INF+3+PL
espalhafatarem-se	espalhafatar+V.ele.REFL+SBJF+3+PL
espalhafatarem-te	espalhafatar+V.tu.AD.2.SG+INF+3+PL
espalhafatarem-te	espalhafatar+V.tu.AD.2.SG+SBJF+3+PL
espalhafatarem-vos	espalhafatar+V.vós.AD.2.PL+INF+3+PL
espalhafatarem-vos	espalhafatar+V.vós.AD.2.PL+SBJF+3+PL
espalhafatare-nos	espalhafatar+nós.AD.1.PL+INF+2+SG
espalhafatare-nos	espalhafatar+nós.AD.1.PL+SBJF+2+SG
espalhafatares-lhe	espalhafatar+V.ele.DAT.3.SG+INF+2+SG
espalhafatares-lhe	espalhafatar+V.ele.DAT.3.SG+SBJF+2+SG
espalhafatares-lhes	espalhafatar+V.ele.DAT.3.PL+INF+2+SG
espalhafatares-lhes	espalhafatar+V.ele.DAT.3.PL+SBJF+2+SG
espalhafatares-me	espalhafatar+V.eu.AD.1.SG+INF+2+SG
espalhafatares-me	espalhafatar+V.eu.AD.1.SG+SBJF+2+SG
espalhafatares-te	espalhafatar+V.tu.AD.2.SG+INF+2+SG
espalhafatares-te	espalhafatar+V.tu.AD.2.SG+SBJF+2+SG
espalhafatares-vos	espalhafatar+V.vós.AD.2.PL+INF+2+SG
espalhafatares-vos	espalhafatar+V.vós.AD.2.PL+SBJF+2+SG
espalhafatar-lhe-á	espalhafatar+V.ele.DAT.3.SG+FUT+3+SG
espalhafatar-lhe-ão	espalhafatar+V.ele.DAT.3.SG+FUT+3+PL
espalhafatar-lhe-ás	espalhafatar+V.ele.DAT.3.SG+FUT+2+SG
espalhafatar-lhe-ei	espalhafatar+V.ele.DAT.3.SG+FUT+1+SG
espalhafatar-lhe-eis	espalhafatar+V.ele.DAT.3.SG+FUT+2+PL
espalhafatar-lhe-emos	espalhafatar+V.ele.DAT.3.SG+FUT+1+PL
espalhafatar-lhe	espalhafatar+V.ele.DAT.3.SG+INF
espalhafatar-lhe	espalhafatar+V.ele.DAT.3.SG+INF+1+SG
espalhafatar-lhe	espalhafatar+V.ele.DAT.3.SG+INF+3+SG
espalhafatar-lhe	espalhafatar+V.ele.DAT.3.SG+SBJF+1+SG
espalhafatar-lhe	espalhafatar+V.ele.DAT.3.SG+SBJF+3+SG
espalhafatar-lhe-ia	espalhafatar+V.ele.DAT.3.SG+COND+1+SG
espalhafatar-lhe-ia	espalhafatar+V.ele.DAT.3.SG+COND+3+SG
espalhafatar-lhe-iam	espalhafatar+V.ele.DAT.3.SG+COND+3+PL
espalhafatar-lhe-íamos	espalhafatar+V.ele.DAT.3.SG+COND+1+PL
espalhafatar-lhe-ias	espalhafatar+V.ele.DAT.3.SG+COND+2+SG
espalhafatar-lhe-íeis	espalhafatar+V.ele.DAT.3.SG+COND+2+PL
espalhafatar-lhes-á	espalhafatar+V.ele.DAT.3.PL+FUT+3+SG
espalhafatar-lhes-ão	espalhafatar+V.ele.DAT.3.PL+FUT+3+PL
espalhafatar-lhes-ás	espalhafatar+V.ele.DAT.3.PL+FUT+2+SG
espalhafatar-lhes-ei	espalhafatar+V.ele.DAT.3.PL+FUT+1+SG
espalhafatar-lhes-eis	espalhafatar+V.ele.DAT.3.PL+FUT+2+PL
espalhafatar-lhes-emos	espalhafatar+V.ele.DAT.3.PL+FUT+1+PL
espalhafatar-lhes	espalhafatar+V.ele.DAT.3.PL+INF
espalhafatar-lhes	espalhafatar+V.ele.DAT.3.PL+INF+1+SG
espalhafatar-lhes	espalhafatar+V.ele.DAT.3.PL+INF+3+SG
espalhafatar-lhes	espalhafatar+V.ele.DAT.3.PL+SBJF+1+SG
espalhafatar-lhes	espalhafatar+V.ele.DAT.3.PL+SBJF+3+SG
espalhafatar-lhes-ia	espalhafatar+V.ele.DAT.3.PL+COND+1+SG
espalhafatar-lhes-ia	espalhafatar+V.ele.DAT.3.PL+COND+3+SG
espalhafatar-lhes-iam	espalhafatar+V.ele.DAT.3.PL+COND+3+PL
espalhafatar-lhes-íamos	espalhafatar+V.ele.DAT.3.PL+COND+1+PL
espalhafatar-lhes-ias	espalhafatar+V.ele.DAT.3.PL+COND+2+SG
espalhafatar-lhes-íeis	espalhafatar+V.ele.DAT.3.PL+COND+2+PL
espalhafatar-me-á	espalhafatar+V.eu.AD.1.SG+FUT+3+SG
espalhafatar-me-ão	espalhafatar+V.eu.AD.1.SG+FUT+3+PL
espalhafatar-me-ás	espalhafatar+V.eu.AD.1.SG+FUT+2+SG
espalhafatar-me-ei	espalhafatar+V.eu.AD.1.SG+FUT+1+SG
espalhafatar-me-eis	espalhafatar+V.eu.AD.1.SG+FUT+2+PL
espalhafatar-me-emos	espalhafatar+V.eu.AD.1.SG+FUT+1+PL
espalhafatar-me	espalhafatar+V.eu.AD.1.SG+INF
espalhafatar-me	espalhafatar+V.eu.AD.1.SG+INF+1+SG
espalhafatar-me	espalhafatar+V.eu.AD.1.SG+INF+3+SG
espalhafatar-me	espalhafatar+V.eu.AD.1.SG+SBJF+1+SG
espalhafatar-me	espalhafatar+V.eu.AD.1.SG+SBJF+3+SG
espalhafatar-me-ia	espalhafatar+V.eu.AD.1.SG+COND+1+SG
espalhafatar-me-ia	espalhafatar+V.eu.AD.1.SG+COND+3+SG
espalhafatar-me-iam	espalhafatar+V.eu.AD.1.SG+COND+3+PL
espalhafatar-me-íamos	espalhafatar+V.eu.AD.1.SG+COND+1+PL
espalhafatar-me-ias	espalhafatar+V.eu.AD.1.SG+COND+2+SG
espalhafatar-me-íeis	espalhafatar+V.eu.AD.1.SG+COND+2+PL
espalhafatarmo-la	espalhafatar+V.ele.ACC.3.F.SG+INF+1+PL
espalhafatarmo-la	espalhafatar+V.ele.ACC.3.F.SG+SBJF+1+PL
espalhafatarmo-las	espalhafatar+V.ele.ACC.3.F.PL+INF+1+PL
espalhafatarmo-las	espalhafatar+V.ele.ACC.3.F.PL+SBJF+1+PL
espalhafatarmo-lo	espalhafatar+V.ele.ACC.3.M.SG+INF+1+PL
espalhafatarmo-lo	espalhafatar+V.ele.ACC.3.M.SG+SBJF+1+PL
espalhafatarmo-los	espalhafatar+V.ele.ACC.3.M.PL+INF+1+PL
espalhafatarmo-los	espalhafatar+V.ele.ACC.3.M.PL+SBJF+1+PL
espalhafatarmo-nos	espalhafatar+nós.AD.1.PL+INF+1+PL
espalhafatarmo-nos	espalhafatar+nós.AD.1.PL+SBJF+1+PL
espalhafatarmos-lhe	espalhafatar+V.ele.DAT.3.SG+INF+1+PL
espalhafatarmos-lhe	espalhafatar+V.ele.DAT.3.SG+SBJF+1+PL
espalhafatarmos-lhes	espalhafatar+V.ele.DAT.3.PL+INF+1+PL
espalhafatarmos-lhes	espalhafatar+V.ele.DAT.3.PL+SBJF+1+PL
espalhafatarmos-me	espalhafatar+V.eu.AD.1.SG+INF+1+PL
espalhafatarmos-me	espalhafatar+V.eu.AD.1.SG+SBJF+1+PL
espalhafatarmos-te	espalhafatar+V.tu.AD.2.SG+INF+1+PL
espalhafatarmos-te	espalhafatar+V.tu.AD.2.SG+SBJF+1+PL
espalhafatarmos-vos	espalhafatar+V.vós.AD.2.PL+INF+1+PL
espalhafatarmos-vos	espalhafatar+V.vós.AD.2.PL+SBJF+1+PL
espalhafatar-nos-á	espalhafatar+nós.AD.1.PL+FUT+3+SG
espalhafatar-nos-ão	espalhafatar+nós.AD.1.PL+FUT+3+PL
espalhafatar-nos-ás	espalhafatar+nós.AD.1.PL+FUT+2+SG
espalhafatar-nos-ei	espalhafatar+nós.AD.1.PL+FUT+1+SG
espalhafatar-nos-eis	espalhafatar+nós.AD.1.PL+FUT+2+PL
espalhafatar-nos-emos	espalhafatar+nós.AD.1.PL+FUT+1+PL
espalhafatar-nos	espalhafatar+nós.AD.1.PL+INF
espalhafatar-nos	espalhafatar+nós.AD.1.PL+INF+1+SG
espalhafatar-nos	espalhafatar+nós.AD.1.PL+INF+3+SG
espalhafatar-nos	espalhafatar+nós.AD.1.PL+SBJF+1+SG
espalhafatar-nos	espalhafatar+nós.AD.1.PL+SBJF+3+SG
espalhafatar-nos-ia	espalhafatar+nós.AD.1.PL+COND+1+SG
espalhafatar-nos-ia	espalhafatar+nós.AD.1.PL+COND+3+SG
espalhafatar-nos-iam	espalhafatar+nós.AD.1.PL+COND+3+PL
espalhafatar-nos-íamos	espalhafatar+nós.AD.1.PL+COND+1+PL
espalhafatar-nos-ias	espalhafatar+nós.AD.1.PL+COND+2+SG
espalhafatar-nos-íeis	espalhafatar+nós.AD.1.PL+COND+2+PL
espalhafatar-se-á	espalhafatar+V.ele.REFL+FUT+3+SG
espalhafatar-se-ão	espalhafatar+V.ele.REFL+FUT+3+PL
espalhafatar-se	espalhafatar+V.ele.REFL+INF
espalhafatar-se	espalhafatar+V.ele.REFL+INF+3+SG
espalhafatar-se	espalhafatar+V.ele.REFL+SBJF+3+SG
espalhafatar-se-ia	espalhafatar+V.ele.REFL+COND+3+SG
espalhafatar-se-iam	espalhafatar+V.ele.REFL+COND+3+PL
espalhafatar-te-á	espalhafatar+V.tu.AD.2.SG+FUT+3+SG
espalhafatar-te-ão	espalhafatar+V.tu.AD.2.SG+FUT+3+PL
espalhafatar-te-ás	espalhafatar+V.tu.AD.2.SG+FUT+2+SG
espalhafatar-te-ei	espalhafatar+V.tu.AD.2.SG+FUT+1+SG
espalhafatar-te-eis	espalhafatar+V.tu.AD.2.SG+FUT+2+PL
espalhafatar-te-emos	espalhafatar+V.tu.AD.2.SG+FUT+1+PL
espalhafatar-te	espalhafatar+V.tu.AD.2.SG+INF
espalhafatar-te	espalhafatar+V.tu.AD.2.SG+INF+1+SG
espalhafatar-te	espalhafatar+V.tu.AD.2.SG+INF+3+SG
espalhafatar-te	espalhafatar+V.tu.AD.2.SG+SBJF+1+SG
espalhafatar-te	espalhafatar+V.tu.AD.2.SG+SBJF+3+SG
espalhafatar-te-ia	espalhafatar+V.tu.AD.2.SG+COND+1+SG
espalhafatar-te-ia	espalhafatar+V.tu.AD.2.SG+COND+3+SG
espalhafatar-te-iam	espalhafatar+V.tu.AD.2.SG+COND+3+PL
espalhafatar-te-íamos	espalhafatar+V.tu.AD.2.SG+COND+1+PL
espalhafatar-te-ias	espalhafatar+V.tu.AD.2.SG+COND+2+SG
espalhafatar-te-íeis	espalhafatar+V.tu.AD.2.SG+COND+2+PL
espalhafatar-vos-á	espalhafatar+V.vós.AD.2.PL+FUT+3+SG
espalhafatar-vos-ão	espalhafatar+V.vós.AD.2.PL+FUT+3+PL
espalhafatar-vos-ás	espalhafatar+V.vós.AD.2.PL+FUT+2+SG
espalhafatar-vos-ei	espalhafatar+V.vós.AD.2.PL+FUT+1+SG
espalhafatar-vos-eis	espalhafatar+V.vós.AD.2.PL+FUT+2+PL
espalhafatar-vos-emos	espalhafatar+V.vós.AD.2.PL+FUT+1+PL
espalhafatar-vos	espalhafatar+V.vós.AD.2.PL+INF
espalhafatar-vos	espalhafatar+V.vós.AD.2.PL+INF+1+SG
espalhafatar-vos	espalhafatar+V.vós.AD.2.PL+INF+3+SG
espalhafatar-vos	espalhafatar+V.vós.AD.2.PL+SBJF+1+SG
espalhafatar-vos	espalhafatar+V.vós.AD.2.PL+SBJF+3+SG
espalhafatar-vos-ia	espalhafatar+V.vós.AD.2.PL+COND+1+SG
espalhafatar-vos-ia	espalhafatar+V.vós.AD.2.PL+COND+3+SG
espalhafatar-vos-iam	espalhafatar+V.vós.AD.2.PL+COND+3+PL
espalhafatar-vos-íamos	espalhafatar+V.vós.AD.2.PL+COND+1+PL
espalhafatar-vos-ias	espalhafatar+V.vós.AD.2.PL+COND+2+SG
espalhafatar-vos-íeis	espalhafatar+V.vós.AD.2.PL+COND+2+PL
espalhafata-se	espalhafatar+V.ele.REFL+PRS+3+SG
espalhafatas-lhe	espalhafatar+V.ele.DAT.3.SG+PRS+2+SG
espalhafatas-lhes	espalhafatar+V.ele.DAT.3.PL+PRS+2+SG
espalhafatas-me	espalhafatar+V.eu.AD.1.SG+PRS+2+SG
espalhafataste-a	espalhafatar+V.ele.ACC.3.F.SG+PRF+2+SG
espalhafataste-as	espalhafatar+V.ele.ACC.3.F.PL+PRF+2+SG
espalhafatas-te	espalhafatar+V.tu.AD.2.SG+PRS+2+SG
espalhafataste-la	espalhafatar+V.ele.ACC.3.F.SG+PRF+2+PL
espalhafataste-las	espalhafatar+V.ele.ACC.3.F.PL+PRF+2+PL
espalhafataste-lhe	espalhafatar+V.ele.DAT.3.SG+PRF+2+SG
espalhafataste-lhes	espalhafatar+V.ele.DAT.3.PL+PRF+2+SG
espalhafataste-lo	espalhafatar+V.ele.ACC.3.M.SG+PRF+2+PL
espalhafataste-los	espalhafatar+V.ele.ACC.3.M.PL+PRF+2+PL
espalhafataste-me	espalhafatar+V.eu.AD.1.SG+PRF+2+SG
espalhafataste-nos	espalhafatar+nós.AD.1.PL+PRF+2+PL
espalhafataste-nos	espalhafatar+nós.AD.1.PL+PRF+2+SG
espalhafataste-o	espalhafatar+V.ele.ACC.3.M.SG+PRF+2+SG
espalhafataste-os	espalhafatar+V.ele.ACC.3.M.PL+PRF+2+SG
espalhafatastes-lhe	espalhafatar+V.ele.DAT.3.SG+PRF+2+PL
espalhafatastes-lhes	espalhafatar+V.ele.DAT.3.PL+PRF+2+PL
espalhafatastes-me	espalhafatar+V.eu.AD.1.SG+PRF+2+PL
espalhafatastes-te	espalhafatar+V.tu.AD.2.SG+PRF+2+PL
espalhafatastes-vos	espalhafatar+V.vós.AD.2.PL+PRF+2+PL
espalhafataste-te	espalhafatar+V.tu.AD.2.SG+PRF+2+SG
espalhafataste-vos	espalhafatar+V.vós.AD.2.PL+PRF+2+SG
espalhafatas-vos	espalhafatar+V.vós.AD.2.PL+PRS+2+SG
espalhafata-te	espalhafatar+V.tu.AD.2.SG+PRS+3+SG
espalhafatava-a	espalhafatar+V.ele.ACC.3.F.SG+IMPF+1+SG
espalhafatava-a	espalhafatar+V.ele.ACC.3.F.SG+IMPF+3+SG
espalhafatava-as	espalhafatar+V.ele.ACC.3.F.PL+IMPF+1+SG
espalhafatava-as	espalhafatar+V.ele.ACC.3.F.PL+IMPF+3+SG
espalhafatava-la	espalhafatar+V.ele.ACC.3.F.SG+IMPF+2+SG
espalhafatava-las	espalhafatar+V.ele.ACC.3.F.PL+IMPF+2+SG
espalhafatava-lhe	espalhafatar+V.ele.DAT.3.SG+IMPF+1+SG
espalhafatava-lhe	espalhafatar+V.ele.DAT.3.SG+IMPF+3+SG
espalhafatava-lhes	espalhafatar+V.ele.DAT.3.PL+IMPF+1+SG
espalhafatava-lhes	espalhafatar+V.ele.DAT.3.PL+IMPF+3+SG
espalhafatava-lo	espalhafatar+V.ele.ACC.3.M.SG+IMPF+2+SG
espalhafatava-los	espalhafatar+V.ele.ACC.3.M.PL+IMPF+2+SG
espalhafatava-me	espalhafatar+V.eu.AD.1.SG+IMPF+1+SG
espalhafatava-me	espalhafatar+V.eu.AD.1.SG+IMPF+3+SG
espalhafatavam-lhe	espalhafatar+V.ele.DAT.3.SG+IMPF+3+PL
espalhafatavam-lhes	espalhafatar+V.ele.DAT.3.PL+IMPF+3+PL
espalhafatavam-me	espalhafatar+V.eu.AD.1.SG+IMPF+3+PL
espalhafatavam-na	espalhafatar+V.ele.ACC.3.F.SG+IMPF+3+PL
espalhafatavam-nas	espalhafatar+V.ele.ACC.3.F.PL+IMPF+3+PL
espalhafatavam-no	espalhafatar+V.ele.ACC.3.M.SG+IMPF+3+PL
espalhafatavam-nos	espalhafatar+V.ele.ACC.3.M.PL+IMPF+3+PL
espalhafatavam-nos	espalhafatar+V.nós.AD.1.PL+IMPF+3+PL
espalhafatávamo-la	espalhafatar+V.ele.ACC.3.F.SG+IMPF+1+PL
espalhafatávamo-las	espalhafatar+V.ele.ACC.3.F.PL+IMPF+1+PL
espalhafatávamo-lo	espalhafatar+V.ele.ACC.3.M.SG+IMPF+1+PL
espalhafatávamo-los	espalhafatar+V.ele.ACC.3.M.PL+IMPF+1+PL
espalhafatávamo-nos	espalhafatar+nós.AD.1.PL+IMPF+1+PL
espalhafatávamos-lhe	espalhafatar+V.ele.DAT.3.SG+IMPF+1+PL
espalhafatávamos-lhes	espalhafatar+V.ele.DAT.3.PL+IMPF+1+PL
espalhafatávamos-me	espalhafatar+V.eu.AD.1.SG+IMPF+1+PL
espalhafatávamos-te	espalhafatar+V.tu.AD.2.SG+IMPF+1+PL
espalhafatávamos-vos	espalhafatar+V.vós.AD.2.PL+IMPF+1+PL
espalhafatavam-se	espalhafatar+V.ele.REFL+IMPF+3+PL
espalhafatavam-te	espalhafatar+V.tu.AD.2.SG+IMPF+3+PL
espalhafatavam-vos	espalhafatar+V.vós.AD.2.PL+IMPF+3+PL
espalhafatava-nos	espalhafatar+nós.AD.1.PL+IMPF+1+SG
espalhafatava-nos	espalhafatar+nós.AD.1.PL+IMPF+2+SG
espalhafatava-nos	espalhafatar+nós.AD.1.PL+IMPF+3+SG
espalhafatava-o	espalhafatar+V.ele.ACC.3.M.SG+IMPF+1+SG
espalhafatava-o	espalhafatar+V.ele.ACC.3.M.SG+IMPF+3+SG
espalhafatava-os	espalhafatar+V.ele.ACC.3.M.PL+IMPF+1+SG
espalhafatava-os	espalhafatar+V.ele.ACC.3.M.PL+IMPF+3+SG
espalhafatava-se	espalhafatar+V.ele.REFL+IMPF+1+SG
espalhafatava-se	espalhafatar+V.ele.REFL+IMPF+3+SG
espalhafatavas-lhe	espalhafatar+V.ele.DAT.3.SG+IMPF+2+SG
espalhafatavas-lhes	espalhafatar+V.ele.DAT.3.PL+IMPF+2+SG
espalhafatavas-me	espalhafatar+V.eu.AD.1.SG+IMPF+2+SG
espalhafatavas-te	espalhafatar+V.tu.AD.2.SG+IMPF+2+SG
espalhafatavas-vos	espalhafatar+V.vós.AD.2.PL+IMPF+2+SG
espalhafatava-te	espalhafatar+V.tu.AD.2.SG+IMPF+1+SG
espalhafatava-te	espalhafatar+V.tu.AD.2.SG+IMPF+3+SG
espalhafatava-vos	espalhafatar+V.vós.AD.2.PL+IMPF+1+SG
espalhafatava-vos	espalhafatar+V.vós.AD.2.PL+IMPF+3+SG
espalhafatávei-la	espalhafatar+V.ele.ACC.3.F.SG+IMPF+2+PL
espalhafatávei-las	espalhafatar+V.ele.ACC.3.F.PL+IMPF+2+PL
espalhafatávei-lo	espalhafatar+V.ele.ACC.3.M.SG+IMPF+2+PL
espalhafatávei-los	espalhafatar+V.ele.ACC.3.M.PL+IMPF+2+PL
espalhafatávei-nos	espalhafatar+nós.AD.1.PL+IMPF+2+PL
espalhafatáveis-lhe	espalhafatar+V.ele.DAT.3.SG+IMPF+2+PL
espalhafatáveis-lhes	espalhafatar+V.ele.DAT.3.PL+IMPF+2+PL
espalhafatáveis-me	espalhafatar+V.eu.AD.1.SG+IMPF+2+PL
espalhafatáveis-te	espalhafatar+V.tu.AD.2.SG+IMPF+2+PL
espalhafatáveis-vos	espalhafatar+V.vós.AD.2.PL+IMPF+2+PL
espalhafata-vos	espalhafatar+V.vós.AD.2.PL+PRS+3+SG
espalhafate-a	espalhafatar+V.ele.ACC.3.F.SG+IMP+3+SG
espalhafate-as	espalhafatar+V.ele.ACC.3.F.PL+IMP+3+SG
espalhafatei-a	espalhafatar+V.ele.ACC.3.F.SG+PRF+1+SG
espalhafatei-as	espalhafatar+V.ele.ACC.3.F.PL+PRF+1+SG
espalhafatei-lhe	espalhafatar+V.ele.DAT.3.SG+PRF+1+SG
espalhafatei-lhes	espalhafatar+V.ele.DAT.3.PL+PRF+1+SG
espalhafatei-me	espalhafatar+V.eu.AD.1.SG+PRF+1+SG
espalhafatei-nos	espalhafatar+nós.AD.1.PL+PRF+1+SG
espalhafatei-o	espalhafatar+V.ele.ACC.3.M.SG+PRF+1+SG
espalhafatei-os	espalhafatar+V.ele.ACC.3.M.PL+PRF+1+SG
espalhafatei-te	espalhafatar+V.tu.AD.2.SG+PRF+1+SG
espalhafatei-vos	espalhafatar+V.vós.AD.2.PL+PRF+1+SG
espalhafate-lhe	espalhafatar+V.ele.DAT.3.SG+IMP+3+SG
espalhafate-lhes	espalhafatar+V.ele.DAT.3.PL+IMP+3+SG
espalhafate-me	espalhafatar+V.eu.AD.1.SG+IMP+3+SG
espalhafatem-lhe	espalhafatar+V.ele.DAT.3.SG+IMP+3+PL
espalhafatem-lhes	espalhafatar+V.ele.DAT.3.PL+IMP+3+PL
espalhafatem-me	espalhafatar+V.eu.AD.1.SG+IMP+3+PL
espalhafatem-na	espalhafatar+V.ele.ACC.3.F.SG+IMP+3+PL
espalhafatem-nas	espalhafatar+V.ele.ACC.3.F.PL+IMP+3+PL
espalhafatem-no	espalhafatar+V.ele.ACC.3.M.SG+IMP+3+PL
espalhafatem-nos	espalhafatar+V.ele.ACC.3.M.PL+IMP+3+PL
espalhafatem-nos	espalhafatar+V.nós.AD.1.PL+IMP+3+PL
espalhafatemo-la	espalhafatar+V.ele.ACC.3.F.SG+IMP+1+PL
espalhafatemo-las	espalhafatar+V.ele.ACC.3.F.PL+IMP+1+PL
espalhafatemo-lo	espalhafatar+V.ele.ACC.3.M.SG+IMP+1+PL
espalhafatemo-los	espalhafatar+V.ele.ACC.3.M.PL+IMP+1+PL
espalhafatemo-nos	espalhafatar+nós.AD.1.PL+IMP+1+PL
espalhafatemos-lhe	espalhafatar+V.ele.DAT.3.SG+IMP+1+PL
espalhafatemos-lhes	espalhafatar+V.ele.DAT.3.PL+IMP+1+PL
espalhafatemos-me	espalhafatar+V.eu.AD.1.SG+IMP+1+PL
espalhafatemos-te	espalhafatar+V.tu.AD.2.SG+IMP+1+PL
espalhafatemos-vos	espalhafatar+V.vós.AD.2.PL+IMP+1+PL
espalhafatem-se	espalhafatar+V.ele.REFL+IMP+3+PL
espalhafatem-te	espalhafatar+V.tu.AD.2.SG+IMP+3+PL
espalhafatem-vos	espalhafatar+V.vós.AD.2.PL+IMP+3+PL
espalhafate-nos	espalhafatar+nós.AD.1.PL+IMP+3+SG
espalhafate-o	espalhafatar+V.ele.ACC.3.M.SG+IMP+3+SG
espalhafate-os	espalhafatar+V.ele.ACC.3.M.PL+IMP+3+SG
espalhafate-se	espalhafatar+V.ele.REFL+IMP+3+SG
espalhafate-te	espalhafatar+V.tu.AD.2.SG+IMP+3+SG
espalhafate-vos	espalhafatar+V.vós.AD.2.PL+IMP+3+SG
espalhafato-a	espalhafatar+V.ele.ACC.3.F.SG+PRS+1+SG
espalhafato-as	espalhafatar+V.ele.ACC.3.F.PL+PRS+1+SG
espalhafato-lhe	espalhafatar+V.ele.DAT.3.SG+PRS+1+SG
espalhafato-lhes	espalhafatar+V.ele.DAT.3.PL+PRS+1+SG
espalhafato-me	espalhafatar+V.eu.AD.1.SG+PRS+1+SG
espalhafato-nos	espalhafatar+nós.AD.1.PL+PRS+1+SG
espalhafato-o	espalhafatar+V.ele.ACC.3.M.SG+PRS+1+SG
espalhafato-os	espalhafatar+V.ele.ACC.3.M.PL+PRS+1+SG
espalhafato-te	espalhafatar+V.tu.AD.2.SG+PRS+1+SG
espalhafatou-a	espalhafatar+V.ele.ACC.3.F.SG+PRF+3+SG
espalhafatou-as	espalhafatar+V.ele.ACC.3.F.PL+PRF+3+SG
espalhafatou-lhe	espalhafatar+V.ele.DAT.3.SG+PRF+3+SG
espalhafatou-lhes	espalhafatar+V.ele.DAT.3.PL+PRF+3+SG
espalhafatou-me	espalhafatar+V.eu.AD.1.SG+PRF+3+SG
espalhafatou-nos	espalhafatar+nós.AD.1.PL+PRF+3+SG
espalhafatou-o	espalhafatar+V.ele.ACC.3.M.SG+PRF+3+SG
espalhafatou-os	espalhafatar+V.ele.ACC.3.M.PL+PRF+3+SG
espalhafatou-se	espalhafatar+V.ele.REFL+PRF+3+SG
espalhafatou-te	espalhafatar+V.tu.AD.2.SG+PRF+3+SG
espalhafatou-vos	espalhafatar+V.vós.AD.2.PL+PRF+3+SG
espalhafato-vos	espalhafatar+V.vós.AD.2.PL+PRS+1+SG
espalhaga-a	espalhagar+V.ele.ACC.3.F.SG+PRS+3+SG
espalhaga-as	espalhagar+V.ele.ACC.3.F.PL+PRS+3+SG
espalhagai-la	espalhagar+V.ele.ACC.3.F.SG+PRS+2+PL
espalhagai-las	espalhagar+V.ele.ACC.3.F.PL+PRS+2+PL
espalhagai-lo	espalhagar+V.ele.ACC.3.M.SG+PRS+2+PL
espalhagai-los	espalhagar+V.ele.ACC.3.M.PL+PRS+2+PL
espalhagai-nos	espalhagar+nós.AD.1.PL+PRS+2+PL
espalhagais-lhe	espalhagar+V.ele.DAT.3.SG+PRS+2+PL
espalhagais-lhes	espalhagar+V.ele.DAT.3.PL+PRS+2+PL
espalhagais-me	espalhagar+V.eu.AD.1.SG+PRS+2+PL
espalhagais-te	espalhagar+V.tu.AD.2.SG+PRS+2+PL
espalhagais-vos	espalhagar+V.vós.AD.2.PL+PRS+2+PL
espalhagá-la-á	espalhagar+V.ele.ACC.3.F.SG+FUT+3+SG
espalhagá-la-ão	espalhagar+V.ele.ACC.3.F.SG+FUT+3+PL
espalhagá-la-ás	espalhagar+V.ele.ACC.3.F.SG+FUT+2+SG
espalhagá-la-ei	espalhagar+V.ele.ACC.3.F.SG+FUT+1+SG
espalhagá-la-eis	espalhagar+V.ele.ACC.3.F.SG+FUT+2+PL
espalhagá-la-emos	espalhagar+V.ele.ACC.3.F.SG+FUT+1+PL
espalhagá-la	espalhagar+V.ele.ACC.3.F.SG+INF+1+SG
espalhagá-la	espalhagar+V.ele.ACC.3.F.SG+INF+3+SG
espalhaga-la	espalhagar+V.ele.ACC.3.F.SG+PRS+2+SG
espalhagá-la	espalhagar+V.ele.ACC.3.F.SG+SBJF+1+SG
espalhagá-la	espalhagar+V.ele.ACC.3.F.SG+SBJF+3+SG
espalhagá-la-ia	espalhagar+V.ele.ACC.3.F.SG+COND+1+SG
espalhagá-la-ia	espalhagar+V.ele.ACC.3.F.SG+COND+3+SG
espalhagá-la-iam	espalhagar+V.ele.ACC.3.F.SG+COND+3+PL
espalhagá-la-íamos	espalhagar+V.ele.ACC.3.F.SG+COND+1+PL
espalhagá-la-ias	espalhagar+V.ele.ACC.3.F.SG+COND+2+SG
espalhagá-la-íeis	espalhagar+V.ele.ACC.3.F.SG+COND+2+PL
espalhagá-las-á	espalhagar+V.ele.ACC.3.F.PL+FUT+3+SG
espalhagá-las-ão	espalhagar+V.ele.ACC.3.F.PL+FUT+3+PL
espalhagá-las-ás	espalhagar+V.ele.ACC.3.F.PL+FUT+2+SG
espalhagá-las-ei	espalhagar+V.ele.ACC.3.F.PL+FUT+1+SG
espalhagá-las-eis	espalhagar+V.ele.ACC.3.F.PL+FUT+2+PL
espalhagá-las-emos	espalhagar+V.ele.ACC.3.F.PL+FUT+1+PL
espalhagá-las	espalhagar+V.ele.ACC.3.F.PL+INF+1+SG
espalhagá-las	espalhagar+V.ele.ACC.3.F.PL+INF+3+SG
espalhaga-las	espalhagar+V.ele.ACC.3.F.PL+PRS+2+SG
espalhagá-las	espalhagar+V.ele.ACC.3.F.PL+SBJF+1+SG
espalhagá-las	espalhagar+V.ele.ACC.3.F.PL+SBJF+3+SG
espalhagá-las-ia	espalhagar+V.ele.ACC.3.F.PL+COND+1+SG
espalhagá-las-ia	espalhagar+V.ele.ACC.3.F.PL+COND+3+SG
espalhagá-las-iam	espalhagar+V.ele.ACC.3.F.PL+COND+3+PL
espalhagá-las-íamos	espalhagar+V.ele.ACC.3.F.PL+COND+1+PL
espalhagá-las-ias	espalhagar+V.ele.ACC.3.F.PL+COND+2+SG
espalhagá-las-íeis	espalhagar+V.ele.ACC.3.F.PL+COND+2+PL
espalhaga-lhe	espalhagar+V.ele.DAT.3.SG+PRS+3+SG
espalhaga-lhes	espalhagar+V.ele.DAT.3.PL+PRS+3+SG
espalhagá-lo-á	espalhagar+V.ele.ACC.3.M.SG+FUT+3+SG
espalhagá-lo-ão	espalhagar+V.ele.ACC.3.M.SG+FUT+3+PL
espalhagá-lo-ás	espalhagar+V.ele.ACC.3.M.SG+FUT+2+SG
espalhagá-lo-ei	espalhagar+V.ele.ACC.3.M.SG+FUT+1+SG
espalhagá-lo-eis	espalhagar+V.ele.ACC.3.M.SG+FUT+2+PL
espalhagá-lo-emos	espalhagar+V.ele.ACC.3.M.SG+FUT+1+PL
espalhagá-lo	espalhagar+V.ele.ACC.3.M.SG+INF+1+SG
espalhagá-lo	espalhagar+V.ele.ACC.3.M.SG+INF+3+SG
espalhaga-lo	espalhagar+V.ele.ACC.3.M.SG+PRS+2+SG
espalhagá-lo	espalhagar+V.ele.ACC.3.M.SG+SBJF+1+SG
espalhagá-lo	espalhagar+V.ele.ACC.3.M.SG+SBJF+3+SG
espalhagá-lo-ia	espalhagar+V.ele.ACC.3.M.SG+COND+1+SG
espalhagá-lo-ia	espalhagar+V.ele.ACC.3.M.SG+COND+3+SG
espalhagá-lo-iam	espalhagar+V.ele.ACC.3.M.SG+COND+3+PL
espalhagá-lo-íamos	espalhagar+V.ele.ACC.3.M.SG+COND+1+PL
espalhagá-lo-ias	espalhagar+V.ele.ACC.3.M.SG+COND+2+SG
espalhagá-lo-íeis	espalhagar+V.ele.ACC.3.M.SG+COND+2+PL
espalhagá-los-á	espalhagar+V.ele.ACC.3.M.PL+FUT+3+SG
espalhagá-los-ão	espalhagar+V.ele.ACC.3.M.PL+FUT+3+PL
espalhagá-los-ás	espalhagar+V.ele.ACC.3.M.PL+FUT+2+SG
espalhagá-los-ei	espalhagar+V.ele.ACC.3.M.PL+FUT+1+SG
espalhagá-los-eis	espalhagar+V.ele.ACC.3.M.PL+FUT+2+PL
espalhagá-los-emos	espalhagar+V.ele.ACC.3.M.PL+FUT+1+PL
espalhagá-los	espalhagar+V.ele.ACC.3.M.PL+INF+1+SG
espalhagá-los	espalhagar+V.ele.ACC.3.M.PL+INF+3+SG
espalhaga-los	espalhagar+V.ele.ACC.3.M.PL+PRS+2+SG
espalhagá-los	espalhagar+V.ele.ACC.3.M.PL+SBJF+1+SG
espalhagá-los	espalhagar+V.ele.ACC.3.M.PL+SBJF+3+SG
espalhagá-los-ia	espalhagar+V.ele.ACC.3.M.PL+COND+1+SG
espalhagá-los-ia	espalhagar+V.ele.ACC.3.M.PL+COND+3+SG
espalhagá-los-iam	espalhagar+V.ele.ACC.3.M.PL+COND+3+PL
espalhagá-los-íamos	espalhagar+V.ele.ACC.3.M.PL+COND+1+PL
espalhagá-los-ias	espalhagar+V.ele.ACC.3.M.PL+COND+2+SG
espalhagá-los-íeis	espalhagar+V.ele.ACC.3.M.PL+COND+2+PL
espalhaga-me	espalhagar+V.eu.AD.1.SG+PRS+3+SG
espalhagam-lhe	espalhagar+V.ele.DAT.3.SG+PRS+3+PL
espalhagam-lhes	espalhagar+V.ele.DAT.3.PL+PRS+3+PL
