estigmatizei-as	estigmatizar+V.ele.ACC.3.F.PL+PRF+1+SG
estigmatizei-lhe	estigmatizar+V.ele.DAT.3.SG+PRF+1+SG
estigmatizei-lhes	estigmatizar+V.ele.DAT.3.PL+PRF+1+SG
estigmatizei-me	estigmatizar+V.eu.AD.1.SG+PRF+1+SG
estigmatizei-nos	estigmatizar+nós.AD.1.PL+PRF+1+SG
estigmatizei-o	estigmatizar+V.ele.ACC.3.M.SG+PRF+1+SG
estigmatizei-os	estigmatizar+V.ele.ACC.3.M.PL+PRF+1+SG
estigmatizei-te	estigmatizar+V.tu.AD.2.SG+PRF+1+SG
estigmatizei-vos	estigmatizar+V.vós.AD.2.PL+PRF+1+SG
estigmatize-lhe	estigmatizar+V.ele.DAT.3.SG+IMP+3+SG
estigmatize-lhes	estigmatizar+V.ele.DAT.3.PL+IMP+3+SG
estigmatize-me	estigmatizar+V.eu.AD.1.SG+IMP+3+SG
estigmatizem-lhe	estigmatizar+V.ele.DAT.3.SG+IMP+3+PL
estigmatizem-lhes	estigmatizar+V.ele.DAT.3.PL+IMP+3+PL
estigmatizem-me	estigmatizar+V.eu.AD.1.SG+IMP+3+PL
estigmatizem-na	estigmatizar+V.ele.ACC.3.F.SG+IMP+3+PL
estigmatizem-nas	estigmatizar+V.ele.ACC.3.F.PL+IMP+3+PL
estigmatizem-no	estigmatizar+V.ele.ACC.3.M.SG+IMP+3+PL
estigmatizem-nos	estigmatizar+V.ele.ACC.3.M.PL+IMP+3+PL
estigmatizem-nos	estigmatizar+V.nós.AD.1.PL+IMP+3+PL
estigmatizemo-la	estigmatizar+V.ele.ACC.3.F.SG+IMP+1+PL
estigmatizemo-las	estigmatizar+V.ele.ACC.3.F.PL+IMP+1+PL
estigmatizemo-lo	estigmatizar+V.ele.ACC.3.M.SG+IMP+1+PL
estigmatizemo-los	estigmatizar+V.ele.ACC.3.M.PL+IMP+1+PL
estigmatizemo-nos	estigmatizar+nós.AD.1.PL+IMP+1+PL
estigmatizemos-lhe	estigmatizar+V.ele.DAT.3.SG+IMP+1+PL
estigmatizemos-lhes	estigmatizar+V.ele.DAT.3.PL+IMP+1+PL
estigmatizemos-me	estigmatizar+V.eu.AD.1.SG+IMP+1+PL
estigmatizemos-te	estigmatizar+V.tu.AD.2.SG+IMP+1+PL
estigmatizemos-vos	estigmatizar+V.vós.AD.2.PL+IMP+1+PL
estigmatizem-se	estigmatizar+V.ele.REFL+IMP+3+PL
estigmatizem-te	estigmatizar+V.tu.AD.2.SG+IMP+3+PL
estigmatizem-vos	estigmatizar+V.vós.AD.2.PL+IMP+3+PL
estigmatize-nos	estigmatizar+nós.AD.1.PL+IMP+3+SG
estigmatize-o	estigmatizar+V.ele.ACC.3.M.SG+IMP+3+SG
estigmatize-os	estigmatizar+V.ele.ACC.3.M.PL+IMP+3+SG
estigmatize-se	estigmatizar+V.ele.REFL+IMP+3+SG
estigmatize-te	estigmatizar+V.tu.AD.2.SG+IMP+3+SG
estigmatize-vos	estigmatizar+V.vós.AD.2.PL+IMP+3+SG
estigmatizo-a	estigmatizar+V.ele.ACC.3.F.SG+PRS+1+SG
estigmatizo-as	estigmatizar+V.ele.ACC.3.F.PL+PRS+1+SG
estigmatizo-lhe	estigmatizar+V.ele.DAT.3.SG+PRS+1+SG
estigmatizo-lhes	estigmatizar+V.ele.DAT.3.PL+PRS+1+SG
estigmatizo-me	estigmatizar+V.eu.AD.1.SG+PRS+1+SG
estigmatizo-nos	estigmatizar+nós.AD.1.PL+PRS+1+SG
estigmatizo-o	estigmatizar+V.ele.ACC.3.M.SG+PRS+1+SG
estigmatizo-os	estigmatizar+V.ele.ACC.3.M.PL+PRS+1+SG
estigmatizo-te	estigmatizar+V.tu.AD.2.SG+PRS+1+SG
estigmatizou-a	estigmatizar+V.ele.ACC.3.F.SG+PRF+3+SG
estigmatizou-as	estigmatizar+V.ele.ACC.3.F.PL+PRF+3+SG
estigmatizou-lhe	estigmatizar+V.ele.DAT.3.SG+PRF+3+SG
estigmatizou-lhes	estigmatizar+V.ele.DAT.3.PL+PRF+3+SG
estigmatizou-me	estigmatizar+V.eu.AD.1.SG+PRF+3+SG
estigmatizou-nos	estigmatizar+nós.AD.1.PL+PRF+3+SG
estigmatizou-o	estigmatizar+V.ele.ACC.3.M.SG+PRF+3+SG
estigmatizou-os	estigmatizar+V.ele.ACC.3.M.PL+PRF+3+SG
estigmatizou-se	estigmatizar+V.ele.REFL+PRF+3+SG
estigmatizou-te	estigmatizar+V.tu.AD.2.SG+PRF+3+SG
estigmatizou-vos	estigmatizar+V.vós.AD.2.PL+PRF+3+SG
estigmatizo-vos	estigmatizar+V.vós.AD.2.PL+PRS+1+SG
estigmava-a	estigmar+V.ele.ACC.3.F.SG+IMPF+1+SG
estigmava-a	estigmar+V.ele.ACC.3.F.SG+IMPF+3+SG
estigmava-as	estigmar+V.ele.ACC.3.F.PL+IMPF+1+SG
estigmava-as	estigmar+V.ele.ACC.3.F.PL+IMPF+3+SG
estigmava-la	estigmar+V.ele.ACC.3.F.SG+IMPF+2+SG
estigmava-las	estigmar+V.ele.ACC.3.F.PL+IMPF+2+SG
estigmava-lhe	estigmar+V.ele.DAT.3.SG+IMPF+1+SG
estigmava-lhe	estigmar+V.ele.DAT.3.SG+IMPF+3+SG
estigmava-lhes	estigmar+V.ele.DAT.3.PL+IMPF+1+SG
estigmava-lhes	estigmar+V.ele.DAT.3.PL+IMPF+3+SG
estigmava-lo	estigmar+V.ele.ACC.3.M.SG+IMPF+2+SG
estigmava-los	estigmar+V.ele.ACC.3.M.PL+IMPF+2+SG
estigmava-me	estigmar+V.eu.AD.1.SG+IMPF+1+SG
estigmava-me	estigmar+V.eu.AD.1.SG+IMPF+3+SG
estigmavam-lhe	estigmar+V.ele.DAT.3.SG+IMPF+3+PL
estigmavam-lhes	estigmar+V.ele.DAT.3.PL+IMPF+3+PL
estigmavam-me	estigmar+V.eu.AD.1.SG+IMPF+3+PL
estigmavam-na	estigmar+V.ele.ACC.3.F.SG+IMPF+3+PL
estigmavam-nas	estigmar+V.ele.ACC.3.F.PL+IMPF+3+PL
estigmavam-no	estigmar+V.ele.ACC.3.M.SG+IMPF+3+PL
estigmavam-nos	estigmar+V.ele.ACC.3.M.PL+IMPF+3+PL
estigmavam-nos	estigmar+V.nós.AD.1.PL+IMPF+3+PL
estigmávamo-la	estigmar+V.ele.ACC.3.F.SG+IMPF+1+PL
estigmávamo-las	estigmar+V.ele.ACC.3.F.PL+IMPF+1+PL
estigmávamo-lo	estigmar+V.ele.ACC.3.M.SG+IMPF+1+PL
estigmávamo-los	estigmar+V.ele.ACC.3.M.PL+IMPF+1+PL
estigmávamo-nos	estigmar+V.ele.ACC.3.M.PL+IMPF+1+PL
estigmávamo-nos	estigmar+V.nós.AD.1.PL+IMPF+1+PL
estigmávamos-lhe	estigmar+V.ele.DAT.3.SG+IMPF+1+PL
estigmávamos-lhes	estigmar+V.ele.DAT.3.PL+IMPF+1+PL
estigmávamos-me	estigmar+V.eu.AD.1.SG+IMPF+1+PL
estigmávamos-te	estigmar+V.tu.AD.2.SG+IMPF+1+PL
estigmávamos-vos	estigmar+V.vós.AD.2.PL+IMPF+1+PL
estigmavam-se	estigmar+V.ele.REFL+IMPF+3+PL
estigmavam-te	estigmar+V.tu.AD.2.SG+IMPF+3+PL
estigmavam-vos	estigmar+V.vós.AD.2.PL+IMPF+3+PL
estigmava-nos	estigmar+nós.AD.1.PL+IMPF+1+SG
estigmava-nos	estigmar+nós.AD.1.PL+IMPF+2+SG
estigmava-nos	estigmar+nós.AD.1.PL+IMPF+3+SG
estigmava-o	estigmar+V.ele.ACC.3.M.SG+IMPF+1+SG
estigmava-o	estigmar+V.ele.ACC.3.M.SG+IMPF+3+SG
estigmava-os	estigmar+V.ele.ACC.3.M.PL+IMPF+1+SG
estigmava-os	estigmar+V.ele.ACC.3.M.PL+IMPF+3+SG
estigmava-se	estigmar+V.ele.REFL+IMPF+1+SG
estigmava-se	estigmar+V.ele.REFL+IMPF+3+SG
estigmavas-lhe	estigmar+V.ele.DAT.3.SG+IMPF+2+SG
estigmavas-lhes	estigmar+V.ele.DAT.3.PL+IMPF+2+SG
estigmavas-me	estigmar+V.eu.AD.1.SG+IMPF+2+SG
estigmavas-te	estigmar+V.tu.AD.2.SG+IMPF+2+SG
estigmavas-vos	estigmar+V.vós.AD.2.PL+IMPF+2+SG
estigmava-te	estigmar+V.tu.AD.2.SG+IMPF+1+SG
estigmava-te	estigmar+V.tu.AD.2.SG+IMPF+3+SG
estigmava-vos	estigmar+V.vós.AD.2.PL+IMPF+1+SG
estigmava-vos	estigmar+V.vós.AD.2.PL+IMPF+3+SG
estigmávei-la	estigmar+V.ele.ACC.3.F.SG+IMPF+2+PL
estigmávei-las	estigmar+V.ele.ACC.3.F.PL+IMPF+2+PL
estigmávei-lo	estigmar+V.ele.ACC.3.M.SG+IMPF+2+PL
estigmávei-los	estigmar+V.ele.ACC.3.M.PL+IMPF+2+PL
estigmávei-nos	estigmar+V.ele.ACC.3.M.PL+IMPF+2+PL
estigmávei-nos	estigmar+V.nós.AD.1.PL+IMPF+2+PL
estigmáveis-lhe	estigmar+V.ele.DAT.3.SG+IMPF+2+PL
estigmáveis-lhes	estigmar+V.ele.DAT.3.PL+IMPF+2+PL
estigmáveis-me	estigmar+V.eu.AD.1.SG+IMPF+2+PL
estigmáveis-te	estigmar+V.tu.AD.2.SG+IMPF+2+PL
estigmáveis-vos	estigmar+V.vós.AD.2.PL+IMPF+2+PL
estigma-vos	estigmar+V.vós.AD.2.PL+PRS+3+SG
estigme-a	estigmar+V.ele.ACC.3.F.SG+IMP+3+SG
estigme-as	estigmar+V.ele.ACC.3.F.PL+IMP+3+SG
estigmei-a	estigmar+V.ele.ACC.3.F.SG+PRF+1+SG
estigmei-as	estigmar+V.ele.ACC.3.F.PL+PRF+1+SG
estigmei-lhe	estigmar+V.ele.DAT.3.SG+PRF+1+SG
estigmei-lhes	estigmar+V.ele.DAT.3.PL+PRF+1+SG
estigmei-me	estigmar+V.eu.AD.1.SG+PRF+1+SG
estigmei-nos	estigmar+nós.AD.1.PL+PRF+1+SG
estigmei-o	estigmar+V.ele.ACC.3.M.SG+PRF+1+SG
estigmei-os	estigmar+V.ele.ACC.3.M.PL+PRF+1+SG
estigmei-te	estigmar+V.tu.AD.2.SG+PRF+1+SG
estigmei-vos	estigmar+V.vós.AD.2.PL+PRF+1+SG
estigme-lhe	estigmar+V.ele.DAT.3.SG+IMP+3+SG
estigme-lhes	estigmar+V.ele.DAT.3.PL+IMP+3+SG
estigme-me	estigmar+V.eu.AD.1.SG+IMP+3+SG
estigmem-lhe	estigmar+V.ele.DAT.3.SG+IMP+3+PL
estigmem-lhes	estigmar+V.ele.DAT.3.PL+IMP+3+PL
estigmem-me	estigmar+V.eu.AD.1.SG+IMP+3+PL
estigmem-na	estigmar+V.ele.ACC.3.F.SG+IMP+3+PL
estigmem-nas	estigmar+V.ele.ACC.3.F.PL+IMP+3+PL
estigmem-no	estigmar+V.ele.ACC.3.M.SG+IMP+3+PL
estigmem-nos	estigmar+V.ele.ACC.3.M.PL+IMP+3+PL
estigmem-nos	estigmar+V.nós.AD.1.PL+IMP+3+PL
estigmemo-la	estigmar+V.ele.ACC.3.F.SG+IMP+1+PL
estigmemo-las	estigmar+V.ele.ACC.3.F.PL+IMP+1+PL
estigmemo-lo	estigmar+V.ele.ACC.3.M.SG+IMP+1+PL
estigmemo-los	estigmar+V.ele.ACC.3.M.PL+IMP+1+PL
estigmemo-nos	estigmar+nós.AD.1.PL+IMP+1+PL
estigmemos-lhe	estigmar+V.ele.DAT.3.SG+IMP+1+PL
estigmemos-lhes	estigmar+V.ele.DAT.3.PL+IMP+1+PL
estigmemos-me	estigmar+V.eu.AD.1.SG+IMP+1+PL
estigmemos-te	estigmar+V.tu.AD.2.SG+IMP+1+PL
estigmemos-vos	estigmar+V.vós.AD.2.PL+IMP+1+PL
estigmem-se	estigmar+V.ele.REFL+IMP+3+PL
estigmem-te	estigmar+V.tu.AD.2.SG+IMP+3+PL
estigmem-vos	estigmar+V.vós.AD.2.PL+IMP+3+PL
estigme-nos	estigmar+nós.AD.1.PL+IMP+3+SG
estigme-o	estigmar+V.ele.ACC.3.M.SG+IMP+3+SG
estigme-os	estigmar+V.ele.ACC.3.M.PL+IMP+3+SG
estigme-se	estigmar+V.ele.REFL+IMP+3+SG
estigme-te	estigmar+V.tu.AD.2.SG+IMP+3+SG
estigme-vos	estigmar+V.vós.AD.2.PL+IMP+3+SG
estigmo-a	estigmar+V.ele.ACC.3.F.SG+PRS+1+SG
estigmo-as	estigmar+V.ele.ACC.3.F.PL+PRS+1+SG
estigmo-lhe	estigmar+V.ele.DAT.3.SG+PRS+1+SG
estigmo-lhes	estigmar+V.ele.DAT.3.PL+PRS+1+SG
estigmo-me	estigmar+V.eu.AD.1.SG+PRS+1+SG
estigmo-nos	estigmar+nós.AD.1.PL+PRS+1+SG
estigmo-o	estigmar+V.ele.ACC.3.M.SG+PRS+1+SG
estigmo-os	estigmar+V.ele.ACC.3.M.PL+PRS+1+SG
estigmo-te	estigmar+V.tu.AD.2.SG+PRS+1+SG
estigmou-a	estigmar+V.ele.ACC.3.F.SG+PRF+3+SG
estigmou-as	estigmar+V.ele.ACC.3.F.PL+PRF+3+SG
estigmou-lhe	estigmar+V.ele.DAT.3.SG+PRF+3+SG
estigmou-lhes	estigmar+V.ele.DAT.3.PL+PRF+3+SG
estigmou-me	estigmar+V.eu.AD.1.SG+PRF+3+SG
estigmou-nos	estigmar+nós.AD.1.PL+PRF+3+SG
estigmou-o	estigmar+V.ele.ACC.3.M.SG+PRF+3+SG
estigmou-os	estigmar+V.ele.ACC.3.M.PL+PRF+3+SG
estigmou-se	estigmar+V.ele.REFL+PRF+3+SG
estigmou-te	estigmar+V.tu.AD.2.SG+PRF+3+SG
estigmou-vos	estigmar+V.vós.AD.2.PL+PRF+3+SG
estigmo-vos	estigmar+V.vós.AD.2.PL+PRS+1+SG
estila-a	estilar+V.ele.ACC.3.F.SG+PRS+3+SG
estila-as	estilar+V.ele.ACC.3.F.PL+PRS+3+SG
estilai-la	estilar+V.ele.ACC.3.F.SG+PRS+2+PL
estilai-las	estilar+V.ele.ACC.3.F.PL+PRS+2+PL
estilai-lo	estilar+V.ele.ACC.3.M.SG+PRS+2+PL
estilai-los	estilar+V.ele.ACC.3.M.PL+PRS+2+PL
estilai-nos	estilar+nós.AD.1.PL+PRS+2+PL
estilais-lhe	estilar+V.ele.DAT.3.SG+PRS+2+PL
estilais-lhes	estilar+V.ele.DAT.3.PL+PRS+2+PL
estilais-me	estilar+V.eu.AD.1.SG+PRS+2+PL
estilais-te	estilar+V.tu.AD.2.SG+PRS+2+PL
estilais-vos	estilar+V.vós.AD.2.PL+PRS+2+PL
estilá-la-á	estilar+V.ele.ACC.3.F.SG+FUT+3+SG
estilá-la-ão	estilar+V.ele.ACC.3.F.SG+FUT+3+PL
estilá-la-ás	estilar+V.ele.ACC.3.F.SG+FUT+2+SG
estilá-la-ei	estilar+V.ele.ACC.3.F.SG+FUT+1+SG
estilá-la-eis	estilar+V.ele.ACC.3.F.SG+FUT+2+PL
estilá-la-emos	estilar+V.ele.ACC.3.F.SG+FUT+1+PL
estilá-la	estilar+V.ele.ACC.3.F.SG+INF+1+SG
estilá-la	estilar+V.ele.ACC.3.F.SG+INF+3+SG
estila-la	estilar+V.ele.ACC.3.F.SG+PRS+2+SG
estilá-la	estilar+V.ele.ACC.3.F.SG+SBJF+1+SG
estilá-la	estilar+V.ele.ACC.3.F.SG+SBJF+3+SG
estilá-la-ia	estilar+V.ele.ACC.3.F.SG+COND+1+SG
estilá-la-ia	estilar+V.ele.ACC.3.F.SG+COND+3+SG
estilá-la-iam	estilar+V.ele.ACC.3.F.SG+COND+3+PL
estilá-la-íamos	estilar+V.ele.ACC.3.F.SG+COND+1+PL
estilá-la-ias	estilar+V.ele.ACC.3.F.SG+COND+2+SG
estilá-la-íeis	estilar+V.ele.ACC.3.F.SG+COND+2+PL
estilá-las-á	estilar+V.ele.ACC.3.F.PL+FUT+3+SG
estilá-las-ão	estilar+V.ele.ACC.3.F.PL+FUT+3+PL
estilá-las-ás	estilar+V.ele.ACC.3.F.PL+FUT+2+SG
estilá-las-ei	estilar+V.ele.ACC.3.F.PL+FUT+1+SG
estilá-las-eis	estilar+V.ele.ACC.3.F.PL+FUT+2+PL
estilá-las-emos	estilar+V.ele.ACC.3.F.PL+FUT+1+PL
estilá-las	estilar+V.ele.ACC.3.F.PL+INF+1+SG
estilá-las	estilar+V.ele.ACC.3.F.PL+INF+3+SG
estila-las	estilar+V.ele.ACC.3.F.PL+PRS+2+SG
estilá-las	estilar+V.ele.ACC.3.F.PL+SBJF+1+SG
estilá-las	estilar+V.ele.ACC.3.F.PL+SBJF+3+SG
estilá-las-ia	estilar+V.ele.ACC.3.F.PL+COND+1+SG
estilá-las-ia	estilar+V.ele.ACC.3.F.PL+COND+3+SG
estilá-las-iam	estilar+V.ele.ACC.3.F.PL+COND+3+PL
estilá-las-íamos	estilar+V.ele.ACC.3.F.PL+COND+1+PL
estilá-las-ias	estilar+V.ele.ACC.3.F.PL+COND+2+SG
estilá-las-íeis	estilar+V.ele.ACC.3.F.PL+COND+2+PL
estila-lhe	estilar+V.ele.DAT.3.SG+PRS+3+SG
estila-lhes	estilar+V.ele.DAT.3.PL+PRS+3+SG
estilá-lo-á	estilar+V.ele.ACC.3.M.SG+FUT+3+SG
estilá-lo-ão	estilar+V.ele.ACC.3.M.SG+FUT+3+PL
estilá-lo-ás	estilar+V.ele.ACC.3.M.SG+FUT+2+SG
estilá-lo-ei	estilar+V.ele.ACC.3.M.SG+FUT+1+SG
estilá-lo-eis	estilar+V.ele.ACC.3.M.SG+FUT+2+PL
estilá-lo-emos	estilar+V.ele.ACC.3.M.SG+FUT+1+PL
estilá-lo	estilar+V.ele.ACC.3.M.SG+INF+1+SG
estilá-lo	estilar+V.ele.ACC.3.M.SG+INF+3+SG
estila-lo	estilar+V.ele.ACC.3.M.SG+PRS+2+SG
estilá-lo	estilar+V.ele.ACC.3.M.SG+SBJF+1+SG
estilá-lo	estilar+V.ele.ACC.3.M.SG+SBJF+3+SG
estilá-lo-ia	estilar+V.ele.ACC.3.M.SG+COND+1+SG
estilá-lo-ia	estilar+V.ele.ACC.3.M.SG+COND+3+SG
estilá-lo-iam	estilar+V.ele.ACC.3.M.SG+COND+3+PL
estilá-lo-íamos	estilar+V.ele.ACC.3.M.SG+COND+1+PL
estilá-lo-ias	estilar+V.ele.ACC.3.M.SG+COND+2+SG
estilá-lo-íeis	estilar+V.ele.ACC.3.M.SG+COND+2+PL
estilá-los-á	estilar+V.ele.ACC.3.M.PL+FUT+3+SG
estilá-los-ão	estilar+V.ele.ACC.3.M.PL+FUT+3+PL
estilá-los-ás	estilar+V.ele.ACC.3.M.PL+FUT+2+SG
estilá-los-ei	estilar+V.ele.ACC.3.M.PL+FUT+1+SG
estilá-los-eis	estilar+V.ele.ACC.3.M.PL+FUT+2+PL
estilá-los-emos	estilar+V.ele.ACC.3.M.PL+FUT+1+PL
estilá-los	estilar+V.ele.ACC.3.M.PL+INF+1+SG
estilá-los	estilar+V.ele.ACC.3.M.PL+INF+3+SG
estila-los	estilar+V.ele.ACC.3.M.PL+PRS+2+SG
estilá-los	estilar+V.ele.ACC.3.M.PL+SBJF+1+SG
estilá-los	estilar+V.ele.ACC.3.M.PL+SBJF+3+SG
estilá-los-ia	estilar+V.ele.ACC.3.M.PL+COND+1+SG
estilá-los-ia	estilar+V.ele.ACC.3.M.PL+COND+3+SG
estilá-los-iam	estilar+V.ele.ACC.3.M.PL+COND+3+PL
estilá-los-íamos	estilar+V.ele.ACC.3.M.PL+COND+1+PL
estilá-los-ias	estilar+V.ele.ACC.3.M.PL+COND+2+SG
estilá-los-íeis	estilar+V.ele.ACC.3.M.PL+COND+2+PL
estila-me	estilar+V.eu.AD.1.SG+PRS+3+SG
estilam-lhe	estilar+V.ele.DAT.3.SG+PRS+3+PL
estilam-lhes	estilar+V.ele.DAT.3.PL+PRS+3+PL
estilam-me	estilar+V.eu.AD.1.SG+PRS+3+PL
estilam-na	estilar+V.ele.ACC.3.F.SG+PRS+3+PL
estilam-nas	estilar+V.ele.ACC.3.F.PL+PRS+3+PL
estilam-no	estilar+V.ele.ACC.3.M.SG+PRS+3+PL
estilam-nos	estilar+V.ele.ACC.3.M.PL+PRS+3+PL
estilam-nos	estilar+V.nós.AD.1.PL+PRS+3+PL
estilamo-la	estilar+V.ele.ACC.3.F.SG+PRF+1+PL
estilamo-la	estilar+V.ele.ACC.3.F.SG+PRS+1+PL
estilamo-las	estilar+V.ele.ACC.3.F.PL+PRF+1+PL
estilamo-las	estilar+V.ele.ACC.3.F.PL+PRS+1+PL
estilamo-lo	estilar+V.ele.ACC.3.M.SG+PRF+1+PL
estilamo-lo	estilar+V.ele.ACC.3.M.SG+PRS+1+PL
estilamo-los	estilar+V.ele.ACC.3.M.PL+PRF+1+PL
estilamo-los	estilar+V.ele.ACC.3.M.PL+PRS+1+PL
estilamo-nos	estilar+nós.AD.1.PL+PRF+1+PL
estilamo-nos	estilar+nós.AD.1.PL+PRS+1+PL
estilamos-lhe	estilar+V.ele.DAT.3.SG+PRF+1+PL
estilamos-lhe	estilar+V.ele.DAT.3.SG+PRS+1+PL
estilamos-lhes	estilar+V.ele.DAT.3.PL+PRF+1+PL
estilamos-lhes	estilar+V.ele.DAT.3.PL+PRS+1+PL
estilamos-me	estilar+V.eu.AD.1.SG+PRF+1+PL
estilamos-me	estilar+V.eu.AD.1.SG+PRS+1+PL
estilamos-te	estilar+V.tu.AD.2.SG+PRF+1+PL
estilamos-te	estilar+V.tu.AD.2.SG+PRS+1+PL
estilamos-vos	estilar+V.vós.AD.2.PL+PRF+1+PL
estilamos-vos	estilar+V.vós.AD.2.PL+PRS+1+PL
estilam-se	estilar+V.ele.REFL+PRS+3+PL
estilam-te	estilar+V.tu.AD.2.SG+PRS+3+PL
estilam-vos	estilar+V.vós.AD.2.PL+PRS+3+PL
estilando-a	estilar+V.ele.ACC.3.F.SG+GRD
estilando-as	estilar+V.ele.ACC.3.F.PL+GRD
estilando-lhe	estilar+V.ele.DAT.3.SG+GRD
estilando-lhes	estilar+V.ele.DAT.3.PL+GRD
estilando-me	estilar+V.eu.AD.1.SG+GRD
estilando-nos	estilar+nós.AD.1.PL+GRD
estilando-o	estilar+V.ele.ACC.3.M.SG+GRD
estilando-os	estilar+V.ele.ACC.3.M.PL+GRD
estilando-se	estilar+V.ele.REFL+GRD
estilando-te	estilar+V.tu.AD.2.SG+GRD
estilando-vos	estilar+V.vós.AD.2.PL+GRD
estila-nos	estilar+nós.AD.1.PL+PRS+2+SG
estila-nos	estilar+nós.AD.1.PL+PRS+3+SG
estila-o	estilar+V.ele.ACC.3.M.SG+PRS+3+SG
estila-os	estilar+V.ele.ACC.3.M.PL+PRS+3+SG
estilara-a	estilar+V.ele.ACC.3.F.SG+PQP+1+SG
estilara-a	estilar+V.ele.ACC.3.F.SG+PQP+3+SG
estilara-as	estilar+V.ele.ACC.3.F.PL+PQP+1+SG
estilara-as	estilar+V.ele.ACC.3.F.PL+PQP+3+SG
estilara-la	estilar+V.ele.ACC.3.F.SG+PQP+2+SG
estilara-las	estilar+V.ele.ACC.3.F.PL+PQP+2+SG
estilara-lhe	estilar+V.ele.DAT.3.SG+PQP+1+SG
estilara-lhe	estilar+V.ele.DAT.3.SG+PQP+3+SG
estilara-lhes	estilar+V.ele.DAT.3.PL+PQP+1+SG
estilara-lhes	estilar+V.ele.DAT.3.PL+PQP+3+SG
estilara-lo	estilar+V.ele.ACC.3.M.SG+PQP+2+SG
estilara-los	estilar+V.ele.ACC.3.M.PL+PQP+2+SG
estilara-me	estilar+V.eu.AD.1.SG+PQP+1+SG
estilara-me	estilar+V.eu.AD.1.SG+PQP+3+SG
estilaram-lhe	estilar+V.ele.DAT.3.SG+PQP+3+PL
estilaram-lhe	estilar+V.ele.DAT.3.SG+PRF+3+PL
estilaram-lhes	estilar+V.ele.DAT.3.PL+PQP+3+PL
estilaram-lhes	estilar+V.ele.DAT.3.PL+PRF+3+PL
estilaram-me	estilar+V.eu.AD.1.SG+PQP+3+PL
estilaram-me	estilar+V.eu.AD.1.SG+PRF+3+PL
estilaram-na	estilar+V.ele.ACC.3.F.SG+PQP+3+PL
estilaram-na	estilar+V.ele.ACC.3.F.SG+PRF+3+PL
estilaram-nas	estilar+V.ele.ACC.3.F.PL+PQP+3+PL
estilaram-nas	estilar+V.ele.ACC.3.F.PL+PRF+3+PL
estilaram-no	estilar+V.ele.ACC.3.M.SG+PQP+3+PL
estilaram-no	estilar+V.ele.ACC.3.M.SG+PRF+3+PL
estilaram-nos	estilar+V.ele.ACC.3.M.PL+PQP+3+PL
estilaram-nos	estilar+V.ele.ACC.3.M.PL+PRF+3+PL
estilaram-nos	estilar+V.nós.AD.1.PL+PQP+3+PL
estilaram-nos	estilar+V.nós.AD.1.PL+PRF+3+PL
estiláramo-la	estilar+V.ele.ACC.3.F.SG+PQP+1+PL
estiláramo-las	estilar+V.ele.ACC.3.F.PL+PQP+1+PL
estiláramo-lo	estilar+V.ele.ACC.3.M.SG+PQP+1+PL
estiláramo-los	estilar+V.ele.ACC.3.M.PL+PQP+1+PL
estiláramo-nos	estilar+nós.AD.1.PL+PQP+1+PL
estiláramos-lhe	estilar+V.ele.DAT.3.SG+PQP+1+PL
estiláramos-lhes	estilar+V.ele.DAT.3.PL+PQP+1+PL
estiláramos-me	estilar+V.eu.AD.1.SG+PQP+1+PL
estiláramos-te	estilar+V.tu.AD.2.SG+PQP+1+PL
estiláramos-vos	estilar+V.vós.AD.2.PL+PQP+1+PL
estilaram-se	estilar+V.ele.REFL+PQP+3+PL
estilaram-se	estilar+V.ele.REFL+PRF+3+PL
estilaram-te	estilar+V.tu.AD.2.SG+PQP+3+PL
estilaram-te	estilar+V.tu.AD.2.SG+PRF+3+PL
estilaram-vos	estilar+V.vós.AD.2.PL+PQP+3+PL
estilaram-vos	estilar+V.vós.AD.2.PL+PRF+3+PL
estilara-nos	estilar+nós.AD.1.PL+PQP+1+SG
estilara-nos	estilar+nós.AD.1.PL+PQP+2+SG
estilara-nos	estilar+nós.AD.1.PL+PQP+3+SG
estilara-o	estilar+V.ele.ACC.3.M.SG+PQP+1+SG
estilara-o	estilar+V.ele.ACC.3.M.SG+PQP+3+SG
estilara-os	estilar+V.ele.ACC.3.M.PL+PQP+1+SG
estilara-os	estilar+V.ele.ACC.3.M.PL+PQP+3+SG
estilara-se	estilar+V.ele.REFL+PQP+1+SG
estilara-se	estilar+V.ele.REFL+PQP+3+SG
estilaras-lhe	estilar+V.ele.DAT.3.SG+PQP+2+SG
estilaras-lhes	estilar+V.ele.DAT.3.PL+PQP+2+SG
estilaras-me	estilar+V.eu.AD.1.SG+PQP+2+SG
estilaras-te	estilar+V.tu.AD.2.SG+PQP+2+SG
estilaras-vos	estilar+V.vós.AD.2.PL+PQP+2+SG
estilara-te	estilar+V.tu.AD.2.SG+PQP+1+SG
estilara-te	estilar+V.tu.AD.2.SG+PQP+3+SG
estilara-vos	estilar+V.vós.AD.2.PL+PQP+1+SG
estilara-vos	estilar+V.vós.AD.2.PL+PQP+3+SG
estilarde-la	estilar+V.ele.ACC.3.F.SG+INF+2+PL
estilarde-la	estilar+V.ele.ACC.3.F.SG+SBJF+2+PL
estilarde-las	estilar+V.ele.ACC.3.F.PL+INF+2+PL
estilarde-las	estilar+V.ele.ACC.3.F.PL+SBJF+2+PL
estilarde-lo	estilar+V.ele.ACC.3.M.SG+INF+2+PL
estilarde-lo	estilar+V.ele.ACC.3.M.SG+SBJF+2+PL
estilarde-los	estilar+V.ele.ACC.3.M.PL+INF+2+PL
estilarde-los	estilar+V.ele.ACC.3.M.PL+SBJF+2+PL
estilarde-nos	estilar+nós.AD.1.PL+INF+2+PL
estilarde-nos	estilar+nós.AD.1.PL+SBJF+2+PL
estilardes-lhe	estilar+V.ele.DAT.3.SG+INF+2+PL
estilardes-lhe	estilar+V.ele.DAT.3.SG+SBJF+2+PL
estilardes-lhes	estilar+V.ele.DAT.3.PL+INF+2+PL
estilardes-lhes	estilar+V.ele.DAT.3.PL+SBJF+2+PL
estilardes-me	estilar+V.eu.AD.1.SG+INF+2+PL
estilardes-me	estilar+V.eu.AD.1.SG+SBJF+2+PL
estilardes-te	estilar+V.tu.AD.2.SG+INF+2+PL
estilardes-te	estilar+V.tu.AD.2.SG+SBJF+2+PL
estilardes-vos	estilar+V.vós.AD.2.PL+INF+2+PL
estilardes-vos	estilar+V.vós.AD.2.PL+SBJF+2+PL
estilárei-la	estilar+V.ele.ACC.3.F.SG+PQP+2+PL
estilárei-las	estilar+V.ele.ACC.3.F.PL+PQP+2+PL
estilárei-lo	estilar+V.ele.ACC.3.M.SG+PQP+2+PL
estilárei-los	estilar+V.ele.ACC.3.M.PL+PQP+2+PL
estilárei-nos	estilar+nós.AD.1.PL+PQP+2+PL
estiláreis-lhe	estilar+V.ele.DAT.3.SG+PQP+2+PL
estiláreis-lhes	estilar+V.ele.DAT.3.PL+PQP+2+PL
estiláreis-me	estilar+V.eu.AD.1.SG+PQP+2+PL
estiláreis-te	estilar+V.tu.AD.2.SG+PQP+2+PL
estiláreis-vos	estilar+V.vós.AD.2.PL+PQP+2+PL
estilare-la	estilar+V.ele.ACC.3.F.SG+INF+2+SG
estilare-la	estilar+V.ele.ACC.3.F.SG+SBJF+2+SG
estilare-las	estilar+V.ele.ACC.3.F.PL+INF+2+SG
estilare-las	estilar+V.ele.ACC.3.F.PL+SBJF+2+SG
estilare-lo	estilar+V.ele.ACC.3.M.SG+INF+2+SG
estilare-lo	estilar+V.ele.ACC.3.M.SG+SBJF+2+SG
estilare-los	estilar+V.ele.ACC.3.M.PL+INF+2+SG
estilare-los	estilar+V.ele.ACC.3.M.PL+SBJF+2+SG
estilarem-lhe	estilar+V.ele.DAT.3.SG+INF+3+PL
estilarem-lhe	estilar+V.ele.DAT.3.SG+SBJF+3+PL
estilarem-lhes	estilar+V.ele.DAT.3.PL+INF+3+PL
estilarem-lhes	estilar+V.ele.DAT.3.PL+SBJF+3+PL
estilarem-me	estilar+V.eu.AD.1.SG+INF+3+PL
estilarem-me	estilar+V.eu.AD.1.SG+SBJF+3+PL
estilarem-na	estilar+V.ele.ACC.3.F.SG+INF+3+PL
estilarem-na	estilar+V.ele.ACC.3.F.SG+SBJF+3+PL
estilarem-nas	estilar+V.ele.ACC.3.F.PL+INF+3+PL
estilarem-nas	estilar+V.ele.ACC.3.F.PL+SBJF+3+PL
estilarem-no	estilar+V.ele.ACC.3.M.SG+INF+3+PL
estilarem-no	estilar+V.ele.ACC.3.M.SG+SBJF+3+PL
estilarem-nos	estilar+V.ele.ACC.3.M.PL+INF+3+PL
estilarem-nos	estilar+V.ele.ACC.3.M.PL+SBJF+3+PL
estilarem-nos	estilar+V.nós.AD.1.PL+INF+3+PL
estilarem-nos	estilar+V.nós.AD.1.PL+SBJF+3+PL
estilarem-se	estilar+V.ele.REFL+INF+3+PL
estilarem-se	estilar+V.ele.REFL+SBJF+3+PL
estilarem-te	estilar+V.tu.AD.2.SG+INF+3+PL
estilarem-te	estilar+V.tu.AD.2.SG+SBJF+3+PL
estilarem-vos	estilar+V.vós.AD.2.PL+INF+3+PL
estilarem-vos	estilar+V.vós.AD.2.PL+SBJF+3+PL
estilare-nos	estilar+nós.AD.1.PL+INF+2+SG
estilare-nos	estilar+nós.AD.1.PL+SBJF+2+SG
estilares-lhe	estilar+V.ele.DAT.3.SG+INF+2+SG
estilares-lhe	estilar+V.ele.DAT.3.SG+SBJF+2+SG
estilares-lhes	estilar+V.ele.DAT.3.PL+INF+2+SG
estilares-lhes	estilar+V.ele.DAT.3.PL+SBJF+2+SG
estilares-me	estilar+V.eu.AD.1.SG+INF+2+SG
estilares-me	estilar+V.eu.AD.1.SG+SBJF+2+SG
estilares-te	estilar+V.tu.AD.2.SG+INF+2+SG
estilares-te	estilar+V.tu.AD.2.SG+SBJF+2+SG
estilares-vos	estilar+V.vós.AD.2.PL+INF+2+SG
estilares-vos	estilar+V.vós.AD.2.PL+SBJF+2+SG
estilar-lhe-á	estilar+V.ele.DAT.3.SG+FUT+3+SG
estilar-lhe-ão	estilar+V.ele.DAT.3.SG+FUT+3+PL
estilar-lhe-ás	estilar+V.ele.DAT.3.SG+FUT+2+SG
estilar-lhe-ei	estilar+V.ele.DAT.3.SG+FUT+1+SG
estilar-lhe-eis	estilar+V.ele.DAT.3.SG+FUT+2+PL
estilar-lhe-emos	estilar+V.ele.DAT.3.SG+FUT+1+PL
estilar-lhe	estilar+V.ele.DAT.3.SG+INF
estilar-lhe	estilar+V.ele.DAT.3.SG+INF+1+SG
estilar-lhe	estilar+V.ele.DAT.3.SG+INF+3+SG
estilar-lhe	estilar+V.ele.DAT.3.SG+SBJF+1+SG
estilar-lhe	estilar+V.ele.DAT.3.SG+SBJF+3+SG
estilar-lhe-ia	estilar+V.ele.DAT.3.SG+COND+1+SG
estilar-lhe-ia	estilar+V.ele.DAT.3.SG+COND+3+SG
estilar-lhe-iam	estilar+V.ele.DAT.3.SG+COND+3+PL
estilar-lhe-íamos	estilar+V.ele.DAT.3.SG+COND+1+PL
estilar-lhe-ias	estilar+V.ele.DAT.3.SG+COND+2+SG
estilar-lhe-íeis	estilar+V.ele.DAT.3.SG+COND+2+PL
estilar-lhes-á	estilar+V.ele.DAT.3.PL+FUT+3+SG
estilar-lhes-ão	estilar+V.ele.DAT.3.PL+FUT+3+PL
estilar-lhes-ás	estilar+V.ele.DAT.3.PL+FUT+2+SG
estilar-lhes-ei	estilar+V.ele.DAT.3.PL+FUT+1+SG
estilar-lhes-eis	estilar+V.ele.DAT.3.PL+FUT+2+PL
estilar-lhes-emos	estilar+V.ele.DAT.3.PL+FUT+1+PL
estilar-lhes	estilar+V.ele.DAT.3.PL+INF
estilar-lhes	estilar+V.ele.DAT.3.PL+INF+1+SG
estilar-lhes	estilar+V.ele.DAT.3.PL+INF+3+SG
estilar-lhes	estilar+V.ele.DAT.3.PL+SBJF+1+SG
estilar-lhes	estilar+V.ele.DAT.3.PL+SBJF+3+SG
estilar-lhes-ia	estilar+V.ele.DAT.3.PL+COND+1+SG
estilar-lhes-ia	estilar+V.ele.DAT.3.PL+COND+3+SG
estilar-lhes-iam	estilar+V.ele.DAT.3.PL+COND+3+PL
estilar-lhes-íamos	estilar+V.ele.DAT.3.PL+COND+1+PL
estilar-lhes-ias	estilar+V.ele.DAT.3.PL+COND+2+SG
estilar-lhes-íeis	estilar+V.ele.DAT.3.PL+COND+2+PL
estilar-me-á	estilar+V.eu.AD.1.SG+FUT+3+SG
estilar-me-ão	estilar+V.eu.AD.1.SG+FUT+3+PL
estilar-me-ás	estilar+V.eu.AD.1.SG+FUT+2+SG
estilar-me-ei	estilar+V.eu.AD.1.SG+FUT+1+SG
estilar-me-eis	estilar+V.eu.AD.1.SG+FUT+2+PL
estilar-me-emos	estilar+V.eu.AD.1.SG+FUT+1+PL
estilar-me	estilar+V.eu.AD.1.SG+INF
estilar-me	estilar+V.eu.AD.1.SG+INF+1+SG
estilar-me	estilar+V.eu.AD.1.SG+INF+3+SG
estilar-me	estilar+V.eu.AD.1.SG+SBJF+1+SG
estilar-me	estilar+V.eu.AD.1.SG+SBJF+3+SG
estilar-me-ia	estilar+V.eu.AD.1.SG+COND+1+SG
estilar-me-ia	estilar+V.eu.AD.1.SG+COND+3+SG
estilar-me-iam	estilar+V.eu.AD.1.SG+COND+3+PL
estilar-me-íamos	estilar+V.eu.AD.1.SG+COND+1+PL
estilar-me-ias	estilar+V.eu.AD.1.SG+COND+2+SG
estilar-me-íeis	estilar+V.eu.AD.1.SG+COND+2+PL
estilarmo-la	estilar+V.ele.ACC.3.F.SG+INF+1+PL
estilarmo-la	estilar+V.ele.ACC.3.F.SG+SBJF+1+PL
estilarmo-las	estilar+V.ele.ACC.3.F.PL+INF+1+PL
estilarmo-las	estilar+V.ele.ACC.3.F.PL+SBJF+1+PL
estilarmo-lo	estilar+V.ele.ACC.3.M.SG+INF+1+PL
estilarmo-lo	estilar+V.ele.ACC.3.M.SG+SBJF+1+PL
estilarmo-los	estilar+V.ele.ACC.3.M.PL+INF+1+PL
estilarmo-los	estilar+V.ele.ACC.3.M.PL+SBJF+1+PL
estilarmo-nos	estilar+nós.AD.1.PL+INF+1+PL
estilarmo-nos	estilar+nós.AD.1.PL+SBJF+1+PL
estilarmos-lhe	estilar+V.ele.DAT.3.SG+INF+1+PL
estilarmos-lhe	estilar+V.ele.DAT.3.SG+SBJF+1+PL
estilarmos-lhes	estilar+V.ele.DAT.3.PL+INF+1+PL
estilarmos-lhes	estilar+V.ele.DAT.3.PL+SBJF+1+PL
estilarmos-me	estilar+V.eu.AD.1.SG+INF+1+PL
estilarmos-me	estilar+V.eu.AD.1.SG+SBJF+1+PL
estilarmos-te	estilar+V.tu.AD.2.SG+INF+1+PL
estilarmos-te	estilar+V.tu.AD.2.SG+SBJF+1+PL
estilarmos-vos	estilar+V.vós.AD.2.PL+INF+1+PL
estilarmos-vos	estilar+V.vós.AD.2.PL+SBJF+1+PL
estilar-nos-á	estilar+nós.AD.1.PL+FUT+3+SG
estilar-nos-ão	estilar+nós.AD.1.PL+FUT+3+PL
estilar-nos-ás	estilar+nós.AD.1.PL+FUT+2+SG
estilar-nos-ei	estilar+nós.AD.1.PL+FUT+1+SG
estilar-nos-eis	estilar+nós.AD.1.PL+FUT+2+PL
estilar-nos-emos	estilar+nós.AD.1.PL+FUT+1+PL
estilar-nos	estilar+nós.AD.1.PL+INF
estilar-nos	estilar+nós.AD.1.PL+INF+1+SG
estilar-nos	estilar+nós.AD.1.PL+INF+3+SG
estilar-nos	estilar+nós.AD.1.PL+SBJF+1+SG
estilar-nos	estilar+nós.AD.1.PL+SBJF+3+SG
estilar-nos-ia	estilar+nós.AD.1.PL+COND+1+SG
estilar-nos-ia	estilar+nós.AD.1.PL+COND+3+SG
estilar-nos-iam	estilar+nós.AD.1.PL+COND+3+PL
estilar-nos-íamos	estilar+nós.AD.1.PL+COND+1+PL
estilar-nos-ias	estilar+nós.AD.1.PL+COND+2+SG
estilar-nos-íeis	estilar+nós.AD.1.PL+COND+2+PL
estilar-se-á	estilar+V.ele.REFL+FUT+3+SG
estilar-se-ão	estilar+V.ele.REFL+FUT+3+PL
estilar-se	estilar+V.ele.REFL+INF
estilar-se	estilar+V.ele.REFL+INF+3+SG
estilar-se	estilar+V.ele.REFL+SBJF+3+SG
estilar-se-ia	estilar+V.ele.REFL+COND+3+SG
estilar-se-iam	estilar+V.ele.REFL+COND+3+PL
estilar-te-á	estilar+V.tu.AD.2.SG+FUT+3+SG
estilar-te-ão	estilar+V.tu.AD.2.SG+FUT+3+PL
estilar-te-ás	estilar+V.tu.AD.2.SG+FUT+2+SG
estilar-te-ei	estilar+V.tu.AD.2.SG+FUT+1+SG
estilar-te-eis	estilar+V.tu.AD.2.SG+FUT+2+PL
estilar-te-emos	estilar+V.tu.AD.2.SG+FUT+1+PL
estilar-te	estilar+V.tu.AD.2.SG+INF
estilar-te	estilar+V.tu.AD.2.SG+INF+1+SG
estilar-te	estilar+V.tu.AD.2.SG+INF+3+SG
estilar-te	estilar+V.tu.AD.2.SG+SBJF+1+SG
estilar-te	estilar+V.tu.AD.2.SG+SBJF+3+SG
estilar-te-ia	estilar+V.tu.AD.2.SG+COND+1+SG
estilar-te-ia	estilar+V.tu.AD.2.SG+COND+3+SG
estilar-te-iam	estilar+V.tu.AD.2.SG+COND+3+PL
estilar-te-íamos	estilar+V.tu.AD.2.SG+COND+1+PL
estilar-te-ias	estilar+V.tu.AD.2.SG+COND+2+SG
estilar-te-íeis	estilar+V.tu.AD.2.SG+COND+2+PL
estilar-vos-á	estilar+V.vós.AD.2.PL+FUT+3+SG
estilar-vos-ão	estilar+V.vós.AD.2.PL+FUT+3+PL
estilar-vos-ás	estilar+V.vós.AD.2.PL+FUT+2+SG
estilar-vos-ei	estilar+V.vós.AD.2.PL+FUT+1+SG
estilar-vos-eis	estilar+V.vós.AD.2.PL+FUT+2+PL
estilar-vos-emos	estilar+V.vós.AD.2.PL+FUT+1+PL
estilar-vos	estilar+V.vós.AD.2.PL+INF
estilar-vos	estilar+V.vós.AD.2.PL+INF+1+SG
estilar-vos	estilar+V.vós.AD.2.PL+INF+3+SG
estilar-vos	estilar+V.vós.AD.2.PL+SBJF+1+SG
estilar-vos	estilar+V.vós.AD.2.PL+SBJF+3+SG
estilar-vos-ia	estilar+V.vós.AD.2.PL+COND+1+SG
estilar-vos-ia	estilar+V.vós.AD.2.PL+COND+3+SG
estilar-vos-iam	estilar+V.vós.AD.2.PL+COND+3+PL
estilar-vos-íamos	estilar+V.vós.AD.2.PL+COND+1+PL
estilar-vos-ias	estilar+V.vós.AD.2.PL+COND+2+SG
estilar-vos-íeis	estilar+V.vós.AD.2.PL+COND+2+PL
estila-se	estilar+V.ele.REFL+PRS+3+SG
estilas-lhe	estilar+V.ele.DAT.3.SG+PRS+2+SG
estilas-lhes	estilar+V.ele.DAT.3.PL+PRS+2+SG
estilas-me	estilar+V.eu.AD.1.SG+PRS+2+SG
estilaste-a	estilar+V.ele.ACC.3.F.SG+PRF+2+SG
estilaste-as	estilar+V.ele.ACC.3.F.PL+PRF+2+SG
estilas-te	estilar+V.tu.AD.2.SG+PRS+2+SG
estilaste-la	estilar+V.ele.ACC.3.F.SG+PRF+2+PL
estilaste-las	estilar+V.ele.ACC.3.F.PL+PRF+2+PL
estilaste-lhe	estilar+V.ele.DAT.3.SG+PRF+2+SG
estilaste-lhes	estilar+V.ele.DAT.3.PL+PRF+2+SG
estilaste-lo	estilar+V.ele.ACC.3.M.SG+PRF+2+PL
estilaste-los	estilar+V.ele.ACC.3.M.PL+PRF+2+PL
estilaste-me	estilar+V.eu.AD.1.SG+PRF+2+SG
estilaste-nos	estilar+nós.AD.1.PL+PRF+2+PL
estilaste-nos	estilar+nós.AD.1.PL+PRF+2+SG
estilaste-o	estilar+V.ele.ACC.3.M.SG+PRF+2+SG
estilaste-os	estilar+V.ele.ACC.3.M.PL+PRF+2+SG
estilastes-lhe	estilar+V.ele.DAT.3.SG+PRF+2+PL
estilastes-lhes	estilar+V.ele.DAT.3.PL+PRF+2+PL
estilastes-me	estilar+V.eu.AD.1.SG+PRF+2+PL
estilastes-te	estilar+V.tu.AD.2.SG+PRF+2+PL
estilastes-vos	estilar+V.vós.AD.2.PL+PRF+2+PL
estilaste-te	estilar+V.tu.AD.2.SG+PRF+2+SG
estilaste-vos	estilar+V.vós.AD.2.PL+PRF+2+SG
estilas-vos	estilar+V.vós.AD.2.PL+PRS+2+SG
estila-te	estilar+V.tu.AD.2.SG+PRS+3+SG
estilava-a	estilar+V.ele.ACC.3.F.SG+IMPF+1+SG
estilava-a	estilar+V.ele.ACC.3.F.SG+IMPF+3+SG
estilava-as	estilar+V.ele.ACC.3.F.PL+IMPF+1+SG
estilava-as	estilar+V.ele.ACC.3.F.PL+IMPF+3+SG
estilava-la	estilar+V.ele.ACC.3.F.SG+IMPF+2+SG
estilava-las	estilar+V.ele.ACC.3.F.PL+IMPF+2+SG
estilava-lhe	estilar+V.ele.DAT.3.SG+IMPF+1+SG
estilava-lhe	estilar+V.ele.DAT.3.SG+IMPF+3+SG
estilava-lhes	estilar+V.ele.DAT.3.PL+IMPF+1+SG
estilava-lhes	estilar+V.ele.DAT.3.PL+IMPF+3+SG
estilava-lo	estilar+V.ele.ACC.3.M.SG+IMPF+2+SG
estilava-los	estilar+V.ele.ACC.3.M.PL+IMPF+2+SG
estilava-me	estilar+V.eu.AD.1.SG+IMPF+1+SG
estilava-me	estilar+V.eu.AD.1.SG+IMPF+3+SG
estilavam-lhe	estilar+V.ele.DAT.3.SG+IMPF+3+PL
estilavam-lhes	estilar+V.ele.DAT.3.PL+IMPF+3+PL
estilavam-me	estilar+V.eu.AD.1.SG+IMPF+3+PL
estilavam-na	estilar+V.ele.ACC.3.F.SG+IMPF+3+PL
estilavam-nas	estilar+V.ele.ACC.3.F.PL+IMPF+3+PL
estilavam-no	estilar+V.ele.ACC.3.M.SG+IMPF+3+PL
estilavam-nos	estilar+V.ele.ACC.3.M.PL+IMPF+3+PL
estilavam-nos	estilar+V.nós.AD.1.PL+IMPF+3+PL
estilávamo-la	estilar+V.ele.ACC.3.F.SG+IMPF+1+PL
estilávamo-las	estilar+V.ele.ACC.3.F.PL+IMPF+1+PL
estilávamo-lo	estilar+V.ele.ACC.3.M.SG+IMPF+1+PL
estilávamo-los	estilar+V.ele.ACC.3.M.PL+IMPF+1+PL
estilávamo-nos	estilar+nós.AD.1.PL+IMPF+1+PL
estilávamos-lhe	estilar+V.ele.DAT.3.SG+IMPF+1+PL
estilávamos-lhes	estilar+V.ele.DAT.3.PL+IMPF+1+PL
estilávamos-me	estilar+V.eu.AD.1.SG+IMPF+1+PL
estilávamos-te	estilar+V.tu.AD.2.SG+IMPF+1+PL
estilávamos-vos	estilar+V.vós.AD.2.PL+IMPF+1+PL
estilavam-se	estilar+V.ele.REFL+IMPF+3+PL
estilavam-te	estilar+V.tu.AD.2.SG+IMPF+3+PL
estilavam-vos	estilar+V.vós.AD.2.PL+IMPF+3+PL
estilava-nos	estilar+nós.AD.1.PL+IMPF+1+SG
estilava-nos	estilar+nós.AD.1.PL+IMPF+2+SG
estilava-nos	estilar+nós.AD.1.PL+IMPF+3+SG
estilava-o	estilar+V.ele.ACC.3.M.SG+IMPF+1+SG
estilava-o	estilar+V.ele.ACC.3.M.SG+IMPF+3+SG
estilava-os	estilar+V.ele.ACC.3.M.PL+IMPF+1+SG
estilava-os	estilar+V.ele.ACC.3.M.PL+IMPF+3+SG
estilava-se	estilar+V.ele.REFL+IMPF+1+SG
estilava-se	estilar+V.ele.REFL+IMPF+3+SG
estilavas-lhe	estilar+V.ele.DAT.3.SG+IMPF+2+SG
estilavas-lhes	estilar+V.ele.DAT.3.PL+IMPF+2+SG
estilavas-me	estilar+V.eu.AD.1.SG+IMPF+2+SG
estilavas-te	estilar+V.tu.AD.2.SG+IMPF+2+SG
estilavas-vos	estilar+V.vós.AD.2.PL+IMPF+2+SG
estilava-te	estilar+V.tu.AD.2.SG+IMPF+1+SG
estilava-te	estilar+V.tu.AD.2.SG+IMPF+3+SG
estilava-vos	estilar+V.vós.AD.2.PL+IMPF+1+SG
estilava-vos	estilar+V.vós.AD.2.PL+IMPF+3+SG
estilávei-la	estilar+V.ele.ACC.3.F.SG+IMPF+2+PL
estilávei-las	estilar+V.ele.ACC.3.F.PL+IMPF+2+PL
estilávei-lo	estilar+V.ele.ACC.3.M.SG+IMPF+2+PL
estilávei-los	estilar+V.ele.ACC.3.M.PL+IMPF+2+PL
estilávei-nos	estilar+nós.AD.1.PL+IMPF+2+PL
estiláveis-lhe	estilar+V.ele.DAT.3.SG+IMPF+2+PL
estiláveis-lhes	estilar+V.ele.DAT.3.PL+IMPF+2+PL
estiláveis-me	estilar+V.eu.AD.1.SG+IMPF+2+PL
estiláveis-te	estilar+V.tu.AD.2.SG+IMPF+2+PL
estiláveis-vos	estilar+V.vós.AD.2.PL+IMPF+2+PL
estila-vos	estilar+V.vós.AD.2.PL+PRS+3+SG
estile-a	estilar+V.ele.ACC.3.F.SG+IMP+3+SG
estile-as	estilar+V.ele.ACC.3.F.PL+IMP+3+SG
estilei-a	estilar+V.ele.ACC.3.F.SG+PRF+1+SG
estilei-as	estilar+V.ele.ACC.3.F.PL+PRF+1+SG
estilei-lhe	estilar+V.ele.DAT.3.SG+PRF+1+SG
estilei-lhes	estilar+V.ele.DAT.3.PL+PRF+1+SG
estilei-me	estilar+V.eu.AD.1.SG+PRF+1+SG
estilei-nos	estilar+nós.AD.1.PL+PRF+1+SG
estilei-o	estilar+V.ele.ACC.3.M.SG+PRF+1+SG
estilei-os	estilar+V.ele.ACC.3.M.PL+PRF+1+SG
estilei-te	estilar+V.tu.AD.2.SG+PRF+1+SG
estilei-vos	estilar+V.vós.AD.2.PL+PRF+1+SG
estile-lhe	estilar+V.ele.DAT.3.SG+IMP+3+SG
estile-lhes	estilar+V.ele.DAT.3.PL+IMP+3+SG
estile-me	estilar+V.eu.AD.1.SG+IMP+3+SG
estilem-lhe	estilar+V.ele.DAT.3.SG+IMP+3+PL
estilem-lhes	estilar+V.ele.DAT.3.PL+IMP+3+PL
estilem-me	estilar+V.eu.AD.1.SG+IMP+3+PL
estilem-na	estilar+V.ele.ACC.3.F.SG+IMP+3+PL
estilem-nas	estilar+V.ele.ACC.3.F.PL+IMP+3+PL
estilem-no	estilar+V.ele.ACC.3.M.SG+IMP+3+PL
estilem-nos	estilar+V.ele.ACC.3.M.PL+IMP+3+PL
estilem-nos	estilar+V.nós.AD.1.PL+IMP+3+PL
estilemo-la	estilar+V.ele.ACC.3.F.SG+IMP+1+PL
estilemo-las	estilar+V.ele.ACC.3.F.PL+IMP+1+PL
estilemo-lo	estilar+V.ele.ACC.3.M.SG+IMP+1+PL
estilemo-los	estilar+V.ele.ACC.3.M.PL+IMP+1+PL
estilemo-nos	estilar+nós.AD.1.PL+IMP+1+PL
estilemos-lhe	estilar+V.ele.DAT.3.SG+IMP+1+PL
estilemos-lhes	estilar+V.ele.DAT.3.PL+IMP+1+PL
estilemos-me	estilar+V.eu.AD.1.SG+IMP+1+PL
estilemos-te	estilar+V.tu.AD.2.SG+IMP+1+PL
estilemos-vos	estilar+V.vós.AD.2.PL+IMP+1+PL
estilem-se	estilar+V.ele.REFL+IMP+3+PL
estilem-te	estilar+V.tu.AD.2.SG+IMP+3+PL
estilem-vos	estilar+V.vós.AD.2.PL+IMP+3+PL
estile-nos	estilar+nós.AD.1.PL+IMP+3+SG
estile-o	estilar+V.ele.ACC.3.M.SG+IMP+3+SG
estile-os	estilar+V.ele.ACC.3.M.PL+IMP+3+SG
estile-se	estilar+V.ele.REFL+IMP+3+SG
estileteai-la	estiletear+V.ele.ACC.3.F.SG+PRS+2+PL
estileteai-las	estiletear+V.ele.ACC.3.F.PL+PRS+2+PL
estileteai-lo	estiletear+V.ele.ACC.3.M.SG+PRS+2+PL
estileteai-los	estiletear+V.ele.ACC.3.M.PL+PRS+2+PL
estileteai-nos	estiletear+nós.AD.1.PL+PRS+2+PL
estileteais-lhe	estiletear+V.ele.DAT.3.SG+PRS+2+PL
estileteais-lhes	estiletear+V.ele.DAT.3.PL+PRS+2+PL
estileteais-me	estiletear+V.eu.AD.1.SG+PRS+2+PL
estileteais-te	estiletear+V.tu.AD.2.SG+PRS+2+PL
estileteais-vos	estiletear+V.vós.AD.2.PL+PRS+2+PL
estileteá-la-á	estiletear+V.ele.ACC.3.F.SG+FUT+3+SG
estileteá-la-ão	estiletear+V.ele.ACC.3.F.SG+FUT+3+PL
estileteá-la-ás	estiletear+V.ele.ACC.3.F.SG+FUT+2+SG
estileteá-la-ei	estiletear+V.ele.ACC.3.F.SG+FUT+1+SG
estileteá-la-eis	estiletear+V.ele.ACC.3.F.SG+FUT+2+PL
estileteá-la-emos	estiletear+V.ele.ACC.3.F.SG+FUT+1+PL
estileteá-la	estiletear+V.ele.ACC.3.F.SG+INF+1+SG
estileteá-la	estiletear+V.ele.ACC.3.F.SG+INF+3+SG
estileteá-la	estiletear+V.ele.ACC.3.F.SG+SBJF+1+SG
estileteá-la	estiletear+V.ele.ACC.3.F.SG+SBJF+3+SG
estileteá-la-ia	estiletear+V.ele.ACC.3.F.SG+COND+1+SG
estileteá-la-ia	estiletear+V.ele.ACC.3.F.SG+COND+3+SG
estileteá-la-iam	estiletear+V.ele.ACC.3.F.SG+COND+3+PL
estileteá-la-íamos	estiletear+V.ele.ACC.3.F.SG+COND+1+PL
estileteá-la-ias	estiletear+V.ele.ACC.3.F.SG+COND+2+SG
estileteá-la-íeis	estiletear+V.ele.ACC.3.F.SG+COND+2+PL
estileteá-las-á	estiletear+V.ele.ACC.3.F.PL+FUT+3+SG
estileteá-las-ão	estiletear+V.ele.ACC.3.F.PL+FUT+3+PL
estileteá-las-ás	estiletear+V.ele.ACC.3.F.PL+FUT+2+SG
estileteá-las-ei	estiletear+V.ele.ACC.3.F.PL+FUT+1+SG
estileteá-las-eis	estiletear+V.ele.ACC.3.F.PL+FUT+2+PL
estileteá-las-emos	estiletear+V.ele.ACC.3.F.PL+FUT+1+PL
estileteá-las	estiletear+V.ele.ACC.3.F.PL+INF+1+SG
estileteá-las	estiletear+V.ele.ACC.3.F.PL+INF+3+SG
estileteá-las	estiletear+V.ele.ACC.3.F.PL+SBJF+1+SG
estileteá-las	estiletear+V.ele.ACC.3.F.PL+SBJF+3+SG
estileteá-las-ia	estiletear+V.ele.ACC.3.F.PL+COND+1+SG
estileteá-las-ia	estiletear+V.ele.ACC.3.F.PL+COND+3+SG
estileteá-las-iam	estiletear+V.ele.ACC.3.F.PL+COND+3+PL
estileteá-las-íamos	estiletear+V.ele.ACC.3.F.PL+COND+1+PL
estileteá-las-ias	estiletear+V.ele.ACC.3.F.PL+COND+2+SG
estileteá-las-íeis	estiletear+V.ele.ACC.3.F.PL+COND+2+PL
estileteá-lo-á	estiletear+V.ele.ACC.3.M.SG+FUT+3+SG
estileteá-lo-ão	estiletear+V.ele.ACC.3.M.SG+FUT+3+PL
estileteá-lo-ás	estiletear+V.ele.ACC.3.M.SG+FUT+2+SG
estileteá-lo-ei	estiletear+V.ele.ACC.3.M.SG+FUT+1+SG
estileteá-lo-eis	estiletear+V.ele.ACC.3.M.SG+FUT+2+PL
estileteá-lo-emos	estiletear+V.ele.ACC.3.M.SG+FUT+1+PL
estileteá-lo	estiletear+V.ele.ACC.3.M.SG+INF+1+SG
estileteá-lo	estiletear+V.ele.ACC.3.M.SG+INF+3+SG
estileteá-lo	estiletear+V.ele.ACC.3.M.SG+SBJF+1+SG
estileteá-lo	estiletear+V.ele.ACC.3.M.SG+SBJF+3+SG
estileteá-lo-ia	estiletear+V.ele.ACC.3.M.SG+COND+1+SG
estileteá-lo-ia	estiletear+V.ele.ACC.3.M.SG+COND+3+SG
estileteá-lo-iam	estiletear+V.ele.ACC.3.M.SG+COND+3+PL
estileteá-lo-íamos	estiletear+V.ele.ACC.3.M.SG+COND+1+PL
estileteá-lo-ias	estiletear+V.ele.ACC.3.M.SG+COND+2+SG
estileteá-lo-íeis	estiletear+V.ele.ACC.3.M.SG+COND+2+PL
estileteá-los-á	estiletear+V.ele.ACC.3.M.PL+FUT+3+SG
estileteá-los-ão	estiletear+V.ele.ACC.3.M.PL+FUT+3+PL
estileteá-los-ás	estiletear+V.ele.ACC.3.M.PL+FUT+2+SG
estileteá-los-ei	estiletear+V.ele.ACC.3.M.PL+FUT+1+SG
estileteá-los-eis	estiletear+V.ele.ACC.3.M.PL+FUT+2+PL
estileteá-los-emos	estiletear+V.ele.ACC.3.M.PL+FUT+1+PL
estileteá-los	estiletear+V.ele.ACC.3.M.PL+INF+1+SG
estileteá-los	estiletear+V.ele.ACC.3.M.PL+INF+3+SG
estileteá-los	estiletear+V.ele.ACC.3.M.PL+SBJF+1+SG
estileteá-los	estiletear+V.ele.ACC.3.M.PL+SBJF+3+SG
estileteá-los-ia	estiletear+V.ele.ACC.3.M.PL+COND+1+SG
estileteá-los-ia	estiletear+V.ele.ACC.3.M.PL+COND+3+SG
estileteá-los-iam	estiletear+V.ele.ACC.3.M.PL+COND+3+PL
estileteá-los-íamos	estiletear+V.ele.ACC.3.M.PL+COND+1+PL
estileteá-los-ias	estiletear+V.ele.ACC.3.M.PL+COND+2+SG
estileteá-los-íeis	estiletear+V.ele.ACC.3.M.PL+COND+2+PL
estileteamo-la	estiletear+V.ele.ACC.3.F.SG+PRF+1+PL
estileteamo-la	estiletear+V.ele.ACC.3.F.SG+PRS+1+PL
estileteamo-las	estiletear+V.ele.ACC.3.F.PL+PRF+1+PL
estileteamo-las	estiletear+V.ele.ACC.3.F.PL+PRS+1+PL
estileteamo-lo	estiletear+V.ele.ACC.3.M.SG+PRF+1+PL
estileteamo-lo	estiletear+V.ele.ACC.3.M.SG+PRS+1+PL
estileteamo-los	estiletear+V.ele.ACC.3.M.PL+PRF+1+PL
estileteamo-los	estiletear+V.ele.ACC.3.M.PL+PRS+1+PL
estileteamo-nos	estiletear+nós.AD.1.PL+PRF+1+PL
estileteamo-nos	estiletear+nós.AD.1.PL+PRS+1+PL
estileteamos-lhe	estiletear+V.ele.DAT.3.SG+PRF+1+PL
estileteamos-lhe	estiletear+V.ele.DAT.3.SG+PRS+1+PL
estileteamos-lhes	estiletear+V.ele.DAT.3.PL+PRF+1+PL
estileteamos-lhes	estiletear+V.ele.DAT.3.PL+PRS+1+PL
estileteamos-me	estiletear+V.eu.AD.1.SG+PRF+1+PL
estileteamos-me	estiletear+V.eu.AD.1.SG+PRS+1+PL
estileteamos-te	estiletear+V.tu.AD.2.SG+PRF+1+PL
estileteamos-te	estiletear+V.tu.AD.2.SG+PRS+1+PL
estileteamos-vos	estiletear+V.vós.AD.2.PL+PRF+1+PL
estileteamos-vos	estiletear+V.vós.AD.2.PL+PRS+1+PL
estileteando-a	estiletear+V.ele.ACC.3.F.SG+GRD
estileteando-as	estiletear+V.ele.ACC.3.F.PL+GRD
estileteando-lhe	estiletear+V.ele.DAT.3.SG+GRD
estileteando-lhes	estiletear+V.ele.DAT.3.PL+GRD
estileteando-me	estiletear+V.eu.AD.1.SG+GRD
estileteando-nos	estiletear+nós.AD.1.PL+GRD
estileteando-o	estiletear+V.ele.ACC.3.M.SG+GRD
estileteando-os	estiletear+V.ele.ACC.3.M.PL+GRD
estileteando-se	estiletear+V.ele.REFL+GRD
estileteando-te	estiletear+V.tu.AD.2.SG+GRD
estileteando-vos	estiletear+V.vós.AD.2.PL+GRD
estileteara-a	estiletear+V.ele.ACC.3.F.SG+PQP+1+SG
estileteara-a	estiletear+V.ele.ACC.3.F.SG+PQP+3+SG
estileteara-as	estiletear+V.ele.ACC.3.F.PL+PQP+1+SG
estileteara-as	estiletear+V.ele.ACC.3.F.PL+PQP+3+SG
estileteara-la	estiletear+V.ele.ACC.3.F.SG+PQP+2+SG
estileteara-las	estiletear+V.ele.ACC.3.F.PL+PQP+2+SG
estileteara-lhe	estiletear+V.ele.DAT.3.SG+PQP+1+SG
estileteara-lhe	estiletear+V.ele.DAT.3.SG+PQP+3+SG
estileteara-lhes	estiletear+V.ele.DAT.3.PL+PQP+1+SG
estileteara-lhes	estiletear+V.ele.DAT.3.PL+PQP+3+SG
estileteara-lo	estiletear+V.ele.ACC.3.M.SG+PQP+2+SG
estileteara-los	estiletear+V.ele.ACC.3.M.PL+PQP+2+SG
estileteara-me	estiletear+V.eu.AD.1.SG+PQP+1+SG
estileteara-me	estiletear+V.eu.AD.1.SG+PQP+3+SG
estiletearam-lhe	estiletear+V.ele.DAT.3.SG+PQP+3+PL
estiletearam-lhe	estiletear+V.ele.DAT.3.SG+PRF+3+PL
estiletearam-lhes	estiletear+V.ele.DAT.3.PL+PQP+3+PL
estiletearam-lhes	estiletear+V.ele.DAT.3.PL+PRF+3+PL
estiletearam-me	estiletear+V.eu.AD.1.SG+PQP+3+PL
estiletearam-me	estiletear+V.eu.AD.1.SG+PRF+3+PL
estiletearam-na	estiletear+V.ele.ACC.3.F.SG+PQP+3+PL
estiletearam-na	estiletear+V.ele.ACC.3.F.SG+PRF+3+PL
estiletearam-nas	estiletear+V.ele.ACC.3.F.PL+PQP+3+PL
estiletearam-nas	estiletear+V.ele.ACC.3.F.PL+PRF+3+PL
estiletearam-no	estiletear+V.ele.ACC.3.M.SG+PQP+3+PL
estiletearam-no	estiletear+V.ele.ACC.3.M.SG+PRF+3+PL
estiletearam-nos	estiletear+V.ele.ACC.3.M.PL+PQP+3+PL
estiletearam-nos	estiletear+V.ele.ACC.3.M.PL+PRF+3+PL
estiletearam-nos	estiletear+V.nós.AD.1.PL+PQP+3+PL
estiletearam-nos	estiletear+V.nós.AD.1.PL+PRF+3+PL
estileteáramo-la	estiletear+V.ele.ACC.3.F.SG+PQP+1+PL
estileteáramo-las	estiletear+V.ele.ACC.3.F.PL+PQP+1+PL
estileteáramo-lo	estiletear+V.ele.ACC.3.M.SG+PQP+1+PL
estileteáramo-los	estiletear+V.ele.ACC.3.M.PL+PQP+1+PL
estileteáramo-nos	estiletear+nós.AD.1.PL+PQP+1+PL
estileteáramos-lhe	estiletear+V.ele.DAT.3.SG+PQP+1+PL
estileteáramos-lhes	estiletear+V.ele.DAT.3.PL+PQP+1+PL
estileteáramos-me	estiletear+V.eu.AD.1.SG+PQP+1+PL
estileteáramos-te	estiletear+V.tu.AD.2.SG+PQP+1+PL
estileteáramos-vos	estiletear+V.vós.AD.2.PL+PQP+1+PL
estiletearam-se	estiletear+V.ele.REFL+PQP+3+PL
estiletearam-se	estiletear+V.ele.REFL+PRF+3+PL
estiletearam-te	estiletear+V.tu.AD.2.SG+PQP+3+PL
estiletearam-te	estiletear+V.tu.AD.2.SG+PRF+3+PL
estiletearam-vos	estiletear+V.vós.AD.2.PL+PQP+3+PL
estiletearam-vos	estiletear+V.vós.AD.2.PL+PRF+3+PL
estileteara-nos	estiletear+nós.AD.1.PL+PQP+1+SG
estileteara-nos	estiletear+nós.AD.1.PL+PQP+2+SG
estileteara-nos	estiletear+nós.AD.1.PL+PQP+3+SG
estileteara-o	estiletear+V.ele.ACC.3.M.SG+PQP+1+SG
estileteara-o	estiletear+V.ele.ACC.3.M.SG+PQP+3+SG
estileteara-os	estiletear+V.ele.ACC.3.M.PL+PQP+1+SG
estileteara-os	estiletear+V.ele.ACC.3.M.PL+PQP+3+SG
estileteara-se	estiletear+V.ele.REFL+PQP+1+SG
estileteara-se	estiletear+V.ele.REFL+PQP+3+SG
estiletearas-lhe	estiletear+V.ele.DAT.3.SG+PQP+2+SG
estiletearas-lhes	estiletear+V.ele.DAT.3.PL+PQP+2+SG
estiletearas-me	estiletear+V.eu.AD.1.SG+PQP+2+SG
estiletearas-te	estiletear+V.tu.AD.2.SG+PQP+2+SG
estiletearas-vos	estiletear+V.vós.AD.2.PL+PQP+2+SG
estileteara-te	estiletear+V.tu.AD.2.SG+PQP+1+SG
estileteara-te	estiletear+V.tu.AD.2.SG+PQP+3+SG
estileteara-vos	estiletear+V.vós.AD.2.PL+PQP+1+SG
estileteara-vos	estiletear+V.vós.AD.2.PL+PQP+3+SG
estiletearde-la	estiletear+V.ele.ACC.3.F.SG+INF+2+PL
estiletearde-la	estiletear+V.ele.ACC.3.F.SG+SBJF+2+PL
estiletearde-las	estiletear+V.ele.ACC.3.F.PL+INF+2+PL
estiletearde-las	estiletear+V.ele.ACC.3.F.PL+SBJF+2+PL
estiletearde-lo	estiletear+V.ele.ACC.3.M.SG+INF+2+PL
estiletearde-lo	estiletear+V.ele.ACC.3.M.SG+SBJF+2+PL
estiletearde-los	estiletear+V.ele.ACC.3.M.PL+INF+2+PL
estiletearde-los	estiletear+V.ele.ACC.3.M.PL+SBJF+2+PL
estiletearde-nos	estiletear+nós.AD.1.PL+INF+2+PL
estiletearde-nos	estiletear+nós.AD.1.PL+SBJF+2+PL
estileteardes-lhe	estiletear+V.ele.DAT.3.SG+INF+2+PL
estileteardes-lhe	estiletear+V.ele.DAT.3.SG+SBJF+2+PL
estileteardes-lhes	estiletear+V.ele.DAT.3.PL+INF+2+PL
estileteardes-lhes	estiletear+V.ele.DAT.3.PL+SBJF+2+PL
estileteardes-me	estiletear+V.eu.AD.1.SG+INF+2+PL
estileteardes-me	estiletear+V.eu.AD.1.SG+SBJF+2+PL
estileteardes-te	estiletear+V.tu.AD.2.SG+INF+2+PL
estileteardes-te	estiletear+V.tu.AD.2.SG+SBJF+2+PL
estileteardes-vos	estiletear+V.vós.AD.2.PL+INF+2+PL
estileteardes-vos	estiletear+V.vós.AD.2.PL+SBJF+2+PL
estileteárei-la	estiletear+V.ele.ACC.3.F.SG+PQP+2+PL
estileteárei-las	estiletear+V.ele.ACC.3.F.PL+PQP+2+PL
estileteárei-lo	estiletear+V.ele.ACC.3.M.SG+PQP+2+PL
estileteárei-los	estiletear+V.ele.ACC.3.M.PL+PQP+2+PL
estileteárei-nos	estiletear+nós.AD.1.PL+PQP+2+PL
estileteáreis-lhe	estiletear+V.ele.DAT.3.SG+PQP+2+PL
estileteáreis-lhes	estiletear+V.ele.DAT.3.PL+PQP+2+PL
estileteáreis-me	estiletear+V.eu.AD.1.SG+PQP+2+PL
estileteáreis-te	estiletear+V.tu.AD.2.SG+PQP+2+PL
estileteáreis-vos	estiletear+V.vós.AD.2.PL+PQP+2+PL
estileteare-la	estiletear+V.ele.ACC.3.F.SG+INF+2+SG
estileteare-la	estiletear+V.ele.ACC.3.F.SG+SBJF+2+SG
estileteare-las	estiletear+V.ele.ACC.3.F.PL+INF+2+SG
estileteare-las	estiletear+V.ele.ACC.3.F.PL+SBJF+2+SG
estileteare-lo	estiletear+V.ele.ACC.3.M.SG+INF+2+SG
estileteare-lo	estiletear+V.ele.ACC.3.M.SG+SBJF+2+SG
estileteare-los	estiletear+V.ele.ACC.3.M.PL+INF+2+SG
estileteare-los	estiletear+V.ele.ACC.3.M.PL+SBJF+2+SG
estiletearem-lhe	estiletear+V.ele.DAT.3.SG+INF+3+PL
estiletearem-lhe	estiletear+V.ele.DAT.3.SG+SBJF+3+PL
estiletearem-lhes	estiletear+V.ele.DAT.3.PL+INF+3+PL
estiletearem-lhes	estiletear+V.ele.DAT.3.PL+SBJF+3+PL
estiletearem-me	estiletear+V.eu.AD.1.SG+INF+3+PL
estiletearem-me	estiletear+V.eu.AD.1.SG+SBJF+3+PL
estiletearem-na	estiletear+V.ele.ACC.3.F.SG+INF+3+PL
estiletearem-na	estiletear+V.ele.ACC.3.F.SG+SBJF+3+PL
estiletearem-nas	estiletear+V.ele.ACC.3.F.PL+INF+3+PL
estiletearem-nas	estiletear+V.ele.ACC.3.F.PL+SBJF+3+PL
estiletearem-no	estiletear+V.ele.ACC.3.M.SG+INF+3+PL
estiletearem-no	estiletear+V.ele.ACC.3.M.SG+SBJF+3+PL
estiletearem-nos	estiletear+V.ele.ACC.3.M.PL+INF+3+PL
estiletearem-nos	estiletear+V.ele.ACC.3.M.PL+SBJF+3+PL
estiletearem-nos	estiletear+V.nós.AD.1.PL+INF+3+PL
estiletearem-nos	estiletear+V.nós.AD.1.PL+SBJF+3+PL
estiletearem-se	estiletear+V.ele.REFL+INF+3+PL
estiletearem-se	estiletear+V.ele.REFL+SBJF+3+PL
estiletearem-te	estiletear+V.tu.AD.2.SG+INF+3+PL
estiletearem-te	estiletear+V.tu.AD.2.SG+SBJF+3+PL
estiletearem-vos	estiletear+V.vós.AD.2.PL+INF+3+PL
estiletearem-vos	estiletear+V.vós.AD.2.PL+SBJF+3+PL
estileteare-nos	estiletear+nós.AD.1.PL+INF+2+SG
estileteare-nos	estiletear+nós.AD.1.PL+SBJF+2+SG
estileteares-lhe	estiletear+V.ele.DAT.3.SG+INF+2+SG
estileteares-lhe	estiletear+V.ele.DAT.3.SG+SBJF+2+SG
estileteares-lhes	estiletear+V.ele.DAT.3.PL+INF+2+SG
estileteares-lhes	estiletear+V.ele.DAT.3.PL+SBJF+2+SG
estileteares-me	estiletear+V.eu.AD.1.SG+INF+2+SG
estileteares-me	estiletear+V.eu.AD.1.SG+SBJF+2+SG
estileteares-te	estiletear+V.tu.AD.2.SG+INF+2+SG
estileteares-te	estiletear+V.tu.AD.2.SG+SBJF+2+SG
estileteares-vos	estiletear+V.vós.AD.2.PL+INF+2+SG
estileteares-vos	estiletear+V.vós.AD.2.PL+SBJF+2+SG
estiletear-lhe-á	estiletear+V.ele.DAT.3.SG+FUT+3+SG
estiletear-lhe-ão	estiletear+V.ele.DAT.3.SG+FUT+3+PL
estiletear-lhe-ás	estiletear+V.ele.DAT.3.SG+FUT+2+SG
estiletear-lhe-ei	estiletear+V.ele.DAT.3.SG+FUT+1+SG
estiletear-lhe-eis	estiletear+V.ele.DAT.3.SG+FUT+2+PL
estiletear-lhe-emos	estiletear+V.ele.DAT.3.SG+FUT+1+PL
estiletear-lhe	estiletear+V.ele.DAT.3.SG+INF
estiletear-lhe	estiletear+V.ele.DAT.3.SG+INF+1+SG
estiletear-lhe	estiletear+V.ele.DAT.3.SG+INF+3+SG
estiletear-lhe	estiletear+V.ele.DAT.3.SG+SBJF+1+SG
estiletear-lhe	estiletear+V.ele.DAT.3.SG+SBJF+3+SG
estiletear-lhe-ia	estiletear+V.ele.DAT.3.SG+COND+1+SG
estiletear-lhe-ia	estiletear+V.ele.DAT.3.SG+COND+3+SG
estiletear-lhe-iam	estiletear+V.ele.DAT.3.SG+COND+3+PL
estiletear-lhe-íamos	estiletear+V.ele.DAT.3.SG+COND+1+PL
estiletear-lhe-ias	estiletear+V.ele.DAT.3.SG+COND+2+SG
estiletear-lhe-íeis	estiletear+V.ele.DAT.3.SG+COND+2+PL
estiletear-lhes-á	estiletear+V.ele.DAT.3.PL+FUT+3+SG
estiletear-lhes-ão	estiletear+V.ele.DAT.3.PL+FUT+3+PL
estiletear-lhes-ás	estiletear+V.ele.DAT.3.PL+FUT+2+SG
estiletear-lhes-ei	estiletear+V.ele.DAT.3.PL+FUT+1+SG
estiletear-lhes-eis	estiletear+V.ele.DAT.3.PL+FUT+2+PL
estiletear-lhes-emos	estiletear+V.ele.DAT.3.PL+FUT+1+PL
estiletear-lhes	estiletear+V.ele.DAT.3.PL+INF
estiletear-lhes	estiletear+V.ele.DAT.3.PL+INF+1+SG
estiletear-lhes	estiletear+V.ele.DAT.3.PL+INF+3+SG
estiletear-lhes	estiletear+V.ele.DAT.3.PL+SBJF+1+SG
estiletear-lhes	estiletear+V.ele.DAT.3.PL+SBJF+3+SG
estiletear-lhes-ia	estiletear+V.ele.DAT.3.PL+COND+1+SG
estiletear-lhes-ia	estiletear+V.ele.DAT.3.PL+COND+3+SG
estiletear-lhes-iam	estiletear+V.ele.DAT.3.PL+COND+3+PL
estiletear-lhes-íamos	estiletear+V.ele.DAT.3.PL+COND+1+PL
estiletear-lhes-ias	estiletear+V.ele.DAT.3.PL+COND+2+SG
estiletear-lhes-íeis	estiletear+V.ele.DAT.3.PL+COND+2+PL
estiletear-me-á	estiletear+V.eu.AD.1.SG+FUT+3+SG
estiletear-me-ão	estiletear+V.eu.AD.1.SG+FUT+3+PL
estiletear-me-ás	estiletear+V.eu.AD.1.SG+FUT+2+SG
estiletear-me-ei	estiletear+V.eu.AD.1.SG+FUT+1+SG
estiletear-me-eis	estiletear+V.eu.AD.1.SG+FUT+2+PL
estiletear-me-emos	estiletear+V.eu.AD.1.SG+FUT+1+PL
estiletear-me	estiletear+V.eu.AD.1.SG+INF
estiletear-me	estiletear+V.eu.AD.1.SG+INF+1+SG
estiletear-me	estiletear+V.eu.AD.1.SG+INF+3+SG
estiletear-me	estiletear+V.eu.AD.1.SG+SBJF+1+SG
estiletear-me	estiletear+V.eu.AD.1.SG+SBJF+3+SG
