esturrinhaste-lhe	esturrinhar+V.ele.DAT.3.SG+PRF+2+SG
esturrinhaste-lhes	esturrinhar+V.ele.DAT.3.PL+PRF+2+SG
esturrinhaste-lo	esturrinhar+V.ele.ACC.3.M.SG+PRF+2+PL
esturrinhaste-los	esturrinhar+V.ele.ACC.3.M.PL+PRF+2+PL
esturrinhaste-me	esturrinhar+V.eu.AD.1.SG+PRF+2+SG
esturrinhaste-nos	esturrinhar+nós.AD.1.PL+PRF+2+PL
esturrinhaste-nos	esturrinhar+nós.AD.1.PL+PRF+2+SG
esturrinhaste-o	esturrinhar+V.ele.ACC.3.M.SG+PRF+2+SG
esturrinhaste-os	esturrinhar+V.ele.ACC.3.M.PL+PRF+2+SG
esturrinhastes-lhe	esturrinhar+V.ele.DAT.3.SG+PRF+2+PL
esturrinhastes-lhes	esturrinhar+V.ele.DAT.3.PL+PRF+2+PL
esturrinhastes-me	esturrinhar+V.eu.AD.1.SG+PRF+2+PL
esturrinhastes-te	esturrinhar+V.tu.AD.2.SG+PRF+2+PL
esturrinhastes-vos	esturrinhar+V.vós.AD.2.PL+PRF+2+PL
esturrinhaste-te	esturrinhar+V.tu.AD.2.SG+PRF+2+SG
esturrinhaste-vos	esturrinhar+V.vós.AD.2.PL+PRF+2+SG
esturrinhas-vos	esturrinhar+V.vós.AD.2.PL+PRS+2+SG
esturrinha-te	esturrinhar+V.tu.AD.2.SG+PRS+3+SG
esturrinhava-a	esturrinhar+V.ele.ACC.3.F.SG+IMPF+1+SG
esturrinhava-a	esturrinhar+V.ele.ACC.3.F.SG+IMPF+3+SG
esturrinhava-as	esturrinhar+V.ele.ACC.3.F.PL+IMPF+1+SG
esturrinhava-as	esturrinhar+V.ele.ACC.3.F.PL+IMPF+3+SG
esturrinhava-la	esturrinhar+V.ele.ACC.3.F.SG+IMPF+2+SG
esturrinhava-las	esturrinhar+V.ele.ACC.3.F.PL+IMPF+2+SG
esturrinhava-lhe	esturrinhar+V.ele.DAT.3.SG+IMPF+1+SG
esturrinhava-lhe	esturrinhar+V.ele.DAT.3.SG+IMPF+3+SG
esturrinhava-lhes	esturrinhar+V.ele.DAT.3.PL+IMPF+1+SG
esturrinhava-lhes	esturrinhar+V.ele.DAT.3.PL+IMPF+3+SG
esturrinhava-lo	esturrinhar+V.ele.ACC.3.M.SG+IMPF+2+SG
esturrinhava-los	esturrinhar+V.ele.ACC.3.M.PL+IMPF+2+SG
esturrinhava-me	esturrinhar+V.eu.AD.1.SG+IMPF+1+SG
esturrinhava-me	esturrinhar+V.eu.AD.1.SG+IMPF+3+SG
esturrinhavam-lhe	esturrinhar+V.ele.DAT.3.SG+IMPF+3+PL
esturrinhavam-lhes	esturrinhar+V.ele.DAT.3.PL+IMPF+3+PL
esturrinhavam-me	esturrinhar+V.eu.AD.1.SG+IMPF+3+PL
esturrinhavam-na	esturrinhar+V.ele.ACC.3.F.SG+IMPF+3+PL
esturrinhavam-nas	esturrinhar+V.ele.ACC.3.F.PL+IMPF+3+PL
esturrinhavam-no	esturrinhar+V.ele.ACC.3.M.SG+IMPF+3+PL
esturrinhavam-nos	esturrinhar+V.ele.ACC.3.M.PL+IMPF+3+PL
esturrinhavam-nos	esturrinhar+V.nós.AD.1.PL+IMPF+3+PL
esturrinhávamo-la	esturrinhar+V.ele.ACC.3.F.SG+IMPF+1+PL
esturrinhávamo-las	esturrinhar+V.ele.ACC.3.F.PL+IMPF+1+PL
esturrinhávamo-lo	esturrinhar+V.ele.ACC.3.M.SG+IMPF+1+PL
esturrinhávamo-los	esturrinhar+V.ele.ACC.3.M.PL+IMPF+1+PL
esturrinhávamo-nos	esturrinhar+nós.AD.1.PL+IMPF+1+PL
esturrinhávamos-lhe	esturrinhar+V.ele.DAT.3.SG+IMPF+1+PL
esturrinhávamos-lhes	esturrinhar+V.ele.DAT.3.PL+IMPF+1+PL
esturrinhávamos-me	esturrinhar+V.eu.AD.1.SG+IMPF+1+PL
esturrinhávamos-te	esturrinhar+V.tu.AD.2.SG+IMPF+1+PL
esturrinhávamos-vos	esturrinhar+V.vós.AD.2.PL+IMPF+1+PL
esturrinhavam-se	esturrinhar+V.ele.REFL+IMPF+3+PL
esturrinhavam-te	esturrinhar+V.tu.AD.2.SG+IMPF+3+PL
esturrinhavam-vos	esturrinhar+V.vós.AD.2.PL+IMPF+3+PL
esturrinhava-nos	esturrinhar+nós.AD.1.PL+IMPF+1+SG
esturrinhava-nos	esturrinhar+nós.AD.1.PL+IMPF+2+SG
esturrinhava-nos	esturrinhar+nós.AD.1.PL+IMPF+3+SG
esturrinhava-o	esturrinhar+V.ele.ACC.3.M.SG+IMPF+1+SG
esturrinhava-o	esturrinhar+V.ele.ACC.3.M.SG+IMPF+3+SG
esturrinhava-os	esturrinhar+V.ele.ACC.3.M.PL+IMPF+1+SG
esturrinhava-os	esturrinhar+V.ele.ACC.3.M.PL+IMPF+3+SG
esturrinhava-se	esturrinhar+V.ele.REFL+IMPF+1+SG
esturrinhava-se	esturrinhar+V.ele.REFL+IMPF+3+SG
esturrinhavas-lhe	esturrinhar+V.ele.DAT.3.SG+IMPF+2+SG
esturrinhavas-lhes	esturrinhar+V.ele.DAT.3.PL+IMPF+2+SG
esturrinhavas-me	esturrinhar+V.eu.AD.1.SG+IMPF+2+SG
esturrinhavas-te	esturrinhar+V.tu.AD.2.SG+IMPF+2+SG
esturrinhavas-vos	esturrinhar+V.vós.AD.2.PL+IMPF+2+SG
esturrinhava-te	esturrinhar+V.tu.AD.2.SG+IMPF+1+SG
esturrinhava-te	esturrinhar+V.tu.AD.2.SG+IMPF+3+SG
esturrinhava-vos	esturrinhar+V.vós.AD.2.PL+IMPF+1+SG
esturrinhava-vos	esturrinhar+V.vós.AD.2.PL+IMPF+3+SG
esturrinhávei-la	esturrinhar+V.ele.ACC.3.F.SG+IMPF+2+PL
esturrinhávei-las	esturrinhar+V.ele.ACC.3.F.PL+IMPF+2+PL
esturrinhávei-lo	esturrinhar+V.ele.ACC.3.M.SG+IMPF+2+PL
esturrinhávei-los	esturrinhar+V.ele.ACC.3.M.PL+IMPF+2+PL
esturrinhávei-nos	esturrinhar+nós.AD.1.PL+IMPF+2+PL
esturrinháveis-lhe	esturrinhar+V.ele.DAT.3.SG+IMPF+2+PL
esturrinháveis-lhes	esturrinhar+V.ele.DAT.3.PL+IMPF+2+PL
esturrinháveis-me	esturrinhar+V.eu.AD.1.SG+IMPF+2+PL
esturrinháveis-te	esturrinhar+V.tu.AD.2.SG+IMPF+2+PL
esturrinháveis-vos	esturrinhar+V.vós.AD.2.PL+IMPF+2+PL
esturrinha-vos	esturrinhar+V.vós.AD.2.PL+PRS+3+SG
esturrinhe-a	esturrinhar+V.ele.ACC.3.F.SG+IMP+3+SG
esturrinhe-as	esturrinhar+V.ele.ACC.3.F.PL+IMP+3+SG
esturrinhei-a	esturrinhar+V.ele.ACC.3.F.SG+PRF+1+SG
esturrinhei-as	esturrinhar+V.ele.ACC.3.F.PL+PRF+1+SG
esturrinhei-lhe	esturrinhar+V.ele.DAT.3.SG+PRF+1+SG
esturrinhei-lhes	esturrinhar+V.ele.DAT.3.PL+PRF+1+SG
esturrinhei-me	esturrinhar+V.eu.AD.1.SG+PRF+1+SG
esturrinhei-nos	esturrinhar+nós.AD.1.PL+PRF+1+SG
esturrinhei-o	esturrinhar+V.ele.ACC.3.M.SG+PRF+1+SG
esturrinhei-os	esturrinhar+V.ele.ACC.3.M.PL+PRF+1+SG
esturrinhei-te	esturrinhar+V.tu.AD.2.SG+PRF+1+SG
esturrinhei-vos	esturrinhar+V.vós.AD.2.PL+PRF+1+SG
esturrinhe-lhe	esturrinhar+V.ele.DAT.3.SG+IMP+3+SG
esturrinhe-lhes	esturrinhar+V.ele.DAT.3.PL+IMP+3+SG
esturrinhe-me	esturrinhar+V.eu.AD.1.SG+IMP+3+SG
esturrinhem-lhe	esturrinhar+V.ele.DAT.3.SG+IMP+3+PL
esturrinhem-lhes	esturrinhar+V.ele.DAT.3.PL+IMP+3+PL
esturrinhem-me	esturrinhar+V.eu.AD.1.SG+IMP+3+PL
esturrinhem-na	esturrinhar+V.ele.ACC.3.F.SG+IMP+3+PL
esturrinhem-nas	esturrinhar+V.ele.ACC.3.F.PL+IMP+3+PL
esturrinhem-no	esturrinhar+V.ele.ACC.3.M.SG+IMP+3+PL
esturrinhem-nos	esturrinhar+V.ele.ACC.3.M.PL+IMP+3+PL
esturrinhem-nos	esturrinhar+V.nós.AD.1.PL+IMP+3+PL
esturrinhemo-la	esturrinhar+V.ele.ACC.3.F.SG+IMP+1+PL
esturrinhemo-las	esturrinhar+V.ele.ACC.3.F.PL+IMP+1+PL
esturrinhemo-lo	esturrinhar+V.ele.ACC.3.M.SG+IMP+1+PL
esturrinhemo-los	esturrinhar+V.ele.ACC.3.M.PL+IMP+1+PL
esturrinhemo-nos	esturrinhar+nós.AD.1.PL+IMP+1+PL
esturrinhemos-lhe	esturrinhar+V.ele.DAT.3.SG+IMP+1+PL
esturrinhemos-lhes	esturrinhar+V.ele.DAT.3.PL+IMP+1+PL
esturrinhemos-me	esturrinhar+V.eu.AD.1.SG+IMP+1+PL
esturrinhemos-te	esturrinhar+V.tu.AD.2.SG+IMP+1+PL
esturrinhemos-vos	esturrinhar+V.vós.AD.2.PL+IMP+1+PL
esturrinhem-se	esturrinhar+V.ele.REFL+IMP+3+PL
esturrinhem-te	esturrinhar+V.tu.AD.2.SG+IMP+3+PL
esturrinhem-vos	esturrinhar+V.vós.AD.2.PL+IMP+3+PL
esturrinhe-nos	esturrinhar+nós.AD.1.PL+IMP+3+SG
esturrinhe-o	esturrinhar+V.ele.ACC.3.M.SG+IMP+3+SG
esturrinhe-os	esturrinhar+V.ele.ACC.3.M.PL+IMP+3+SG
esturrinhe-se	esturrinhar+V.ele.REFL+IMP+3+SG
esturrinhe-te	esturrinhar+V.tu.AD.2.SG+IMP+3+SG
esturrinhe-vos	esturrinhar+V.vós.AD.2.PL+IMP+3+SG
esturrinho-a	esturrinhar+V.ele.ACC.3.F.SG+PRS+1+SG
esturrinho-as	esturrinhar+V.ele.ACC.3.F.PL+PRS+1+SG
esturrinho-lhe	esturrinhar+V.ele.DAT.3.SG+PRS+1+SG
esturrinho-lhes	esturrinhar+V.ele.DAT.3.PL+PRS+1+SG
esturrinho-me	esturrinhar+V.eu.AD.1.SG+PRS+1+SG
esturrinho-nos	esturrinhar+nós.AD.1.PL+PRS+1+SG
esturrinho-o	esturrinhar+V.ele.ACC.3.M.SG+PRS+1+SG
esturrinho-os	esturrinhar+V.ele.ACC.3.M.PL+PRS+1+SG
esturrinho-te	esturrinhar+V.tu.AD.2.SG+PRS+1+SG
esturrinhou-a	esturrinhar+V.ele.ACC.3.F.SG+PRF+3+SG
esturrinhou-as	esturrinhar+V.ele.ACC.3.F.PL+PRF+3+SG
esturrinhou-lhe	esturrinhar+V.ele.DAT.3.SG+PRF+3+SG
esturrinhou-lhes	esturrinhar+V.ele.DAT.3.PL+PRF+3+SG
esturrinhou-me	esturrinhar+V.eu.AD.1.SG+PRF+3+SG
esturrinhou-nos	esturrinhar+nós.AD.1.PL+PRF+3+SG
esturrinhou-o	esturrinhar+V.ele.ACC.3.M.SG+PRF+3+SG
esturrinhou-os	esturrinhar+V.ele.ACC.3.M.PL+PRF+3+SG
esturrinhou-se	esturrinhar+V.ele.REFL+PRF+3+SG
esturrinhou-te	esturrinhar+V.tu.AD.2.SG+PRF+3+SG
esturrinhou-vos	esturrinhar+V.vós.AD.2.PL+PRF+3+SG
esturrinho-vos	esturrinhar+V.vós.AD.2.PL+PRS+1+SG
esturrique-a	esturricar+V.ele.ACC.3.F.SG+IMP+3+SG
esturrique-as	esturricar+V.ele.ACC.3.F.PL+IMP+3+SG
esturriquei-a	esturricar+V.ele.ACC.3.F.SG+PRF+1+SG
esturriquei-as	esturricar+V.ele.ACC.3.F.PL+PRF+1+SG
esturriquei-lhe	esturricar+V.ele.DAT.3.SG+PRF+1+SG
esturriquei-lhes	esturricar+V.ele.DAT.3.PL+PRF+1+SG
esturriquei-me	esturricar+V.eu.AD.1.SG+PRF+1+SG
esturriquei-nos	esturricar+nós.AD.1.PL+PRF+1+SG
esturriquei-o	esturricar+V.ele.ACC.3.M.SG+PRF+1+SG
esturriquei-os	esturricar+V.ele.ACC.3.M.PL+PRF+1+SG
esturriquei-te	esturricar+V.tu.AD.2.SG+PRF+1+SG
esturriquei-vos	esturricar+V.vós.AD.2.PL+PRF+1+SG
esturrique-lhe	esturricar+V.ele.DAT.3.SG+IMP+3+SG
esturrique-lhes	esturricar+V.ele.DAT.3.PL+IMP+3+SG
esturrique-me	esturricar+V.eu.AD.1.SG+IMP+3+SG
esturriquem-lhe	esturricar+V.ele.DAT.3.SG+IMP+3+PL
esturriquem-lhes	esturricar+V.ele.DAT.3.PL+IMP+3+PL
esturriquem-me	esturricar+V.eu.AD.1.SG+IMP+3+PL
esturriquem-na	esturricar+V.ele.ACC.3.F.SG+IMP+3+PL
esturriquem-nas	esturricar+V.ele.ACC.3.F.PL+IMP+3+PL
esturriquem-no	esturricar+V.ele.ACC.3.M.SG+IMP+3+PL
esturriquem-nos	esturricar+V.ele.ACC.3.M.PL+IMP+3+PL
esturriquem-nos	esturricar+V.nós.AD.1.PL+IMP+3+PL
esturriquemo-la	esturricar+V.ele.ACC.3.F.SG+IMP+1+PL
esturriquemo-las	esturricar+V.ele.ACC.3.F.PL+IMP+1+PL
esturriquemo-lo	esturricar+V.ele.ACC.3.M.SG+IMP+1+PL
esturriquemo-los	esturricar+V.ele.ACC.3.M.PL+IMP+1+PL
esturriquemo-nos	esturricar+nós.AD.1.PL+IMP+1+PL
esturriquemos-lhe	esturricar+V.ele.DAT.3.SG+IMP+1+PL
esturriquemos-lhes	esturricar+V.ele.DAT.3.PL+IMP+1+PL
esturriquemos-me	esturricar+V.eu.AD.1.SG+IMP+1+PL
esturriquemos-te	esturricar+V.tu.AD.2.SG+IMP+1+PL
esturriquemos-vos	esturricar+V.vós.AD.2.PL+IMP+1+PL
esturriquem-se	esturricar+V.ele.REFL+IMP+3+PL
esturriquem-te	esturricar+V.tu.AD.2.SG+IMP+3+PL
esturriquem-vos	esturricar+V.vós.AD.2.PL+IMP+3+PL
esturrique-nos	esturricar+nós.AD.1.PL+IMP+3+SG
esturrique-o	esturricar+V.ele.ACC.3.M.SG+IMP+3+SG
esturrique-os	esturricar+V.ele.ACC.3.M.PL+IMP+3+SG
esturrique-se	esturricar+V.ele.REFL+IMP+3+SG
esturrique-te	esturricar+V.tu.AD.2.SG+IMP+3+SG
esturrique-vos	esturricar+V.vós.AD.2.PL+IMP+3+SG
esturro-a	esturrar+V.ele.ACC.3.F.SG+PRS+1+SG
esturro-as	esturrar+V.ele.ACC.3.F.PL+PRS+1+SG
esturro-lhe	esturrar+V.ele.DAT.3.SG+PRS+1+SG
esturro-lhes	esturrar+V.ele.DAT.3.PL+PRS+1+SG
esturro-me	esturrar+V.eu.AD.1.SG+PRS+1+SG
esturro-nos	esturrar+nós.AD.1.PL+PRS+1+SG
esturro-o	esturrar+V.ele.ACC.3.M.SG+PRS+1+SG
esturro-os	esturrar+V.ele.ACC.3.M.PL+PRS+1+SG
esturro-te	esturrar+V.tu.AD.2.SG+PRS+1+SG
esturrou-a	esturrar+V.ele.ACC.3.F.SG+PRF+3+SG
esturrou-as	esturrar+V.ele.ACC.3.F.PL+PRF+3+SG
esturrou-lhe	esturrar+V.ele.DAT.3.SG+PRF+3+SG
esturrou-lhes	esturrar+V.ele.DAT.3.PL+PRF+3+SG
esturrou-me	esturrar+V.eu.AD.1.SG+PRF+3+SG
esturrou-nos	esturrar+nós.AD.1.PL+PRF+3+SG
esturrou-o	esturrar+V.ele.ACC.3.M.SG+PRF+3+SG
esturrou-os	esturrar+V.ele.ACC.3.M.PL+PRF+3+SG
esturrou-se	esturrar+V.ele.REFL+PRF+3+SG
esturrou-te	esturrar+V.tu.AD.2.SG+PRF+3+SG
esturrou-vos	esturrar+V.vós.AD.2.PL+PRF+3+SG
esturro-vos	esturrar+V.vós.AD.2.PL+PRS+1+SG
esvaeça-a	esvaecer+V.ele.ACC.3.F.SG+IMP+3+SG
esvaeça-as	esvaecer+V.ele.ACC.3.F.PL+IMP+3+SG
esvaeça-lhe	esvaecer+V.ele.DAT.3.SG+IMP+3+SG
esvaeça-lhes	esvaecer+V.ele.DAT.3.PL+IMP+3+SG
esvaeça-me	esvaecer+V.eu.AD.1.SG+IMP+3+SG
esvaeçam-lhe	esvaecer+V.ele.DAT.3.SG+IMP+3+PL
esvaeçam-lhes	esvaecer+V.ele.DAT.3.PL+IMP+3+PL
esvaeçam-me	esvaecer+V.eu.AD.1.SG+IMP+3+PL
esvaeçam-na	esvaecer+V.ele.ACC.3.F.SG+IMP+3+PL
esvaeçam-nas	esvaecer+V.ele.ACC.3.F.PL+IMP+3+PL
esvaeçam-no	esvaecer+V.ele.ACC.3.M.SG+IMP+3+PL
esvaeçam-nos	esvaecer+nós.AD.1.PL+IMP+3+PL
esvaeçamo-la	esvaecer+V.ele.ACC.3.F.SG+IMP+1+PL
esvaeçamo-las	esvaecer+V.ele.ACC.3.F.PL+IMP+1+PL
esvaeçamo-lo	esvaecer+V.ele.ACC.3.M.SG+IMP+1+PL
esvaeçamo-los	esvaecer+V.ele.ACC.3.M.PL+IMP+1+PL
esvaeçamo-nos	esvaecer+nós.AD.1.PL+IMP+1+PL
esvaeçamos-lhe	esvaecer+V.ele.DAT.3.SG+IMP+1+PL
esvaeçamos-lhes	esvaecer+V.ele.DAT.3.PL+IMP+1+PL
esvaeçamos-me	esvaecer+V.eu.AD.1.SG+IMP+1+PL
esvaeçamos-te	esvaecer+V.tu.AD.2.SG+IMP+1+PL
esvaeçamos-vos	esvaecer+V.vós.AD.2.PL+IMP+1+PL
esvaeçam-se	esvaecer+V.ele.REFL+IMP+3+PL
esvaeçam-te	esvaecer+V.tu.AD.2.SG+IMP+3+PL
esvaeçam-vos	esvaecer+V.vós.AD.2.PL+IMP+3+PL
esvaeça-nos	esvaecer+nós.AD.1.PL+IMP+3+SG
esvaeça-o	esvaecer+V.ele.ACC.3.M.SG+IMP+3+SG
esvaeça-os	esvaecer+V.ele.ACC.3.M.PL+IMP+3+SG
esvaeça-se	esvaecer+V.ele.REFL+IMP+3+SG
esvaeça-te	esvaecer+V.tu.AD.2.SG+IMP+3+SG
esvaeça-vos	esvaecer+V.vós.AD.2.PL+IMP+3+SG
esvaecei-la	esvaecer+V.ele.ACC.3.F.SG+PRS+2+PL
esvaecei-las	esvaecer+V.ele.ACC.3.F.PL+PRS+2+PL
esvaecei-lo	esvaecer+V.ele.ACC.3.M.SG+PRS+2+PL
esvaecei-los	esvaecer+V.ele.ACC.3.M.PL+PRS+2+PL
esvaecei-nos	esvaecer+nós.AD.1.PL+PRS+2+PL
esvaeceis-lhe	esvaecer+V.ele.DAT.3.SG+PRS+2+PL
esvaeceis-lhes	esvaecer+V.ele.DAT.3.PL+PRS+2+PL
esvaeceis-me	esvaecer+V.eu.AD.1.SG+PRS+2+PL
esvaeceis-te	esvaecer+V.tu.AD.2.SG+PRS+2+PL
esvaeceis-vos	esvaecer+V.vós.AD.2.PL+PRS+2+PL
esvaecê-la-á	esvaecer+V.ele.ACC.3.F.SG+FUT+3+SG
esvaecê-la-ão	esvaecer+V.ele.ACC.3.F.SG+FUT+3+PL
esvaecê-la-ás	esvaecer+V.ele.ACC.3.F.SG+FUT+2+SG
esvaecê-la-ei	esvaecer+V.ele.ACC.3.F.SG+FUT+1+SG
esvaecê-la-eis	esvaecer+V.ele.ACC.3.F.SG+FUT+2+PL
esvaecê-la-emos	esvaecer+V.ele.ACC.3.F.SG+FUT+1+PL
esvaecê-la	esvaecer+V.ele.ACC.3.F.SG+INF
esvaecê-la	esvaecer+V.ele.ACC.3.F.SG+INF+1+SG
esvaecê-la	esvaecer+V.ele.ACC.3.F.SG+INF+3+SG
esvaece-la	esvaecer+V.ele.ACC.3.F.SG+PRS+2+SG
esvaecê-la	esvaecer+V.ele.ACC.3.F.SG+SBJF+1+SG
esvaecê-la	esvaecer+V.ele.ACC.3.F.SG+SBJF+3+SG
esvaecê-la-ia	esvaecer+V.ele.ACC.3.F.SG+COND+1+SG
esvaecê-la-ia	esvaecer+V.ele.ACC.3.F.SG+COND+3+SG
esvaecê-la-iam	esvaecer+V.ele.ACC.3.F.SG+COND+3+PL
esvaecê-la-íamos	esvaecer+V.ele.ACC.3.F.SG+COND+1+PL
esvaecê-la-ias	esvaecer+V.ele.ACC.3.F.SG+COND+2+SG
esvaecê-la-íeis	esvaecer+V.ele.ACC.3.F.SG+COND+2+PL
esvaecê-las-á	esvaecer+V.ele.ACC.3.F.PL+FUT+3+SG
esvaecê-las-ão	esvaecer+V.ele.ACC.3.F.PL+FUT+3+PL
esvaecê-las-ás	esvaecer+V.ele.ACC.3.F.PL+FUT+2+SG
esvaecê-las-ei	esvaecer+V.ele.ACC.3.F.PL+FUT+1+SG
esvaecê-las-eis	esvaecer+V.ele.ACC.3.F.PL+FUT+2+PL
esvaecê-las-emos	esvaecer+V.ele.ACC.3.F.PL+FUT+1+PL
esvaecê-las	esvaecer+V.ele.ACC.3.F.PL+INF
esvaecê-las	esvaecer+V.ele.ACC.3.F.PL+INF+1+SG
esvaecê-las	esvaecer+V.ele.ACC.3.F.PL+INF+3+SG
esvaece-las	esvaecer+V.ele.ACC.3.F.PL+PRS+2+SG
esvaecê-las	esvaecer+V.ele.ACC.3.F.PL+SBJF+1+SG
esvaecê-las	esvaecer+V.ele.ACC.3.F.PL+SBJF+3+SG
esvaecê-las-ia	esvaecer+V.ele.ACC.3.F.PL+COND+1+SG
esvaecê-las-ia	esvaecer+V.ele.ACC.3.F.PL+COND+3+SG
esvaecê-las-iam	esvaecer+V.ele.ACC.3.F.PL+COND+3+PL
esvaecê-las-íamos	esvaecer+V.ele.ACC.3.F.PL+COND+1+PL
esvaecê-las-ias	esvaecer+V.ele.ACC.3.F.PL+COND+2+SG
esvaecê-las-íeis	esvaecer+V.ele.ACC.3.F.PL+COND+2+PL
esvaecê-lo-á	esvaecer+V.ele.ACC.3.M.SG+FUT+3+SG
esvaecê-lo-ão	esvaecer+V.ele.ACC.3.M.SG+FUT+3+PL
esvaecê-lo-ás	esvaecer+V.ele.ACC.3.M.SG+FUT+2+SG
esvaecê-lo-ei	esvaecer+V.ele.ACC.3.M.SG+FUT+1+SG
esvaecê-lo-eis	esvaecer+V.ele.ACC.3.M.SG+FUT+2+PL
esvaecê-lo-emos	esvaecer+V.ele.ACC.3.M.SG+FUT+1+PL
esvaecê-lo	esvaecer+V.ele.ACC.3.M.SG+INF
esvaecê-lo	esvaecer+V.ele.ACC.3.M.SG+INF+1+SG
esvaecê-lo	esvaecer+V.ele.ACC.3.M.SG+INF+3+SG
esvaece-lo	esvaecer+V.ele.ACC.3.M.SG+PRS+2+SG
esvaecê-lo	esvaecer+V.ele.ACC.3.M.SG+SBJF+1+SG
esvaecê-lo	esvaecer+V.ele.ACC.3.M.SG+SBJF+3+SG
esvaecê-lo-ia	esvaecer+V.ele.ACC.3.M.SG+COND+1+SG
esvaecê-lo-ia	esvaecer+V.ele.ACC.3.M.SG+COND+3+SG
esvaecê-lo-iam	esvaecer+V.ele.ACC.3.M.SG+COND+3+PL
esvaecê-lo-íamos	esvaecer+V.ele.ACC.3.M.SG+COND+1+PL
esvaecê-lo-ias	esvaecer+V.ele.ACC.3.M.SG+COND+2+SG
esvaecê-lo-íeis	esvaecer+V.ele.ACC.3.M.SG+COND+2+PL
esvaecê-los-á	esvaecer+V.ele.ACC.3.M.PL+FUT+3+SG
esvaecê-los-ão	esvaecer+V.ele.ACC.3.M.PL+FUT+3+PL
esvaecê-los-ás	esvaecer+V.ele.ACC.3.M.PL+FUT+2+SG
esvaecê-los-ei	esvaecer+V.ele.ACC.3.M.PL+FUT+1+SG
esvaecê-los-eis	esvaecer+V.ele.ACC.3.M.PL+FUT+2+PL
esvaecê-los-emos	esvaecer+V.ele.ACC.3.M.PL+FUT+1+PL
esvaecê-los	esvaecer+V.ele.ACC.3.M.PL+INF
esvaecê-los	esvaecer+V.ele.ACC.3.M.PL+INF+1+SG
esvaecê-los	esvaecer+V.ele.ACC.3.M.PL+INF+3+SG
esvaece-los	esvaecer+V.ele.ACC.3.M.PL+PRS+2+SG
esvaecê-los	esvaecer+V.ele.ACC.3.M.PL+SBJF+1+SG
esvaecê-los	esvaecer+V.ele.ACC.3.M.PL+SBJF+3+SG
esvaecê-los-ia	esvaecer+V.ele.ACC.3.M.PL+COND+1+SG
esvaecê-los-ia	esvaecer+V.ele.ACC.3.M.PL+COND+3+SG
esvaecê-los-iam	esvaecer+V.ele.ACC.3.M.PL+COND+3+PL
esvaecê-los-íamos	esvaecer+V.ele.ACC.3.M.PL+COND+1+PL
esvaecê-los-ias	esvaecer+V.ele.ACC.3.M.PL+COND+2+SG
esvaecê-los-íeis	esvaecer+V.ele.ACC.3.M.PL+COND+2+PL
esvaecem-lhe	esvaecer+V.ele.DAT.3.SG+PRS+3+PL
esvaecem-lhes	esvaecer+V.ele.DAT.3.PL+PRS+3+PL
esvaecem-me	esvaecer+V.eu.AD.1.SG+PRS+3+PL
esvaecem-na	esvaecer+V.ele.ACC.3.F.SG+PRS+3+PL
esvaecem-nas	esvaecer+V.ele.ACC.3.F.PL+PRS+3+PL
esvaecem-no	esvaecer+V.ele.ACC.3.M.SG+PRS+3+PL
esvaecem-nos	esvaecer+V.ele.ACC.3.M.PL+PRS+3+PL
esvaecem-nos	esvaecer+V.nós.AD.1.PL+PRS+3+PL
esvaecemo-la	esvaecer+V.ele.ACC.3.F.SG+PRF+1+PL
esvaecemo-la	esvaecer+V.ele.ACC.3.F.SG+PRS+1+PL
esvaecemo-las	esvaecer+V.ele.ACC.3.F.PL+PRF+1+PL
esvaecemo-las	esvaecer+V.ele.ACC.3.F.PL+PRS+1+PL
esvaecemo-lo	esvaecer+V.ele.ACC.3.M.SG+PRF+1+PL
esvaecemo-lo	esvaecer+V.ele.ACC.3.M.SG+PRS+1+PL
esvaecemo-los	esvaecer+V.ele.ACC.3.M.PL+PRF+1+PL
esvaecemo-los	esvaecer+V.ele.ACC.3.M.PL+PRS+1+PL
esvaecemo-nos	esvaecer+nós.AD.1.PL+PRF+1+PL
esvaecemo-nos	esvaecer+nós.AD.1.PL+PRS+1+PL
esvaecemos-lhe	esvaecer+V.ele.DAT.3.SG+PRF+1+PL
esvaecemos-lhe	esvaecer+V.ele.DAT.3.SG+PRS+1+PL
esvaecemos-lhes	esvaecer+V.ele.DAT.3.PL+PRF+1+PL
esvaecemos-lhes	esvaecer+V.ele.DAT.3.PL+PRS+1+PL
esvaecemos-me	esvaecer+V.eu.AD.1.SG+PRF+1+PL
esvaecemos-me	esvaecer+V.eu.AD.1.SG+PRS+1+PL
esvaecemos-te	esvaecer+V.tu.AD.2.SG+PRF+1+PL
esvaecemos-te	esvaecer+V.tu.AD.2.SG+PRS+1+PL
esvaecemos-vos	esvaecer+V.vós.AD.2.PL+PRF+1+PL
esvaecemos-vos	esvaecer+V.vós.AD.2.PL+PRS+1+PL
esvaecem-se	esvaecer+V.ele.REFL+PRS+3+PL
esvaecem-te	esvaecer+V.tu.AD.2.SG+PRS+3+PL
esvaecem-vos	esvaecer+V.vós.AD.2.PL+PRS+3+PL
esvaecendo-a	esvaecer+V.ele.ACC.3.F.SG+GRD
esvaecendo-as	esvaecer+V.ele.ACC.3.F.PL+GRD
esvaecendo-lhe	esvaecer+V.ele.DAT.3.SG+GRD
esvaecendo-lhes	esvaecer+V.ele.DAT.3.PL+GRD
esvaecendo-me	esvaecer+V.eu.AD.1.SG+GRD
esvaecendo-nos	esvaecer+nós.AD.1.PL+GRD
esvaecendo-o	esvaecer+V.ele.ACC.3.M.SG+GRD
esvaecendo-os	esvaecer+V.ele.ACC.3.M.PL+GRD
esvaecendo-se	esvaecer+V.ele.REFL+GRD
esvaecendo-te	esvaecer+V.tu.AD.2.SG+GRD
esvaecendo-vos	esvaecer+V.vós.AD.2.PL+GRD
esvaece-nos	esvaecer+nós.AD.1.PL+PRS+2+SG
esvaecera-a	esvaecer+V.ele.ACC.3.F.SG+PQP+1+SG
esvaecera-a	esvaecer+V.ele.ACC.3.F.SG+PQP+3+SG
esvaecera-as	esvaecer+V.ele.ACC.3.F.PL+PQP+1+SG
esvaecera-as	esvaecer+V.ele.ACC.3.F.PL+PQP+3+SG
esvaecera-la	esvaecer+V.ele.ACC.3.F.SG+PQP+2+SG
esvaecera-las	esvaecer+V.ele.ACC.3.F.PL+PQP+2+SG
esvaecera-lhe	esvaecer+V.ele.DAT.3.SG+PQP+1+SG
esvaecera-lhe	esvaecer+V.ele.DAT.3.SG+PQP+3+SG
esvaecera-lhes	esvaecer+V.ele.DAT.3.PL+PQP+1+SG
esvaecera-lhes	esvaecer+V.ele.DAT.3.PL+PQP+3+SG
esvaecera-lo	esvaecer+V.ele.ACC.3.M.SG+PQP+2+SG
esvaecera-los	esvaecer+V.ele.ACC.3.M.PL+PQP+2+SG
esvaecera-me	esvaecer+V.eu.AD.1.SG+PQP+1+SG
esvaecera-me	esvaecer+V.eu.AD.1.SG+PQP+3+SG
esvaeceram-lhe	esvaecer+V.ele.DAT.3.SG+PQP+3+PL
esvaeceram-lhe	esvaecer+V.ele.DAT.3.SG+PRF+3+PL
esvaeceram-lhes	esvaecer+V.ele.DAT.3.PL+PQP+3+PL
esvaeceram-lhes	esvaecer+V.ele.DAT.3.PL+PRF+3+PL
esvaeceram-me	esvaecer+V.eu.AD.1.SG+PQP+3+PL
esvaeceram-me	esvaecer+V.eu.AD.1.SG+PRF+3+PL
esvaeceram-na	esvaecer+V.ele.ACC.3.F.SG+PQP+3+PL
esvaeceram-na	esvaecer+V.ele.ACC.3.F.SG+PRF+3+PL
esvaeceram-nas	esvaecer+V.ele.ACC.3.F.PL+PQP+3+PL
esvaeceram-nas	esvaecer+V.ele.ACC.3.F.PL+PRF+3+PL
esvaeceram-no	esvaecer+V.ele.ACC.3.M.SG+PQP+3+PL
esvaeceram-no	esvaecer+V.ele.ACC.3.M.SG+PRF+3+PL
esvaeceram-nos	esvaecer+V.ele.ACC.3.M.PL+PQP+3+PL
esvaeceram-nos	esvaecer+V.ele.ACC.3.M.PL+PRF+3+PL
esvaeceram-nos	esvaecer+V.nós.AD.1.PL+PQP+3+PL
esvaeceram-nos	esvaecer+V.nós.AD.1.PL+PRF+3+PL
esvaecêramo-la	esvaecer+V.ele.ACC.3.F.SG+PQP+1+PL
esvaecêramo-las	esvaecer+V.ele.ACC.3.F.PL+PQP+1+PL
esvaecêramo-lo	esvaecer+V.ele.ACC.3.M.SG+PQP+1+PL
esvaecêramo-los	esvaecer+V.ele.ACC.3.M.PL+PQP+1+PL
esvaecêramo-nos	esvaecer+nós.AD.1.PL+PQP+1+PL
esvaecêramos-lhe	esvaecer+V.ele.DAT.3.SG+PQP+1+PL
esvaecêramos-lhes	esvaecer+V.ele.DAT.3.PL+PQP+1+PL
esvaecêramos-me	esvaecer+V.eu.AD.1.SG+PQP+1+PL
esvaecêramos-te	esvaecer+V.tu.AD.2.SG+PQP+1+PL
esvaecêramos-vos	esvaecer+V.vós.AD.2.PL+PQP+1+PL
esvaeceram-se	esvaecer+V.ele.REFL+PQP+3+PL
esvaeceram-se	esvaecer+V.ele.REFL+PRF+3+PL
esvaeceram-te	esvaecer+V.tu.AD.2.SG+PQP+3+PL
esvaeceram-te	esvaecer+V.tu.AD.2.SG+PRF+3+PL
esvaeceram-vos	esvaecer+V.vós.AD.2.PL+PQP+3+PL
esvaeceram-vos	esvaecer+V.vós.AD.2.PL+PRF+3+PL
esvaecera-nos	esvaecer+nós.AD.1.PL+PQP+1+SG
esvaecera-nos	esvaecer+nós.AD.1.PL+PQP+2+SG
esvaecera-nos	esvaecer+nós.AD.1.PL+PQP+3+SG
esvaecera-o	esvaecer+V.ele.ACC.3.M.SG+PQP+1+SG
esvaecera-o	esvaecer+V.ele.ACC.3.M.SG+PQP+3+SG
esvaecera-os	esvaecer+V.ele.ACC.3.M.PL+PQP+1+SG
esvaecera-os	esvaecer+V.ele.ACC.3.M.PL+PQP+3+SG
esvaecera-se	esvaecer+V.ele.REFL+PQP+3+SG
esvaeceras-lhe	esvaecer+V.ele.DAT.3.SG+PQP+2+SG
esvaeceras-lhes	esvaecer+V.ele.DAT.3.PL+PQP+2+SG
esvaeceras-me	esvaecer+V.eu.AD.1.SG+PQP+2+SG
esvaeceras-te	esvaecer+V.tu.AD.2.SG+PQP+2+SG
esvaeceras-vos	esvaecer+V.vós.AD.2.PL+PQP+2+SG
esvaecera-te	esvaecer+V.tu.AD.2.SG+PQP+1+SG
esvaecera-te	esvaecer+V.tu.AD.2.SG+PQP+3+SG
esvaecera-vos	esvaecer+V.vós.AD.2.PL+PQP+1+SG
esvaecera-vos	esvaecer+V.vós.AD.2.PL+PQP+3+SG
esvaecerde-la	esvaecer+V.ele.ACC.3.F.SG+INF+2+PL
esvaecerde-la	esvaecer+V.ele.ACC.3.F.SG+SBJF+2+PL
esvaecerde-las	esvaecer+V.ele.ACC.3.F.PL+INF+2+PL
esvaecerde-las	esvaecer+V.ele.ACC.3.F.PL+SBJF+2+PL
esvaecerde-lo	esvaecer+V.ele.ACC.3.M.SG+INF+2+PL
esvaecerde-lo	esvaecer+V.ele.ACC.3.M.SG+SBJF+2+PL
esvaecerde-los	esvaecer+V.ele.ACC.3.M.PL+INF+2+PL
esvaecerde-los	esvaecer+V.ele.ACC.3.M.PL+SBJF+2+PL
esvaecerde-nos	esvaecer+nós.AD.1.PL+INF+2+PL
esvaecerde-nos	esvaecer+nós.AD.1.PL+SBJF+2+PL
esvaecerdes-lhe	esvaecer+V.ele.DAT.3.SG+INF+2+PL
esvaecerdes-lhe	esvaecer+V.ele.DAT.3.SG+SBJF+2+PL
esvaecerdes-lhes	esvaecer+V.ele.DAT.3.PL+INF+2+PL
esvaecerdes-lhes	esvaecer+V.ele.DAT.3.PL+SBJF+2+PL
esvaecerdes-me	esvaecer+V.eu.AD.1.SG+INF+2+PL
esvaecerdes-me	esvaecer+V.eu.AD.1.SG+SBJF+2+PL
esvaecerdes-te	esvaecer+V.tu.AD.2.SG+INF+2+PL
esvaecerdes-te	esvaecer+V.tu.AD.2.SG+SBJF+2+PL
esvaecerdes-vos	esvaecer+V.vós.AD.2.PL+INF+2+PL
esvaecerdes-vos	esvaecer+V.vós.AD.2.PL+SBJF+2+PL
esvaecêrei-la	esvaecer+V.ele.ACC.3.F.SG+PQP+2+PL
esvaecêrei-las	esvaecer+V.ele.ACC.3.F.PL+PQP+2+PL
esvaecêrei-lo	esvaecer+V.ele.ACC.3.M.SG+PQP+2+PL
esvaecêrei-los	esvaecer+V.ele.ACC.3.M.PL+PQP+2+PL
esvaecêrei-nos	esvaecer+nós.AD.1.PL+PQP+2+PL
esvaecêreis-lhe	esvaecer+V.ele.DAT.3.SG+PQP+2+PL
esvaecêreis-lhes	esvaecer+V.ele.DAT.3.PL+PQP+2+PL
esvaecêreis-me	esvaecer+V.eu.AD.1.SG+PQP+2+PL
esvaecêreis-te	esvaecer+V.tu.AD.2.SG+PQP+2+PL
esvaecêreis-vos	esvaecer+V.vós.AD.2.PL+PQP+2+PL
esvaecere-la	esvaecer+V.ele.ACC.3.F.SG+INF+2+SG
esvaecere-la	esvaecer+V.ele.ACC.3.F.SG+SBJF+2+SG
esvaecere-las	esvaecer+V.ele.ACC.3.F.PL+INF+2+SG
esvaecere-las	esvaecer+V.ele.ACC.3.F.PL+SBJF+2+SG
esvaecere-lo	esvaecer+V.ele.ACC.3.M.SG+INF+2+SG
esvaecere-lo	esvaecer+V.ele.ACC.3.M.SG+SBJF+2+SG
esvaecere-los	esvaecer+V.ele.ACC.3.M.PL+INF+2+SG
esvaecere-los	esvaecer+V.ele.ACC.3.M.PL+SBJF+2+SG
esvaecerem-lhe	esvaecer+V.ele.DAT.3.SG+INF+3+PL
esvaecerem-lhe	esvaecer+V.ele.DAT.3.SG+SBJF+3+PL
esvaecerem-lhes	esvaecer+V.ele.DAT.3.PL+INF+3+PL
esvaecerem-lhes	esvaecer+V.ele.DAT.3.PL+SBJF+3+PL
esvaecerem-me	esvaecer+V.eu.AD.1.SG+INF+3+PL
esvaecerem-me	esvaecer+V.eu.AD.1.SG+SBJF+3+PL
esvaecerem-na	esvaecer+V.ele.ACC.3.F.SG+INF+3+PL
esvaecerem-na	esvaecer+V.ele.ACC.3.F.SG+SBJF+3+PL
esvaecerem-nas	esvaecer+V.ele.ACC.3.F.PL+INF+3+PL
esvaecerem-nas	esvaecer+V.ele.ACC.3.F.PL+SBJF+3+PL
esvaecerem-no	esvaecer+V.ele.ACC.3.M.SG+INF+3+PL
esvaecerem-no	esvaecer+V.ele.ACC.3.M.SG+SBJF+3+PL
esvaecerem-nos	esvaecer+V.ele.ACC.3.M.PL+INF+3+PL
esvaecerem-nos	esvaecer+V.ele.ACC.3.M.PL+SBJF+3+PL
esvaecerem-nos	esvaecer+V.nós.AD.1.PL+INF+3+PL
esvaecerem-nos	esvaecer+V.nós.AD.1.PL+SBJF+3+PL
esvaecerem-se	esvaecer+V.ele.REFL+INF+3+PL
esvaecerem-se	esvaecer+V.ele.REFL+SBJF+3+PL
esvaecerem-te	esvaecer+V.tu.AD.2.SG+INF+3+PL
esvaecerem-te	esvaecer+V.tu.AD.2.SG+SBJF+3+PL
esvaecerem-vos	esvaecer+V.vós.AD.2.PL+INF+3+PL
esvaecerem-vos	esvaecer+V.vós.AD.2.PL+SBJF+3+PL
esvaecere-nos	esvaecer+nós.AD.1.PL+INF+2+SG
esvaecere-nos	esvaecer+nós.AD.1.PL+SBJF+2+SG
esvaeceres-lhe	esvaecer+V.ele.DAT.3.SG+INF+2+SG
esvaeceres-lhe	esvaecer+V.ele.DAT.3.SG+SBJF+2+SG
esvaeceres-lhes	esvaecer+V.ele.DAT.3.PL+INF+2+SG
esvaeceres-lhes	esvaecer+V.ele.DAT.3.PL+SBJF+2+SG
esvaeceres-me	esvaecer+V.eu.AD.1.SG+INF+2+SG
esvaeceres-me	esvaecer+V.eu.AD.1.SG+SBJF+2+SG
esvaeceres-te	esvaecer+V.tu.AD.2.SG+INF+2+SG
esvaeceres-te	esvaecer+V.tu.AD.2.SG+SBJF+2+SG
esvaeceres-vos	esvaecer+V.vós.AD.2.PL+INF+2+SG
esvaeceres-vos	esvaecer+V.vós.AD.2.PL+SBJF+2+SG
esvaecer-lhe-á	esvaecer+V.ele.DAT.3.SG+FUT+3+SG
esvaecer-lhe-ão	esvaecer+V.ele.DAT.3.SG+FUT+3+PL
esvaecer-lhe-ás	esvaecer+V.ele.DAT.3.SG+FUT+2+SG
esvaecer-lhe-ei	esvaecer+V.ele.DAT.3.SG+FUT+1+SG
esvaecer-lhe-eis	esvaecer+V.ele.DAT.3.SG+FUT+2+PL
esvaecer-lhe-emos	esvaecer+V.ele.DAT.3.SG+FUT+1+PL
esvaecer-lhe	esvaecer+V.ele.DAT.3.SG+INF
esvaecer-lhe	esvaecer+V.ele.DAT.3.SG+INF+1+SG
esvaecer-lhe	esvaecer+V.ele.DAT.3.SG+INF+3+SG
esvaecer-lhe	esvaecer+V.ele.DAT.3.SG+SBJF+1+SG
esvaecer-lhe	esvaecer+V.ele.DAT.3.SG+SBJF+3+SG
esvaecer-lhe-ia	esvaecer+V.ele.DAT.3.SG+COND+1+SG
esvaecer-lhe-ia	esvaecer+V.ele.DAT.3.SG+COND+3+SG
esvaecer-lhe-iam	esvaecer+V.ele.DAT.3.SG+COND+3+PL
esvaecer-lhe-íamos	esvaecer+V.ele.DAT.3.SG+COND+1+PL
esvaecer-lhe-ias	esvaecer+V.ele.DAT.3.SG+COND+2+SG
esvaecer-lhe-íeis	esvaecer+V.ele.DAT.3.SG+COND+2+PL
esvaecer-lhes-á	esvaecer+V.ele.DAT.3.PL+FUT+3+SG
esvaecer-lhes-ão	esvaecer+V.ele.DAT.3.PL+FUT+3+PL
esvaecer-lhes-ás	esvaecer+V.ele.DAT.3.PL+FUT+2+SG
esvaecer-lhes-ei	esvaecer+V.ele.DAT.3.PL+FUT+1+SG
esvaecer-lhes-eis	esvaecer+V.ele.DAT.3.PL+FUT+2+PL
esvaecer-lhes-emos	esvaecer+V.ele.DAT.3.PL+FUT+1+PL
esvaecer-lhes	esvaecer+V.ele.DAT.3.PL+INF
esvaecer-lhes	esvaecer+V.ele.DAT.3.PL+INF+1+SG
esvaecer-lhes	esvaecer+V.ele.DAT.3.PL+INF+3+SG
esvaecer-lhes	esvaecer+V.ele.DAT.3.PL+SBJF+1+SG
esvaecer-lhes	esvaecer+V.ele.DAT.3.PL+SBJF+3+SG
esvaecer-lhes-ia	esvaecer+V.ele.DAT.3.PL+COND+1+SG
esvaecer-lhes-ia	esvaecer+V.ele.DAT.3.PL+COND+3+SG
esvaecer-lhes-iam	esvaecer+V.ele.DAT.3.PL+COND+3+PL
esvaecer-lhes-íamos	esvaecer+V.ele.DAT.3.PL+COND+1+PL
esvaecer-lhes-ias	esvaecer+V.ele.DAT.3.PL+COND+2+SG
esvaecer-lhes-íeis	esvaecer+V.ele.DAT.3.PL+COND+2+PL
esvaecer-me-á	esvaecer+V.eu.AD.1.SG+FUT+3+SG
esvaecer-me-ão	esvaecer+V.eu.AD.1.SG+FUT+3+PL
esvaecer-me-ás	esvaecer+V.eu.AD.1.SG+FUT+2+SG
esvaecer-me-ei	esvaecer+V.eu.AD.1.SG+FUT+1+SG
esvaecer-me-eis	esvaecer+V.eu.AD.1.SG+FUT+2+PL
esvaecer-me-emos	esvaecer+V.eu.AD.1.SG+FUT+1+PL
esvaecer-me	esvaecer+V.eu.AD.1.SG+INF
esvaecer-me	esvaecer+V.eu.AD.1.SG+INF+1+SG
esvaecer-me	esvaecer+V.eu.AD.1.SG+INF+3+SG
esvaecer-me	esvaecer+V.eu.AD.1.SG+SBJF+1+SG
esvaecer-me	esvaecer+V.eu.AD.1.SG+SBJF+3+SG
esvaecer-me-ia	esvaecer+V.eu.AD.1.SG+COND+1+SG
esvaecer-me-ia	esvaecer+V.eu.AD.1.SG+COND+3+SG
esvaecer-me-iam	esvaecer+V.eu.AD.1.SG+COND+3+PL
esvaecer-me-íamos	esvaecer+V.eu.AD.1.SG+COND+1+PL
esvaecer-me-ias	esvaecer+V.eu.AD.1.SG+COND+2+SG
esvaecer-me-íeis	esvaecer+V.eu.AD.1.SG+COND+2+PL
esvaecermo-la	esvaecer+V.ele.ACC.3.F.SG+INF+1+PL
esvaecermo-la	esvaecer+V.ele.ACC.3.F.SG+SBJF+1+PL
esvaecermo-las	esvaecer+V.ele.ACC.3.F.PL+INF+1+PL
esvaecermo-las	esvaecer+V.ele.ACC.3.F.PL+SBJF+1+PL
esvaecermo-lo	esvaecer+V.ele.ACC.3.M.SG+INF+1+PL
esvaecermo-lo	esvaecer+V.ele.ACC.3.M.SG+SBJF+1+PL
esvaecermo-los	esvaecer+V.ele.ACC.3.M.PL+INF+1+PL
esvaecermo-los	esvaecer+V.ele.ACC.3.M.PL+SBJF+1+PL
esvaecermo-nos	esvaecer+nós.AD.1.PL+INF+1+PL
esvaecermo-nos	esvaecer+nós.AD.1.PL+SBJF+1+PL
esvaecermos-lhe	esvaecer+V.ele.DAT.3.SG+INF+1+PL
esvaecermos-lhe	esvaecer+V.ele.DAT.3.SG+SBJF+1+PL
esvaecermos-lhes	esvaecer+V.ele.DAT.3.PL+INF+1+PL
esvaecermos-lhes	esvaecer+V.ele.DAT.3.PL+SBJF+1+PL
esvaecermos-me	esvaecer+V.eu.AD.1.SG+INF+1+PL
esvaecermos-me	esvaecer+V.eu.AD.1.SG+SBJF+1+PL
esvaecermos-te	esvaecer+V.tu.AD.2.SG+INF+1+PL
esvaecermos-te	esvaecer+V.tu.AD.2.SG+SBJF+1+PL
esvaecermos-vos	esvaecer+V.vós.AD.2.PL+INF+1+PL
esvaecermos-vos	esvaecer+V.vós.AD.2.PL+SBJF+1+PL
esvaecer-nos-á	esvaecer+nós.AD.1.PL+FUT+3+SG
esvaecer-nos-ão	esvaecer+nós.AD.1.PL+FUT+3+PL
esvaecer-nos-ás	esvaecer+nós.AD.1.PL+FUT+2+SG
esvaecer-nos-ei	esvaecer+nós.AD.1.PL+FUT+1+SG
esvaecer-nos-eis	esvaecer+nós.AD.1.PL+FUT+2+PL
esvaecer-nos-emos	esvaecer+nós.AD.1.PL+FUT+1+PL
esvaecer-nos	esvaecer+nós.AD.1.PL+INF
esvaecer-nos	esvaecer+nós.AD.1.PL+INF+1+SG
esvaecer-nos	esvaecer+nós.AD.1.PL+INF+3+SG
esvaecer-nos	esvaecer+nós.AD.1.PL+SBJF+1+SG
esvaecer-nos	esvaecer+nós.AD.1.PL+SBJF+3+SG
esvaecer-nos-ia	esvaecer+nós.AD.1.PL+COND+1+SG
esvaecer-nos-ia	esvaecer+nós.AD.1.PL+COND+3+SG
esvaecer-nos-iam	esvaecer+nós.AD.1.PL+COND+3+PL
esvaecer-nos-íamos	esvaecer+nós.AD.1.PL+COND+1+PL
esvaecer-nos-ias	esvaecer+nós.AD.1.PL+COND+2+SG
esvaecer-nos-íeis	esvaecer+nós.AD.1.PL+COND+2+PL
esvaecer-se-á	esvaecer+V.ele.REFL+FUT+3+SG
esvaecer-se-ão	esvaecer+V.ele.REFL+FUT+3+PL
esvaecer-se	esvaecer+V.ele.REFL+INF
esvaecer-se	esvaecer+V.ele.REFL+INF+3+SG
esvaecer-se	esvaecer+V.ele.REFL+SBJF+3+SG
esvaecer-se-ia	esvaecer+V.ele.REFL+COND+3+SG
esvaecer-se-iam	esvaecer+V.ele.REFL+COND+3+PL
esvaecer-te-á	esvaecer+V.tu.AD.2.SG+FUT+3+SG
esvaecer-te-ão	esvaecer+V.tu.AD.2.SG+FUT+3+PL
esvaecer-te-ás	esvaecer+V.tu.AD.2.SG+FUT+2+SG
esvaecer-te-ei	esvaecer+V.tu.AD.2.SG+FUT+1+SG
esvaecer-te-eis	esvaecer+V.tu.AD.2.SG+FUT+2+PL
esvaecer-te-emos	esvaecer+V.tu.AD.2.SG+FUT+1+PL
esvaecer-te	esvaecer+V.tu.AD.2.SG+INF
esvaecer-te	esvaecer+V.tu.AD.2.SG+INF+1+SG
esvaecer-te	esvaecer+V.tu.AD.2.SG+INF+3+SG
esvaecer-te	esvaecer+V.tu.AD.2.SG+SBJF+1+SG
esvaecer-te	esvaecer+V.tu.AD.2.SG+SBJF+3+SG
esvaecer-te-ia	esvaecer+V.tu.AD.2.SG+COND+1+SG
esvaecer-te-ia	esvaecer+V.tu.AD.2.SG+COND+3+SG
esvaecer-te-iam	esvaecer+V.tu.AD.2.SG+COND+3+PL
esvaecer-te-íamos	esvaecer+V.tu.AD.2.SG+COND+1+PL
esvaecer-te-ias	esvaecer+V.tu.AD.2.SG+COND+2+SG
esvaecer-te-íeis	esvaecer+V.tu.AD.2.SG+COND+2+PL
esvaecer-vos-á	esvaecer+V.vós.AD.2.PL+FUT+3+SG
esvaecer-vos-ão	esvaecer+V.vós.AD.2.PL+FUT+3+PL
esvaecer-vos-ás	esvaecer+V.vós.AD.2.PL+FUT+2+SG
esvaecer-vos-ei	esvaecer+V.vós.AD.2.PL+FUT+1+SG
esvaecer-vos-eis	esvaecer+V.vós.AD.2.PL+FUT+2+PL
esvaecer-vos-emos	esvaecer+V.vós.AD.2.PL+FUT+1+PL
esvaecer-vos	esvaecer+V.vós.AD.2.PL+INF
esvaecer-vos	esvaecer+V.vós.AD.2.PL+INF+1+SG
esvaecer-vos	esvaecer+V.vós.AD.2.PL+INF+3+SG
esvaecer-vos	esvaecer+V.vós.AD.2.PL+SBJF+1+SG
esvaecer-vos	esvaecer+V.vós.AD.2.PL+SBJF+3+SG
esvaecer-vos-ia	esvaecer+V.vós.AD.2.PL+COND+1+SG
esvaecer-vos-ia	esvaecer+V.vós.AD.2.PL+COND+3+SG
esvaecer-vos-iam	esvaecer+V.vós.AD.2.PL+COND+3+PL
esvaecer-vos-íamos	esvaecer+V.vós.AD.2.PL+COND+1+PL
esvaecer-vos-ias	esvaecer+V.vós.AD.2.PL+COND+2+SG
esvaecer-vos-íeis	esvaecer+V.vós.AD.2.PL+COND+2+PL
esvaece-se	esvaecer+V.ele.REFL+PRS+3+SG
esvaeces-lhe	esvaecer+V.ele.DAT.3.SG+PRS+2+SG
esvaeces-lhes	esvaecer+V.ele.DAT.3.PL+PRS+2+SG
esvaeces-me	esvaecer+V.eu.AD.1.SG+PRS+2+SG
esvaeceste-a	esvaecer+V.ele.ACC.3.F.SG+PRF+2+SG
esvaeceste-as	esvaecer+V.ele.ACC.3.F.PL+PRF+2+SG
esvaeces-te	esvaecer+V.tu.AD.2.SG+PRS+2+SG
esvaeceste-la	esvaecer+V.ele.ACC.3.F.SG+PRF+2+PL
esvaeceste-las	esvaecer+V.ele.ACC.3.F.PL+PRF+2+PL
esvaeceste-lhe	esvaecer+V.ele.DAT.3.SG+PRF+2+SG
esvaeceste-lhes	esvaecer+V.ele.DAT.3.PL+PRF+2+SG
esvaeceste-lo	esvaecer+V.ele.ACC.3.M.SG+PRF+2+PL
esvaeceste-los	esvaecer+V.ele.ACC.3.M.PL+PRF+2+PL
esvaeceste-me	esvaecer+V.eu.AD.1.SG+PRF+2+SG
esvaeceste-nos	esvaecer+nós.AD.1.PL+PRF+2+PL
esvaeceste-nos	esvaecer+nós.AD.1.PL+PRF+2+SG
esvaeceste-o	esvaecer+V.ele.ACC.3.M.SG+PRF+2+SG
esvaeceste-os	esvaecer+V.ele.ACC.3.M.PL+PRF+2+SG
esvaecestes-lhe	esvaecer+V.ele.DAT.3.SG+PRF+2+PL
esvaecestes-lhes	esvaecer+V.ele.DAT.3.PL+PRF+2+PL
esvaecestes-me	esvaecer+V.eu.AD.1.SG+PRF+2+PL
esvaecestes-te	esvaecer+V.tu.AD.2.SG+PRF+2+PL
esvaecestes-vos	esvaecer+V.vós.AD.2.PL+PRF+2+PL
esvaeceste-te	esvaecer+V.tu.AD.2.SG+PRF+2+SG
esvaeceste-vos	esvaecer+V.vós.AD.2.PL+PRF+2+SG
esvaeces-vos	esvaecer+V.vós.AD.2.PL+PRS+2+SG
esvaeceu-a	esvaecer+V.ele.ACC.3.F.SG+PRF+3+SG
esvaeceu-as	esvaecer+V.ele.ACC.3.F.PL+PRF+3+SG
esvaeceu-lhe	esvaecer+V.ele.DAT.3.SG+PRF+3+SG
esvaeceu-lhes	esvaecer+V.ele.DAT.3.PL+PRF+3+SG
esvaeceu-me	esvaecer+V.eu.AD.1.SG+PRF+3+SG
esvaeceu-nos	esvaecer+nós.AD.1.PL+PRF+3+SG
esvaeceu-o	esvaecer+V.ele.ACC.3.M.SG+PRF+3+SG
esvaeceu-os	esvaecer+V.ele.ACC.3.M.PL+PRF+3+SG
esvaeceu-se	esvaecer+V.ele.REFL+PRF+3+SG
esvaeceu-te	esvaecer+V.tu.AD.2.SG+PRF+3+SG
esvaeceu-vos	esvaecer+V.vós.AD.2.PL+PRF+3+SG
esvaecia-a	esvaecer+V.ele.ACC.3.F.SG+IMPF+1+SG
esvaecia-a	esvaecer+V.ele.ACC.3.F.SG+IMPF+3+SG
esvaecia-as	esvaecer+V.ele.ACC.3.F.PL+IMPF+1+SG
esvaecia-as	esvaecer+V.ele.ACC.3.F.PL+IMPF+3+SG
esvaeci-a	esvaecer+V.ele.ACC.3.F.SG+PRF+1+SG
esvaecia-la	esvaecer+V.ele.ACC.3.F.SG+IMPF+2+SG
esvaecia-las	esvaecer+V.ele.ACC.3.F.PL+IMPF+2+SG
esvaecia-lhe	esvaecer+V.ele.DAT.3.SG+IMPF+1+SG
esvaecia-lhe	esvaecer+V.ele.DAT.3.SG+IMPF+3+SG
esvaecia-lhes	esvaecer+V.ele.DAT.3.PL+IMPF+1+SG
esvaecia-lhes	esvaecer+V.ele.DAT.3.PL+IMPF+3+SG
esvaecia-lo	esvaecer+V.ele.ACC.3.M.SG+IMPF+2+SG
esvaecia-los	esvaecer+V.ele.ACC.3.M.PL+IMPF+2+SG
esvaecia-me	esvaecer+V.eu.AD.1.SG+IMPF+1+SG
esvaecia-me	esvaecer+V.eu.AD.1.SG+IMPF+3+SG
esvaeciam-lhe	esvaecer+V.ele.DAT.3.SG+IMPF+3+PL
esvaeciam-lhes	esvaecer+V.ele.DAT.3.PL+IMPF+3+PL
esvaeciam-me	esvaecer+V.eu.AD.1.SG+IMPF+3+PL
esvaeciam-na	esvaecer+V.ele.ACC.3.F.SG+IMPF+3+PL
esvaeciam-nas	esvaecer+V.ele.ACC.3.F.PL+IMPF+3+PL
esvaeciam-no	esvaecer+V.ele.ACC.3.M.SG+IMPF+3+PL
esvaeciam-nos	esvaecer+V.ele.ACC.3.M.PL+IMPF+3+PL
esvaeciam-nos	esvaecer+V.nós.AD.1.PL+IMPF+3+PL
esvaecíamo-la	esvaecer+V.ele.ACC.3.F.SG+IMPF+1+PL
esvaecíamo-las	esvaecer+V.ele.ACC.3.F.PL+IMPF+1+PL
esvaecíamo-lo	esvaecer+V.ele.ACC.3.M.SG+IMPF+1+PL
esvaecíamo-los	esvaecer+V.ele.ACC.3.M.PL+IMPF+1+PL
esvaecíamo-nos	esvaecer+nós.AD.1.PL+IMPF+1+PL
esvaecíamos-lhe	esvaecer+V.ele.DAT.3.SG+IMPF+1+PL
esvaecíamos-lhes	esvaecer+V.ele.DAT.3.PL+IMPF+1+PL
esvaecíamos-me	esvaecer+V.eu.AD.1.SG+IMPF+1+PL
esvaecíamos-te	esvaecer+V.tu.AD.2.SG+IMPF+1+PL
esvaecíamos-vos	esvaecer+V.vós.AD.2.PL+IMPF+1+PL
esvaeciam-se	esvaecer+V.ele.REFL+IMPF+3+PL
esvaeciam-te	esvaecer+V.tu.AD.2.SG+IMPF+3+PL
esvaeciam-vos	esvaecer+V.vós.AD.2.PL+IMPF+3+PL
esvaecia-nos	esvaecer+nós.AD.1.PL+IMPF+1+SG
esvaecia-nos	esvaecer+nós.AD.1.PL+IMPF+2+SG
esvaecia-nos	esvaecer+nós.AD.1.PL+IMPF+3+SG
esvaecia-o	esvaecer+V.ele.ACC.3.M.SG+IMPF+1+SG
esvaecia-o	esvaecer+V.ele.ACC.3.M.SG+IMPF+3+SG
esvaecia-os	esvaecer+V.ele.ACC.3.M.PL+IMPF+1+SG
esvaecia-os	esvaecer+V.ele.ACC.3.M.PL+IMPF+3+SG
esvaecia-se	esvaecer+V.ele.REFL+IMPF+3+SG
esvaeci-as	esvaecer+V.ele.ACC.3.F.PL+PRF+1+SG
esvaecias-lhe	esvaecer+V.ele.DAT.3.SG+IMPF+2+SG
esvaecias-lhes	esvaecer+V.ele.DAT.3.PL+IMPF+2+SG
esvaecias-me	esvaecer+V.eu.AD.1.SG+IMPF+2+SG
esvaecias-te	esvaecer+V.tu.AD.2.SG+IMPF+2+SG
esvaecias-vos	esvaecer+V.vós.AD.2.PL+IMPF+2+SG
esvaecia-te	esvaecer+V.tu.AD.2.SG+IMPF+1+SG
esvaecia-te	esvaecer+V.tu.AD.2.SG+IMPF+3+SG
esvaecia-vos	esvaecer+V.vós.AD.2.PL+IMPF+1+SG
esvaecia-vos	esvaecer+V.vós.AD.2.PL+IMPF+3+SG
esvaecíei-la	esvaecer+V.ele.ACC.3.F.SG+IMPF+2+PL
esvaecíei-las	esvaecer+V.ele.ACC.3.F.PL+IMPF+2+PL
esvaecíei-lo	esvaecer+V.ele.ACC.3.M.SG+IMPF+2+PL
esvaecíei-los	esvaecer+V.ele.ACC.3.M.PL+IMPF+2+PL
esvaecíei-nos	esvaecer+nós.AD.1.PL+IMPF+2+PL
esvaecíeis-lhe	esvaecer+V.ele.DAT.3.SG+IMPF+2+PL
esvaecíeis-lhes	esvaecer+V.ele.DAT.3.PL+IMPF+2+PL
esvaecíeis-me	esvaecer+V.eu.AD.1.SG+IMPF+2+PL
esvaecíeis-te	esvaecer+V.tu.AD.2.SG+IMPF+2+PL
esvaecíeis-vos	esvaecer+V.vós.AD.2.PL+IMPF+2+PL
esvaeci-lhe	esvaecer+V.ele.DAT.3.SG+PRF+1+SG
esvaeci-lhes	esvaecer+V.ele.DAT.3.PL+PRF+1+SG
esvaeci-me	esvaecer+V.eu.AD.1.SG+PRF+1+SG
esvaeci-nos	esvaecer+nós.AD.1.PL+PRF+1+SG
esvaeci-o	esvaecer+V.ele.ACC.3.M.SG+PRF+1+SG
esvaeci-os	esvaecer+V.ele.ACC.3.M.PL+PRF+1+SG
esvaeci-te	esvaecer+V.tu.AD.2.SG+PRF+1+SG
esvaeci-vos	esvaecer+V.vós.AD.2.PL+PRF+1+SG
esvaeço-a	esvaecer+V.ele.ACC.3.F.SG+PRS+1+SG
esvaeço-as	esvaecer+V.ele.ACC.3.F.PL+PRS+1+SG
esvaeço-lhe	esvaecer+V.ele.DAT.3.SG+PRS+1+SG
esvaeço-lhes	esvaecer+V.ele.DAT.3.PL+PRS+1+SG
esvaeço-me	esvaecer+V.eu.AD.1.SG+PRS+1+SG
esvaeço-nos	esvaecer+nós.AD.1.PL+PRS+1+SG
esvaeço-o	esvaecer+V.ele.ACC.3.M.SG+PRS+1+SG
esvaeço-os	esvaecer+V.ele.ACC.3.M.PL+PRS+1+SG
esvaeço-te	esvaecer+V.tu.AD.2.SG+PRS+1+SG
esvaeço-vos	esvaecer+V.vós.AD.2.PL+PRS+1+SG
esvaem-lhe	esvair+V.ele.DAT.3.SG+PRS+3+PL
esvaem-lhes	esvair+V.ele.DAT.3.PL+PRS+3+PL
esvaem-me	esvair+V.eu.AD.1.SG+PRS+3+PL
esvaem-na	esvair+V.ele.ACC.3.F.SG+PRS+3+PL
esvaem-nas	esvair+V.ele.ACC.3.F.PL+PRS+3+PL
esvaem-no	esvair+V.ele.ACC.3.M.SG+PRS+3+PL
esvaem-nos	esvair+V.ele.ACC.3.M.PL+PRS+3+PL
esvaem-nos	esvair+V.nós.AD.1.PL+PRS+3+PL
esvaem-se	esvair+V.ele.REFL+PRS+3+PL
esvaem-te	esvair+V.tu.AD.2.SG+PRS+3+PL
esvaem-vos	esvair+V.vós.AD.2.PL+PRS+3+PL
esvaia-a	esvair+V.ele.ACC.3.F.SG+IMP+3+SG
esvaía-a	esvair+V.ele.ACC.3.F.SG+IMPF+1+SG
esvaía-a	esvair+V.ele.ACC.3.F.SG+IMPF+3+SG
esvaia-as	esvair+V.ele.ACC.3.F.PL+IMP+3+SG
esvaía-as	esvair+V.ele.ACC.3.F.PL+IMPF+1+SG
esvaía-as	esvair+V.ele.ACC.3.F.PL+IMPF+3+SG
esvaí-a	esvair+V.ele.ACC.3.F.SG+PRF+1+SG
esvai-a	esvair+V.ele.ACC.3.F.SG+PRS+3+SG
esvaía-la	esvair+V.ele.ACC.3.F.SG+IMPF+2+SG
esvaía-las	esvair+V.ele.ACC.3.F.PL+IMPF+2+SG
esvaia-lhe	esvair+V.ele.DAT.3.SG+IMP+3+SG
esvaía-lhe	esvair+V.ele.DAT.3.SG+IMPF+1+SG
esvaía-lhe	esvair+V.ele.DAT.3.SG+IMPF+3+SG
esvaia-lhes	esvair+V.ele.DAT.3.PL+IMP+3+SG
esvaía-lhes	esvair+V.ele.DAT.3.PL+IMPF+1+SG
esvaía-lhes	esvair+V.ele.DAT.3.PL+IMPF+3+SG
esvaía-lo	esvair+V.ele.ACC.3.M.SG+IMPF+2+SG
esvaía-los	esvair+V.ele.ACC.3.M.PL+IMPF+2+SG
esvaia-me	esvair+V.eu.AD.1.SG+IMP+3+SG
esvaía-me	esvair+V.eu.AD.1.SG+IMPF+1+SG
esvaía-me	esvair+V.eu.AD.1.SG+IMPF+3+SG
esvaiam-lhe	esvair+V.ele.DAT.3.SG+IMP+3+PL
esvaíam-lhe	esvair+V.ele.DAT.3.SG+IMPF+3+PL
esvaiam-lhes	esvair+V.ele.DAT.3.PL+IMP+3+PL
esvaíam-lhes	esvair+V.ele.DAT.3.PL+IMPF+3+PL
esvaiam-me	esvair+V.eu.AD.1.SG+IMP+3+PL
esvaíam-me	esvair+V.eu.AD.1.SG+IMPF+3+PL
esvaiam-na	esvair+V.ele.ACC.3.F.SG+IMP+3+PL
esvaíam-na	esvair+V.ele.ACC.3.F.SG+IMPF+3+PL
esvaiam-nas	esvair+V.ele.ACC.3.F.PL+IMP+3+PL
esvaíam-nas	esvair+V.ele.ACC.3.F.PL+IMPF+3+PL
esvaiam-no	esvair+V.ele.ACC.3.M.SG+IMP+3+PL
esvaíam-no	esvair+V.ele.ACC.3.M.SG+IMPF+3+PL
esvaíam-nos	esvair+nós.AD.1.PL+IMPF+3+PL
esvaiam-nos	esvair+V.ele.ACC.3.M.PL+IMP+3+PL
esvaiam-nos	esvair+V.nós.AD.1.PL+IMP+3+PL
esvaiamo-la	esvair+V.ele.ACC.3.F.SG+IMP+1+PL
esvaíamo-la	esvair+V.ele.ACC.3.F.SG+IMPF+1+PL
esvaiamo-las	esvair+V.ele.ACC.3.F.PL+IMP+1+PL
esvaíamo-las	esvair+V.ele.ACC.3.F.PL+IMPF+1+PL
esvaiamo-lo	esvair+V.ele.ACC.3.M.SG+IMP+1+PL
esvaíamo-lo	esvair+V.ele.ACC.3.M.SG+IMPF+1+PL
esvaiamo-los	esvair+V.ele.ACC.3.M.PL+IMP+1+PL
esvaíamo-los	esvair+V.ele.ACC.3.M.PL+IMPF+1+PL
esvaiamo-nos	esvair+nós.AD.1.PL+IMP+1+PL
esvaíamo-nos	esvair+nós.AD.1.PL+IMPF+1+PL
esvaiamos-lhe	esvair+V.ele.DAT.3.SG+IMP+1+PL
esvaíamos-lhe	esvair+V.ele.DAT.3.SG+IMPF+1+PL
esvaiamos-lhes	esvair+V.ele.DAT.3.PL+IMP+1+PL
esvaíamos-lhes	esvair+V.ele.DAT.3.PL+IMPF+1+PL
esvaiamos-me	esvair+V.eu.AD.1.SG+IMP+1+PL
esvaíamos-me	esvair+V.eu.AD.1.SG+IMPF+1+PL
esvaiamos-te	esvair+V.tu.AD.2.SG+IMP+1+PL
esvaíamos-te	esvair+V.tu.AD.2.SG+IMPF+1+PL
esvaiamos-vos	esvair+V.vós.AD.2.PL+IMP+1+PL
esvaíamos-vos	esvair+V.vós.AD.2.PL+IMPF+1+PL
esvaiam-se	esvair+V.ele.REFL+IMP+3+PL
esvaíam-se	esvair+V.ele.REFL+IMPF+3+PL
esvaiam-te	esvair+V.tu.AD.2.SG+IMP+3+PL
esvaíam-te	esvair+V.tu.AD.2.SG+IMPF+3+PL
esvaiam-vos	esvair+V.vós.AD.2.PL+IMP+3+PL
esvaíam-vos	esvair+V.vós.AD.2.PL+IMPF+3+PL
esvaia-nos	esvair+nós.AD.1.PL+IMP+3+SG
esvaía-nos	esvair+nós.AD.1.PL+IMPF+1+SG
esvaía-nos	esvair+nós.AD.1.PL+IMPF+2+SG
esvaía-nos	esvair+nós.AD.1.PL+IMPF+3+SG
esvaia-o	esvair+V.ele.ACC.3.M.SG+IMP+3+SG
esvaía-o	esvair+V.ele.ACC.3.M.SG+IMPF+1+SG
esvaía-o	esvair+V.ele.ACC.3.M.SG+IMPF+3+SG
esvaia-os	esvair+V.ele.ACC.3.M.PL+IMP+3+SG
esvaía-os	esvair+V.ele.ACC.3.M.PL+IMPF+1+SG
esvaía-os	esvair+V.ele.ACC.3.M.PL+IMPF+3+SG
esvaia-se	esvair+V.ele.REFL+IMP+3+SG
esvaía-se	esvair+V.ele.REFL+IMPF+3+SG
esvaí-as	esvair+V.ele.ACC.3.F.PL+PRF+1+SG
esvai-as	esvair+V.ele.ACC.3.F.PL+PRS+3+SG
esvaías-lhe	esvair+V.ele.DAT.3.SG+IMPF+2+SG
esvaías-lhes	esvair+V.ele.DAT.3.PL+IMPF+2+SG
esvaías-me	esvair+V.eu.AD.1.SG+IMPF+2+SG
esvaías-te	esvair+V.tu.AD.2.SG+IMPF+2+SG
esvaías-vos	esvair+V.vós.AD.2.PL+IMPF+2+SG
esvaia-te	esvair+V.tu.AD.2.SG+IMP+3+SG
esvaía-te	esvair+V.tu.AD.2.SG+IMPF+1+SG
esvaía-te	esvair+V.tu.AD.2.SG+IMPF+3+SG
esvaia-vos	esvair+V.vós.AD.2.PL+IMP+3+SG
esvaía-vos	esvair+V.vós.AD.2.PL+IMPF+1+SG
esvaía-vos	esvair+V.vós.AD.2.PL+IMPF+3+SG
esvaíei-la	esvair+V.ele.ACC.3.F.SG+IMPF+2+PL
esvaíei-las	esvair+V.ele.ACC.3.F.PL+IMPF+2+PL
esvaíei-lo	esvair+V.ele.ACC.3.M.SG+IMPF+2+PL
esvaíei-los	esvair+V.ele.ACC.3.M.PL+IMPF+2+PL
esvaíei-nos	esvair+nós.AD.1.PL+IMPF+2+PL
esvaíeis-lhe	esvair+V.ele.DAT.3.SG+IMPF+2+PL
esvaíeis-lhes	esvair+V.ele.DAT.3.PL+IMPF+2+PL
esvaíeis-me	esvair+V.eu.AD.1.SG+IMPF+2+PL
esvaíeis-te	esvair+V.tu.AD.2.SG+IMPF+2+PL
esvaíeis-vos	esvair+V.vós.AD.2.PL+IMPF+2+PL
esvai-la-á	esvair+V.ele.ACC.3.F.SG+FUT+3+SG
esvai-la-ão	esvair+V.ele.ACC.3.F.SG+FUT+3+PL
esvai-la-ás	esvair+V.ele.ACC.3.F.SG+FUT+2+SG
esvai-la-ei	esvair+V.ele.ACC.3.F.SG+FUT+1+SG
esvai-la-eis	esvair+V.ele.ACC.3.F.SG+FUT+2+PL
esvai-la-emos	esvair+V.ele.ACC.3.F.SG+FUT+1+PL
esvai-la	esvair+V.ele.ACC.3.F.SG+INF+1+SG
esvai-la	esvair+V.ele.ACC.3.F.SG+INF+3+SG
esvaí-la	esvair+V.ele.ACC.3.F.SG+PRS+2+PL
esvai-la	esvair+V.ele.ACC.3.F.SG+PRS+2+SG
esvai-la	esvair+V.ele.ACC.3.F.SG+SBJF+1+SG
esvai-la	esvair+V.ele.ACC.3.F.SG+SBJF+3+SG
esvai-la-ia	esvair+V.ele.ACC.3.F.SG+COND+1+SG
esvai-la-ia	esvair+V.ele.ACC.3.F.SG+COND+3+SG
esvai-la-iam	esvair+V.ele.ACC.3.F.SG+COND+3+PL
esvai-la-íamos	esvair+V.ele.ACC.3.F.SG+COND+1+PL
esvai-la-ias	esvair+V.ele.ACC.3.F.SG+COND+2+SG
esvai-la-íeis	esvair+V.ele.ACC.3.F.SG+COND+2+PL
esvai-las-á	esvair+V.ele.ACC.3.F.PL+FUT+3+SG
esvai-las-ão	esvair+V.ele.ACC.3.F.PL+FUT+3+PL
esvai-las-ás	esvair+V.ele.ACC.3.F.PL+FUT+2+SG
esvai-las-ei	esvair+V.ele.ACC.3.F.PL+FUT+1+SG
esvai-las-eis	esvair+V.ele.ACC.3.F.PL+FUT+2+PL
esvai-las-emos	esvair+V.ele.ACC.3.F.PL+FUT+1+PL
esvai-las	esvair+V.ele.ACC.3.F.PL+INF+1+SG
esvai-las	esvair+V.ele.ACC.3.F.PL+INF+3+SG
esvaí-las	esvair+V.ele.ACC.3.F.PL+PRS+2+PL
esvai-las	esvair+V.ele.ACC.3.F.PL+PRS+2+SG
esvai-las	esvair+V.ele.ACC.3.F.PL+SBJF+1+SG
esvai-las	esvair+V.ele.ACC.3.F.PL+SBJF+3+SG
esvai-las-ia	esvair+V.ele.ACC.3.F.PL+COND+1+SG
esvai-las-ia	esvair+V.ele.ACC.3.F.PL+COND+3+SG
esvai-las-iam	esvair+V.ele.ACC.3.F.PL+COND+3+PL
esvai-las-íamos	esvair+V.ele.ACC.3.F.PL+COND+1+PL
esvai-las-ias	esvair+V.ele.ACC.3.F.PL+COND+2+SG
esvai-las-íeis	esvair+V.ele.ACC.3.F.PL+COND+2+PL
esvaí-lhe	esvair+V.ele.DAT.3.SG+PRF+1+SG
esvai-lhe	esvair+V.ele.DAT.3.SG+PRS+3+SG
esvaí-lhes	esvair+V.ele.DAT.3.PL+PRF+1+SG
esvai-lhes	esvair+V.ele.DAT.3.PL+PRS+3+SG
esvai-lo-á	esvair+V.ele.ACC.3.M.SG+FUT+3+SG
esvai-lo-ão	esvair+V.ele.ACC.3.M.SG+FUT+3+PL
esvai-lo-ás	esvair+V.ele.ACC.3.M.SG+FUT+2+SG
esvai-lo-ei	esvair+V.ele.ACC.3.M.SG+FUT+1+SG
esvai-lo-eis	esvair+V.ele.ACC.3.M.SG+FUT+2+PL
esvai-lo-emos	esvair+V.ele.ACC.3.M.SG+FUT+1+PL
esvai-lo	esvair+V.ele.ACC.3.M.SG+INF+1+SG
esvai-lo	esvair+V.ele.ACC.3.M.SG+INF+3+SG
esvaí-lo	esvair+V.ele.ACC.3.M.SG+PRS+2+PL
esvai-lo	esvair+V.ele.ACC.3.M.SG+PRS+2+SG
esvai-lo	esvair+V.ele.ACC.3.M.SG+SBJF+1+SG
esvai-lo	esvair+V.ele.ACC.3.M.SG+SBJF+3+SG
esvai-lo-ia	esvair+V.ele.ACC.3.M.SG+COND+1+SG
esvai-lo-ia	esvair+V.ele.ACC.3.M.SG+COND+3+SG
esvai-lo-iam	esvair+V.ele.ACC.3.M.SG+COND+3+PL
esvai-lo-íamos	esvair+V.ele.ACC.3.M.SG+COND+1+PL
esvai-lo-ias	esvair+V.ele.ACC.3.M.SG+COND+2+SG
esvai-lo-íeis	esvair+V.ele.ACC.3.M.SG+COND+2+PL
esvai-los-á	esvair+V.ele.ACC.3.M.PL+FUT+3+SG
esvai-los-ão	esvair+V.ele.ACC.3.M.PL+FUT+3+PL
esvai-los-ás	esvair+V.ele.ACC.3.M.PL+FUT+2+SG
esvai-los-ei	esvair+V.ele.ACC.3.M.PL+FUT+1+SG
esvai-los-eis	esvair+V.ele.ACC.3.M.PL+FUT+2+PL
esvai-los-emos	esvair+V.ele.ACC.3.M.PL+FUT+1+PL
esvai-los	esvair+V.ele.ACC.3.M.PL+INF+1+SG
esvai-los	esvair+V.ele.ACC.3.M.PL+INF+3+SG
esvaí-los	esvair+V.ele.ACC.3.M.PL+PRS+2+PL
esvai-los	esvair+V.ele.ACC.3.M.PL+PRS+2+SG
esvai-los	esvair+V.ele.ACC.3.M.PL+SBJF+1+SG
esvai-los	esvair+V.ele.ACC.3.M.PL+SBJF+3+SG
esvai-los-ia	esvair+V.ele.ACC.3.M.PL+COND+1+SG
esvai-los-ia	esvair+V.ele.ACC.3.M.PL+COND+3+SG
esvai-los-iam	esvair+V.ele.ACC.3.M.PL+COND+3+PL
esvai-los-íamos	esvair+V.ele.ACC.3.M.PL+COND+1+PL
esvai-los-ias	esvair+V.ele.ACC.3.M.PL+COND+2+SG
esvai-los-íeis	esvair+V.ele.ACC.3.M.PL+COND+2+PL
esvaí-me	esvair+V.eu.AD.1.SG+PRF+1+SG
esvai-me	esvair+V.eu.AD.1.SG+PRS+3+SG
esvaímo-la	esvair+V.ele.ACC.3.F.SG+PRF+1+PL
esvaímo-la	esvair+V.ele.ACC.3.F.SG+PRS+1+PL
esvaímo-las	esvair+V.ele.ACC.3.F.PL+PRF+1+PL
esvaímo-las	esvair+V.ele.ACC.3.F.PL+PRS+1+PL
esvaímo-lo	esvair+V.ele.ACC.3.M.SG+PRF+1+PL
esvaímo-lo	esvair+V.ele.ACC.3.M.SG+PRS+1+PL
esvaímo-los	esvair+V.ele.ACC.3.M.PL+PRF+1+PL
esvaímo-los	esvair+V.ele.ACC.3.M.PL+PRS+1+PL
esvaímo-nos	esvair+nós.AD.1.PL+PRF+1+PL
esvaímo-nos	esvair+nós.AD.1.PL+PRS+1+PL
esvaímos-lhe	esvair+V.ele.DAT.3.SG+PRF+1+PL
esvaímos-lhe	esvair+V.ele.DAT.3.SG+PRS+1+PL
esvaímos-lhes	esvair+V.ele.DAT.3.PL+PRF+1+PL
esvaímos-lhes	esvair+V.ele.DAT.3.PL+PRS+1+PL
esvaímos-me	esvair+V.eu.AD.1.SG+PRF+1+PL
esvaímos-me	esvair+V.eu.AD.1.SG+PRS+1+PL
esvaímos-te	esvair+V.tu.AD.2.SG+PRF+1+PL
esvaímos-te	esvair+V.tu.AD.2.SG+PRS+1+PL
esvaímos-vos	esvair+V.vós.AD.2.PL+PRF+1+PL
esvaímos-vos	esvair+V.vós.AD.2.PL+PRS+1+PL
esvaindo-a	esvair+V.ele.ACC.3.F.SG+GRD
esvaindo-as	esvair+V.ele.ACC.3.F.PL+GRD
esvaindo-lhe	esvair+V.ele.DAT.3.SG+GRD
esvaindo-lhes	esvair+V.ele.DAT.3.PL+GRD
esvaindo-me	esvair+V.eu.AD.1.SG+GRD
esvaindo-nos	esvair+nós.AD.1.PL+GRD
esvaindo-o	esvair+V.ele.ACC.3.M.SG+GRD
esvaindo-os	esvair+V.ele.ACC.3.M.PL+GRD
esvaindo-se	esvair+V.ele.REFL+GRD
esvaindo-te	esvair+V.tu.AD.2.SG+GRD
esvaindo-vos	esvair+V.vós.AD.2.PL+GRD
esvaí-nos	esvair+nós.AD.1.PL+PRF+1+SG
esvaí-nos	esvair+nós.AD.1.PL+PRS+2+PL
esvai-nos	esvair+nós.AD.1.PL+PRS+2+SG
esvai-nos	esvair+nós.AD.1.PL+PRS+3+SG
esvaio-a	esvair+V.ele.ACC.3.F.SG+PRS+1+SG
esvaio-as	esvair+V.ele.ACC.3.F.PL+PRS+1+SG
esvaí-o	esvair+V.ele.ACC.3.M.SG+PRF+1+SG
esvai-o	esvair+V.ele.ACC.3.M.SG+PRS+3+SG
esvaio-lhe	esvair+V.ele.DAT.3.SG+PRS+1+SG
esvaio-lhes	esvair+V.ele.DAT.3.PL+PRS+1+SG
esvaio-me	esvair+V.eu.AD.1.SG+PRS+1+SG
esvaio-nos	esvair+nós.AD.1.PL+PRS+1+SG
esvaio-o	esvair+V.ele.ACC.3.M.SG+PRS+1+SG
esvaio-os	esvair+V.ele.ACC.3.M.PL+PRS+1+SG
esvaí-os	esvair+V.ele.ACC.3.M.PL+PRF+1+SG
esvai-os	esvair+V.ele.ACC.3.M.PL+PRS+3+SG
esvaio-te	esvair+V.tu.AD.2.SG+PRS+1+SG
esvaio-vos	esvair+V.vós.AD.2.PL+PRS+1+SG
esvaíra-a	esvair+V.ele.ACC.3.F.SG+PQP+1+SG
esvaíra-a	esvair+V.ele.ACC.3.F.SG+PQP+3+SG
esvaíra-as	esvair+V.ele.ACC.3.F.PL+PQP+1+SG
esvaíra-as	esvair+V.ele.ACC.3.F.PL+PQP+3+SG
esvaíra-la	esvair+V.ele.ACC.3.F.SG+PQP+2+SG
esvaíra-las	esvair+V.ele.ACC.3.F.PL+PQP+2+SG
esvaíra-lhe	esvair+V.ele.DAT.3.SG+PQP+1+SG
esvaíra-lhe	esvair+V.ele.DAT.3.SG+PQP+3+SG
esvaíra-lhes	esvair+V.ele.DAT.3.PL+PQP+1+SG
esvaíra-lhes	esvair+V.ele.DAT.3.PL+PQP+3+SG
esvaíra-lo	esvair+V.ele.ACC.3.M.SG+PQP+2+SG
esvaíra-los	esvair+V.ele.ACC.3.M.PL+PQP+2+SG
esvaíra-me	esvair+V.eu.AD.1.SG+PQP+1+SG
esvaíra-me	esvair+V.eu.AD.1.SG+PQP+3+SG
esvaíram-lhe	esvair+V.ele.DAT.3.SG+PQP+3+PL
esvaíram-lhe	esvair+V.ele.DAT.3.SG+PRF+3+PL
esvaíram-lhes	esvair+V.ele.DAT.3.PL+PQP+3+PL
esvaíram-lhes	esvair+V.ele.DAT.3.PL+PRF+3+PL
