gaiatar-se	gaiatar+V.ele.REFL+INF
gaiatar-se	gaiatar+V.ele.REFL+INF+3+SG
gaiatar-se	gaiatar+V.ele.REFL+SBJF+3+SG
gaiatar-se-ia	gaiatar+V.ele.REFL+COND+3+SG
gaiatar-se-iam	gaiatar+V.ele.REFL+COND+3+PL
gaiatar-te-á	gaiatar+V.tu.AD.2.SG+FUT+3+SG
gaiatar-te-ão	gaiatar+V.tu.AD.2.SG+FUT+3+PL
gaiatar-te-ás	gaiatar+V.tu.AD.2.SG+FUT+2+SG
gaiatar-te-ei	gaiatar+V.tu.AD.2.SG+FUT+1+SG
gaiatar-te-eis	gaiatar+V.tu.AD.2.SG+FUT+2+PL
gaiatar-te-emos	gaiatar+V.tu.AD.2.SG+FUT+1+PL
gaiatar-te	gaiatar+V.tu.AD.2.SG+INF
gaiatar-te	gaiatar+V.tu.AD.2.SG+INF+1+SG
gaiatar-te	gaiatar+V.tu.AD.2.SG+INF+3+SG
gaiatar-te	gaiatar+V.tu.AD.2.SG+SBJF+1+SG
gaiatar-te	gaiatar+V.tu.AD.2.SG+SBJF+3+SG
gaiatar-te-ia	gaiatar+V.tu.AD.2.SG+COND+1+SG
gaiatar-te-ia	gaiatar+V.tu.AD.2.SG+COND+3+SG
gaiatar-te-iam	gaiatar+V.tu.AD.2.SG+COND+3+PL
gaiatar-te-íamos	gaiatar+V.tu.AD.2.SG+COND+1+PL
gaiatar-te-ias	gaiatar+V.tu.AD.2.SG+COND+2+SG
gaiatar-te-íeis	gaiatar+V.tu.AD.2.SG+COND+2+PL
gaiatar-vos-á	gaiatar+V.vós.AD.2.PL+FUT+3+SG
gaiatar-vos-ão	gaiatar+V.vós.AD.2.PL+FUT+3+PL
gaiatar-vos-ás	gaiatar+V.vós.AD.2.PL+FUT+2+SG
gaiatar-vos-ei	gaiatar+V.vós.AD.2.PL+FUT+1+SG
gaiatar-vos-eis	gaiatar+V.vós.AD.2.PL+FUT+2+PL
gaiatar-vos-emos	gaiatar+V.vós.AD.2.PL+FUT+1+PL
gaiatar-vos	gaiatar+V.vós.AD.2.PL+INF
gaiatar-vos	gaiatar+V.vós.AD.2.PL+INF+1+SG
gaiatar-vos	gaiatar+V.vós.AD.2.PL+INF+3+SG
gaiatar-vos	gaiatar+V.vós.AD.2.PL+SBJF+1+SG
gaiatar-vos	gaiatar+V.vós.AD.2.PL+SBJF+3+SG
gaiatar-vos-ia	gaiatar+V.vós.AD.2.PL+COND+1+SG
gaiatar-vos-ia	gaiatar+V.vós.AD.2.PL+COND+3+SG
gaiatar-vos-iam	gaiatar+V.vós.AD.2.PL+COND+3+PL
gaiatar-vos-íamos	gaiatar+V.vós.AD.2.PL+COND+1+PL
gaiatar-vos-ias	gaiatar+V.vós.AD.2.PL+COND+2+SG
gaiatar-vos-íeis	gaiatar+V.vós.AD.2.PL+COND+2+PL
gaiata-se	gaiatar+V.ele.REFL+PRS+3+SG
gaiatas-lhe	gaiatar+V.ele.DAT.3.SG+PRS+2+SG
gaiatas-lhes	gaiatar+V.ele.DAT.3.PL+PRS+2+SG
gaiatas-me	gaiatar+V.eu.AD.1.SG+PRS+2+SG
gaiataste-a	gaiatar+V.ele.ACC.3.F.SG+PRF+2+SG
gaiataste-as	gaiatar+V.ele.ACC.3.F.PL+PRF+2+SG
gaiatas-te	gaiatar+V.tu.AD.2.SG+PRS+2+SG
gaiataste-la	gaiatar+V.ele.ACC.3.F.SG+PRF+2+PL
gaiataste-las	gaiatar+V.ele.ACC.3.F.PL+PRF+2+PL
gaiataste-lhe	gaiatar+V.ele.DAT.3.SG+PRF+2+SG
gaiataste-lhes	gaiatar+V.ele.DAT.3.PL+PRF+2+SG
gaiataste-lo	gaiatar+V.ele.ACC.3.M.SG+PRF+2+PL
gaiataste-los	gaiatar+V.ele.ACC.3.M.PL+PRF+2+PL
gaiataste-me	gaiatar+V.eu.AD.1.SG+PRF+2+SG
gaiataste-nos	gaiatar+nós.AD.1.PL+PRF+2+PL
gaiataste-nos	gaiatar+nós.AD.1.PL+PRF+2+SG
gaiataste-o	gaiatar+V.ele.ACC.3.M.SG+PRF+2+SG
gaiataste-os	gaiatar+V.ele.ACC.3.M.PL+PRF+2+SG
gaiatastes-lhe	gaiatar+V.ele.DAT.3.SG+PRF+2+PL
gaiatastes-lhes	gaiatar+V.ele.DAT.3.PL+PRF+2+PL
gaiatastes-me	gaiatar+V.eu.AD.1.SG+PRF+2+PL
gaiatastes-te	gaiatar+V.tu.AD.2.SG+PRF+2+PL
gaiatastes-vos	gaiatar+V.vós.AD.2.PL+PRF+2+PL
gaiataste-te	gaiatar+V.tu.AD.2.SG+PRF+2+SG
gaiataste-vos	gaiatar+V.vós.AD.2.PL+PRF+2+SG
gaiatas-vos	gaiatar+V.vós.AD.2.PL+PRS+2+SG
gaiata-te	gaiatar+V.tu.AD.2.SG+PRS+3+SG
gaiatava-a	gaiatar+V.ele.ACC.3.F.SG+IMPF+1+SG
gaiatava-a	gaiatar+V.ele.ACC.3.F.SG+IMPF+3+SG
gaiatava-as	gaiatar+V.ele.ACC.3.F.PL+IMPF+1+SG
gaiatava-as	gaiatar+V.ele.ACC.3.F.PL+IMPF+3+SG
gaiatava-la	gaiatar+V.ele.ACC.3.F.SG+IMPF+2+SG
gaiatava-las	gaiatar+V.ele.ACC.3.F.PL+IMPF+2+SG
gaiatava-lhe	gaiatar+V.ele.DAT.3.SG+IMPF+1+SG
gaiatava-lhe	gaiatar+V.ele.DAT.3.SG+IMPF+3+SG
gaiatava-lhes	gaiatar+V.ele.DAT.3.PL+IMPF+1+SG
gaiatava-lhes	gaiatar+V.ele.DAT.3.PL+IMPF+3+SG
gaiatava-lo	gaiatar+V.ele.ACC.3.M.SG+IMPF+2+SG
gaiatava-los	gaiatar+V.ele.ACC.3.M.PL+IMPF+2+SG
gaiatava-me	gaiatar+V.eu.AD.1.SG+IMPF+1+SG
gaiatava-me	gaiatar+V.eu.AD.1.SG+IMPF+3+SG
gaiatavam-lhe	gaiatar+V.ele.DAT.3.SG+IMPF+3+PL
gaiatavam-lhes	gaiatar+V.ele.DAT.3.PL+IMPF+3+PL
gaiatavam-me	gaiatar+V.eu.AD.1.SG+IMPF+3+PL
gaiatavam-na	gaiatar+V.ele.ACC.3.F.SG+IMPF+3+PL
gaiatavam-nas	gaiatar+V.ele.ACC.3.F.PL+IMPF+3+PL
gaiatavam-no	gaiatar+V.ele.ACC.3.M.SG+IMPF+3+PL
gaiatavam-nos	gaiatar+V.ele.ACC.3.M.PL+IMPF+3+PL
gaiatavam-nos	gaiatar+V.nós.AD.1.PL+IMPF+3+PL
gaiatávamo-la	gaiatar+V.ele.ACC.3.F.SG+IMPF+1+PL
gaiatávamo-las	gaiatar+V.ele.ACC.3.F.PL+IMPF+1+PL
gaiatávamo-lo	gaiatar+V.ele.ACC.3.M.SG+IMPF+1+PL
gaiatávamo-los	gaiatar+V.ele.ACC.3.M.PL+IMPF+1+PL
gaiatávamo-nos	gaiatar+nós.AD.1.PL+IMPF+1+PL
gaiatávamos-lhe	gaiatar+V.ele.DAT.3.SG+IMPF+1+PL
gaiatávamos-lhes	gaiatar+V.ele.DAT.3.PL+IMPF+1+PL
gaiatávamos-me	gaiatar+V.eu.AD.1.SG+IMPF+1+PL
gaiatávamos-te	gaiatar+V.tu.AD.2.SG+IMPF+1+PL
gaiatávamos-vos	gaiatar+V.vós.AD.2.PL+IMPF+1+PL
gaiatavam-se	gaiatar+V.ele.REFL+IMPF+3+PL
gaiatavam-te	gaiatar+V.tu.AD.2.SG+IMPF+3+PL
gaiatavam-vos	gaiatar+V.vós.AD.2.PL+IMPF+3+PL
gaiatava-nos	gaiatar+nós.AD.1.PL+IMPF+1+SG
gaiatava-nos	gaiatar+nós.AD.1.PL+IMPF+2+SG
gaiatava-nos	gaiatar+nós.AD.1.PL+IMPF+3+SG
gaiatava-o	gaiatar+V.ele.ACC.3.M.SG+IMPF+1+SG
gaiatava-o	gaiatar+V.ele.ACC.3.M.SG+IMPF+3+SG
gaiatava-os	gaiatar+V.ele.ACC.3.M.PL+IMPF+1+SG
gaiatava-os	gaiatar+V.ele.ACC.3.M.PL+IMPF+3+SG
gaiatava-se	gaiatar+V.ele.REFL+IMPF+1+SG
gaiatava-se	gaiatar+V.ele.REFL+IMPF+3+SG
gaiatavas-lhe	gaiatar+V.ele.DAT.3.SG+IMPF+2+SG
gaiatavas-lhes	gaiatar+V.ele.DAT.3.PL+IMPF+2+SG
gaiatavas-me	gaiatar+V.eu.AD.1.SG+IMPF+2+SG
gaiatavas-te	gaiatar+V.tu.AD.2.SG+IMPF+2+SG
gaiatavas-vos	gaiatar+V.vós.AD.2.PL+IMPF+2+SG
gaiatava-te	gaiatar+V.tu.AD.2.SG+IMPF+1+SG
gaiatava-te	gaiatar+V.tu.AD.2.SG+IMPF+3+SG
gaiatava-vos	gaiatar+V.vós.AD.2.PL+IMPF+1+SG
gaiatava-vos	gaiatar+V.vós.AD.2.PL+IMPF+3+SG
gaiatávei-la	gaiatar+V.ele.ACC.3.F.SG+IMPF+2+PL
gaiatávei-las	gaiatar+V.ele.ACC.3.F.PL+IMPF+2+PL
gaiatávei-lo	gaiatar+V.ele.ACC.3.M.SG+IMPF+2+PL
gaiatávei-los	gaiatar+V.ele.ACC.3.M.PL+IMPF+2+PL
gaiatávei-nos	gaiatar+nós.AD.1.PL+IMPF+2+PL
gaiatáveis-lhe	gaiatar+V.ele.DAT.3.SG+IMPF+2+PL
gaiatáveis-lhes	gaiatar+V.ele.DAT.3.PL+IMPF+2+PL
gaiatáveis-me	gaiatar+V.eu.AD.1.SG+IMPF+2+PL
gaiatáveis-te	gaiatar+V.tu.AD.2.SG+IMPF+2+PL
gaiatáveis-vos	gaiatar+V.vós.AD.2.PL+IMPF+2+PL
gaiata-vos	gaiatar+V.vós.AD.2.PL+PRS+3+SG
gaiate-a	gaiatar+V.ele.ACC.3.F.SG+IMP+3+SG
gaiate-as	gaiatar+V.ele.ACC.3.F.PL+IMP+3+SG
gaia-te	gaiar+V.tu.AD.2.SG+PRS+3+SG
gaiatei-a	gaiatar+V.ele.ACC.3.F.SG+PRF+1+SG
gaiatei-as	gaiatar+V.ele.ACC.3.F.PL+PRF+1+SG
gaiatei-lhe	gaiatar+V.ele.DAT.3.SG+PRF+1+SG
gaiatei-lhes	gaiatar+V.ele.DAT.3.PL+PRF+1+SG
gaiatei-me	gaiatar+V.eu.AD.1.SG+PRF+1+SG
gaiatei-nos	gaiatar+nós.AD.1.PL+PRF+1+SG
gaiatei-o	gaiatar+V.ele.ACC.3.M.SG+PRF+1+SG
gaiatei-os	gaiatar+V.ele.ACC.3.M.PL+PRF+1+SG
gaiatei-te	gaiatar+V.tu.AD.2.SG+PRF+1+SG
gaiatei-vos	gaiatar+V.vós.AD.2.PL+PRF+1+SG
gaiate-lhe	gaiatar+V.ele.DAT.3.SG+IMP+3+SG
gaiate-lhes	gaiatar+V.ele.DAT.3.PL+IMP+3+SG
gaiate-me	gaiatar+V.eu.AD.1.SG+IMP+3+SG
gaiatem-lhe	gaiatar+V.ele.DAT.3.SG+IMP+3+PL
gaiatem-lhes	gaiatar+V.ele.DAT.3.PL+IMP+3+PL
gaiatem-me	gaiatar+V.eu.AD.1.SG+IMP+3+PL
gaiatem-na	gaiatar+V.ele.ACC.3.F.SG+IMP+3+PL
gaiatem-nas	gaiatar+V.ele.ACC.3.F.PL+IMP+3+PL
gaiatem-no	gaiatar+V.ele.ACC.3.M.SG+IMP+3+PL
gaiatem-nos	gaiatar+V.ele.ACC.3.M.PL+IMP+3+PL
gaiatem-nos	gaiatar+V.nós.AD.1.PL+IMP+3+PL
gaiatemo-la	gaiatar+V.ele.ACC.3.F.SG+IMP+1+PL
gaiatemo-las	gaiatar+V.ele.ACC.3.F.PL+IMP+1+PL
gaiatemo-lo	gaiatar+V.ele.ACC.3.M.SG+IMP+1+PL
gaiatemo-los	gaiatar+V.ele.ACC.3.M.PL+IMP+1+PL
gaiatemo-nos	gaiatar+nós.AD.1.PL+IMP+1+PL
gaiatemos-lhe	gaiatar+V.ele.DAT.3.SG+IMP+1+PL
gaiatemos-lhes	gaiatar+V.ele.DAT.3.PL+IMP+1+PL
gaiatemos-me	gaiatar+V.eu.AD.1.SG+IMP+1+PL
gaiatemos-te	gaiatar+V.tu.AD.2.SG+IMP+1+PL
gaiatemos-vos	gaiatar+V.vós.AD.2.PL+IMP+1+PL
gaiatem-se	gaiatar+V.ele.REFL+IMP+3+PL
gaiatem-te	gaiatar+V.tu.AD.2.SG+IMP+3+PL
gaiatem-vos	gaiatar+V.vós.AD.2.PL+IMP+3+PL
gaiate-nos	gaiatar+nós.AD.1.PL+IMP+3+SG
gaiate-o	gaiatar+V.ele.ACC.3.M.SG+IMP+3+SG
gaiate-os	gaiatar+V.ele.ACC.3.M.PL+IMP+3+SG
gaiate-se	gaiatar+V.ele.REFL+IMP+3+SG
gaiate-te	gaiatar+V.tu.AD.2.SG+IMP+3+SG
gaiate-vos	gaiatar+V.vós.AD.2.PL+IMP+3+SG
gaiato-a	gaiatar+V.ele.ACC.3.F.SG+PRS+1+SG
gaiato-as	gaiatar+V.ele.ACC.3.F.PL+PRS+1+SG
gaiato-lhe	gaiatar+V.ele.DAT.3.SG+PRS+1+SG
gaiato-lhes	gaiatar+V.ele.DAT.3.PL+PRS+1+SG
gaiato-me	gaiatar+V.eu.AD.1.SG+PRS+1+SG
gaiato-nos	gaiatar+nós.AD.1.PL+PRS+1+SG
gaiato-o	gaiatar+V.ele.ACC.3.M.SG+PRS+1+SG
gaiato-os	gaiatar+V.ele.ACC.3.M.PL+PRS+1+SG
gaiato-te	gaiatar+V.tu.AD.2.SG+PRS+1+SG
gaiatou-a	gaiatar+V.ele.ACC.3.F.SG+PRF+3+SG
gaiatou-as	gaiatar+V.ele.ACC.3.F.PL+PRF+3+SG
gaiatou-lhe	gaiatar+V.ele.DAT.3.SG+PRF+3+SG
gaiatou-lhes	gaiatar+V.ele.DAT.3.PL+PRF+3+SG
gaiatou-me	gaiatar+V.eu.AD.1.SG+PRF+3+SG
gaiatou-nos	gaiatar+nós.AD.1.PL+PRF+3+SG
gaiatou-o	gaiatar+V.ele.ACC.3.M.SG+PRF+3+SG
gaiatou-os	gaiatar+V.ele.ACC.3.M.PL+PRF+3+SG
gaiatou-se	gaiatar+V.ele.REFL+PRF+3+SG
gaiatou-te	gaiatar+V.tu.AD.2.SG+PRF+3+SG
gaiatou-vos	gaiatar+V.vós.AD.2.PL+PRF+3+SG
gaiato-vos	gaiatar+V.vós.AD.2.PL+PRS+1+SG
gaiava-a	gaiar+V.ele.ACC.3.F.SG+IMPF+1+SG
gaiava-a	gaiar+V.ele.ACC.3.F.SG+IMPF+3+SG
gaiava-as	gaiar+V.ele.ACC.3.F.PL+IMPF+1+SG
gaiava-as	gaiar+V.ele.ACC.3.F.PL+IMPF+3+SG
gaiava-la	gaiar+V.ele.ACC.3.F.SG+IMPF+2+SG
gaiava-las	gaiar+V.ele.ACC.3.F.PL+IMPF+2+SG
gaiava-lhe	gaiar+V.ele.DAT.3.SG+IMPF+1+SG
gaiava-lhe	gaiar+V.ele.DAT.3.SG+IMPF+3+SG
gaiava-lhes	gaiar+V.ele.DAT.3.PL+IMPF+1+SG
gaiava-lhes	gaiar+V.ele.DAT.3.PL+IMPF+3+SG
gaiava-lo	gaiar+V.ele.ACC.3.M.SG+IMPF+2+SG
gaiava-los	gaiar+V.ele.ACC.3.M.PL+IMPF+2+SG
gaiava-me	gaiar+V.eu.AD.1.SG+IMPF+1+SG
gaiava-me	gaiar+V.eu.AD.1.SG+IMPF+3+SG
gaiavam-lhe	gaiar+V.ele.DAT.3.SG+IMPF+3+PL
gaiavam-lhes	gaiar+V.ele.DAT.3.PL+IMPF+3+PL
gaiavam-me	gaiar+V.eu.AD.1.SG+IMPF+3+PL
gaiavam-na	gaiar+V.ele.ACC.3.F.SG+IMPF+3+PL
gaiavam-nas	gaiar+V.ele.ACC.3.F.PL+IMPF+3+PL
gaiavam-no	gaiar+V.ele.ACC.3.M.SG+IMPF+3+PL
gaiavam-nos	gaiar+V.ele.ACC.3.M.PL+IMPF+3+PL
gaiavam-nos	gaiar+V.nós.AD.1.PL+IMPF+3+PL
gaiávamo-la	gaiar+V.ele.ACC.3.F.SG+IMPF+1+PL
gaiávamo-las	gaiar+V.ele.ACC.3.F.PL+IMPF+1+PL
gaiávamo-lo	gaiar+V.ele.ACC.3.M.SG+IMPF+1+PL
gaiávamo-los	gaiar+V.ele.ACC.3.M.PL+IMPF+1+PL
gaiávamo-nos	gaiar+nós.AD.1.PL+IMPF+1+PL
gaiávamos-lhe	gaiar+V.ele.DAT.3.SG+IMPF+1+PL
gaiávamos-lhes	gaiar+V.ele.DAT.3.PL+IMPF+1+PL
gaiávamos-me	gaiar+V.eu.AD.1.SG+IMPF+1+PL
gaiávamos-te	gaiar+V.tu.AD.2.SG+IMPF+1+PL
gaiávamos-vos	gaiar+V.vós.AD.2.PL+IMPF+1+PL
gaiavam-se	gaiar+V.ele.REFL+IMPF+3+PL
gaiavam-te	gaiar+V.tu.AD.2.SG+IMPF+3+PL
gaiavam-vos	gaiar+V.vós.AD.2.PL+IMPF+3+PL
gaiava-nos	gaiar+nós.AD.1.PL+IMPF+1+SG
gaiava-nos	gaiar+nós.AD.1.PL+IMPF+2+SG
gaiava-nos	gaiar+nós.AD.1.PL+IMPF+3+SG
gaiava-o	gaiar+V.ele.ACC.3.M.SG+IMPF+1+SG
gaiava-o	gaiar+V.ele.ACC.3.M.SG+IMPF+3+SG
gaiava-os	gaiar+V.ele.ACC.3.M.PL+IMPF+1+SG
gaiava-os	gaiar+V.ele.ACC.3.M.PL+IMPF+3+SG
gaiava-se	gaiar+V.ele.REFL+IMPF+1+SG
gaiava-se	gaiar+V.ele.REFL+IMPF+3+SG
gaiavas-lhe	gaiar+V.ele.DAT.3.SG+IMPF+2+SG
gaiavas-lhes	gaiar+V.ele.DAT.3.PL+IMPF+2+SG
gaiavas-me	gaiar+V.eu.AD.1.SG+IMPF+2+SG
gaiavas-te	gaiar+V.tu.AD.2.SG+IMPF+2+SG
gaiavas-vos	gaiar+V.vós.AD.2.PL+IMPF+2+SG
gaiava-te	gaiar+V.tu.AD.2.SG+IMPF+1+SG
gaiava-te	gaiar+V.tu.AD.2.SG+IMPF+3+SG
gaiava-vos	gaiar+V.vós.AD.2.PL+IMPF+1+SG
gaiava-vos	gaiar+V.vós.AD.2.PL+IMPF+3+SG
gaiávei-la	gaiar+V.ele.ACC.3.F.SG+IMPF+2+PL
gaiávei-las	gaiar+V.ele.ACC.3.F.PL+IMPF+2+PL
gaiávei-lo	gaiar+V.ele.ACC.3.M.SG+IMPF+2+PL
gaiávei-los	gaiar+V.ele.ACC.3.M.PL+IMPF+2+PL
gaiávei-nos	gaiar+nós.AD.1.PL+IMPF+2+PL
gaiáveis-lhe	gaiar+V.ele.DAT.3.SG+IMPF+2+PL
gaiáveis-lhes	gaiar+V.ele.DAT.3.PL+IMPF+2+PL
gaiáveis-me	gaiar+V.eu.AD.1.SG+IMPF+2+PL
gaiáveis-te	gaiar+V.tu.AD.2.SG+IMPF+2+PL
gaiáveis-vos	gaiar+V.vós.AD.2.PL+IMPF+2+PL
gaia-vos	gaiar+V.vós.AD.2.PL+PRS+3+SG
gaie-a	gaiar+V.ele.ACC.3.F.SG+IMP+3+SG
gaie-as	gaiar+V.ele.ACC.3.F.PL+IMP+3+SG
gaiei-a	gaiar+V.ele.ACC.3.F.SG+PRF+1+SG
gaiei-as	gaiar+V.ele.ACC.3.F.PL+PRF+1+SG
gaiei-lhe	gaiar+V.ele.DAT.3.SG+PRF+1+SG
gaiei-lhes	gaiar+V.ele.DAT.3.PL+PRF+1+SG
gaiei-me	gaiar+V.eu.AD.1.SG+PRF+1+SG
gaiei-nos	gaiar+nós.AD.1.PL+PRF+1+SG
gaiei-o	gaiar+V.ele.ACC.3.M.SG+PRF+1+SG
gaiei-os	gaiar+V.ele.ACC.3.M.PL+PRF+1+SG
gaiei-te	gaiar+V.tu.AD.2.SG+PRF+1+SG
gaiei-vos	gaiar+V.vós.AD.2.PL+PRF+1+SG
gaie-lhe	gaiar+V.ele.DAT.3.SG+IMP+3+SG
gaie-lhes	gaiar+V.ele.DAT.3.PL+IMP+3+SG
gaie-me	gaiar+V.eu.AD.1.SG+IMP+3+SG
gaiem-lhe	gaiar+V.ele.DAT.3.SG+IMP+3+PL
gaiem-lhes	gaiar+V.ele.DAT.3.PL+IMP+3+PL
gaiem-me	gaiar+V.eu.AD.1.SG+IMP+3+PL
gaiem-na	gaiar+V.ele.ACC.3.F.SG+IMP+3+PL
gaiem-nas	gaiar+V.ele.ACC.3.F.PL+IMP+3+PL
gaiem-no	gaiar+V.ele.ACC.3.M.SG+IMP+3+PL
gaiem-nos	gaiar+V.ele.ACC.3.M.PL+IMP+3+PL
gaiem-nos	gaiar+V.nós.AD.1.PL+IMP+3+PL
gaiemo-la	gaiar+V.ele.ACC.3.F.SG+IMP+1+PL
gaiemo-las	gaiar+V.ele.ACC.3.F.PL+IMP+1+PL
gaiemo-lo	gaiar+V.ele.ACC.3.M.SG+IMP+1+PL
gaiemo-los	gaiar+V.ele.ACC.3.M.PL+IMP+1+PL
gaiemo-nos	gaiar+nós.AD.1.PL+IMP+1+PL
gaiemos-lhe	gaiar+V.ele.DAT.3.SG+IMP+1+PL
gaiemos-lhes	gaiar+V.ele.DAT.3.PL+IMP+1+PL
gaiemos-me	gaiar+V.eu.AD.1.SG+IMP+1+PL
gaiemos-te	gaiar+V.tu.AD.2.SG+IMP+1+PL
gaiemos-vos	gaiar+V.vós.AD.2.PL+IMP+1+PL
gaiem-se	gaiar+V.ele.REFL+IMP+3+PL
gaiem-te	gaiar+V.tu.AD.2.SG+IMP+3+PL
gaiem-vos	gaiar+V.vós.AD.2.PL+IMP+3+PL
gaie-nos	gaiar+nós.AD.1.PL+IMP+3+SG
gaie-o	gaiar+V.ele.ACC.3.M.SG+IMP+3+SG
gaie-os	gaiar+V.ele.ACC.3.M.PL+IMP+3+SG
gaie-se	gaiar+V.ele.REFL+IMP+3+SG
gaie-te	gaiar+V.tu.AD.2.SG+IMP+3+SG
gaie-vos	gaiar+V.vós.AD.2.PL+IMP+3+SG
gaifona-a	gaifonar+V.ele.ACC.3.F.SG+PRS+3+SG
gaifona-as	gaifonar+V.ele.ACC.3.F.PL+PRS+3+SG
gaifonai-la	gaifonar+V.ele.ACC.3.F.SG+PRS+2+PL
gaifonai-las	gaifonar+V.ele.ACC.3.F.PL+PRS+2+PL
gaifonai-lo	gaifonar+V.ele.ACC.3.M.SG+PRS+2+PL
gaifonai-los	gaifonar+V.ele.ACC.3.M.PL+PRS+2+PL
gaifonai-nos	gaifonar+nós.AD.1.PL+PRS+2+PL
gaifonais-lhe	gaifonar+V.ele.DAT.3.SG+PRS+2+PL
gaifonais-lhes	gaifonar+V.ele.DAT.3.PL+PRS+2+PL
gaifonais-me	gaifonar+V.eu.AD.1.SG+PRS+2+PL
gaifonais-te	gaifonar+V.tu.AD.2.SG+PRS+2+PL
gaifonais-vos	gaifonar+V.vós.AD.2.PL+PRS+2+PL
gaifoná-la-á	gaifonar+V.ele.ACC.3.F.SG+FUT+3+SG
gaifoná-la-ão	gaifonar+V.ele.ACC.3.F.SG+FUT+3+PL
gaifoná-la-ás	gaifonar+V.ele.ACC.3.F.SG+FUT+2+SG
gaifoná-la-ei	gaifonar+V.ele.ACC.3.F.SG+FUT+1+SG
gaifoná-la-eis	gaifonar+V.ele.ACC.3.F.SG+FUT+2+PL
gaifoná-la-emos	gaifonar+V.ele.ACC.3.F.SG+FUT+1+PL
gaifoná-la	gaifonar+V.ele.ACC.3.F.SG+INF+1+SG
gaifoná-la	gaifonar+V.ele.ACC.3.F.SG+INF+3+SG
gaifona-la	gaifonar+V.ele.ACC.3.F.SG+PRS+2+SG
gaifoná-la	gaifonar+V.ele.ACC.3.F.SG+SBJF+1+SG
gaifoná-la	gaifonar+V.ele.ACC.3.F.SG+SBJF+3+SG
gaifoná-la-ia	gaifonar+V.ele.ACC.3.F.SG+COND+1+SG
gaifoná-la-ia	gaifonar+V.ele.ACC.3.F.SG+COND+3+SG
gaifoná-la-iam	gaifonar+V.ele.ACC.3.F.SG+COND+3+PL
gaifoná-la-íamos	gaifonar+V.ele.ACC.3.F.SG+COND+1+PL
gaifoná-la-ias	gaifonar+V.ele.ACC.3.F.SG+COND+2+SG
gaifoná-la-íeis	gaifonar+V.ele.ACC.3.F.SG+COND+2+PL
gaifoná-las-á	gaifonar+V.ele.ACC.3.F.PL+FUT+3+SG
gaifoná-las-ão	gaifonar+V.ele.ACC.3.F.PL+FUT+3+PL
gaifoná-las-ás	gaifonar+V.ele.ACC.3.F.PL+FUT+2+SG
gaifoná-las-ei	gaifonar+V.ele.ACC.3.F.PL+FUT+1+SG
gaifoná-las-eis	gaifonar+V.ele.ACC.3.F.PL+FUT+2+PL
gaifoná-las-emos	gaifonar+V.ele.ACC.3.F.PL+FUT+1+PL
gaifoná-las	gaifonar+V.ele.ACC.3.F.PL+INF+1+SG
gaifoná-las	gaifonar+V.ele.ACC.3.F.PL+INF+3+SG
gaifona-las	gaifonar+V.ele.ACC.3.F.PL+PRS+2+SG
gaifoná-las	gaifonar+V.ele.ACC.3.F.PL+SBJF+1+SG
gaifoná-las	gaifonar+V.ele.ACC.3.F.PL+SBJF+3+SG
gaifoná-las-ia	gaifonar+V.ele.ACC.3.F.PL+COND+1+SG
gaifoná-las-ia	gaifonar+V.ele.ACC.3.F.PL+COND+3+SG
gaifoná-las-iam	gaifonar+V.ele.ACC.3.F.PL+COND+3+PL
gaifoná-las-íamos	gaifonar+V.ele.ACC.3.F.PL+COND+1+PL
gaifoná-las-ias	gaifonar+V.ele.ACC.3.F.PL+COND+2+SG
gaifoná-las-íeis	gaifonar+V.ele.ACC.3.F.PL+COND+2+PL
gaifona-lhe	gaifonar+V.ele.DAT.3.SG+PRS+3+SG
gaifona-lhes	gaifonar+V.ele.DAT.3.PL+PRS+3+SG
gaifoná-lo-á	gaifonar+V.ele.ACC.3.M.SG+FUT+3+SG
gaifoná-lo-ão	gaifonar+V.ele.ACC.3.M.SG+FUT+3+PL
gaifoná-lo-ás	gaifonar+V.ele.ACC.3.M.SG+FUT+2+SG
gaifoná-lo-ei	gaifonar+V.ele.ACC.3.M.SG+FUT+1+SG
gaifoná-lo-eis	gaifonar+V.ele.ACC.3.M.SG+FUT+2+PL
gaifoná-lo-emos	gaifonar+V.ele.ACC.3.M.SG+FUT+1+PL
gaifoná-lo	gaifonar+V.ele.ACC.3.M.SG+INF+1+SG
gaifoná-lo	gaifonar+V.ele.ACC.3.M.SG+INF+3+SG
gaifona-lo	gaifonar+V.ele.ACC.3.M.SG+PRS+2+SG
gaifoná-lo	gaifonar+V.ele.ACC.3.M.SG+SBJF+1+SG
gaifoná-lo	gaifonar+V.ele.ACC.3.M.SG+SBJF+3+SG
gaifoná-lo-ia	gaifonar+V.ele.ACC.3.M.SG+COND+1+SG
gaifoná-lo-ia	gaifonar+V.ele.ACC.3.M.SG+COND+3+SG
gaifoná-lo-iam	gaifonar+V.ele.ACC.3.M.SG+COND+3+PL
gaifoná-lo-íamos	gaifonar+V.ele.ACC.3.M.SG+COND+1+PL
gaifoná-lo-ias	gaifonar+V.ele.ACC.3.M.SG+COND+2+SG
gaifoná-lo-íeis	gaifonar+V.ele.ACC.3.M.SG+COND+2+PL
gaifoná-los-á	gaifonar+V.ele.ACC.3.M.PL+FUT+3+SG
gaifoná-los-ão	gaifonar+V.ele.ACC.3.M.PL+FUT+3+PL
gaifoná-los-ás	gaifonar+V.ele.ACC.3.M.PL+FUT+2+SG
gaifoná-los-ei	gaifonar+V.ele.ACC.3.M.PL+FUT+1+SG
gaifoná-los-eis	gaifonar+V.ele.ACC.3.M.PL+FUT+2+PL
gaifoná-los-emos	gaifonar+V.ele.ACC.3.M.PL+FUT+1+PL
gaifoná-los	gaifonar+V.ele.ACC.3.M.PL+INF+1+SG
gaifoná-los	gaifonar+V.ele.ACC.3.M.PL+INF+3+SG
gaifona-los	gaifonar+V.ele.ACC.3.M.PL+PRS+2+SG
gaifoná-los	gaifonar+V.ele.ACC.3.M.PL+SBJF+1+SG
gaifoná-los	gaifonar+V.ele.ACC.3.M.PL+SBJF+3+SG
gaifoná-los-ia	gaifonar+V.ele.ACC.3.M.PL+COND+1+SG
gaifoná-los-ia	gaifonar+V.ele.ACC.3.M.PL+COND+3+SG
gaifoná-los-iam	gaifonar+V.ele.ACC.3.M.PL+COND+3+PL
gaifoná-los-íamos	gaifonar+V.ele.ACC.3.M.PL+COND+1+PL
gaifoná-los-ias	gaifonar+V.ele.ACC.3.M.PL+COND+2+SG
gaifoná-los-íeis	gaifonar+V.ele.ACC.3.M.PL+COND+2+PL
gaifona-me	gaifonar+V.eu.AD.1.SG+PRS+3+SG
gaifonam-lhe	gaifonar+V.ele.DAT.3.SG+PRS+3+PL
gaifonam-lhes	gaifonar+V.ele.DAT.3.PL+PRS+3+PL
gaifonam-me	gaifonar+V.eu.AD.1.SG+PRS+3+PL
gaifonam-na	gaifonar+V.ele.ACC.3.F.SG+PRS+3+PL
gaifonam-nas	gaifonar+V.ele.ACC.3.F.PL+PRS+3+PL
gaifonam-no	gaifonar+V.ele.ACC.3.M.SG+PRS+3+PL
gaifonam-nos	gaifonar+V.ele.ACC.3.M.PL+PRS+3+PL
gaifonam-nos	gaifonar+V.nós.AD.1.PL+PRS+3+PL
gaifonamo-la	gaifonar+V.ele.ACC.3.F.SG+PRF+1+PL
gaifonamo-la	gaifonar+V.ele.ACC.3.F.SG+PRS+1+PL
gaifonamo-las	gaifonar+V.ele.ACC.3.F.PL+PRF+1+PL
gaifonamo-las	gaifonar+V.ele.ACC.3.F.PL+PRS+1+PL
gaifonamo-lo	gaifonar+V.ele.ACC.3.M.SG+PRF+1+PL
gaifonamo-lo	gaifonar+V.ele.ACC.3.M.SG+PRS+1+PL
gaifonamo-los	gaifonar+V.ele.ACC.3.M.PL+PRF+1+PL
gaifonamo-los	gaifonar+V.ele.ACC.3.M.PL+PRS+1+PL
gaifonamo-nos	gaifonar+nós.AD.1.PL+PRF+1+PL
gaifonamo-nos	gaifonar+nós.AD.1.PL+PRS+1+PL
gaifonamos-lhe	gaifonar+V.ele.DAT.3.SG+PRF+1+PL
gaifonamos-lhe	gaifonar+V.ele.DAT.3.SG+PRS+1+PL
gaifonamos-lhes	gaifonar+V.ele.DAT.3.PL+PRF+1+PL
gaifonamos-lhes	gaifonar+V.ele.DAT.3.PL+PRS+1+PL
gaifonamos-me	gaifonar+V.eu.AD.1.SG+PRF+1+PL
gaifonamos-me	gaifonar+V.eu.AD.1.SG+PRS+1+PL
gaifonamos-te	gaifonar+V.tu.AD.2.SG+PRF+1+PL
gaifonamos-te	gaifonar+V.tu.AD.2.SG+PRS+1+PL
gaifonamos-vos	gaifonar+V.vós.AD.2.PL+PRF+1+PL
gaifonamos-vos	gaifonar+V.vós.AD.2.PL+PRS+1+PL
gaifonam-se	gaifonar+V.ele.REFL+PRS+3+PL
gaifonam-te	gaifonar+V.tu.AD.2.SG+PRS+3+PL
gaifonam-vos	gaifonar+V.vós.AD.2.PL+PRS+3+PL
gaifonando-a	gaifonar+V.ele.ACC.3.F.SG+GRD
gaifonando-as	gaifonar+V.ele.ACC.3.F.PL+GRD
gaifonando-lhe	gaifonar+V.ele.DAT.3.SG+GRD
gaifonando-lhes	gaifonar+V.ele.DAT.3.PL+GRD
gaifonando-me	gaifonar+V.eu.AD.1.SG+GRD
gaifonando-nos	gaifonar+nós.AD.1.PL+GRD
gaifonando-o	gaifonar+V.ele.ACC.3.M.SG+GRD
gaifonando-os	gaifonar+V.ele.ACC.3.M.PL+GRD
gaifonando-se	gaifonar+V.ele.REFL+GRD
gaifonando-te	gaifonar+V.tu.AD.2.SG+GRD
gaifonando-vos	gaifonar+V.vós.AD.2.PL+GRD
gaifona-nos	gaifonar+nós.AD.1.PL+PRS+2+SG
gaifona-nos	gaifonar+nós.AD.1.PL+PRS+3+SG
gaifona-o	gaifonar+V.ele.ACC.3.M.SG+PRS+3+SG
gaifona-os	gaifonar+V.ele.ACC.3.M.PL+PRS+3+SG
gaifonara-a	gaifonar+V.ele.ACC.3.F.SG+PQP+1+SG
gaifonara-a	gaifonar+V.ele.ACC.3.F.SG+PQP+3+SG
gaifonara-as	gaifonar+V.ele.ACC.3.F.PL+PQP+1+SG
gaifonara-as	gaifonar+V.ele.ACC.3.F.PL+PQP+3+SG
gaifonara-la	gaifonar+V.ele.ACC.3.F.SG+PQP+2+SG
gaifonara-las	gaifonar+V.ele.ACC.3.F.PL+PQP+2+SG
gaifonara-lhe	gaifonar+V.ele.DAT.3.SG+PQP+1+SG
gaifonara-lhe	gaifonar+V.ele.DAT.3.SG+PQP+3+SG
gaifonara-lhes	gaifonar+V.ele.DAT.3.PL+PQP+1+SG
gaifonara-lhes	gaifonar+V.ele.DAT.3.PL+PQP+3+SG
gaifonara-lo	gaifonar+V.ele.ACC.3.M.SG+PQP+2+SG
gaifonara-los	gaifonar+V.ele.ACC.3.M.PL+PQP+2+SG
gaifonara-me	gaifonar+V.eu.AD.1.SG+PQP+1+SG
gaifonara-me	gaifonar+V.eu.AD.1.SG+PQP+3+SG
gaifonaram-lhe	gaifonar+V.ele.DAT.3.SG+PQP+3+PL
gaifonaram-lhe	gaifonar+V.ele.DAT.3.SG+PRF+3+PL
gaifonaram-lhes	gaifonar+V.ele.DAT.3.PL+PQP+3+PL
gaifonaram-lhes	gaifonar+V.ele.DAT.3.PL+PRF+3+PL
gaifonaram-me	gaifonar+V.eu.AD.1.SG+PQP+3+PL
gaifonaram-me	gaifonar+V.eu.AD.1.SG+PRF+3+PL
gaifonaram-na	gaifonar+V.ele.ACC.3.F.SG+PQP+3+PL
gaifonaram-na	gaifonar+V.ele.ACC.3.F.SG+PRF+3+PL
gaifonaram-nas	gaifonar+V.ele.ACC.3.F.PL+PQP+3+PL
gaifonaram-nas	gaifonar+V.ele.ACC.3.F.PL+PRF+3+PL
gaifonaram-no	gaifonar+V.ele.ACC.3.M.SG+PQP+3+PL
gaifonaram-no	gaifonar+V.ele.ACC.3.M.SG+PRF+3+PL
gaifonaram-nos	gaifonar+V.ele.ACC.3.M.PL+PQP+3+PL
gaifonaram-nos	gaifonar+V.ele.ACC.3.M.PL+PRF+3+PL
gaifonaram-nos	gaifonar+V.nós.AD.1.PL+PQP+3+PL
gaifonaram-nos	gaifonar+V.nós.AD.1.PL+PRF+3+PL
gaifonáramo-la	gaifonar+V.ele.ACC.3.F.SG+PQP+1+PL
gaifonáramo-las	gaifonar+V.ele.ACC.3.F.PL+PQP+1+PL
gaifonáramo-lo	gaifonar+V.ele.ACC.3.M.SG+PQP+1+PL
gaifonáramo-los	gaifonar+V.ele.ACC.3.M.PL+PQP+1+PL
gaifonáramo-nos	gaifonar+nós.AD.1.PL+PQP+1+PL
gaifonáramos-lhe	gaifonar+V.ele.DAT.3.SG+PQP+1+PL
gaifonáramos-lhes	gaifonar+V.ele.DAT.3.PL+PQP+1+PL
gaifonáramos-me	gaifonar+V.eu.AD.1.SG+PQP+1+PL
gaifonáramos-te	gaifonar+V.tu.AD.2.SG+PQP+1+PL
gaifonáramos-vos	gaifonar+V.vós.AD.2.PL+PQP+1+PL
gaifonaram-se	gaifonar+V.ele.REFL+PQP+3+PL
gaifonaram-se	gaifonar+V.ele.REFL+PRF+3+PL
gaifonaram-te	gaifonar+V.tu.AD.2.SG+PQP+3+PL
gaifonaram-te	gaifonar+V.tu.AD.2.SG+PRF+3+PL
gaifonaram-vos	gaifonar+V.vós.AD.2.PL+PQP+3+PL
gaifonaram-vos	gaifonar+V.vós.AD.2.PL+PRF+3+PL
gaifonara-nos	gaifonar+nós.AD.1.PL+PQP+1+SG
gaifonara-nos	gaifonar+nós.AD.1.PL+PQP+2+SG
gaifonara-nos	gaifonar+nós.AD.1.PL+PQP+3+SG
gaifonara-o	gaifonar+V.ele.ACC.3.M.SG+PQP+1+SG
gaifonara-o	gaifonar+V.ele.ACC.3.M.SG+PQP+3+SG
gaifonara-os	gaifonar+V.ele.ACC.3.M.PL+PQP+1+SG
gaifonara-os	gaifonar+V.ele.ACC.3.M.PL+PQP+3+SG
gaifonara-se	gaifonar+V.ele.REFL+PQP+1+SG
gaifonara-se	gaifonar+V.ele.REFL+PQP+3+SG
gaifonaras-lhe	gaifonar+V.ele.DAT.3.SG+PQP+2+SG
gaifonaras-lhes	gaifonar+V.ele.DAT.3.PL+PQP+2+SG
gaifonaras-me	gaifonar+V.eu.AD.1.SG+PQP+2+SG
gaifonaras-te	gaifonar+V.tu.AD.2.SG+PQP+2+SG
gaifonaras-vos	gaifonar+V.vós.AD.2.PL+PQP+2+SG
gaifonara-te	gaifonar+V.tu.AD.2.SG+PQP+1+SG
gaifonara-te	gaifonar+V.tu.AD.2.SG+PQP+3+SG
gaifonara-vos	gaifonar+V.vós.AD.2.PL+PQP+1+SG
gaifonara-vos	gaifonar+V.vós.AD.2.PL+PQP+3+SG
gaifonarde-la	gaifonar+V.ele.ACC.3.F.SG+INF+2+PL
gaifonarde-la	gaifonar+V.ele.ACC.3.F.SG+SBJF+2+PL
gaifonarde-las	gaifonar+V.ele.ACC.3.F.PL+INF+2+PL
gaifonarde-las	gaifonar+V.ele.ACC.3.F.PL+SBJF+2+PL
gaifonarde-lo	gaifonar+V.ele.ACC.3.M.SG+INF+2+PL
gaifonarde-lo	gaifonar+V.ele.ACC.3.M.SG+SBJF+2+PL
gaifonarde-los	gaifonar+V.ele.ACC.3.M.PL+INF+2+PL
gaifonarde-los	gaifonar+V.ele.ACC.3.M.PL+SBJF+2+PL
gaifonarde-nos	gaifonar+nós.AD.1.PL+INF+2+PL
gaifonarde-nos	gaifonar+nós.AD.1.PL+SBJF+2+PL
gaifonardes-lhe	gaifonar+V.ele.DAT.3.SG+INF+2+PL
gaifonardes-lhe	gaifonar+V.ele.DAT.3.SG+SBJF+2+PL
gaifonardes-lhes	gaifonar+V.ele.DAT.3.PL+INF+2+PL
gaifonardes-lhes	gaifonar+V.ele.DAT.3.PL+SBJF+2+PL
gaifonardes-me	gaifonar+V.eu.AD.1.SG+INF+2+PL
gaifonardes-me	gaifonar+V.eu.AD.1.SG+SBJF+2+PL
gaifonardes-te	gaifonar+V.tu.AD.2.SG+INF+2+PL
gaifonardes-te	gaifonar+V.tu.AD.2.SG+SBJF+2+PL
gaifonardes-vos	gaifonar+V.vós.AD.2.PL+INF+2+PL
gaifonardes-vos	gaifonar+V.vós.AD.2.PL+SBJF+2+PL
gaifonárei-la	gaifonar+V.ele.ACC.3.F.SG+PQP+2+PL
gaifonárei-las	gaifonar+V.ele.ACC.3.F.PL+PQP+2+PL
gaifonárei-lo	gaifonar+V.ele.ACC.3.M.SG+PQP+2+PL
gaifonárei-los	gaifonar+V.ele.ACC.3.M.PL+PQP+2+PL
gaifonárei-nos	gaifonar+nós.AD.1.PL+PQP+2+PL
gaifonáreis-lhe	gaifonar+V.ele.DAT.3.SG+PQP+2+PL
gaifonáreis-lhes	gaifonar+V.ele.DAT.3.PL+PQP+2+PL
gaifonáreis-me	gaifonar+V.eu.AD.1.SG+PQP+2+PL
gaifonáreis-te	gaifonar+V.tu.AD.2.SG+PQP+2+PL
gaifonáreis-vos	gaifonar+V.vós.AD.2.PL+PQP+2+PL
gaifonare-la	gaifonar+V.ele.ACC.3.F.SG+INF+2+SG
gaifonare-la	gaifonar+V.ele.ACC.3.F.SG+SBJF+2+SG
gaifonare-las	gaifonar+V.ele.ACC.3.F.PL+INF+2+SG
gaifonare-las	gaifonar+V.ele.ACC.3.F.PL+SBJF+2+SG
gaifonare-lo	gaifonar+V.ele.ACC.3.M.SG+INF+2+SG
gaifonare-lo	gaifonar+V.ele.ACC.3.M.SG+SBJF+2+SG
gaifonare-los	gaifonar+V.ele.ACC.3.M.PL+INF+2+SG
gaifonare-los	gaifonar+V.ele.ACC.3.M.PL+SBJF+2+SG
gaifonarem-lhe	gaifonar+V.ele.DAT.3.SG+INF+3+PL
gaifonarem-lhe	gaifonar+V.ele.DAT.3.SG+SBJF+3+PL
gaifonarem-lhes	gaifonar+V.ele.DAT.3.PL+INF+3+PL
gaifonarem-lhes	gaifonar+V.ele.DAT.3.PL+SBJF+3+PL
gaifonarem-me	gaifonar+V.eu.AD.1.SG+INF+3+PL
gaifonarem-me	gaifonar+V.eu.AD.1.SG+SBJF+3+PL
gaifonarem-na	gaifonar+V.ele.ACC.3.F.SG+INF+3+PL
gaifonarem-na	gaifonar+V.ele.ACC.3.F.SG+SBJF+3+PL
gaifonarem-nas	gaifonar+V.ele.ACC.3.F.PL+INF+3+PL
gaifonarem-nas	gaifonar+V.ele.ACC.3.F.PL+SBJF+3+PL
gaifonarem-no	gaifonar+V.ele.ACC.3.M.SG+INF+3+PL
gaifonarem-no	gaifonar+V.ele.ACC.3.M.SG+SBJF+3+PL
gaifonarem-nos	gaifonar+V.ele.ACC.3.M.PL+INF+3+PL
gaifonarem-nos	gaifonar+V.ele.ACC.3.M.PL+SBJF+3+PL
gaifonarem-nos	gaifonar+V.nós.AD.1.PL+INF+3+PL
gaifonarem-nos	gaifonar+V.nós.AD.1.PL+SBJF+3+PL
gaifonarem-se	gaifonar+V.ele.REFL+INF+3+PL
gaifonarem-se	gaifonar+V.ele.REFL+SBJF+3+PL
gaifonarem-te	gaifonar+V.tu.AD.2.SG+INF+3+PL
gaifonarem-te	gaifonar+V.tu.AD.2.SG+SBJF+3+PL
gaifonarem-vos	gaifonar+V.vós.AD.2.PL+INF+3+PL
gaifonarem-vos	gaifonar+V.vós.AD.2.PL+SBJF+3+PL
gaifonare-nos	gaifonar+nós.AD.1.PL+INF+2+SG
gaifonare-nos	gaifonar+nós.AD.1.PL+SBJF+2+SG
gaifonares-lhe	gaifonar+V.ele.DAT.3.SG+INF+2+SG
gaifonares-lhe	gaifonar+V.ele.DAT.3.SG+SBJF+2+SG
gaifonares-lhes	gaifonar+V.ele.DAT.3.PL+INF+2+SG
gaifonares-lhes	gaifonar+V.ele.DAT.3.PL+SBJF+2+SG
gaifonares-me	gaifonar+V.eu.AD.1.SG+INF+2+SG
gaifonares-me	gaifonar+V.eu.AD.1.SG+SBJF+2+SG
gaifonares-te	gaifonar+V.tu.AD.2.SG+INF+2+SG
gaifonares-te	gaifonar+V.tu.AD.2.SG+SBJF+2+SG
gaifonares-vos	gaifonar+V.vós.AD.2.PL+INF+2+SG
gaifonares-vos	gaifonar+V.vós.AD.2.PL+SBJF+2+SG
gaifonar-lhe-á	gaifonar+V.ele.DAT.3.SG+FUT+3+SG
gaifonar-lhe-ão	gaifonar+V.ele.DAT.3.SG+FUT+3+PL
gaifonar-lhe-ás	gaifonar+V.ele.DAT.3.SG+FUT+2+SG
gaifonar-lhe-ei	gaifonar+V.ele.DAT.3.SG+FUT+1+SG
gaifonar-lhe-eis	gaifonar+V.ele.DAT.3.SG+FUT+2+PL
gaifonar-lhe-emos	gaifonar+V.ele.DAT.3.SG+FUT+1+PL
gaifonar-lhe	gaifonar+V.ele.DAT.3.SG+INF
gaifonar-lhe	gaifonar+V.ele.DAT.3.SG+INF+1+SG
gaifonar-lhe	gaifonar+V.ele.DAT.3.SG+INF+3+SG
gaifonar-lhe	gaifonar+V.ele.DAT.3.SG+SBJF+1+SG
gaifonar-lhe	gaifonar+V.ele.DAT.3.SG+SBJF+3+SG
gaifonar-lhe-ia	gaifonar+V.ele.DAT.3.SG+COND+1+SG
gaifonar-lhe-ia	gaifonar+V.ele.DAT.3.SG+COND+3+SG
gaifonar-lhe-iam	gaifonar+V.ele.DAT.3.SG+COND+3+PL
gaifonar-lhe-íamos	gaifonar+V.ele.DAT.3.SG+COND+1+PL
gaifonar-lhe-ias	gaifonar+V.ele.DAT.3.SG+COND+2+SG
gaifonar-lhe-íeis	gaifonar+V.ele.DAT.3.SG+COND+2+PL
gaifonar-lhes-á	gaifonar+V.ele.DAT.3.PL+FUT+3+SG
gaifonar-lhes-ão	gaifonar+V.ele.DAT.3.PL+FUT+3+PL
gaifonar-lhes-ás	gaifonar+V.ele.DAT.3.PL+FUT+2+SG
gaifonar-lhes-ei	gaifonar+V.ele.DAT.3.PL+FUT+1+SG
gaifonar-lhes-eis	gaifonar+V.ele.DAT.3.PL+FUT+2+PL
gaifonar-lhes-emos	gaifonar+V.ele.DAT.3.PL+FUT+1+PL
gaifonar-lhes	gaifonar+V.ele.DAT.3.PL+INF
gaifonar-lhes	gaifonar+V.ele.DAT.3.PL+INF+1+SG
gaifonar-lhes	gaifonar+V.ele.DAT.3.PL+INF+3+SG
gaifonar-lhes	gaifonar+V.ele.DAT.3.PL+SBJF+1+SG
gaifonar-lhes	gaifonar+V.ele.DAT.3.PL+SBJF+3+SG
gaifonar-lhes-ia	gaifonar+V.ele.DAT.3.PL+COND+1+SG
gaifonar-lhes-ia	gaifonar+V.ele.DAT.3.PL+COND+3+SG
gaifonar-lhes-iam	gaifonar+V.ele.DAT.3.PL+COND+3+PL
gaifonar-lhes-íamos	gaifonar+V.ele.DAT.3.PL+COND+1+PL
gaifonar-lhes-ias	gaifonar+V.ele.DAT.3.PL+COND+2+SG
gaifonar-lhes-íeis	gaifonar+V.ele.DAT.3.PL+COND+2+PL
gaifonar-me-á	gaifonar+V.eu.AD.1.SG+FUT+3+SG
gaifonar-me-ão	gaifonar+V.eu.AD.1.SG+FUT+3+PL
gaifonar-me-ás	gaifonar+V.eu.AD.1.SG+FUT+2+SG
gaifonar-me-ei	gaifonar+V.eu.AD.1.SG+FUT+1+SG
gaifonar-me-eis	gaifonar+V.eu.AD.1.SG+FUT+2+PL
gaifonar-me-emos	gaifonar+V.eu.AD.1.SG+FUT+1+PL
gaifonar-me	gaifonar+V.eu.AD.1.SG+INF
gaifonar-me	gaifonar+V.eu.AD.1.SG+INF+1+SG
gaifonar-me	gaifonar+V.eu.AD.1.SG+INF+3+SG
gaifonar-me	gaifonar+V.eu.AD.1.SG+SBJF+1+SG
gaifonar-me	gaifonar+V.eu.AD.1.SG+SBJF+3+SG
gaifonar-me-ia	gaifonar+V.eu.AD.1.SG+COND+1+SG
gaifonar-me-ia	gaifonar+V.eu.AD.1.SG+COND+3+SG
gaifonar-me-iam	gaifonar+V.eu.AD.1.SG+COND+3+PL
gaifonar-me-íamos	gaifonar+V.eu.AD.1.SG+COND+1+PL
gaifonar-me-ias	gaifonar+V.eu.AD.1.SG+COND+2+SG
gaifonar-me-íeis	gaifonar+V.eu.AD.1.SG+COND+2+PL
gaifonarmo-la	gaifonar+V.ele.ACC.3.F.SG+INF+1+PL
gaifonarmo-la	gaifonar+V.ele.ACC.3.F.SG+SBJF+1+PL
gaifonarmo-las	gaifonar+V.ele.ACC.3.F.PL+INF+1+PL
gaifonarmo-las	gaifonar+V.ele.ACC.3.F.PL+SBJF+1+PL
gaifonarmo-lo	gaifonar+V.ele.ACC.3.M.SG+INF+1+PL
gaifonarmo-lo	gaifonar+V.ele.ACC.3.M.SG+SBJF+1+PL
gaifonarmo-los	gaifonar+V.ele.ACC.3.M.PL+INF+1+PL
gaifonarmo-los	gaifonar+V.ele.ACC.3.M.PL+SBJF+1+PL
gaifonarmo-nos	gaifonar+nós.AD.1.PL+INF+1+PL
gaifonarmo-nos	gaifonar+nós.AD.1.PL+SBJF+1+PL
gaifonarmos-lhe	gaifonar+V.ele.DAT.3.SG+INF+1+PL
gaifonarmos-lhe	gaifonar+V.ele.DAT.3.SG+SBJF+1+PL
gaifonarmos-lhes	gaifonar+V.ele.DAT.3.PL+INF+1+PL
gaifonarmos-lhes	gaifonar+V.ele.DAT.3.PL+SBJF+1+PL
gaifonarmos-me	gaifonar+V.eu.AD.1.SG+INF+1+PL
gaifonarmos-me	gaifonar+V.eu.AD.1.SG+SBJF+1+PL
gaifonarmos-te	gaifonar+V.tu.AD.2.SG+INF+1+PL
gaifonarmos-te	gaifonar+V.tu.AD.2.SG+SBJF+1+PL
gaifonarmos-vos	gaifonar+V.vós.AD.2.PL+INF+1+PL
gaifonarmos-vos	gaifonar+V.vós.AD.2.PL+SBJF+1+PL
gaifonar-nos-á	gaifonar+nós.AD.1.PL+FUT+3+SG
gaifonar-nos-ão	gaifonar+nós.AD.1.PL+FUT+3+PL
gaifonar-nos-ás	gaifonar+nós.AD.1.PL+FUT+2+SG
gaifonar-nos-ei	gaifonar+nós.AD.1.PL+FUT+1+SG
gaifonar-nos-eis	gaifonar+nós.AD.1.PL+FUT+2+PL
gaifonar-nos-emos	gaifonar+nós.AD.1.PL+FUT+1+PL
gaifonar-nos	gaifonar+nós.AD.1.PL+INF
gaifonar-nos	gaifonar+nós.AD.1.PL+INF+1+SG
gaifonar-nos	gaifonar+nós.AD.1.PL+INF+3+SG
gaifonar-nos	gaifonar+nós.AD.1.PL+SBJF+1+SG
gaifonar-nos	gaifonar+nós.AD.1.PL+SBJF+3+SG
gaifonar-nos-ia	gaifonar+nós.AD.1.PL+COND+1+SG
gaifonar-nos-ia	gaifonar+nós.AD.1.PL+COND+3+SG
gaifonar-nos-iam	gaifonar+nós.AD.1.PL+COND+3+PL
gaifonar-nos-íamos	gaifonar+nós.AD.1.PL+COND+1+PL
gaifonar-nos-ias	gaifonar+nós.AD.1.PL+COND+2+SG
gaifonar-nos-íeis	gaifonar+nós.AD.1.PL+COND+2+PL
gaifonar-se-á	gaifonar+V.ele.REFL+FUT+3+SG
gaifonar-se-ão	gaifonar+V.ele.REFL+FUT+3+PL
gaifonar-se	gaifonar+V.ele.REFL+INF
gaifonar-se	gaifonar+V.ele.REFL+INF+3+SG
gaifonar-se	gaifonar+V.ele.REFL+SBJF+3+SG
gaifonar-se-ia	gaifonar+V.ele.REFL+COND+3+SG
gaifonar-se-iam	gaifonar+V.ele.REFL+COND+3+PL
gaifonar-te-á	gaifonar+V.tu.AD.2.SG+FUT+3+SG
gaifonar-te-ão	gaifonar+V.tu.AD.2.SG+FUT+3+PL
gaifonar-te-ás	gaifonar+V.tu.AD.2.SG+FUT+2+SG
gaifonar-te-ei	gaifonar+V.tu.AD.2.SG+FUT+1+SG
gaifonar-te-eis	gaifonar+V.tu.AD.2.SG+FUT+2+PL
gaifonar-te-emos	gaifonar+V.tu.AD.2.SG+FUT+1+PL
gaifonar-te	gaifonar+V.tu.AD.2.SG+INF
gaifonar-te	gaifonar+V.tu.AD.2.SG+INF+1+SG
gaifonar-te	gaifonar+V.tu.AD.2.SG+INF+3+SG
gaifonar-te	gaifonar+V.tu.AD.2.SG+SBJF+1+SG
gaifonar-te	gaifonar+V.tu.AD.2.SG+SBJF+3+SG
gaifonar-te-ia	gaifonar+V.tu.AD.2.SG+COND+1+SG
gaifonar-te-ia	gaifonar+V.tu.AD.2.SG+COND+3+SG
gaifonar-te-iam	gaifonar+V.tu.AD.2.SG+COND+3+PL
gaifonar-te-íamos	gaifonar+V.tu.AD.2.SG+COND+1+PL
gaifonar-te-ias	gaifonar+V.tu.AD.2.SG+COND+2+SG
gaifonar-te-íeis	gaifonar+V.tu.AD.2.SG+COND+2+PL
gaifonar-vos-á	gaifonar+V.vós.AD.2.PL+FUT+3+SG
gaifonar-vos-ão	gaifonar+V.vós.AD.2.PL+FUT+3+PL
gaifonar-vos-ás	gaifonar+V.vós.AD.2.PL+FUT+2+SG
gaifonar-vos-ei	gaifonar+V.vós.AD.2.PL+FUT+1+SG
gaifonar-vos-eis	gaifonar+V.vós.AD.2.PL+FUT+2+PL
gaifonar-vos-emos	gaifonar+V.vós.AD.2.PL+FUT+1+PL
gaifonar-vos	gaifonar+V.vós.AD.2.PL+INF
gaifonar-vos	gaifonar+V.vós.AD.2.PL+INF+1+SG
gaifonar-vos	gaifonar+V.vós.AD.2.PL+INF+3+SG
gaifonar-vos	gaifonar+V.vós.AD.2.PL+SBJF+1+SG
gaifonar-vos	gaifonar+V.vós.AD.2.PL+SBJF+3+SG
gaifonar-vos-ia	gaifonar+V.vós.AD.2.PL+COND+1+SG
gaifonar-vos-ia	gaifonar+V.vós.AD.2.PL+COND+3+SG
gaifonar-vos-iam	gaifonar+V.vós.AD.2.PL+COND+3+PL
gaifonar-vos-íamos	gaifonar+V.vós.AD.2.PL+COND+1+PL
gaifonar-vos-ias	gaifonar+V.vós.AD.2.PL+COND+2+SG
gaifonar-vos-íeis	gaifonar+V.vós.AD.2.PL+COND+2+PL
gaifona-se	gaifonar+V.ele.REFL+PRS+3+SG
gaifonas-lhe	gaifonar+V.ele.DAT.3.SG+PRS+2+SG
gaifonas-lhes	gaifonar+V.ele.DAT.3.PL+PRS+2+SG
gaifonas-me	gaifonar+V.eu.AD.1.SG+PRS+2+SG
gaifonaste-a	gaifonar+V.ele.ACC.3.F.SG+PRF+2+SG
gaifonaste-as	gaifonar+V.ele.ACC.3.F.PL+PRF+2+SG
gaifonas-te	gaifonar+V.tu.AD.2.SG+PRS+2+SG
gaifonaste-la	gaifonar+V.ele.ACC.3.F.SG+PRF+2+PL
gaifonaste-las	gaifonar+V.ele.ACC.3.F.PL+PRF+2+PL
gaifonaste-lhe	gaifonar+V.ele.DAT.3.SG+PRF+2+SG
gaifonaste-lhes	gaifonar+V.ele.DAT.3.PL+PRF+2+SG
gaifonaste-lo	gaifonar+V.ele.ACC.3.M.SG+PRF+2+PL
gaifonaste-los	gaifonar+V.ele.ACC.3.M.PL+PRF+2+PL
gaifonaste-me	gaifonar+V.eu.AD.1.SG+PRF+2+SG
gaifonaste-nos	gaifonar+nós.AD.1.PL+PRF+2+PL
gaifonaste-nos	gaifonar+nós.AD.1.PL+PRF+2+SG
gaifonaste-o	gaifonar+V.ele.ACC.3.M.SG+PRF+2+SG
gaifonaste-os	gaifonar+V.ele.ACC.3.M.PL+PRF+2+SG
gaifonastes-lhe	gaifonar+V.ele.DAT.3.SG+PRF+2+PL
gaifonastes-lhes	gaifonar+V.ele.DAT.3.PL+PRF+2+PL
gaifonastes-me	gaifonar+V.eu.AD.1.SG+PRF+2+PL
gaifonastes-te	gaifonar+V.tu.AD.2.SG+PRF+2+PL
gaifonastes-vos	gaifonar+V.vós.AD.2.PL+PRF+2+PL
gaifonaste-te	gaifonar+V.tu.AD.2.SG+PRF+2+SG
gaifonaste-vos	gaifonar+V.vós.AD.2.PL+PRF+2+SG
gaifonas-vos	gaifonar+V.vós.AD.2.PL+PRS+2+SG
gaifona-te	gaifonar+V.tu.AD.2.SG+PRS+3+SG
gaifonava-a	gaifonar+V.ele.ACC.3.F.SG+IMPF+1+SG
gaifonava-a	gaifonar+V.ele.ACC.3.F.SG+IMPF+3+SG
gaifonava-as	gaifonar+V.ele.ACC.3.F.PL+IMPF+1+SG
gaifonava-as	gaifonar+V.ele.ACC.3.F.PL+IMPF+3+SG
gaifonava-la	gaifonar+V.ele.ACC.3.F.SG+IMPF+2+SG
gaifonava-las	gaifonar+V.ele.ACC.3.F.PL+IMPF+2+SG
gaifonava-lhe	gaifonar+V.ele.DAT.3.SG+IMPF+1+SG
gaifonava-lhe	gaifonar+V.ele.DAT.3.SG+IMPF+3+SG
gaifonava-lhes	gaifonar+V.ele.DAT.3.PL+IMPF+1+SG
gaifonava-lhes	gaifonar+V.ele.DAT.3.PL+IMPF+3+SG
gaifonava-lo	gaifonar+V.ele.ACC.3.M.SG+IMPF+2+SG
gaifonava-los	gaifonar+V.ele.ACC.3.M.PL+IMPF+2+SG
gaifonava-me	gaifonar+V.eu.AD.1.SG+IMPF+1+SG
gaifonava-me	gaifonar+V.eu.AD.1.SG+IMPF+3+SG
gaifonavam-lhe	gaifonar+V.ele.DAT.3.SG+IMPF+3+PL
gaifonavam-lhes	gaifonar+V.ele.DAT.3.PL+IMPF+3+PL
gaifonavam-me	gaifonar+V.eu.AD.1.SG+IMPF+3+PL
gaifonavam-na	gaifonar+V.ele.ACC.3.F.SG+IMPF+3+PL
gaifonavam-nas	gaifonar+V.ele.ACC.3.F.PL+IMPF+3+PL
gaifonavam-no	gaifonar+V.ele.ACC.3.M.SG+IMPF+3+PL
gaifonavam-nos	gaifonar+V.ele.ACC.3.M.PL+IMPF+3+PL
gaifonavam-nos	gaifonar+V.nós.AD.1.PL+IMPF+3+PL
gaifonávamo-la	gaifonar+V.ele.ACC.3.F.SG+IMPF+1+PL
gaifonávamo-las	gaifonar+V.ele.ACC.3.F.PL+IMPF+1+PL
gaifonávamo-lo	gaifonar+V.ele.ACC.3.M.SG+IMPF+1+PL
gaifonávamo-los	gaifonar+V.ele.ACC.3.M.PL+IMPF+1+PL
gaifonávamo-nos	gaifonar+nós.AD.1.PL+IMPF+1+PL
gaifonávamos-lhe	gaifonar+V.ele.DAT.3.SG+IMPF+1+PL
gaifonávamos-lhes	gaifonar+V.ele.DAT.3.PL+IMPF+1+PL
gaifonávamos-me	gaifonar+V.eu.AD.1.SG+IMPF+1+PL
gaifonávamos-te	gaifonar+V.tu.AD.2.SG+IMPF+1+PL
gaifonávamos-vos	gaifonar+V.vós.AD.2.PL+IMPF+1+PL
gaifonavam-se	gaifonar+V.ele.REFL+IMPF+3+PL
gaifonavam-te	gaifonar+V.tu.AD.2.SG+IMPF+3+PL
gaifonavam-vos	gaifonar+V.vós.AD.2.PL+IMPF+3+PL
gaifonava-nos	gaifonar+nós.AD.1.PL+IMPF+1+SG
gaifonava-nos	gaifonar+nós.AD.1.PL+IMPF+2+SG
gaifonava-nos	gaifonar+nós.AD.1.PL+IMPF+3+SG
gaifonava-o	gaifonar+V.ele.ACC.3.M.SG+IMPF+1+SG
gaifonava-o	gaifonar+V.ele.ACC.3.M.SG+IMPF+3+SG
gaifonava-os	gaifonar+V.ele.ACC.3.M.PL+IMPF+1+SG
gaifonava-os	gaifonar+V.ele.ACC.3.M.PL+IMPF+3+SG
gaifonava-se	gaifonar+V.ele.REFL+IMPF+1+SG
gaifonava-se	gaifonar+V.ele.REFL+IMPF+3+SG
gaifonavas-lhe	gaifonar+V.ele.DAT.3.SG+IMPF+2+SG
gaifonavas-lhes	gaifonar+V.ele.DAT.3.PL+IMPF+2+SG
gaifonavas-me	gaifonar+V.eu.AD.1.SG+IMPF+2+SG
gaifonavas-te	gaifonar+V.tu.AD.2.SG+IMPF+2+SG
gaifonavas-vos	gaifonar+V.vós.AD.2.PL+IMPF+2+SG
gaifonava-te	gaifonar+V.tu.AD.2.SG+IMPF+1+SG
gaifonava-te	gaifonar+V.tu.AD.2.SG+IMPF+3+SG
gaifonava-vos	gaifonar+V.vós.AD.2.PL+IMPF+1+SG
gaifonava-vos	gaifonar+V.vós.AD.2.PL+IMPF+3+SG
gaifonávei-la	gaifonar+V.ele.ACC.3.F.SG+IMPF+2+PL
gaifonávei-las	gaifonar+V.ele.ACC.3.F.PL+IMPF+2+PL
gaifonávei-lo	gaifonar+V.ele.ACC.3.M.SG+IMPF+2+PL
gaifonávei-los	gaifonar+V.ele.ACC.3.M.PL+IMPF+2+PL
gaifonávei-nos	gaifonar+nós.AD.1.PL+IMPF+2+PL
gaifonáveis-lhe	gaifonar+V.ele.DAT.3.SG+IMPF+2+PL
gaifonáveis-lhes	gaifonar+V.ele.DAT.3.PL+IMPF+2+PL
gaifonáveis-me	gaifonar+V.eu.AD.1.SG+IMPF+2+PL
gaifonáveis-te	gaifonar+V.tu.AD.2.SG+IMPF+2+PL
gaifonáveis-vos	gaifonar+V.vós.AD.2.PL+IMPF+2+PL
gaifona-vos	gaifonar+V.vós.AD.2.PL+PRS+3+SG
gaifone-a	gaifonar+V.ele.ACC.3.F.SG+IMP+3+SG
gaifone-as	gaifonar+V.ele.ACC.3.F.PL+IMP+3+SG
gaifonei-a	gaifonar+V.ele.ACC.3.F.SG+PRF+1+SG
gaifonei-as	gaifonar+V.ele.ACC.3.F.PL+PRF+1+SG
gaifonei-lhe	gaifonar+V.ele.DAT.3.SG+PRF+1+SG
gaifonei-lhes	gaifonar+V.ele.DAT.3.PL+PRF+1+SG
gaifonei-me	gaifonar+V.eu.AD.1.SG+PRF+1+SG
gaifonei-nos	gaifonar+nós.AD.1.PL+PRF+1+SG
gaifonei-o	gaifonar+V.ele.ACC.3.M.SG+PRF+1+SG
gaifonei-os	gaifonar+V.ele.ACC.3.M.PL+PRF+1+SG
gaifonei-te	gaifonar+V.tu.AD.2.SG+PRF+1+SG
gaifonei-vos	gaifonar+V.vós.AD.2.PL+PRF+1+SG
gaifone-lhe	gaifonar+V.ele.DAT.3.SG+IMP+3+SG
gaifone-lhes	gaifonar+V.ele.DAT.3.PL+IMP+3+SG
gaifone-me	gaifonar+V.eu.AD.1.SG+IMP+3+SG
gaifonem-lhe	gaifonar+V.ele.DAT.3.SG+IMP+3+PL
gaifonem-lhes	gaifonar+V.ele.DAT.3.PL+IMP+3+PL
gaifonem-me	gaifonar+V.eu.AD.1.SG+IMP+3+PL
gaifonem-na	gaifonar+V.ele.ACC.3.F.SG+IMP+3+PL
gaifonem-nas	gaifonar+V.ele.ACC.3.F.PL+IMP+3+PL
gaifonem-no	gaifonar+V.ele.ACC.3.M.SG+IMP+3+PL
gaifonem-nos	gaifonar+V.ele.ACC.3.M.PL+IMP+3+PL
gaifonem-nos	gaifonar+V.nós.AD.1.PL+IMP+3+PL
gaifonemo-la	gaifonar+V.ele.ACC.3.F.SG+IMP+1+PL
gaifonemo-las	gaifonar+V.ele.ACC.3.F.PL+IMP+1+PL
gaifonemo-lo	gaifonar+V.ele.ACC.3.M.SG+IMP+1+PL
gaifonemo-los	gaifonar+V.ele.ACC.3.M.PL+IMP+1+PL
gaifonemo-nos	gaifonar+nós.AD.1.PL+IMP+1+PL
gaifonemos-lhe	gaifonar+V.ele.DAT.3.SG+IMP+1+PL
gaifonemos-lhes	gaifonar+V.ele.DAT.3.PL+IMP+1+PL
gaifonemos-me	gaifonar+V.eu.AD.1.SG+IMP+1+PL
gaifonemos-te	gaifonar+V.tu.AD.2.SG+IMP+1+PL
gaifonemos-vos	gaifonar+V.vós.AD.2.PL+IMP+1+PL
gaifonem-se	gaifonar+V.ele.REFL+IMP+3+PL
gaifonem-te	gaifonar+V.tu.AD.2.SG+IMP+3+PL
gaifonem-vos	gaifonar+V.vós.AD.2.PL+IMP+3+PL
gaifone-nos	gaifonar+nós.AD.1.PL+IMP+3+SG
gaifone-o	gaifonar+V.ele.ACC.3.M.SG+IMP+3+SG
gaifone-os	gaifonar+V.ele.ACC.3.M.PL+IMP+3+SG
gaifone-se	gaifonar+V.ele.REFL+IMP+3+SG
gaifone-te	gaifonar+V.tu.AD.2.SG+IMP+3+SG
gaifone-vos	gaifonar+V.vós.AD.2.PL+IMP+3+SG
gaifono-a	gaifonar+V.ele.ACC.3.F.SG+PRS+1+SG
gaifono-as	gaifonar+V.ele.ACC.3.F.PL+PRS+1+SG
gaifono-lhe	gaifonar+V.ele.DAT.3.SG+PRS+1+SG
gaifono-lhes	gaifonar+V.ele.DAT.3.PL+PRS+1+SG
gaifono-me	gaifonar+V.eu.AD.1.SG+PRS+1+SG
gaifono-nos	gaifonar+nós.AD.1.PL+PRS+1+SG
gaifono-o	gaifonar+V.ele.ACC.3.M.SG+PRS+1+SG
gaifono-os	gaifonar+V.ele.ACC.3.M.PL+PRS+1+SG
gaifono-te	gaifonar+V.tu.AD.2.SG+PRS+1+SG
gaifonou-a	gaifonar+V.ele.ACC.3.F.SG+PRF+3+SG
gaifonou-as	gaifonar+V.ele.ACC.3.F.PL+PRF+3+SG
gaifonou-lhe	gaifonar+V.ele.DAT.3.SG+PRF+3+SG
gaifonou-lhes	gaifonar+V.ele.DAT.3.PL+PRF+3+SG
gaifonou-me	gaifonar+V.eu.AD.1.SG+PRF+3+SG
gaifonou-nos	gaifonar+nós.AD.1.PL+PRF+3+SG
gaifonou-o	gaifonar+V.ele.ACC.3.M.SG+PRF+3+SG
gaifonou-os	gaifonar+V.ele.ACC.3.M.PL+PRF+3+SG
gaifonou-se	gaifonar+V.ele.REFL+PRF+3+SG
gaifonou-te	gaifonar+V.tu.AD.2.SG+PRF+3+SG
gaifonou-vos	gaifonar+V.vós.AD.2.PL+PRF+3+SG
gaifono-vos	gaifonar+V.vós.AD.2.PL+PRS+1+SG
gaio-a	gaiar+V.ele.ACC.3.F.SG+PRS+1+SG
gaio-as	gaiar+V.ele.ACC.3.F.PL+PRS+1+SG
gaio-lhe	gaiar+V.ele.DAT.3.SG+PRS+1+SG
gaio-lhes	gaiar+V.ele.DAT.3.PL+PRS+1+SG
gaio-me	gaiar+V.eu.AD.1.SG+PRS+1+SG
gaio-nos	gaiar+nós.AD.1.PL+PRS+1+SG
gaio-o	gaiar+V.ele.ACC.3.M.SG+PRS+1+SG
gaio-os	gaiar+V.ele.ACC.3.M.PL+PRS+1+SG
gaio-te	gaiar+V.tu.AD.2.SG+PRS+1+SG
gaiou-a	gaiar+V.ele.ACC.3.F.SG+PRF+3+SG
gaiou-as	gaiar+V.ele.ACC.3.F.PL+PRF+3+SG
gaiou-lhe	gaiar+V.ele.DAT.3.SG+PRF+3+SG
gaiou-lhes	gaiar+V.ele.DAT.3.PL+PRF+3+SG
gaiou-me	gaiar+V.eu.AD.1.SG+PRF+3+SG
gaiou-nos	gaiar+nós.AD.1.PL+PRF+3+SG
gaiou-o	gaiar+V.ele.ACC.3.M.SG+PRF+3+SG
gaiou-os	gaiar+V.ele.ACC.3.M.PL+PRF+3+SG
gaiou-se	gaiar+V.ele.REFL+PRF+3+SG
gaiou-te	gaiar+V.tu.AD.2.SG+PRF+3+SG
gaiou-vos	gaiar+V.vós.AD.2.PL+PRF+3+SG
gaio-vos	gaiar+V.vós.AD.2.PL+PRS+1+SG
gaiteai-la	gaitear+V.ele.ACC.3.F.SG+PRS+2+PL
gaiteai-las	gaitear+V.ele.ACC.3.F.PL+PRS+2+PL
gaiteai-lo	gaitear+V.ele.ACC.3.M.SG+PRS+2+PL
gaiteai-los	gaitear+V.ele.ACC.3.M.PL+PRS+2+PL
gaiteai-nos	gaitear+nós.AD.1.PL+PRS+2+PL
gaiteais-lhe	gaitear+V.ele.DAT.3.SG+PRS+2+PL
gaiteais-lhes	gaitear+V.ele.DAT.3.PL+PRS+2+PL
gaiteais-me	gaitear+V.eu.AD.1.SG+PRS+2+PL
gaiteais-te	gaitear+V.tu.AD.2.SG+PRS+2+PL
gaiteais-vos	gaitear+V.vós.AD.2.PL+PRS+2+PL
gaiteá-la-á	gaitear+V.ele.ACC.3.F.SG+FUT+3+SG
gaiteá-la-ão	gaitear+V.ele.ACC.3.F.SG+FUT+3+PL
gaiteá-la-ás	gaitear+V.ele.ACC.3.F.SG+FUT+2+SG
gaiteá-la-ei	gaitear+V.ele.ACC.3.F.SG+FUT+1+SG
gaiteá-la-eis	gaitear+V.ele.ACC.3.F.SG+FUT+2+PL
gaiteá-la-emos	gaitear+V.ele.ACC.3.F.SG+FUT+1+PL
gaiteá-la	gaitear+V.ele.ACC.3.F.SG+INF+1+SG
gaiteá-la	gaitear+V.ele.ACC.3.F.SG+INF+3+SG
gaiteá-la	gaitear+V.ele.ACC.3.F.SG+SBJF+1+SG
gaiteá-la	gaitear+V.ele.ACC.3.F.SG+SBJF+3+SG
gaiteá-la-ia	gaitear+V.ele.ACC.3.F.SG+COND+1+SG
gaiteá-la-ia	gaitear+V.ele.ACC.3.F.SG+COND+3+SG
gaiteá-la-iam	gaitear+V.ele.ACC.3.F.SG+COND+3+PL
gaiteá-la-íamos	gaitear+V.ele.ACC.3.F.SG+COND+1+PL
gaiteá-la-ias	gaitear+V.ele.ACC.3.F.SG+COND+2+SG
gaiteá-la-íeis	gaitear+V.ele.ACC.3.F.SG+COND+2+PL
gaiteá-las-á	gaitear+V.ele.ACC.3.F.PL+FUT+3+SG
gaiteá-las-ão	gaitear+V.ele.ACC.3.F.PL+FUT+3+PL
gaiteá-las-ás	gaitear+V.ele.ACC.3.F.PL+FUT+2+SG
gaiteá-las-ei	gaitear+V.ele.ACC.3.F.PL+FUT+1+SG
gaiteá-las-eis	gaitear+V.ele.ACC.3.F.PL+FUT+2+PL
gaiteá-las-emos	gaitear+V.ele.ACC.3.F.PL+FUT+1+PL
gaiteá-las	gaitear+V.ele.ACC.3.F.PL+INF+1+SG
gaiteá-las	gaitear+V.ele.ACC.3.F.PL+INF+3+SG
gaiteá-las	gaitear+V.ele.ACC.3.F.PL+SBJF+1+SG
gaiteá-las	gaitear+V.ele.ACC.3.F.PL+SBJF+3+SG
gaiteá-las-ia	gaitear+V.ele.ACC.3.F.PL+COND+1+SG
gaiteá-las-ia	gaitear+V.ele.ACC.3.F.PL+COND+3+SG
gaiteá-las-iam	gaitear+V.ele.ACC.3.F.PL+COND+3+PL
gaiteá-las-íamos	gaitear+V.ele.ACC.3.F.PL+COND+1+PL
gaiteá-las-ias	gaitear+V.ele.ACC.3.F.PL+COND+2+SG
gaiteá-las-íeis	gaitear+V.ele.ACC.3.F.PL+COND+2+PL
gaiteá-lo-á	gaitear+V.ele.ACC.3.M.SG+FUT+3+SG
gaiteá-lo-ão	gaitear+V.ele.ACC.3.M.SG+FUT+3+PL
gaiteá-lo-ás	gaitear+V.ele.ACC.3.M.SG+FUT+2+SG
gaiteá-lo-ei	gaitear+V.ele.ACC.3.M.SG+FUT+1+SG
gaiteá-lo-eis	gaitear+V.ele.ACC.3.M.SG+FUT+2+PL
gaiteá-lo-emos	gaitear+V.ele.ACC.3.M.SG+FUT+1+PL
gaiteá-lo	gaitear+V.ele.ACC.3.M.SG+INF+1+SG
gaiteá-lo	gaitear+V.ele.ACC.3.M.SG+INF+3+SG
gaiteá-lo	gaitear+V.ele.ACC.3.M.SG+SBJF+1+SG
gaiteá-lo	gaitear+V.ele.ACC.3.M.SG+SBJF+3+SG
gaiteá-lo-ia	gaitear+V.ele.ACC.3.M.SG+COND+1+SG
gaiteá-lo-ia	gaitear+V.ele.ACC.3.M.SG+COND+3+SG
gaiteá-lo-iam	gaitear+V.ele.ACC.3.M.SG+COND+3+PL
gaiteá-lo-íamos	gaitear+V.ele.ACC.3.M.SG+COND+1+PL
gaiteá-lo-ias	gaitear+V.ele.ACC.3.M.SG+COND+2+SG
gaiteá-lo-íeis	gaitear+V.ele.ACC.3.M.SG+COND+2+PL
gaiteá-los-á	gaitear+V.ele.ACC.3.M.PL+FUT+3+SG
gaiteá-los-ão	gaitear+V.ele.ACC.3.M.PL+FUT+3+PL
gaiteá-los-ás	gaitear+V.ele.ACC.3.M.PL+FUT+2+SG
gaiteá-los-ei	gaitear+V.ele.ACC.3.M.PL+FUT+1+SG
gaiteá-los-eis	gaitear+V.ele.ACC.3.M.PL+FUT+2+PL
gaiteá-los-emos	gaitear+V.ele.ACC.3.M.PL+FUT+1+PL
gaiteá-los	gaitear+V.ele.ACC.3.M.PL+INF+1+SG
gaiteá-los	gaitear+V.ele.ACC.3.M.PL+INF+3+SG
gaiteá-los	gaitear+V.ele.ACC.3.M.PL+SBJF+1+SG
gaiteá-los	gaitear+V.ele.ACC.3.M.PL+SBJF+3+SG
gaiteá-los-ia	gaitear+V.ele.ACC.3.M.PL+COND+1+SG
gaiteá-los-ia	gaitear+V.ele.ACC.3.M.PL+COND+3+SG
gaiteá-los-iam	gaitear+V.ele.ACC.3.M.PL+COND+3+PL
gaiteá-los-íamos	gaitear+V.ele.ACC.3.M.PL+COND+1+PL
gaiteá-los-ias	gaitear+V.ele.ACC.3.M.PL+COND+2+SG
gaiteá-los-íeis	gaitear+V.ele.ACC.3.M.PL+COND+2+PL
gaiteamo-la	gaitear+V.ele.ACC.3.F.SG+PRF+1+PL
gaiteamo-la	gaitear+V.ele.ACC.3.F.SG+PRS+1+PL
gaiteamo-las	gaitear+V.ele.ACC.3.F.PL+PRF+1+PL
gaiteamo-las	gaitear+V.ele.ACC.3.F.PL+PRS+1+PL
gaiteamo-lo	gaitear+V.ele.ACC.3.M.SG+PRF+1+PL
gaiteamo-lo	gaitear+V.ele.ACC.3.M.SG+PRS+1+PL
gaiteamo-los	gaitear+V.ele.ACC.3.M.PL+PRF+1+PL
gaiteamo-los	gaitear+V.ele.ACC.3.M.PL+PRS+1+PL
gaiteamo-nos	gaitear+nós.AD.1.PL+PRF+1+PL
gaiteamo-nos	gaitear+nós.AD.1.PL+PRS+1+PL
gaiteamos-lhe	gaitear+V.ele.DAT.3.SG+PRF+1+PL
gaiteamos-lhe	gaitear+V.ele.DAT.3.SG+PRS+1+PL
gaiteamos-lhes	gaitear+V.ele.DAT.3.PL+PRF+1+PL
gaiteamos-lhes	gaitear+V.ele.DAT.3.PL+PRS+1+PL
gaiteamos-me	gaitear+V.eu.AD.1.SG+PRF+1+PL
gaiteamos-me	gaitear+V.eu.AD.1.SG+PRS+1+PL
gaiteamos-te	gaitear+V.tu.AD.2.SG+PRF+1+PL
gaiteamos-te	gaitear+V.tu.AD.2.SG+PRS+1+PL
gaiteamos-vos	gaitear+V.vós.AD.2.PL+PRF+1+PL
gaiteamos-vos	gaitear+V.vós.AD.2.PL+PRS+1+PL
gaiteando-a	gaitear+V.ele.ACC.3.F.SG+GRD
gaiteando-as	gaitear+V.ele.ACC.3.F.PL+GRD
gaiteando-lhe	gaitear+V.ele.DAT.3.SG+GRD
gaiteando-lhes	gaitear+V.ele.DAT.3.PL+GRD
gaiteando-me	gaitear+V.eu.AD.1.SG+GRD
gaiteando-nos	gaitear+nós.AD.1.PL+GRD
gaiteando-o	gaitear+V.ele.ACC.3.M.SG+GRD
gaiteando-os	gaitear+V.ele.ACC.3.M.PL+GRD
gaiteando-se	gaitear+V.ele.REFL+GRD
gaiteando-te	gaitear+V.tu.AD.2.SG+GRD
gaiteando-vos	gaitear+V.vós.AD.2.PL+GRD
gaiteara-a	gaitear+V.ele.ACC.3.F.SG+PQP+1+SG
gaiteara-a	gaitear+V.ele.ACC.3.F.SG+PQP+3+SG
gaiteara-as	gaitear+V.ele.ACC.3.F.PL+PQP+1+SG
gaiteara-as	gaitear+V.ele.ACC.3.F.PL+PQP+3+SG
gaiteara-la	gaitear+V.ele.ACC.3.F.SG+PQP+2+SG
gaiteara-las	gaitear+V.ele.ACC.3.F.PL+PQP+2+SG
gaiteara-lhe	gaitear+V.ele.DAT.3.SG+PQP+1+SG
gaiteara-lhe	gaitear+V.ele.DAT.3.SG+PQP+3+SG
gaiteara-lhes	gaitear+V.ele.DAT.3.PL+PQP+1+SG
gaiteara-lhes	gaitear+V.ele.DAT.3.PL+PQP+3+SG
gaiteara-lo	gaitear+V.ele.ACC.3.M.SG+PQP+2+SG
gaiteara-los	gaitear+V.ele.ACC.3.M.PL+PQP+2+SG
gaiteara-me	gaitear+V.eu.AD.1.SG+PQP+1+SG
gaiteara-me	gaitear+V.eu.AD.1.SG+PQP+3+SG
gaitearam-lhe	gaitear+V.ele.DAT.3.SG+PQP+3+PL
gaitearam-lhe	gaitear+V.ele.DAT.3.SG+PRF+3+PL
gaitearam-lhes	gaitear+V.ele.DAT.3.PL+PQP+3+PL
gaitearam-lhes	gaitear+V.ele.DAT.3.PL+PRF+3+PL
gaitearam-me	gaitear+V.eu.AD.1.SG+PQP+3+PL
gaitearam-me	gaitear+V.eu.AD.1.SG+PRF+3+PL
gaitearam-na	gaitear+V.ele.ACC.3.F.SG+PQP+3+PL
gaitearam-na	gaitear+V.ele.ACC.3.F.SG+PRF+3+PL
gaitearam-nas	gaitear+V.ele.ACC.3.F.PL+PQP+3+PL
gaitearam-nas	gaitear+V.ele.ACC.3.F.PL+PRF+3+PL
gaitearam-no	gaitear+V.ele.ACC.3.M.SG+PQP+3+PL
gaitearam-no	gaitear+V.ele.ACC.3.M.SG+PRF+3+PL
