humectar-lhes	humectar+V.ele.DAT.3.PL+INF+1+SG
humectar-lhes	humectar+V.ele.DAT.3.PL+INF+3+SG
humectar-lhes	humectar+V.ele.DAT.3.PL+SBJF+1+SG
humectar-lhes	humectar+V.ele.DAT.3.PL+SBJF+3+SG
humectar-lhes-ia	humectar+V.ele.DAT.3.PL+COND+1+SG
humectar-lhes-ia	humectar+V.ele.DAT.3.PL+COND+3+SG
humectar-lhes-iam	humectar+V.ele.DAT.3.PL+COND+3+PL
humectar-lhes-íamos	humectar+V.ele.DAT.3.PL+COND+1+PL
humectar-lhes-ias	humectar+V.ele.DAT.3.PL+COND+2+SG
humectar-lhes-íeis	humectar+V.ele.DAT.3.PL+COND+2+PL
humectar-me-á	humectar+V.eu.AD.1.SG+FUT+3+SG
humectar-me-ão	humectar+V.eu.AD.1.SG+FUT+3+PL
humectar-me-ás	humectar+V.eu.AD.1.SG+FUT+2+SG
humectar-me-ei	humectar+V.eu.AD.1.SG+FUT+1+SG
humectar-me-eis	humectar+V.eu.AD.1.SG+FUT+2+PL
humectar-me-emos	humectar+V.eu.AD.1.SG+FUT+1+PL
humectar-me	humectar+V.eu.AD.1.SG+INF
humectar-me	humectar+V.eu.AD.1.SG+INF+1+SG
humectar-me	humectar+V.eu.AD.1.SG+INF+3+SG
humectar-me	humectar+V.eu.AD.1.SG+SBJF+1+SG
humectar-me	humectar+V.eu.AD.1.SG+SBJF+3+SG
humectar-me-ia	humectar+V.eu.AD.1.SG+COND+1+SG
humectar-me-ia	humectar+V.eu.AD.1.SG+COND+3+SG
humectar-me-iam	humectar+V.eu.AD.1.SG+COND+3+PL
humectar-me-íamos	humectar+V.eu.AD.1.SG+COND+1+PL
humectar-me-ias	humectar+V.eu.AD.1.SG+COND+2+SG
humectar-me-íeis	humectar+V.eu.AD.1.SG+COND+2+PL
humectarmo-la	humectar+V.ele.ACC.3.F.SG+INF+1+PL
humectarmo-la	humectar+V.ele.ACC.3.F.SG+SBJF+1+PL
humectarmo-las	humectar+V.ele.ACC.3.F.PL+INF+1+PL
humectarmo-las	humectar+V.ele.ACC.3.F.PL+SBJF+1+PL
humectarmo-lo	humectar+V.ele.ACC.3.M.SG+INF+1+PL
humectarmo-lo	humectar+V.ele.ACC.3.M.SG+SBJF+1+PL
humectarmo-los	humectar+V.ele.ACC.3.M.PL+INF+1+PL
humectarmo-los	humectar+V.ele.ACC.3.M.PL+SBJF+1+PL
humectarmo-nos	humectar+nós.AD.1.PL+INF+1+PL
humectarmo-nos	humectar+nós.AD.1.PL+SBJF+1+PL
humectarmos-lhe	humectar+V.ele.DAT.3.SG+INF+1+PL
humectarmos-lhe	humectar+V.ele.DAT.3.SG+SBJF+1+PL
humectarmos-lhes	humectar+V.ele.DAT.3.PL+INF+1+PL
humectarmos-lhes	humectar+V.ele.DAT.3.PL+SBJF+1+PL
humectarmos-me	humectar+V.eu.AD.1.SG+INF+1+PL
humectarmos-me	humectar+V.eu.AD.1.SG+SBJF+1+PL
humectarmos-te	humectar+V.tu.AD.2.SG+INF+1+PL
humectarmos-te	humectar+V.tu.AD.2.SG+SBJF+1+PL
humectarmos-vos	humectar+V.vós.AD.2.PL+INF+1+PL
humectarmos-vos	humectar+V.vós.AD.2.PL+SBJF+1+PL
humectar-nos-á	humectar+nós.AD.1.PL+FUT+3+SG
humectar-nos-ão	humectar+nós.AD.1.PL+FUT+3+PL
humectar-nos-ás	humectar+nós.AD.1.PL+FUT+2+SG
humectar-nos-ei	humectar+nós.AD.1.PL+FUT+1+SG
humectar-nos-eis	humectar+nós.AD.1.PL+FUT+2+PL
humectar-nos-emos	humectar+nós.AD.1.PL+FUT+1+PL
humectar-nos	humectar+nós.AD.1.PL+INF
humectar-nos	humectar+nós.AD.1.PL+INF+1+SG
humectar-nos	humectar+nós.AD.1.PL+INF+3+SG
humectar-nos	humectar+nós.AD.1.PL+SBJF+1+SG
humectar-nos	humectar+nós.AD.1.PL+SBJF+3+SG
humectar-nos-ia	humectar+nós.AD.1.PL+COND+1+SG
humectar-nos-ia	humectar+nós.AD.1.PL+COND+3+SG
humectar-nos-iam	humectar+nós.AD.1.PL+COND+3+PL
humectar-nos-íamos	humectar+nós.AD.1.PL+COND+1+PL
humectar-nos-ias	humectar+nós.AD.1.PL+COND+2+SG
humectar-nos-íeis	humectar+nós.AD.1.PL+COND+2+PL
humectar-se-á	humectar+V.ele.REFL+FUT+3+SG
humectar-se-ão	humectar+V.ele.REFL+FUT+3+PL
humectar-se	humectar+V.ele.REFL+INF
humectar-se	humectar+V.ele.REFL+INF+3+SG
humectar-se	humectar+V.ele.REFL+SBJF+3+SG
humectar-se-ia	humectar+V.ele.REFL+COND+3+SG
humectar-se-iam	humectar+V.ele.REFL+COND+3+PL
humectar-te-á	humectar+V.tu.AD.2.SG+FUT+3+SG
humectar-te-ão	humectar+V.tu.AD.2.SG+FUT+3+PL
humectar-te-ás	humectar+V.tu.AD.2.SG+FUT+2+SG
humectar-te-ei	humectar+V.tu.AD.2.SG+FUT+1+SG
humectar-te-eis	humectar+V.tu.AD.2.SG+FUT+2+PL
humectar-te-emos	humectar+V.tu.AD.2.SG+FUT+1+PL
humectar-te	humectar+V.tu.AD.2.SG+INF
humectar-te	humectar+V.tu.AD.2.SG+INF+1+SG
humectar-te	humectar+V.tu.AD.2.SG+INF+3+SG
humectar-te	humectar+V.tu.AD.2.SG+SBJF+1+SG
humectar-te	humectar+V.tu.AD.2.SG+SBJF+3+SG
humectar-te-ia	humectar+V.tu.AD.2.SG+COND+1+SG
humectar-te-ia	humectar+V.tu.AD.2.SG+COND+3+SG
humectar-te-iam	humectar+V.tu.AD.2.SG+COND+3+PL
humectar-te-íamos	humectar+V.tu.AD.2.SG+COND+1+PL
humectar-te-ias	humectar+V.tu.AD.2.SG+COND+2+SG
humectar-te-íeis	humectar+V.tu.AD.2.SG+COND+2+PL
humectar-vos-á	humectar+V.vós.AD.2.PL+FUT+3+SG
humectar-vos-ão	humectar+V.vós.AD.2.PL+FUT+3+PL
humectar-vos-ás	humectar+V.vós.AD.2.PL+FUT+2+SG
humectar-vos-ei	humectar+V.vós.AD.2.PL+FUT+1+SG
humectar-vos-eis	humectar+V.vós.AD.2.PL+FUT+2+PL
humectar-vos-emos	humectar+V.vós.AD.2.PL+FUT+1+PL
humectar-vos	humectar+V.vós.AD.2.PL+INF
humectar-vos	humectar+V.vós.AD.2.PL+INF+1+SG
humectar-vos	humectar+V.vós.AD.2.PL+INF+3+SG
humectar-vos	humectar+V.vós.AD.2.PL+SBJF+1+SG
humectar-vos	humectar+V.vós.AD.2.PL+SBJF+3+SG
humectar-vos-ia	humectar+V.vós.AD.2.PL+COND+1+SG
humectar-vos-ia	humectar+V.vós.AD.2.PL+COND+3+SG
humectar-vos-iam	humectar+V.vós.AD.2.PL+COND+3+PL
humectar-vos-íamos	humectar+V.vós.AD.2.PL+COND+1+PL
humectar-vos-ias	humectar+V.vós.AD.2.PL+COND+2+SG
humectar-vos-íeis	humectar+V.vós.AD.2.PL+COND+2+PL
humecta-se	humectar+V.ele.REFL+PRS+3+SG
humectas-lhe	humectar+V.ele.DAT.3.SG+PRS+2+SG
humectas-lhes	humectar+V.ele.DAT.3.PL+PRS+2+SG
humectas-me	humectar+V.eu.AD.1.SG+PRS+2+SG
humectaste-a	humectar+V.ele.ACC.3.F.SG+PRF+2+SG
humectaste-as	humectar+V.ele.ACC.3.F.PL+PRF+2+SG
humectas-te	humectar+V.tu.AD.2.SG+PRS+2+SG
humectaste-la	humectar+V.ele.ACC.3.F.SG+PRF+2+PL
humectaste-las	humectar+V.ele.ACC.3.F.PL+PRF+2+PL
humectaste-lhe	humectar+V.ele.DAT.3.SG+PRF+2+SG
humectaste-lhes	humectar+V.ele.DAT.3.PL+PRF+2+SG
humectaste-lo	humectar+V.ele.ACC.3.M.SG+PRF+2+PL
humectaste-los	humectar+V.ele.ACC.3.M.PL+PRF+2+PL
humectaste-me	humectar+V.eu.AD.1.SG+PRF+2+SG
humectaste-nos	humectar+nós.AD.1.PL+PRF+2+PL
humectaste-nos	humectar+nós.AD.1.PL+PRF+2+SG
humectaste-o	humectar+V.ele.ACC.3.M.SG+PRF+2+SG
humectaste-os	humectar+V.ele.ACC.3.M.PL+PRF+2+SG
humectastes-lhe	humectar+V.ele.DAT.3.SG+PRF+2+PL
humectastes-lhes	humectar+V.ele.DAT.3.PL+PRF+2+PL
humectastes-me	humectar+V.eu.AD.1.SG+PRF+2+PL
humectastes-te	humectar+V.tu.AD.2.SG+PRF+2+PL
humectastes-vos	humectar+V.vós.AD.2.PL+PRF+2+PL
humectaste-te	humectar+V.tu.AD.2.SG+PRF+2+SG
humectaste-vos	humectar+V.vós.AD.2.PL+PRF+2+SG
humectas-vos	humectar+V.vós.AD.2.PL+PRS+2+SG
humecta-te	humectar+V.tu.AD.2.SG+PRS+3+SG
humectava-a	humectar+V.ele.ACC.3.F.SG+IMPF+1+SG
humectava-a	humectar+V.ele.ACC.3.F.SG+IMPF+3+SG
humectava-as	humectar+V.ele.ACC.3.F.PL+IMPF+1+SG
humectava-as	humectar+V.ele.ACC.3.F.PL+IMPF+3+SG
humectava-la	humectar+V.ele.ACC.3.F.SG+IMPF+2+SG
humectava-las	humectar+V.ele.ACC.3.F.PL+IMPF+2+SG
humectava-lhe	humectar+V.ele.DAT.3.SG+IMPF+1+SG
humectava-lhe	humectar+V.ele.DAT.3.SG+IMPF+3+SG
humectava-lhes	humectar+V.ele.DAT.3.PL+IMPF+1+SG
humectava-lhes	humectar+V.ele.DAT.3.PL+IMPF+3+SG
humectava-lo	humectar+V.ele.ACC.3.M.SG+IMPF+2+SG
humectava-los	humectar+V.ele.ACC.3.M.PL+IMPF+2+SG
humectava-me	humectar+V.eu.AD.1.SG+IMPF+1+SG
humectava-me	humectar+V.eu.AD.1.SG+IMPF+3+SG
humectavam-lhe	humectar+V.ele.DAT.3.SG+IMPF+3+PL
humectavam-lhes	humectar+V.ele.DAT.3.PL+IMPF+3+PL
humectavam-me	humectar+V.eu.AD.1.SG+IMPF+3+PL
humectavam-na	humectar+V.ele.ACC.3.F.SG+IMPF+3+PL
humectavam-nas	humectar+V.ele.ACC.3.F.PL+IMPF+3+PL
humectavam-no	humectar+V.ele.ACC.3.M.SG+IMPF+3+PL
humectavam-nos	humectar+V.ele.ACC.3.M.PL+IMPF+3+PL
humectavam-nos	humectar+V.nós.AD.1.PL+IMPF+3+PL
humectávamo-la	humectar+V.ele.ACC.3.F.SG+IMPF+1+PL
humectávamo-las	humectar+V.ele.ACC.3.F.PL+IMPF+1+PL
humectávamo-lo	humectar+V.ele.ACC.3.M.SG+IMPF+1+PL
humectávamo-los	humectar+V.ele.ACC.3.M.PL+IMPF+1+PL
humectávamo-nos	humectar+nós.AD.1.PL+IMPF+1+PL
humectávamos-lhe	humectar+V.ele.DAT.3.SG+IMPF+1+PL
humectávamos-lhes	humectar+V.ele.DAT.3.PL+IMPF+1+PL
humectávamos-me	humectar+V.eu.AD.1.SG+IMPF+1+PL
humectávamos-te	humectar+V.tu.AD.2.SG+IMPF+1+PL
humectávamos-vos	humectar+V.vós.AD.2.PL+IMPF+1+PL
humectavam-se	humectar+V.ele.REFL+IMPF+3+PL
humectavam-te	humectar+V.tu.AD.2.SG+IMPF+3+PL
humectavam-vos	humectar+V.vós.AD.2.PL+IMPF+3+PL
humectava-nos	humectar+nós.AD.1.PL+IMPF+1+SG
humectava-nos	humectar+nós.AD.1.PL+IMPF+2+SG
humectava-nos	humectar+nós.AD.1.PL+IMPF+3+SG
humectava-o	humectar+V.ele.ACC.3.M.SG+IMPF+1+SG
humectava-o	humectar+V.ele.ACC.3.M.SG+IMPF+3+SG
humectava-os	humectar+V.ele.ACC.3.M.PL+IMPF+1+SG
humectava-os	humectar+V.ele.ACC.3.M.PL+IMPF+3+SG
humectava-se	humectar+V.ele.REFL+IMPF+1+SG
humectava-se	humectar+V.ele.REFL+IMPF+3+SG
humectavas-lhe	humectar+V.ele.DAT.3.SG+IMPF+2+SG
humectavas-lhes	humectar+V.ele.DAT.3.PL+IMPF+2+SG
humectavas-me	humectar+V.eu.AD.1.SG+IMPF+2+SG
humectavas-te	humectar+V.tu.AD.2.SG+IMPF+2+SG
humectavas-vos	humectar+V.vós.AD.2.PL+IMPF+2+SG
humectava-te	humectar+V.tu.AD.2.SG+IMPF+1+SG
humectava-te	humectar+V.tu.AD.2.SG+IMPF+3+SG
humectava-vos	humectar+V.vós.AD.2.PL+IMPF+1+SG
humectava-vos	humectar+V.vós.AD.2.PL+IMPF+3+SG
humectávei-la	humectar+V.ele.ACC.3.F.SG+IMPF+2+PL
humectávei-las	humectar+V.ele.ACC.3.F.PL+IMPF+2+PL
humectávei-lo	humectar+V.ele.ACC.3.M.SG+IMPF+2+PL
humectávei-los	humectar+V.ele.ACC.3.M.PL+IMPF+2+PL
humectávei-nos	humectar+nós.AD.1.PL+IMPF+2+PL
humectáveis-lhe	humectar+V.ele.DAT.3.SG+IMPF+2+PL
humectáveis-lhes	humectar+V.ele.DAT.3.PL+IMPF+2+PL
humectáveis-me	humectar+V.eu.AD.1.SG+IMPF+2+PL
humectáveis-te	humectar+V.tu.AD.2.SG+IMPF+2+PL
humectáveis-vos	humectar+V.vós.AD.2.PL+IMPF+2+PL
humecta-vos	humectar+V.vós.AD.2.PL+PRS+3+SG
humecte-a	humectar+V.ele.ACC.3.F.SG+IMP+3+SG
humecte-as	humectar+V.ele.ACC.3.F.PL+IMP+3+SG
humectei-a	humectar+V.ele.ACC.3.F.SG+PRF+1+SG
humectei-as	humectar+V.ele.ACC.3.F.PL+PRF+1+SG
humectei-lhe	humectar+V.ele.DAT.3.SG+PRF+1+SG
humectei-lhes	humectar+V.ele.DAT.3.PL+PRF+1+SG
humectei-me	humectar+V.eu.AD.1.SG+PRF+1+SG
humectei-nos	humectar+nós.AD.1.PL+PRF+1+SG
humectei-o	humectar+V.ele.ACC.3.M.SG+PRF+1+SG
humectei-os	humectar+V.ele.ACC.3.M.PL+PRF+1+SG
humectei-te	humectar+V.tu.AD.2.SG+PRF+1+SG
humectei-vos	humectar+V.vós.AD.2.PL+PRF+1+SG
humecte-lhe	humectar+V.ele.DAT.3.SG+IMP+3+SG
humecte-lhes	humectar+V.ele.DAT.3.PL+IMP+3+SG
humecte-me	humectar+V.eu.AD.1.SG+IMP+3+SG
humectem-lhe	humectar+V.ele.DAT.3.SG+IMP+3+PL
humectem-lhes	humectar+V.ele.DAT.3.PL+IMP+3+PL
humectem-me	humectar+V.eu.AD.1.SG+IMP+3+PL
humectem-na	humectar+V.ele.ACC.3.F.SG+IMP+3+PL
humectem-nas	humectar+V.ele.ACC.3.F.PL+IMP+3+PL
humectem-no	humectar+V.ele.ACC.3.M.SG+IMP+3+PL
humectem-nos	humectar+V.ele.ACC.3.M.PL+IMP+3+PL
humectem-nos	humectar+V.nós.AD.1.PL+IMP+3+PL
humectemo-la	humectar+V.ele.ACC.3.F.SG+IMP+1+PL
humectemo-las	humectar+V.ele.ACC.3.F.PL+IMP+1+PL
humectemo-lo	humectar+V.ele.ACC.3.M.SG+IMP+1+PL
humectemo-los	humectar+V.ele.ACC.3.M.PL+IMP+1+PL
humectemo-nos	humectar+nós.AD.1.PL+IMP+1+PL
humectemos-lhe	humectar+V.ele.DAT.3.SG+IMP+1+PL
humectemos-lhes	humectar+V.ele.DAT.3.PL+IMP+1+PL
humectemos-me	humectar+V.eu.AD.1.SG+IMP+1+PL
humectemos-te	humectar+V.tu.AD.2.SG+IMP+1+PL
humectemos-vos	humectar+V.vós.AD.2.PL+IMP+1+PL
humectem-se	humectar+V.ele.REFL+IMP+3+PL
humectem-te	humectar+V.tu.AD.2.SG+IMP+3+PL
humectem-vos	humectar+V.vós.AD.2.PL+IMP+3+PL
humecte-nos	humectar+nós.AD.1.PL+IMP+3+SG
humecte-o	humectar+V.ele.ACC.3.M.SG+IMP+3+SG
humecte-os	humectar+V.ele.ACC.3.M.PL+IMP+3+SG
humecte-se	humectar+V.ele.REFL+IMP+3+SG
humecte-te	humectar+V.tu.AD.2.SG+IMP+3+SG
humecte-vos	humectar+V.vós.AD.2.PL+IMP+3+SG
humecto-a	humectar+V.ele.ACC.3.F.SG+PRS+1+SG
humecto-as	humectar+V.ele.ACC.3.F.PL+PRS+1+SG
humecto-lhe	humectar+V.ele.DAT.3.SG+PRS+1+SG
humecto-lhes	humectar+V.ele.DAT.3.PL+PRS+1+SG
humecto-me	humectar+V.eu.AD.1.SG+PRS+1+SG
humecto-nos	humectar+nós.AD.1.PL+PRS+1+SG
humecto-o	humectar+V.ele.ACC.3.M.SG+PRS+1+SG
humecto-os	humectar+V.ele.ACC.3.M.PL+PRS+1+SG
humecto-te	humectar+V.tu.AD.2.SG+PRS+1+SG
humectou-a	humectar+V.ele.ACC.3.F.SG+PRF+3+SG
humectou-as	humectar+V.ele.ACC.3.F.PL+PRF+3+SG
humectou-lhe	humectar+V.ele.DAT.3.SG+PRF+3+SG
humectou-lhes	humectar+V.ele.DAT.3.PL+PRF+3+SG
humectou-me	humectar+V.eu.AD.1.SG+PRF+3+SG
humectou-nos	humectar+nós.AD.1.PL+PRF+3+SG
humectou-o	humectar+V.ele.ACC.3.M.SG+PRF+3+SG
humectou-os	humectar+V.ele.ACC.3.M.PL+PRF+3+SG
humectou-se	humectar+V.ele.REFL+PRF+3+SG
humectou-te	humectar+V.tu.AD.2.SG+PRF+3+SG
humectou-vos	humectar+V.vós.AD.2.PL+PRF+3+SG
humecto-vos	humectar+V.vós.AD.2.PL+PRS+1+SG
humedeça-a	humedecer+V.ele.ACC.3.F.SG+IMP+3+SG
humedeça-as	humedecer+V.ele.ACC.3.F.PL+IMP+3+SG
humedeça-lhe	humedecer+V.ele.DAT.3.SG+IMP+3+SG
humedeça-lhes	humedecer+V.ele.DAT.3.PL+IMP+3+SG
humedeça-me	humedecer+V.eu.AD.1.SG+IMP+3+SG
humedeçam-lhe	humedecer+V.ele.DAT.3.SG+IMP+3+PL
humedeçam-lhes	humedecer+V.ele.DAT.3.PL+IMP+3+PL
humedeçam-me	humedecer+V.eu.AD.1.SG+IMP+3+PL
humedeçam-na	humedecer+V.ele.ACC.3.F.SG+IMP+3+PL
humedeçam-nas	humedecer+V.ele.ACC.3.F.PL+IMP+3+PL
humedeçam-no	humedecer+V.ele.ACC.3.M.SG+IMP+3+PL
humedeçam-nos	humedecer+nós.AD.1.PL+IMP+3+PL
humedeçamo-la	humedecer+V.ele.ACC.3.F.SG+IMP+1+PL
humedeçamo-las	humedecer+V.ele.ACC.3.F.PL+IMP+1+PL
humedeçamo-lo	humedecer+V.ele.ACC.3.M.SG+IMP+1+PL
humedeçamo-los	humedecer+V.ele.ACC.3.M.PL+IMP+1+PL
humedeçamo-nos	humedecer+nós.AD.1.PL+IMP+1+PL
humedeçamos-lhe	humedecer+V.ele.DAT.3.SG+IMP+1+PL
humedeçamos-lhes	humedecer+V.ele.DAT.3.PL+IMP+1+PL
humedeçamos-me	humedecer+V.eu.AD.1.SG+IMP+1+PL
humedeçamos-te	humedecer+V.tu.AD.2.SG+IMP+1+PL
humedeçamos-vos	humedecer+V.vós.AD.2.PL+IMP+1+PL
humedeçam-se	humedecer+V.ele.REFL+IMP+3+PL
humedeçam-te	humedecer+V.tu.AD.2.SG+IMP+3+PL
humedeçam-vos	humedecer+V.vós.AD.2.PL+IMP+3+PL
humedeça-nos	humedecer+nós.AD.1.PL+IMP+3+SG
humedeça-o	humedecer+V.ele.ACC.3.M.SG+IMP+3+SG
humedeça-os	humedecer+V.ele.ACC.3.M.PL+IMP+3+SG
humedeça-se	humedecer+V.ele.REFL+IMP+3+SG
humedeça-te	humedecer+V.tu.AD.2.SG+IMP+3+SG
humedeça-vos	humedecer+V.vós.AD.2.PL+IMP+3+SG
humedecei-la	humedecer+V.ele.ACC.3.F.SG+PRS+2+PL
humedecei-las	humedecer+V.ele.ACC.3.F.PL+PRS+2+PL
humedecei-lo	humedecer+V.ele.ACC.3.M.SG+PRS+2+PL
humedecei-los	humedecer+V.ele.ACC.3.M.PL+PRS+2+PL
humedecei-nos	humedecer+nós.AD.1.PL+PRS+2+PL
humedeceis-lhe	humedecer+V.ele.DAT.3.SG+PRS+2+PL
humedeceis-lhes	humedecer+V.ele.DAT.3.PL+PRS+2+PL
humedeceis-me	humedecer+V.eu.AD.1.SG+PRS+2+PL
humedeceis-te	humedecer+V.tu.AD.2.SG+PRS+2+PL
humedeceis-vos	humedecer+V.vós.AD.2.PL+PRS+2+PL
humedecê-la-á	humedecer+V.ele.ACC.3.F.SG+FUT+3+SG
humedecê-la-ão	humedecer+V.ele.ACC.3.F.SG+FUT+3+PL
humedecê-la-ás	humedecer+V.ele.ACC.3.F.SG+FUT+2+SG
humedecê-la-ei	humedecer+V.ele.ACC.3.F.SG+FUT+1+SG
humedecê-la-eis	humedecer+V.ele.ACC.3.F.SG+FUT+2+PL
humedecê-la-emos	humedecer+V.ele.ACC.3.F.SG+FUT+1+PL
humedecê-la	humedecer+V.ele.ACC.3.F.SG+INF
humedecê-la	humedecer+V.ele.ACC.3.F.SG+INF+1+SG
humedecê-la	humedecer+V.ele.ACC.3.F.SG+INF+3+SG
humedece-la	humedecer+V.ele.ACC.3.F.SG+PRS+2+SG
humedecê-la	humedecer+V.ele.ACC.3.F.SG+SBJF+1+SG
humedecê-la	humedecer+V.ele.ACC.3.F.SG+SBJF+3+SG
humedecê-la-ia	humedecer+V.ele.ACC.3.F.SG+COND+1+SG
humedecê-la-ia	humedecer+V.ele.ACC.3.F.SG+COND+3+SG
humedecê-la-iam	humedecer+V.ele.ACC.3.F.SG+COND+3+PL
humedecê-la-íamos	humedecer+V.ele.ACC.3.F.SG+COND+1+PL
humedecê-la-ias	humedecer+V.ele.ACC.3.F.SG+COND+2+SG
humedecê-la-íeis	humedecer+V.ele.ACC.3.F.SG+COND+2+PL
humedecê-las-á	humedecer+V.ele.ACC.3.F.PL+FUT+3+SG
humedecê-las-ão	humedecer+V.ele.ACC.3.F.PL+FUT+3+PL
humedecê-las-ás	humedecer+V.ele.ACC.3.F.PL+FUT+2+SG
humedecê-las-ei	humedecer+V.ele.ACC.3.F.PL+FUT+1+SG
humedecê-las-eis	humedecer+V.ele.ACC.3.F.PL+FUT+2+PL
humedecê-las-emos	humedecer+V.ele.ACC.3.F.PL+FUT+1+PL
humedecê-las	humedecer+V.ele.ACC.3.F.PL+INF
humedecê-las	humedecer+V.ele.ACC.3.F.PL+INF+1+SG
humedecê-las	humedecer+V.ele.ACC.3.F.PL+INF+3+SG
humedece-las	humedecer+V.ele.ACC.3.F.PL+PRS+2+SG
humedecê-las	humedecer+V.ele.ACC.3.F.PL+SBJF+1+SG
humedecê-las	humedecer+V.ele.ACC.3.F.PL+SBJF+3+SG
humedecê-las-ia	humedecer+V.ele.ACC.3.F.PL+COND+1+SG
humedecê-las-ia	humedecer+V.ele.ACC.3.F.PL+COND+3+SG
humedecê-las-iam	humedecer+V.ele.ACC.3.F.PL+COND+3+PL
humedecê-las-íamos	humedecer+V.ele.ACC.3.F.PL+COND+1+PL
humedecê-las-ias	humedecer+V.ele.ACC.3.F.PL+COND+2+SG
humedecê-las-íeis	humedecer+V.ele.ACC.3.F.PL+COND+2+PL
humedecê-lo-á	humedecer+V.ele.ACC.3.M.SG+FUT+3+SG
humedecê-lo-ão	humedecer+V.ele.ACC.3.M.SG+FUT+3+PL
humedecê-lo-ás	humedecer+V.ele.ACC.3.M.SG+FUT+2+SG
humedecê-lo-ei	humedecer+V.ele.ACC.3.M.SG+FUT+1+SG
humedecê-lo-eis	humedecer+V.ele.ACC.3.M.SG+FUT+2+PL
humedecê-lo-emos	humedecer+V.ele.ACC.3.M.SG+FUT+1+PL
humedecê-lo	humedecer+V.ele.ACC.3.M.SG+INF
humedecê-lo	humedecer+V.ele.ACC.3.M.SG+INF+1+SG
humedecê-lo	humedecer+V.ele.ACC.3.M.SG+INF+3+SG
humedece-lo	humedecer+V.ele.ACC.3.M.SG+PRS+2+SG
humedecê-lo	humedecer+V.ele.ACC.3.M.SG+SBJF+1+SG
humedecê-lo	humedecer+V.ele.ACC.3.M.SG+SBJF+3+SG
humedecê-lo-ia	humedecer+V.ele.ACC.3.M.SG+COND+1+SG
humedecê-lo-ia	humedecer+V.ele.ACC.3.M.SG+COND+3+SG
humedecê-lo-iam	humedecer+V.ele.ACC.3.M.SG+COND+3+PL
humedecê-lo-íamos	humedecer+V.ele.ACC.3.M.SG+COND+1+PL
humedecê-lo-ias	humedecer+V.ele.ACC.3.M.SG+COND+2+SG
humedecê-lo-íeis	humedecer+V.ele.ACC.3.M.SG+COND+2+PL
humedecê-los-á	humedecer+V.ele.ACC.3.M.PL+FUT+3+SG
humedecê-los-ão	humedecer+V.ele.ACC.3.M.PL+FUT+3+PL
humedecê-los-ás	humedecer+V.ele.ACC.3.M.PL+FUT+2+SG
humedecê-los-ei	humedecer+V.ele.ACC.3.M.PL+FUT+1+SG
humedecê-los-eis	humedecer+V.ele.ACC.3.M.PL+FUT+2+PL
humedecê-los-emos	humedecer+V.ele.ACC.3.M.PL+FUT+1+PL
humedecê-los	humedecer+V.ele.ACC.3.M.PL+INF
humedecê-los	humedecer+V.ele.ACC.3.M.PL+INF+1+SG
humedecê-los	humedecer+V.ele.ACC.3.M.PL+INF+3+SG
humedece-los	humedecer+V.ele.ACC.3.M.PL+PRS+2+SG
humedecê-los	humedecer+V.ele.ACC.3.M.PL+SBJF+1+SG
humedecê-los	humedecer+V.ele.ACC.3.M.PL+SBJF+3+SG
humedecê-los-ia	humedecer+V.ele.ACC.3.M.PL+COND+1+SG
humedecê-los-ia	humedecer+V.ele.ACC.3.M.PL+COND+3+SG
humedecê-los-iam	humedecer+V.ele.ACC.3.M.PL+COND+3+PL
humedecê-los-íamos	humedecer+V.ele.ACC.3.M.PL+COND+1+PL
humedecê-los-ias	humedecer+V.ele.ACC.3.M.PL+COND+2+SG
humedecê-los-íeis	humedecer+V.ele.ACC.3.M.PL+COND+2+PL
humedecem-lhe	humedecer+V.ele.DAT.3.SG+PRS+3+PL
humedecem-lhes	humedecer+V.ele.DAT.3.PL+PRS+3+PL
humedecem-me	humedecer+V.eu.AD.1.SG+PRS+3+PL
humedecem-na	humedecer+V.ele.ACC.3.F.SG+PRS+3+PL
humedecem-nas	humedecer+V.ele.ACC.3.F.PL+PRS+3+PL
humedecem-no	humedecer+V.ele.ACC.3.M.SG+PRS+3+PL
humedecem-nos	humedecer+V.ele.ACC.3.M.PL+PRS+3+PL
humedecem-nos	humedecer+V.nós.AD.1.PL+PRS+3+PL
humedecemo-la	humedecer+V.ele.ACC.3.F.SG+PRF+1+PL
humedecemo-la	humedecer+V.ele.ACC.3.F.SG+PRS+1+PL
humedecemo-las	humedecer+V.ele.ACC.3.F.PL+PRF+1+PL
humedecemo-las	humedecer+V.ele.ACC.3.F.PL+PRS+1+PL
humedecemo-lo	humedecer+V.ele.ACC.3.M.SG+PRF+1+PL
humedecemo-lo	humedecer+V.ele.ACC.3.M.SG+PRS+1+PL
humedecemo-los	humedecer+V.ele.ACC.3.M.PL+PRF+1+PL
humedecemo-los	humedecer+V.ele.ACC.3.M.PL+PRS+1+PL
humedecemo-nos	humedecer+nós.AD.1.PL+PRF+1+PL
humedecemo-nos	humedecer+nós.AD.1.PL+PRS+1+PL
humedecemos-lhe	humedecer+V.ele.DAT.3.SG+PRF+1+PL
humedecemos-lhe	humedecer+V.ele.DAT.3.SG+PRS+1+PL
humedecemos-lhes	humedecer+V.ele.DAT.3.PL+PRF+1+PL
humedecemos-lhes	humedecer+V.ele.DAT.3.PL+PRS+1+PL
humedecemos-me	humedecer+V.eu.AD.1.SG+PRF+1+PL
humedecemos-me	humedecer+V.eu.AD.1.SG+PRS+1+PL
humedecemos-te	humedecer+V.tu.AD.2.SG+PRF+1+PL
humedecemos-te	humedecer+V.tu.AD.2.SG+PRS+1+PL
humedecemos-vos	humedecer+V.vós.AD.2.PL+PRF+1+PL
humedecemos-vos	humedecer+V.vós.AD.2.PL+PRS+1+PL
humedecem-se	humedecer+V.ele.REFL+PRS+3+PL
humedecem-te	humedecer+V.tu.AD.2.SG+PRS+3+PL
humedecem-vos	humedecer+V.vós.AD.2.PL+PRS+3+PL
humedecendo-a	humedecer+V.ele.ACC.3.F.SG+GRD
humedecendo-as	humedecer+V.ele.ACC.3.F.PL+GRD
humedecendo-lhe	humedecer+V.ele.DAT.3.SG+GRD
humedecendo-lhes	humedecer+V.ele.DAT.3.PL+GRD
humedecendo-me	humedecer+V.eu.AD.1.SG+GRD
humedecendo-nos	humedecer+nós.AD.1.PL+GRD
humedecendo-o	humedecer+V.ele.ACC.3.M.SG+GRD
humedecendo-os	humedecer+V.ele.ACC.3.M.PL+GRD
humedecendo-se	humedecer+V.ele.REFL+GRD
humedecendo-te	humedecer+V.tu.AD.2.SG+GRD
humedecendo-vos	humedecer+V.vós.AD.2.PL+GRD
humedece-nos	humedecer+nós.AD.1.PL+PRS+2+SG
humedecera-a	humedecer+V.ele.ACC.3.F.SG+PQP+1+SG
humedecera-a	humedecer+V.ele.ACC.3.F.SG+PQP+3+SG
humedecera-as	humedecer+V.ele.ACC.3.F.PL+PQP+1+SG
humedecera-as	humedecer+V.ele.ACC.3.F.PL+PQP+3+SG
humedecera-la	humedecer+V.ele.ACC.3.F.SG+PQP+2+SG
humedecera-las	humedecer+V.ele.ACC.3.F.PL+PQP+2+SG
humedecera-lhe	humedecer+V.ele.DAT.3.SG+PQP+1+SG
humedecera-lhe	humedecer+V.ele.DAT.3.SG+PQP+3+SG
humedecera-lhes	humedecer+V.ele.DAT.3.PL+PQP+1+SG
humedecera-lhes	humedecer+V.ele.DAT.3.PL+PQP+3+SG
humedecera-lo	humedecer+V.ele.ACC.3.M.SG+PQP+2+SG
humedecera-los	humedecer+V.ele.ACC.3.M.PL+PQP+2+SG
humedecera-me	humedecer+V.eu.AD.1.SG+PQP+1+SG
humedecera-me	humedecer+V.eu.AD.1.SG+PQP+3+SG
humedeceram-lhe	humedecer+V.ele.DAT.3.SG+PQP+3+PL
humedeceram-lhe	humedecer+V.ele.DAT.3.SG+PRF+3+PL
humedeceram-lhes	humedecer+V.ele.DAT.3.PL+PQP+3+PL
humedeceram-lhes	humedecer+V.ele.DAT.3.PL+PRF+3+PL
humedeceram-me	humedecer+V.eu.AD.1.SG+PQP+3+PL
humedeceram-me	humedecer+V.eu.AD.1.SG+PRF+3+PL
humedeceram-na	humedecer+V.ele.ACC.3.F.SG+PQP+3+PL
humedeceram-na	humedecer+V.ele.ACC.3.F.SG+PRF+3+PL
humedeceram-nas	humedecer+V.ele.ACC.3.F.PL+PQP+3+PL
humedeceram-nas	humedecer+V.ele.ACC.3.F.PL+PRF+3+PL
humedeceram-no	humedecer+V.ele.ACC.3.M.SG+PQP+3+PL
humedeceram-no	humedecer+V.ele.ACC.3.M.SG+PRF+3+PL
humedeceram-nos	humedecer+V.ele.ACC.3.M.PL+PQP+3+PL
humedeceram-nos	humedecer+V.ele.ACC.3.M.PL+PRF+3+PL
humedeceram-nos	humedecer+V.nós.AD.1.PL+PQP+3+PL
humedeceram-nos	humedecer+V.nós.AD.1.PL+PRF+3+PL
humedecêramo-la	humedecer+V.ele.ACC.3.F.SG+PQP+1+PL
humedecêramo-las	humedecer+V.ele.ACC.3.F.PL+PQP+1+PL
humedecêramo-lo	humedecer+V.ele.ACC.3.M.SG+PQP+1+PL
humedecêramo-los	humedecer+V.ele.ACC.3.M.PL+PQP+1+PL
humedecêramo-nos	humedecer+nós.AD.1.PL+PQP+1+PL
humedecêramos-lhe	humedecer+V.ele.DAT.3.SG+PQP+1+PL
humedecêramos-lhes	humedecer+V.ele.DAT.3.PL+PQP+1+PL
humedecêramos-me	humedecer+V.eu.AD.1.SG+PQP+1+PL
humedecêramos-te	humedecer+V.tu.AD.2.SG+PQP+1+PL
humedecêramos-vos	humedecer+V.vós.AD.2.PL+PQP+1+PL
humedeceram-se	humedecer+V.ele.REFL+PQP+3+PL
humedeceram-se	humedecer+V.ele.REFL+PRF+3+PL
humedeceram-te	humedecer+V.tu.AD.2.SG+PQP+3+PL
humedeceram-te	humedecer+V.tu.AD.2.SG+PRF+3+PL
humedeceram-vos	humedecer+V.vós.AD.2.PL+PQP+3+PL
humedeceram-vos	humedecer+V.vós.AD.2.PL+PRF+3+PL
humedecera-nos	humedecer+nós.AD.1.PL+PQP+1+SG
humedecera-nos	humedecer+nós.AD.1.PL+PQP+2+SG
humedecera-nos	humedecer+nós.AD.1.PL+PQP+3+SG
humedecera-o	humedecer+V.ele.ACC.3.M.SG+PQP+1+SG
humedecera-o	humedecer+V.ele.ACC.3.M.SG+PQP+3+SG
humedecera-os	humedecer+V.ele.ACC.3.M.PL+PQP+1+SG
humedecera-os	humedecer+V.ele.ACC.3.M.PL+PQP+3+SG
humedecera-se	humedecer+V.ele.REFL+PQP+3+SG
humedeceras-lhe	humedecer+V.ele.DAT.3.SG+PQP+2+SG
humedeceras-lhes	humedecer+V.ele.DAT.3.PL+PQP+2+SG
humedeceras-me	humedecer+V.eu.AD.1.SG+PQP+2+SG
humedeceras-te	humedecer+V.tu.AD.2.SG+PQP+2+SG
humedeceras-vos	humedecer+V.vós.AD.2.PL+PQP+2+SG
humedecera-te	humedecer+V.tu.AD.2.SG+PQP+1+SG
humedecera-te	humedecer+V.tu.AD.2.SG+PQP+3+SG
humedecera-vos	humedecer+V.vós.AD.2.PL+PQP+1+SG
humedecera-vos	humedecer+V.vós.AD.2.PL+PQP+3+SG
humedecerde-la	humedecer+V.ele.ACC.3.F.SG+INF+2+PL
humedecerde-la	humedecer+V.ele.ACC.3.F.SG+SBJF+2+PL
humedecerde-las	humedecer+V.ele.ACC.3.F.PL+INF+2+PL
humedecerde-las	humedecer+V.ele.ACC.3.F.PL+SBJF+2+PL
humedecerde-lo	humedecer+V.ele.ACC.3.M.SG+INF+2+PL
humedecerde-lo	humedecer+V.ele.ACC.3.M.SG+SBJF+2+PL
humedecerde-los	humedecer+V.ele.ACC.3.M.PL+INF+2+PL
humedecerde-los	humedecer+V.ele.ACC.3.M.PL+SBJF+2+PL
humedecerde-nos	humedecer+nós.AD.1.PL+INF+2+PL
humedecerde-nos	humedecer+nós.AD.1.PL+SBJF+2+PL
humedecerdes-lhe	humedecer+V.ele.DAT.3.SG+INF+2+PL
humedecerdes-lhe	humedecer+V.ele.DAT.3.SG+SBJF+2+PL
humedecerdes-lhes	humedecer+V.ele.DAT.3.PL+INF+2+PL
humedecerdes-lhes	humedecer+V.ele.DAT.3.PL+SBJF+2+PL
humedecerdes-me	humedecer+V.eu.AD.1.SG+INF+2+PL
humedecerdes-me	humedecer+V.eu.AD.1.SG+SBJF+2+PL
humedecerdes-te	humedecer+V.tu.AD.2.SG+INF+2+PL
humedecerdes-te	humedecer+V.tu.AD.2.SG+SBJF+2+PL
humedecerdes-vos	humedecer+V.vós.AD.2.PL+INF+2+PL
humedecerdes-vos	humedecer+V.vós.AD.2.PL+SBJF+2+PL
humedecêrei-la	humedecer+V.ele.ACC.3.F.SG+PQP+2+PL
humedecêrei-las	humedecer+V.ele.ACC.3.F.PL+PQP+2+PL
humedecêrei-lo	humedecer+V.ele.ACC.3.M.SG+PQP+2+PL
humedecêrei-los	humedecer+V.ele.ACC.3.M.PL+PQP+2+PL
humedecêrei-nos	humedecer+nós.AD.1.PL+PQP+2+PL
humedecêreis-lhe	humedecer+V.ele.DAT.3.SG+PQP+2+PL
humedecêreis-lhes	humedecer+V.ele.DAT.3.PL+PQP+2+PL
humedecêreis-me	humedecer+V.eu.AD.1.SG+PQP+2+PL
humedecêreis-te	humedecer+V.tu.AD.2.SG+PQP+2+PL
humedecêreis-vos	humedecer+V.vós.AD.2.PL+PQP+2+PL
humedecere-la	humedecer+V.ele.ACC.3.F.SG+INF+2+SG
humedecere-la	humedecer+V.ele.ACC.3.F.SG+SBJF+2+SG
humedecere-las	humedecer+V.ele.ACC.3.F.PL+INF+2+SG
humedecere-las	humedecer+V.ele.ACC.3.F.PL+SBJF+2+SG
humedecere-lo	humedecer+V.ele.ACC.3.M.SG+INF+2+SG
humedecere-lo	humedecer+V.ele.ACC.3.M.SG+SBJF+2+SG
humedecere-los	humedecer+V.ele.ACC.3.M.PL+INF+2+SG
humedecere-los	humedecer+V.ele.ACC.3.M.PL+SBJF+2+SG
humedecerem-lhe	humedecer+V.ele.DAT.3.SG+INF+3+PL
humedecerem-lhe	humedecer+V.ele.DAT.3.SG+SBJF+3+PL
humedecerem-lhes	humedecer+V.ele.DAT.3.PL+INF+3+PL
humedecerem-lhes	humedecer+V.ele.DAT.3.PL+SBJF+3+PL
humedecerem-me	humedecer+V.eu.AD.1.SG+INF+3+PL
humedecerem-me	humedecer+V.eu.AD.1.SG+SBJF+3+PL
humedecerem-na	humedecer+V.ele.ACC.3.F.SG+INF+3+PL
humedecerem-na	humedecer+V.ele.ACC.3.F.SG+SBJF+3+PL
humedecerem-nas	humedecer+V.ele.ACC.3.F.PL+INF+3+PL
humedecerem-nas	humedecer+V.ele.ACC.3.F.PL+SBJF+3+PL
humedecerem-no	humedecer+V.ele.ACC.3.M.SG+INF+3+PL
humedecerem-no	humedecer+V.ele.ACC.3.M.SG+SBJF+3+PL
humedecerem-nos	humedecer+V.ele.ACC.3.M.PL+INF+3+PL
humedecerem-nos	humedecer+V.ele.ACC.3.M.PL+SBJF+3+PL
humedecerem-nos	humedecer+V.nós.AD.1.PL+INF+3+PL
humedecerem-nos	humedecer+V.nós.AD.1.PL+SBJF+3+PL
humedecerem-se	humedecer+V.ele.REFL+INF+3+PL
humedecerem-se	humedecer+V.ele.REFL+SBJF+3+PL
humedecerem-te	humedecer+V.tu.AD.2.SG+INF+3+PL
humedecerem-te	humedecer+V.tu.AD.2.SG+SBJF+3+PL
humedecerem-vos	humedecer+V.vós.AD.2.PL+INF+3+PL
humedecerem-vos	humedecer+V.vós.AD.2.PL+SBJF+3+PL
humedecere-nos	humedecer+nós.AD.1.PL+INF+2+SG
humedecere-nos	humedecer+nós.AD.1.PL+SBJF+2+SG
humedeceres-lhe	humedecer+V.ele.DAT.3.SG+INF+2+SG
humedeceres-lhe	humedecer+V.ele.DAT.3.SG+SBJF+2+SG
humedeceres-lhes	humedecer+V.ele.DAT.3.PL+INF+2+SG
humedeceres-lhes	humedecer+V.ele.DAT.3.PL+SBJF+2+SG
humedeceres-me	humedecer+V.eu.AD.1.SG+INF+2+SG
humedeceres-me	humedecer+V.eu.AD.1.SG+SBJF+2+SG
humedeceres-te	humedecer+V.tu.AD.2.SG+INF+2+SG
humedeceres-te	humedecer+V.tu.AD.2.SG+SBJF+2+SG
humedeceres-vos	humedecer+V.vós.AD.2.PL+INF+2+SG
humedeceres-vos	humedecer+V.vós.AD.2.PL+SBJF+2+SG
humedecer-lhe-á	humedecer+V.ele.DAT.3.SG+FUT+3+SG
humedecer-lhe-ão	humedecer+V.ele.DAT.3.SG+FUT+3+PL
humedecer-lhe-ás	humedecer+V.ele.DAT.3.SG+FUT+2+SG
humedecer-lhe-ei	humedecer+V.ele.DAT.3.SG+FUT+1+SG
humedecer-lhe-eis	humedecer+V.ele.DAT.3.SG+FUT+2+PL
humedecer-lhe-emos	humedecer+V.ele.DAT.3.SG+FUT+1+PL
humedecer-lhe	humedecer+V.ele.DAT.3.SG+INF
humedecer-lhe	humedecer+V.ele.DAT.3.SG+INF+1+SG
humedecer-lhe	humedecer+V.ele.DAT.3.SG+INF+3+SG
humedecer-lhe	humedecer+V.ele.DAT.3.SG+SBJF+1+SG
humedecer-lhe	humedecer+V.ele.DAT.3.SG+SBJF+3+SG
humedecer-lhe-ia	humedecer+V.ele.DAT.3.SG+COND+1+SG
humedecer-lhe-ia	humedecer+V.ele.DAT.3.SG+COND+3+SG
humedecer-lhe-iam	humedecer+V.ele.DAT.3.SG+COND+3+PL
humedecer-lhe-íamos	humedecer+V.ele.DAT.3.SG+COND+1+PL
humedecer-lhe-ias	humedecer+V.ele.DAT.3.SG+COND+2+SG
humedecer-lhe-íeis	humedecer+V.ele.DAT.3.SG+COND+2+PL
humedecer-lhes-á	humedecer+V.ele.DAT.3.PL+FUT+3+SG
humedecer-lhes-ão	humedecer+V.ele.DAT.3.PL+FUT+3+PL
humedecer-lhes-ás	humedecer+V.ele.DAT.3.PL+FUT+2+SG
humedecer-lhes-ei	humedecer+V.ele.DAT.3.PL+FUT+1+SG
humedecer-lhes-eis	humedecer+V.ele.DAT.3.PL+FUT+2+PL
humedecer-lhes-emos	humedecer+V.ele.DAT.3.PL+FUT+1+PL
humedecer-lhes	humedecer+V.ele.DAT.3.PL+INF
humedecer-lhes	humedecer+V.ele.DAT.3.PL+INF+1+SG
humedecer-lhes	humedecer+V.ele.DAT.3.PL+INF+3+SG
humedecer-lhes	humedecer+V.ele.DAT.3.PL+SBJF+1+SG
humedecer-lhes	humedecer+V.ele.DAT.3.PL+SBJF+3+SG
humedecer-lhes-ia	humedecer+V.ele.DAT.3.PL+COND+1+SG
humedecer-lhes-ia	humedecer+V.ele.DAT.3.PL+COND+3+SG
humedecer-lhes-iam	humedecer+V.ele.DAT.3.PL+COND+3+PL
humedecer-lhes-íamos	humedecer+V.ele.DAT.3.PL+COND+1+PL
humedecer-lhes-ias	humedecer+V.ele.DAT.3.PL+COND+2+SG
humedecer-lhes-íeis	humedecer+V.ele.DAT.3.PL+COND+2+PL
humedecer-me-á	humedecer+V.eu.AD.1.SG+FUT+3+SG
humedecer-me-ão	humedecer+V.eu.AD.1.SG+FUT+3+PL
humedecer-me-ás	humedecer+V.eu.AD.1.SG+FUT+2+SG
humedecer-me-ei	humedecer+V.eu.AD.1.SG+FUT+1+SG
humedecer-me-eis	humedecer+V.eu.AD.1.SG+FUT+2+PL
humedecer-me-emos	humedecer+V.eu.AD.1.SG+FUT+1+PL
humedecer-me	humedecer+V.eu.AD.1.SG+INF
humedecer-me	humedecer+V.eu.AD.1.SG+INF+1+SG
humedecer-me	humedecer+V.eu.AD.1.SG+INF+3+SG
humedecer-me	humedecer+V.eu.AD.1.SG+SBJF+1+SG
humedecer-me	humedecer+V.eu.AD.1.SG+SBJF+3+SG
humedecer-me-ia	humedecer+V.eu.AD.1.SG+COND+1+SG
humedecer-me-ia	humedecer+V.eu.AD.1.SG+COND+3+SG
humedecer-me-iam	humedecer+V.eu.AD.1.SG+COND+3+PL
humedecer-me-íamos	humedecer+V.eu.AD.1.SG+COND+1+PL
humedecer-me-ias	humedecer+V.eu.AD.1.SG+COND+2+SG
humedecer-me-íeis	humedecer+V.eu.AD.1.SG+COND+2+PL
humedecermo-la	humedecer+V.ele.ACC.3.F.SG+INF+1+PL
humedecermo-la	humedecer+V.ele.ACC.3.F.SG+SBJF+1+PL
humedecermo-las	humedecer+V.ele.ACC.3.F.PL+INF+1+PL
humedecermo-las	humedecer+V.ele.ACC.3.F.PL+SBJF+1+PL
humedecermo-lo	humedecer+V.ele.ACC.3.M.SG+INF+1+PL
humedecermo-lo	humedecer+V.ele.ACC.3.M.SG+SBJF+1+PL
humedecermo-los	humedecer+V.ele.ACC.3.M.PL+INF+1+PL
humedecermo-los	humedecer+V.ele.ACC.3.M.PL+SBJF+1+PL
humedecermo-nos	humedecer+nós.AD.1.PL+INF+1+PL
humedecermo-nos	humedecer+nós.AD.1.PL+SBJF+1+PL
humedecermos-lhe	humedecer+V.ele.DAT.3.SG+INF+1+PL
humedecermos-lhe	humedecer+V.ele.DAT.3.SG+SBJF+1+PL
humedecermos-lhes	humedecer+V.ele.DAT.3.PL+INF+1+PL
humedecermos-lhes	humedecer+V.ele.DAT.3.PL+SBJF+1+PL
humedecermos-me	humedecer+V.eu.AD.1.SG+INF+1+PL
humedecermos-me	humedecer+V.eu.AD.1.SG+SBJF+1+PL
humedecermos-te	humedecer+V.tu.AD.2.SG+INF+1+PL
humedecermos-te	humedecer+V.tu.AD.2.SG+SBJF+1+PL
humedecermos-vos	humedecer+V.vós.AD.2.PL+INF+1+PL
humedecermos-vos	humedecer+V.vós.AD.2.PL+SBJF+1+PL
humedecer-nos-á	humedecer+nós.AD.1.PL+FUT+3+SG
humedecer-nos-ão	humedecer+nós.AD.1.PL+FUT+3+PL
humedecer-nos-ás	humedecer+nós.AD.1.PL+FUT+2+SG
humedecer-nos-ei	humedecer+nós.AD.1.PL+FUT+1+SG
humedecer-nos-eis	humedecer+nós.AD.1.PL+FUT+2+PL
humedecer-nos-emos	humedecer+nós.AD.1.PL+FUT+1+PL
humedecer-nos	humedecer+nós.AD.1.PL+INF
humedecer-nos	humedecer+nós.AD.1.PL+INF+1+SG
humedecer-nos	humedecer+nós.AD.1.PL+INF+3+SG
humedecer-nos	humedecer+nós.AD.1.PL+SBJF+1+SG
humedecer-nos	humedecer+nós.AD.1.PL+SBJF+3+SG
humedecer-nos-ia	humedecer+nós.AD.1.PL+COND+1+SG
humedecer-nos-ia	humedecer+nós.AD.1.PL+COND+3+SG
humedecer-nos-iam	humedecer+nós.AD.1.PL+COND+3+PL
humedecer-nos-íamos	humedecer+nós.AD.1.PL+COND+1+PL
humedecer-nos-ias	humedecer+nós.AD.1.PL+COND+2+SG
humedecer-nos-íeis	humedecer+nós.AD.1.PL+COND+2+PL
humedecer-se-á	humedecer+V.ele.REFL+FUT+3+SG
humedecer-se-ão	humedecer+V.ele.REFL+FUT+3+PL
humedecer-se	humedecer+V.ele.REFL+INF
humedecer-se	humedecer+V.ele.REFL+INF+3+SG
humedecer-se	humedecer+V.ele.REFL+SBJF+3+SG
humedecer-se-ia	humedecer+V.ele.REFL+COND+3+SG
humedecer-se-iam	humedecer+V.ele.REFL+COND+3+PL
humedecer-te-á	humedecer+V.tu.AD.2.SG+FUT+3+SG
humedecer-te-ão	humedecer+V.tu.AD.2.SG+FUT+3+PL
humedecer-te-ás	humedecer+V.tu.AD.2.SG+FUT+2+SG
humedecer-te-ei	humedecer+V.tu.AD.2.SG+FUT+1+SG
humedecer-te-eis	humedecer+V.tu.AD.2.SG+FUT+2+PL
humedecer-te-emos	humedecer+V.tu.AD.2.SG+FUT+1+PL
humedecer-te	humedecer+V.tu.AD.2.SG+INF
humedecer-te	humedecer+V.tu.AD.2.SG+INF+1+SG
humedecer-te	humedecer+V.tu.AD.2.SG+INF+3+SG
humedecer-te	humedecer+V.tu.AD.2.SG+SBJF+1+SG
humedecer-te	humedecer+V.tu.AD.2.SG+SBJF+3+SG
humedecer-te-ia	humedecer+V.tu.AD.2.SG+COND+1+SG
humedecer-te-ia	humedecer+V.tu.AD.2.SG+COND+3+SG
humedecer-te-iam	humedecer+V.tu.AD.2.SG+COND+3+PL
humedecer-te-íamos	humedecer+V.tu.AD.2.SG+COND+1+PL
humedecer-te-ias	humedecer+V.tu.AD.2.SG+COND+2+SG
humedecer-te-íeis	humedecer+V.tu.AD.2.SG+COND+2+PL
humedecer-vos-á	humedecer+V.vós.AD.2.PL+FUT+3+SG
humedecer-vos-ão	humedecer+V.vós.AD.2.PL+FUT+3+PL
humedecer-vos-ás	humedecer+V.vós.AD.2.PL+FUT+2+SG
humedecer-vos-ei	humedecer+V.vós.AD.2.PL+FUT+1+SG
humedecer-vos-eis	humedecer+V.vós.AD.2.PL+FUT+2+PL
humedecer-vos-emos	humedecer+V.vós.AD.2.PL+FUT+1+PL
humedecer-vos	humedecer+V.vós.AD.2.PL+INF
humedecer-vos	humedecer+V.vós.AD.2.PL+INF+1+SG
humedecer-vos	humedecer+V.vós.AD.2.PL+INF+3+SG
humedecer-vos	humedecer+V.vós.AD.2.PL+SBJF+1+SG
humedecer-vos	humedecer+V.vós.AD.2.PL+SBJF+3+SG
humedecer-vos-ia	humedecer+V.vós.AD.2.PL+COND+1+SG
humedecer-vos-ia	humedecer+V.vós.AD.2.PL+COND+3+SG
humedecer-vos-iam	humedecer+V.vós.AD.2.PL+COND+3+PL
humedecer-vos-íamos	humedecer+V.vós.AD.2.PL+COND+1+PL
humedecer-vos-ias	humedecer+V.vós.AD.2.PL+COND+2+SG
humedecer-vos-íeis	humedecer+V.vós.AD.2.PL+COND+2+PL
humedece-se	humedecer+V.ele.REFL+PRS+3+SG
humedeces-lhe	humedecer+V.ele.DAT.3.SG+PRS+2+SG
humedeces-lhes	humedecer+V.ele.DAT.3.PL+PRS+2+SG
humedeces-me	humedecer+V.eu.AD.1.SG+PRS+2+SG
humedeceste-a	humedecer+V.ele.ACC.3.F.SG+PRF+2+SG
humedeceste-as	humedecer+V.ele.ACC.3.F.PL+PRF+2+SG
humedeces-te	humedecer+V.tu.AD.2.SG+PRS+2+SG
humedeceste-la	humedecer+V.ele.ACC.3.F.SG+PRF+2+PL
humedeceste-las	humedecer+V.ele.ACC.3.F.PL+PRF+2+PL
humedeceste-lhe	humedecer+V.ele.DAT.3.SG+PRF+2+SG
humedeceste-lhes	humedecer+V.ele.DAT.3.PL+PRF+2+SG
humedeceste-lo	humedecer+V.ele.ACC.3.M.SG+PRF+2+PL
humedeceste-los	humedecer+V.ele.ACC.3.M.PL+PRF+2+PL
humedeceste-me	humedecer+V.eu.AD.1.SG+PRF+2+SG
humedeceste-nos	humedecer+nós.AD.1.PL+PRF+2+PL
humedeceste-nos	humedecer+nós.AD.1.PL+PRF+2+SG
humedeceste-o	humedecer+V.ele.ACC.3.M.SG+PRF+2+SG
humedeceste-os	humedecer+V.ele.ACC.3.M.PL+PRF+2+SG
humedecestes-lhe	humedecer+V.ele.DAT.3.SG+PRF+2+PL
humedecestes-lhes	humedecer+V.ele.DAT.3.PL+PRF+2+PL
humedecestes-me	humedecer+V.eu.AD.1.SG+PRF+2+PL
humedecestes-te	humedecer+V.tu.AD.2.SG+PRF+2+PL
humedecestes-vos	humedecer+V.vós.AD.2.PL+PRF+2+PL
humedeceste-te	humedecer+V.tu.AD.2.SG+PRF+2+SG
humedeceste-vos	humedecer+V.vós.AD.2.PL+PRF+2+SG
humedeces-vos	humedecer+V.vós.AD.2.PL+PRS+2+SG
humedeceu-a	humedecer+V.ele.ACC.3.F.SG+PRF+3+SG
humedeceu-as	humedecer+V.ele.ACC.3.F.PL+PRF+3+SG
humedeceu-lhe	humedecer+V.ele.DAT.3.SG+PRF+3+SG
humedeceu-lhes	humedecer+V.ele.DAT.3.PL+PRF+3+SG
humedeceu-me	humedecer+V.eu.AD.1.SG+PRF+3+SG
humedeceu-nos	humedecer+nós.AD.1.PL+PRF+3+SG
humedeceu-o	humedecer+V.ele.ACC.3.M.SG+PRF+3+SG
humedeceu-os	humedecer+V.ele.ACC.3.M.PL+PRF+3+SG
humedeceu-se	humedecer+V.ele.REFL+PRF+3+SG
humedeceu-te	humedecer+V.tu.AD.2.SG+PRF+3+SG
humedeceu-vos	humedecer+V.vós.AD.2.PL+PRF+3+SG
humedecia-a	humedecer+V.ele.ACC.3.F.SG+IMPF+1+SG
humedecia-a	humedecer+V.ele.ACC.3.F.SG+IMPF+3+SG
humedecia-as	humedecer+V.ele.ACC.3.F.PL+IMPF+1+SG
humedecia-as	humedecer+V.ele.ACC.3.F.PL+IMPF+3+SG
humedeci-a	humedecer+V.ele.ACC.3.F.SG+PRF+1+SG
humedecia-la	humedecer+V.ele.ACC.3.F.SG+IMPF+2+SG
humedecia-las	humedecer+V.ele.ACC.3.F.PL+IMPF+2+SG
humedecia-lhe	humedecer+V.ele.DAT.3.SG+IMPF+1+SG
humedecia-lhe	humedecer+V.ele.DAT.3.SG+IMPF+3+SG
humedecia-lhes	humedecer+V.ele.DAT.3.PL+IMPF+1+SG
humedecia-lhes	humedecer+V.ele.DAT.3.PL+IMPF+3+SG
humedecia-lo	humedecer+V.ele.ACC.3.M.SG+IMPF+2+SG
humedecia-los	humedecer+V.ele.ACC.3.M.PL+IMPF+2+SG
humedecia-me	humedecer+V.eu.AD.1.SG+IMPF+1+SG
humedecia-me	humedecer+V.eu.AD.1.SG+IMPF+3+SG
humedeciam-lhe	humedecer+V.ele.DAT.3.SG+IMPF+3+PL
humedeciam-lhes	humedecer+V.ele.DAT.3.PL+IMPF+3+PL
humedeciam-me	humedecer+V.eu.AD.1.SG+IMPF+3+PL
humedeciam-na	humedecer+V.ele.ACC.3.F.SG+IMPF+3+PL
humedeciam-nas	humedecer+V.ele.ACC.3.F.PL+IMPF+3+PL
humedeciam-no	humedecer+V.ele.ACC.3.M.SG+IMPF+3+PL
humedeciam-nos	humedecer+V.ele.ACC.3.M.PL+IMPF+3+PL
humedeciam-nos	humedecer+V.nós.AD.1.PL+IMPF+3+PL
humedecíamo-la	humedecer+V.ele.ACC.3.F.SG+IMPF+1+PL
humedecíamo-las	humedecer+V.ele.ACC.3.F.PL+IMPF+1+PL
humedecíamo-lo	humedecer+V.ele.ACC.3.M.SG+IMPF+1+PL
humedecíamo-los	humedecer+V.ele.ACC.3.M.PL+IMPF+1+PL
humedecíamo-nos	humedecer+nós.AD.1.PL+IMPF+1+PL
humedecíamos-lhe	humedecer+V.ele.DAT.3.SG+IMPF+1+PL
humedecíamos-lhes	humedecer+V.ele.DAT.3.PL+IMPF+1+PL
humedecíamos-me	humedecer+V.eu.AD.1.SG+IMPF+1+PL
humedecíamos-te	humedecer+V.tu.AD.2.SG+IMPF+1+PL
humedecíamos-vos	humedecer+V.vós.AD.2.PL+IMPF+1+PL
humedeciam-se	humedecer+V.ele.REFL+IMPF+3+PL
humedeciam-te	humedecer+V.tu.AD.2.SG+IMPF+3+PL
humedeciam-vos	humedecer+V.vós.AD.2.PL+IMPF+3+PL
humedecia-nos	humedecer+nós.AD.1.PL+IMPF+1+SG
humedecia-nos	humedecer+nós.AD.1.PL+IMPF+2+SG
humedecia-nos	humedecer+nós.AD.1.PL+IMPF+3+SG
humedecia-o	humedecer+V.ele.ACC.3.M.SG+IMPF+1+SG
humedecia-o	humedecer+V.ele.ACC.3.M.SG+IMPF+3+SG
humedecia-os	humedecer+V.ele.ACC.3.M.PL+IMPF+1+SG
humedecia-os	humedecer+V.ele.ACC.3.M.PL+IMPF+3+SG
humedecia-se	humedecer+V.ele.REFL+IMPF+3+SG
humedeci-as	humedecer+V.ele.ACC.3.F.PL+PRF+1+SG
humedecias-lhe	humedecer+V.ele.DAT.3.SG+IMPF+2+SG
humedecias-lhes	humedecer+V.ele.DAT.3.PL+IMPF+2+SG
humedecias-me	humedecer+V.eu.AD.1.SG+IMPF+2+SG
humedecias-te	humedecer+V.tu.AD.2.SG+IMPF+2+SG
humedecias-vos	humedecer+V.vós.AD.2.PL+IMPF+2+SG
humedecia-te	humedecer+V.tu.AD.2.SG+IMPF+1+SG
humedecia-te	humedecer+V.tu.AD.2.SG+IMPF+3+SG
humedecia-vos	humedecer+V.vós.AD.2.PL+IMPF+1+SG
humedecia-vos	humedecer+V.vós.AD.2.PL+IMPF+3+SG
humedecíei-la	humedecer+V.ele.ACC.3.F.SG+IMPF+2+PL
humedecíei-las	humedecer+V.ele.ACC.3.F.PL+IMPF+2+PL
humedecíei-lo	humedecer+V.ele.ACC.3.M.SG+IMPF+2+PL
humedecíei-los	humedecer+V.ele.ACC.3.M.PL+IMPF+2+PL
humedecíei-nos	humedecer+nós.AD.1.PL+IMPF+2+PL
humedecíeis-lhe	humedecer+V.ele.DAT.3.SG+IMPF+2+PL
humedecíeis-lhes	humedecer+V.ele.DAT.3.PL+IMPF+2+PL
humedecíeis-me	humedecer+V.eu.AD.1.SG+IMPF+2+PL
humedecíeis-te	humedecer+V.tu.AD.2.SG+IMPF+2+PL
humedecíeis-vos	humedecer+V.vós.AD.2.PL+IMPF+2+PL
humedeci-lhe	humedecer+V.ele.DAT.3.SG+PRF+1+SG
humedeci-lhes	humedecer+V.ele.DAT.3.PL+PRF+1+SG
humedeci-me	humedecer+V.eu.AD.1.SG+PRF+1+SG
humedeci-nos	humedecer+nós.AD.1.PL+PRF+1+SG
humedeci-o	humedecer+V.ele.ACC.3.M.SG+PRF+1+SG
humedeci-os	humedecer+V.ele.ACC.3.M.PL+PRF+1+SG
humedeci-te	humedecer+V.tu.AD.2.SG+PRF+1+SG
humedeci-vos	humedecer+V.vós.AD.2.PL+PRF+1+SG
humedeço-a	humedecer+V.ele.ACC.3.F.SG+PRS+1+SG
humedeço-as	humedecer+V.ele.ACC.3.F.PL+PRS+1+SG
humedeço-lhe	humedecer+V.ele.DAT.3.SG+PRS+1+SG
humedeço-lhes	humedecer+V.ele.DAT.3.PL+PRS+1+SG
humedeço-me	humedecer+V.eu.AD.1.SG+PRS+1+SG
humedeço-nos	humedecer+nós.AD.1.PL+PRS+1+SG
humedeço-o	humedecer+V.ele.ACC.3.M.SG+PRS+1+SG
humedeço-os	humedecer+V.ele.ACC.3.M.PL+PRS+1+SG
humedeço-te	humedecer+V.tu.AD.2.SG+PRS+1+SG
humedeço-vos	humedecer+V.vós.AD.2.PL+PRS+1+SG
humidifica-a	humidificar+V.ele.ACC.3.F.SG+PRS+3+SG
humidifica-as	humidificar+V.ele.ACC.3.F.PL+PRS+3+SG
humidificai-la	humidificar+V.ele.ACC.3.F.SG+PRS+2+PL
humidificai-las	humidificar+V.ele.ACC.3.F.PL+PRS+2+PL
humidificai-lo	humidificar+V.ele.ACC.3.M.SG+PRS+2+PL
humidificai-los	humidificar+V.ele.ACC.3.M.PL+PRS+2+PL
humidificai-nos	humidificar+nós.AD.1.PL+PRS+2+PL
humidificais-lhe	humidificar+V.ele.DAT.3.SG+PRS+2+PL
humidificais-lhes	humidificar+V.ele.DAT.3.PL+PRS+2+PL
humidificais-me	humidificar+V.eu.AD.1.SG+PRS+2+PL
humidificais-te	humidificar+V.tu.AD.2.SG+PRS+2+PL
humidificais-vos	humidificar+V.vós.AD.2.PL+PRS+2+PL
humidificá-la-á	humidificar+V.ele.ACC.3.F.SG+FUT+3+SG
humidificá-la-ão	humidificar+V.ele.ACC.3.F.SG+FUT+3+PL
humidificá-la-ás	humidificar+V.ele.ACC.3.F.SG+FUT+2+SG
humidificá-la-ei	humidificar+V.ele.ACC.3.F.SG+FUT+1+SG
humidificá-la-eis	humidificar+V.ele.ACC.3.F.SG+FUT+2+PL
humidificá-la-emos	humidificar+V.ele.ACC.3.F.SG+FUT+1+PL
humidificá-la	humidificar+V.ele.ACC.3.F.SG+INF+1+SG
humidificá-la	humidificar+V.ele.ACC.3.F.SG+INF+3+SG
humidifica-la	humidificar+V.ele.ACC.3.F.SG+PRS+2+SG
humidificá-la	humidificar+V.ele.ACC.3.F.SG+SBJF+1+SG
humidificá-la	humidificar+V.ele.ACC.3.F.SG+SBJF+3+SG
humidificá-la-ia	humidificar+V.ele.ACC.3.F.SG+COND+1+SG
humidificá-la-ia	humidificar+V.ele.ACC.3.F.SG+COND+3+SG
humidificá-la-iam	humidificar+V.ele.ACC.3.F.SG+COND+3+PL
humidificá-la-íamos	humidificar+V.ele.ACC.3.F.SG+COND+1+PL
humidificá-la-ias	humidificar+V.ele.ACC.3.F.SG+COND+2+SG
humidificá-la-íeis	humidificar+V.ele.ACC.3.F.SG+COND+2+PL
humidificá-las-á	humidificar+V.ele.ACC.3.F.PL+FUT+3+SG
humidificá-las-ão	humidificar+V.ele.ACC.3.F.PL+FUT+3+PL
humidificá-las-ás	humidificar+V.ele.ACC.3.F.PL+FUT+2+SG
humidificá-las-ei	humidificar+V.ele.ACC.3.F.PL+FUT+1+SG
humidificá-las-eis	humidificar+V.ele.ACC.3.F.PL+FUT+2+PL
humidificá-las-emos	humidificar+V.ele.ACC.3.F.PL+FUT+1+PL
humidificá-las	humidificar+V.ele.ACC.3.F.PL+INF+1+SG
humidificá-las	humidificar+V.ele.ACC.3.F.PL+INF+3+SG
humidifica-las	humidificar+V.ele.ACC.3.F.PL+PRS+2+SG
humidificá-las	humidificar+V.ele.ACC.3.F.PL+SBJF+1+SG
humidificá-las	humidificar+V.ele.ACC.3.F.PL+SBJF+3+SG
humidificá-las-ia	humidificar+V.ele.ACC.3.F.PL+COND+1+SG
humidificá-las-ia	humidificar+V.ele.ACC.3.F.PL+COND+3+SG
humidificá-las-iam	humidificar+V.ele.ACC.3.F.PL+COND+3+PL
humidificá-las-íamos	humidificar+V.ele.ACC.3.F.PL+COND+1+PL
humidificá-las-ias	humidificar+V.ele.ACC.3.F.PL+COND+2+SG
humidificá-las-íeis	humidificar+V.ele.ACC.3.F.PL+COND+2+PL
humidifica-lhe	humidificar+V.ele.DAT.3.SG+PRS+3+SG
humidifica-lhes	humidificar+V.ele.DAT.3.PL+PRS+3+SG
humidificá-lo-á	humidificar+V.ele.ACC.3.M.SG+FUT+3+SG
humidificá-lo-ão	humidificar+V.ele.ACC.3.M.SG+FUT+3+PL
humidificá-lo-ás	humidificar+V.ele.ACC.3.M.SG+FUT+2+SG
humidificá-lo-ei	humidificar+V.ele.ACC.3.M.SG+FUT+1+SG
humidificá-lo-eis	humidificar+V.ele.ACC.3.M.SG+FUT+2+PL
humidificá-lo-emos	humidificar+V.ele.ACC.3.M.SG+FUT+1+PL
humidificá-lo	humidificar+V.ele.ACC.3.M.SG+INF+1+SG
humidificá-lo	humidificar+V.ele.ACC.3.M.SG+INF+3+SG
humidifica-lo	humidificar+V.ele.ACC.3.M.SG+PRS+2+SG
humidificá-lo	humidificar+V.ele.ACC.3.M.SG+SBJF+1+SG
humidificá-lo	humidificar+V.ele.ACC.3.M.SG+SBJF+3+SG
humidificá-lo-ia	humidificar+V.ele.ACC.3.M.SG+COND+1+SG
humidificá-lo-ia	humidificar+V.ele.ACC.3.M.SG+COND+3+SG
humidificá-lo-iam	humidificar+V.ele.ACC.3.M.SG+COND+3+PL
humidificá-lo-íamos	humidificar+V.ele.ACC.3.M.SG+COND+1+PL
humidificá-lo-ias	humidificar+V.ele.ACC.3.M.SG+COND+2+SG
humidificá-lo-íeis	humidificar+V.ele.ACC.3.M.SG+COND+2+PL
humidificá-los-á	humidificar+V.ele.ACC.3.M.PL+FUT+3+SG
humidificá-los-ão	humidificar+V.ele.ACC.3.M.PL+FUT+3+PL
humidificá-los-ás	humidificar+V.ele.ACC.3.M.PL+FUT+2+SG
humidificá-los-ei	humidificar+V.ele.ACC.3.M.PL+FUT+1+SG
humidificá-los-eis	humidificar+V.ele.ACC.3.M.PL+FUT+2+PL
humidificá-los-emos	humidificar+V.ele.ACC.3.M.PL+FUT+1+PL
humidificá-los	humidificar+V.ele.ACC.3.M.PL+INF+1+SG
humidificá-los	humidificar+V.ele.ACC.3.M.PL+INF+3+SG
humidifica-los	humidificar+V.ele.ACC.3.M.PL+PRS+2+SG
humidificá-los	humidificar+V.ele.ACC.3.M.PL+SBJF+1+SG
humidificá-los	humidificar+V.ele.ACC.3.M.PL+SBJF+3+SG
humidificá-los-ia	humidificar+V.ele.ACC.3.M.PL+COND+1+SG
humidificá-los-ia	humidificar+V.ele.ACC.3.M.PL+COND+3+SG
humidificá-los-iam	humidificar+V.ele.ACC.3.M.PL+COND+3+PL
humidificá-los-íamos	humidificar+V.ele.ACC.3.M.PL+COND+1+PL
humidificá-los-ias	humidificar+V.ele.ACC.3.M.PL+COND+2+SG
humidificá-los-íeis	humidificar+V.ele.ACC.3.M.PL+COND+2+PL
humidifica-me	humidificar+V.eu.AD.1.SG+PRS+3+SG
humidificam-lhe	humidificar+V.ele.DAT.3.SG+PRS+3+PL
humidificam-lhes	humidificar+V.ele.DAT.3.PL+PRS+3+PL
humidificam-me	humidificar+V.eu.AD.1.SG+PRS+3+PL
humidificam-na	humidificar+V.ele.ACC.3.F.SG+PRS+3+PL
humidificam-nas	humidificar+V.ele.ACC.3.F.PL+PRS+3+PL
humidificam-no	humidificar+V.ele.ACC.3.M.SG+PRS+3+PL
humidificam-nos	humidificar+V.ele.ACC.3.M.PL+PRS+3+PL
humidificam-nos	humidificar+V.nós.AD.1.PL+PRS+3+PL
humidificamo-la	humidificar+V.ele.ACC.3.F.SG+PRF+1+PL
humidificamo-la	humidificar+V.ele.ACC.3.F.SG+PRS+1+PL
humidificamo-las	humidificar+V.ele.ACC.3.F.PL+PRF+1+PL
humidificamo-las	humidificar+V.ele.ACC.3.F.PL+PRS+1+PL
humidificamo-lo	humidificar+V.ele.ACC.3.M.SG+PRF+1+PL
humidificamo-lo	humidificar+V.ele.ACC.3.M.SG+PRS+1+PL
humidificamo-los	humidificar+V.ele.ACC.3.M.PL+PRF+1+PL
humidificamo-los	humidificar+V.ele.ACC.3.M.PL+PRS+1+PL
humidificamo-nos	humidificar+nós.AD.1.PL+PRF+1+PL
humidificamo-nos	humidificar+nós.AD.1.PL+PRS+1+PL
humidificamos-lhe	humidificar+V.ele.DAT.3.SG+PRF+1+PL
humidificamos-lhe	humidificar+V.ele.DAT.3.SG+PRS+1+PL
humidificamos-lhes	humidificar+V.ele.DAT.3.PL+PRF+1+PL
humidificamos-lhes	humidificar+V.ele.DAT.3.PL+PRS+1+PL
humidificamos-me	humidificar+V.eu.AD.1.SG+PRF+1+PL
humidificamos-me	humidificar+V.eu.AD.1.SG+PRS+1+PL
humidificamos-te	humidificar+V.tu.AD.2.SG+PRF+1+PL
humidificamos-te	humidificar+V.tu.AD.2.SG+PRS+1+PL
humidificamos-vos	humidificar+V.vós.AD.2.PL+PRF+1+PL
humidificamos-vos	humidificar+V.vós.AD.2.PL+PRS+1+PL
humidificam-se	humidificar+V.ele.REFL+PRS+3+PL
humidificam-te	humidificar+V.tu.AD.2.SG+PRS+3+PL
humidificam-vos	humidificar+V.vós.AD.2.PL+PRS+3+PL
humidificando-a	humidificar+V.ele.ACC.3.F.SG+GRD
humidificando-as	humidificar+V.ele.ACC.3.F.PL+GRD
humidificando-lhe	humidificar+V.ele.DAT.3.SG+GRD
humidificando-lhes	humidificar+V.ele.DAT.3.PL+GRD
humidificando-me	humidificar+V.eu.AD.1.SG+GRD
humidificando-nos	humidificar+nós.AD.1.PL+GRD
humidificando-o	humidificar+V.ele.ACC.3.M.SG+GRD
humidificando-os	humidificar+V.ele.ACC.3.M.PL+GRD
humidificando-se	humidificar+V.ele.REFL+GRD
humidificando-te	humidificar+V.tu.AD.2.SG+GRD
humidificando-vos	humidificar+V.vós.AD.2.PL+GRD
humidifica-nos	humidificar+nós.AD.1.PL+PRS+2+SG
humidifica-nos	humidificar+nós.AD.1.PL+PRS+3+SG
humidifica-o	humidificar+V.ele.ACC.3.M.SG+PRS+3+SG
humidifica-os	humidificar+V.ele.ACC.3.M.PL+PRS+3+SG
humidificara-a	humidificar+V.ele.ACC.3.F.SG+PQP+1+SG
humidificara-a	humidificar+V.ele.ACC.3.F.SG+PQP+3+SG
humidificara-as	humidificar+V.ele.ACC.3.F.PL+PQP+1+SG
humidificara-as	humidificar+V.ele.ACC.3.F.PL+PQP+3+SG
humidificara-la	humidificar+V.ele.ACC.3.F.SG+PQP+2+SG
humidificara-las	humidificar+V.ele.ACC.3.F.PL+PQP+2+SG
humidificara-lhe	humidificar+V.ele.DAT.3.SG+PQP+1+SG
humidificara-lhe	humidificar+V.ele.DAT.3.SG+PQP+3+SG
humidificara-lhes	humidificar+V.ele.DAT.3.PL+PQP+1+SG
humidificara-lhes	humidificar+V.ele.DAT.3.PL+PQP+3+SG
humidificara-lo	humidificar+V.ele.ACC.3.M.SG+PQP+2+SG
humidificara-los	humidificar+V.ele.ACC.3.M.PL+PQP+2+SG
humidificara-me	humidificar+V.eu.AD.1.SG+PQP+1+SG
humidificara-me	humidificar+V.eu.AD.1.SG+PQP+3+SG
humidificaram-lhe	humidificar+V.ele.DAT.3.SG+PQP+3+PL
humidificaram-lhe	humidificar+V.ele.DAT.3.SG+PRF+3+PL
humidificaram-lhes	humidificar+V.ele.DAT.3.PL+PQP+3+PL
humidificaram-lhes	humidificar+V.ele.DAT.3.PL+PRF+3+PL
humidificaram-me	humidificar+V.eu.AD.1.SG+PQP+3+PL
humidificaram-me	humidificar+V.eu.AD.1.SG+PRF+3+PL
humidificaram-na	humidificar+V.ele.ACC.3.F.SG+PQP+3+PL
humidificaram-na	humidificar+V.ele.ACC.3.F.SG+PRF+3+PL
humidificaram-nas	humidificar+V.ele.ACC.3.F.PL+PQP+3+PL
humidificaram-nas	humidificar+V.ele.ACC.3.F.PL+PRF+3+PL
humidificaram-no	humidificar+V.ele.ACC.3.M.SG+PQP+3+PL
humidificaram-no	humidificar+V.ele.ACC.3.M.SG+PRF+3+PL
humidificaram-nos	humidificar+V.ele.ACC.3.M.PL+PQP+3+PL
humidificaram-nos	humidificar+V.ele.ACC.3.M.PL+PRF+3+PL
humidificaram-nos	humidificar+V.nós.AD.1.PL+PQP+3+PL
humidificaram-nos	humidificar+V.nós.AD.1.PL+PRF+3+PL
humidificáramo-la	humidificar+V.ele.ACC.3.F.SG+PQP+1+PL
humidificáramo-las	humidificar+V.ele.ACC.3.F.PL+PQP+1+PL
humidificáramo-lo	humidificar+V.ele.ACC.3.M.SG+PQP+1+PL
humidificáramo-los	humidificar+V.ele.ACC.3.M.PL+PQP+1+PL
humidificáramo-nos	humidificar+nós.AD.1.PL+PQP+1+PL
humidificáramos-lhe	humidificar+V.ele.DAT.3.SG+PQP+1+PL
humidificáramos-lhes	humidificar+V.ele.DAT.3.PL+PQP+1+PL
humidificáramos-me	humidificar+V.eu.AD.1.SG+PQP+1+PL
humidificáramos-te	humidificar+V.tu.AD.2.SG+PQP+1+PL
humidificáramos-vos	humidificar+V.vós.AD.2.PL+PQP+1+PL
humidificaram-se	humidificar+V.ele.REFL+PQP+3+PL
humidificaram-se	humidificar+V.ele.REFL+PRF+3+PL
humidificaram-te	humidificar+V.tu.AD.2.SG+PQP+3+PL
humidificaram-te	humidificar+V.tu.AD.2.SG+PRF+3+PL
humidificaram-vos	humidificar+V.vós.AD.2.PL+PQP+3+PL
humidificaram-vos	humidificar+V.vós.AD.2.PL+PRF+3+PL
humidificara-nos	humidificar+nós.AD.1.PL+PQP+1+SG
humidificara-nos	humidificar+nós.AD.1.PL+PQP+2+SG
humidificara-nos	humidificar+nós.AD.1.PL+PQP+3+SG
humidificara-o	humidificar+V.ele.ACC.3.M.SG+PQP+1+SG
humidificara-o	humidificar+V.ele.ACC.3.M.SG+PQP+3+SG
humidificara-os	humidificar+V.ele.ACC.3.M.PL+PQP+1+SG
humidificara-os	humidificar+V.ele.ACC.3.M.PL+PQP+3+SG
humidificara-se	humidificar+V.ele.REFL+PQP+1+SG
humidificara-se	humidificar+V.ele.REFL+PQP+3+SG
humidificaras-lhe	humidificar+V.ele.DAT.3.SG+PQP+2+SG
humidificaras-lhes	humidificar+V.ele.DAT.3.PL+PQP+2+SG
humidificaras-me	humidificar+V.eu.AD.1.SG+PQP+2+SG
humidificaras-te	humidificar+V.tu.AD.2.SG+PQP+2+SG
humidificaras-vos	humidificar+V.vós.AD.2.PL+PQP+2+SG
humidificara-te	humidificar+V.tu.AD.2.SG+PQP+1+SG
humidificara-te	humidificar+V.tu.AD.2.SG+PQP+3+SG
humidificara-vos	humidificar+V.vós.AD.2.PL+PQP+1+SG
humidificara-vos	humidificar+V.vós.AD.2.PL+PQP+3+SG
humidificarde-la	humidificar+V.ele.ACC.3.F.SG+INF+2+PL
humidificarde-la	humidificar+V.ele.ACC.3.F.SG+SBJF+2+PL
humidificarde-las	humidificar+V.ele.ACC.3.F.PL+INF+2+PL
humidificarde-las	humidificar+V.ele.ACC.3.F.PL+SBJF+2+PL
humidificarde-lo	humidificar+V.ele.ACC.3.M.SG+INF+2+PL
humidificarde-lo	humidificar+V.ele.ACC.3.M.SG+SBJF+2+PL
humidificarde-los	humidificar+V.ele.ACC.3.M.PL+INF+2+PL
humidificarde-los	humidificar+V.ele.ACC.3.M.PL+SBJF+2+PL
humidificarde-nos	humidificar+nós.AD.1.PL+INF+2+PL
