insipidavam-nas	insipidar+V.ele.ACC.3.F.PL+IMPF+3+PL
insipidavam-no	insipidar+V.ele.ACC.3.M.SG+IMPF+3+PL
insipidavam-nos	insipidar+V.ele.ACC.3.M.PL+IMPF+3+PL
insipidavam-nos	insipidar+V.nós.AD.1.PL+IMPF+3+PL
insipidávamo-la	insipidar+V.ele.ACC.3.F.SG+IMPF+1+PL
insipidávamo-las	insipidar+V.ele.ACC.3.F.PL+IMPF+1+PL
insipidávamo-lo	insipidar+V.ele.ACC.3.M.SG+IMPF+1+PL
insipidávamo-los	insipidar+V.ele.ACC.3.M.PL+IMPF+1+PL
insipidávamo-nos	insipidar+nós.AD.1.PL+IMPF+1+PL
insipidávamos-lhe	insipidar+V.ele.DAT.3.SG+IMPF+1+PL
insipidávamos-lhes	insipidar+V.ele.DAT.3.PL+IMPF+1+PL
insipidávamos-me	insipidar+V.eu.AD.1.SG+IMPF+1+PL
insipidávamos-te	insipidar+V.tu.AD.2.SG+IMPF+1+PL
insipidávamos-vos	insipidar+V.vós.AD.2.PL+IMPF+1+PL
insipidavam-se	insipidar+V.ele.REFL+IMPF+3+PL
insipidavam-te	insipidar+V.tu.AD.2.SG+IMPF+3+PL
insipidavam-vos	insipidar+V.vós.AD.2.PL+IMPF+3+PL
insipidava-nos	insipidar+nós.AD.1.PL+IMPF+1+SG
insipidava-nos	insipidar+nós.AD.1.PL+IMPF+2+SG
insipidava-nos	insipidar+nós.AD.1.PL+IMPF+3+SG
insipidava-o	insipidar+V.ele.ACC.3.M.SG+IMPF+1+SG
insipidava-o	insipidar+V.ele.ACC.3.M.SG+IMPF+3+SG
insipidava-os	insipidar+V.ele.ACC.3.M.PL+IMPF+1+SG
insipidava-os	insipidar+V.ele.ACC.3.M.PL+IMPF+3+SG
insipidava-se	insipidar+V.ele.REFL+IMPF+1+SG
insipidava-se	insipidar+V.ele.REFL+IMPF+3+SG
insipidavas-lhe	insipidar+V.ele.DAT.3.SG+IMPF+2+SG
insipidavas-lhes	insipidar+V.ele.DAT.3.PL+IMPF+2+SG
insipidavas-me	insipidar+V.eu.AD.1.SG+IMPF+2+SG
insipidavas-te	insipidar+V.tu.AD.2.SG+IMPF+2+SG
insipidavas-vos	insipidar+V.vós.AD.2.PL+IMPF+2+SG
insipidava-te	insipidar+V.tu.AD.2.SG+IMPF+1+SG
insipidava-te	insipidar+V.tu.AD.2.SG+IMPF+3+SG
insipidava-vos	insipidar+V.vós.AD.2.PL+IMPF+1+SG
insipidava-vos	insipidar+V.vós.AD.2.PL+IMPF+3+SG
insipidávei-la	insipidar+V.ele.ACC.3.F.SG+IMPF+2+PL
insipidávei-las	insipidar+V.ele.ACC.3.F.PL+IMPF+2+PL
insipidávei-lo	insipidar+V.ele.ACC.3.M.SG+IMPF+2+PL
insipidávei-los	insipidar+V.ele.ACC.3.M.PL+IMPF+2+PL
insipidávei-nos	insipidar+nós.AD.1.PL+IMPF+2+PL
insipidáveis-lhe	insipidar+V.ele.DAT.3.SG+IMPF+2+PL
insipidáveis-lhes	insipidar+V.ele.DAT.3.PL+IMPF+2+PL
insipidáveis-me	insipidar+V.eu.AD.1.SG+IMPF+2+PL
insipidáveis-te	insipidar+V.tu.AD.2.SG+IMPF+2+PL
insipidáveis-vos	insipidar+V.vós.AD.2.PL+IMPF+2+PL
insipida-vos	insipidar+V.vós.AD.2.PL+PRS+3+SG
insipide-a	insipidar+V.ele.ACC.3.F.SG+IMP+3+SG
insipide-as	insipidar+V.ele.ACC.3.F.PL+IMP+3+SG
insipidei-a	insipidar+V.ele.ACC.3.F.SG+PRF+1+SG
insipidei-as	insipidar+V.ele.ACC.3.F.PL+PRF+1+SG
insipidei-lhe	insipidar+V.ele.DAT.3.SG+PRF+1+SG
insipidei-lhes	insipidar+V.ele.DAT.3.PL+PRF+1+SG
insipidei-me	insipidar+V.eu.AD.1.SG+PRF+1+SG
insipidei-nos	insipidar+nós.AD.1.PL+PRF+1+SG
insipidei-o	insipidar+V.ele.ACC.3.M.SG+PRF+1+SG
insipidei-os	insipidar+V.ele.ACC.3.M.PL+PRF+1+SG
insipidei-te	insipidar+V.tu.AD.2.SG+PRF+1+SG
insipidei-vos	insipidar+V.vós.AD.2.PL+PRF+1+SG
insipide-lhe	insipidar+V.ele.DAT.3.SG+IMP+3+SG
insipide-lhes	insipidar+V.ele.DAT.3.PL+IMP+3+SG
insipide-me	insipidar+V.eu.AD.1.SG+IMP+3+SG
insipidem-lhe	insipidar+V.ele.DAT.3.SG+IMP+3+PL
insipidem-lhes	insipidar+V.ele.DAT.3.PL+IMP+3+PL
insipidem-me	insipidar+V.eu.AD.1.SG+IMP+3+PL
insipidem-na	insipidar+V.ele.ACC.3.F.SG+IMP+3+PL
insipidem-nas	insipidar+V.ele.ACC.3.F.PL+IMP+3+PL
insipidem-no	insipidar+V.ele.ACC.3.M.SG+IMP+3+PL
insipidem-nos	insipidar+V.ele.ACC.3.M.PL+IMP+3+PL
insipidem-nos	insipidar+V.nós.AD.1.PL+IMP+3+PL
insipidemo-la	insipidar+V.ele.ACC.3.F.SG+IMP+1+PL
insipidemo-las	insipidar+V.ele.ACC.3.F.PL+IMP+1+PL
insipidemo-lo	insipidar+V.ele.ACC.3.M.SG+IMP+1+PL
insipidemo-los	insipidar+V.ele.ACC.3.M.PL+IMP+1+PL
insipidemo-nos	insipidar+nós.AD.1.PL+IMP+1+PL
insipidemos-lhe	insipidar+V.ele.DAT.3.SG+IMP+1+PL
insipidemos-lhes	insipidar+V.ele.DAT.3.PL+IMP+1+PL
insipidemos-me	insipidar+V.eu.AD.1.SG+IMP+1+PL
insipidemos-te	insipidar+V.tu.AD.2.SG+IMP+1+PL
insipidemos-vos	insipidar+V.vós.AD.2.PL+IMP+1+PL
insipidem-se	insipidar+V.ele.REFL+IMP+3+PL
insipidem-te	insipidar+V.tu.AD.2.SG+IMP+3+PL
insipidem-vos	insipidar+V.vós.AD.2.PL+IMP+3+PL
insipide-nos	insipidar+nós.AD.1.PL+IMP+3+SG
insipide-o	insipidar+V.ele.ACC.3.M.SG+IMP+3+SG
insipide-os	insipidar+V.ele.ACC.3.M.PL+IMP+3+SG
insipide-se	insipidar+V.ele.REFL+IMP+3+SG
insipide-te	insipidar+V.tu.AD.2.SG+IMP+3+SG
insipide-vos	insipidar+V.vós.AD.2.PL+IMP+3+SG
insipido-a	insipidar+V.ele.ACC.3.F.SG+PRS+1+SG
insipido-as	insipidar+V.ele.ACC.3.F.PL+PRS+1+SG
insipido-lhe	insipidar+V.ele.DAT.3.SG+PRS+1+SG
insipido-lhes	insipidar+V.ele.DAT.3.PL+PRS+1+SG
insipido-me	insipidar+V.eu.AD.1.SG+PRS+1+SG
insipido-nos	insipidar+nós.AD.1.PL+PRS+1+SG
insipido-o	insipidar+V.ele.ACC.3.M.SG+PRS+1+SG
insipido-os	insipidar+V.ele.ACC.3.M.PL+PRS+1+SG
insipido-te	insipidar+V.tu.AD.2.SG+PRS+1+SG
insipidou-a	insipidar+V.ele.ACC.3.F.SG+PRF+3+SG
insipidou-as	insipidar+V.ele.ACC.3.F.PL+PRF+3+SG
insipidou-lhe	insipidar+V.ele.DAT.3.SG+PRF+3+SG
insipidou-lhes	insipidar+V.ele.DAT.3.PL+PRF+3+SG
insipidou-me	insipidar+V.eu.AD.1.SG+PRF+3+SG
insipidou-nos	insipidar+nós.AD.1.PL+PRF+3+SG
insipidou-o	insipidar+V.ele.ACC.3.M.SG+PRF+3+SG
insipidou-os	insipidar+V.ele.ACC.3.M.PL+PRF+3+SG
insipidou-se	insipidar+V.ele.REFL+PRF+3+SG
insipidou-te	insipidar+V.tu.AD.2.SG+PRF+3+SG
insipidou-vos	insipidar+V.vós.AD.2.PL+PRF+3+SG
insipido-vos	insipidar+V.vós.AD.2.PL+PRS+1+SG
insira-a	inserir+V.ele.ACC.3.F.SG+IMP+3+SG
insira-as	inserir+V.ele.ACC.3.F.PL+IMP+3+SG
insira-lhe	inserir+V.ele.DAT.3.SG+IMP+3+SG
insira-lhes	inserir+V.ele.DAT.3.PL+IMP+3+SG
insira-me	inserir+V.eu.AD.1.SG+IMP+3+SG
insiram-lhe	inserir+V.ele.DAT.3.SG+IMP+3+PL
insiram-lhes	inserir+V.ele.DAT.3.PL+IMP+3+PL
insiram-me	inserir+V.eu.AD.1.SG+IMP+3+PL
insiram-na	inserir+V.ele.ACC.3.F.SG+IMP+3+PL
insiram-nas	inserir+V.ele.ACC.3.F.PL+IMP+3+PL
insiram-no	inserir+V.ele.ACC.3.M.SG+IMP+3+PL
insiram-nos	inserir+V.ele.ACC.3.M.PL+IMP+3+PL
insiram-nos	inserir+V.nós.AD.1.PL+IMP+3+PL
insiramo-la	inserir+V.ele.ACC.3.F.SG+IMP+1+PL
insiramo-las	inserir+V.ele.ACC.3.F.PL+IMP+1+PL
insiramo-lo	inserir+V.ele.ACC.3.M.SG+IMP+1+PL
insiramo-los	inserir+V.ele.ACC.3.M.PL+IMP+1+PL
insiramo-nos	inserir+nós.AD.1.PL+IMP+1+PL
insiramos-lhe	inserir+V.ele.DAT.3.SG+IMP+1+PL
insiramos-lhes	inserir+V.ele.DAT.3.PL+IMP+1+PL
insiramos-me	inserir+V.eu.AD.1.SG+IMP+1+PL
insiramos-te	inserir+V.tu.AD.2.SG+IMP+1+PL
insiramos-vos	inserir+V.vós.AD.2.PL+IMP+1+PL
insiram-se	inserir+V.ele.REFL+IMP+3+PL
insiram-te	inserir+V.tu.AD.2.SG+IMP+3+PL
insiram-vos	inserir+V.vós.AD.2.PL+IMP+3+PL
insira-nos	inserir+nós.AD.1.PL+IMP+3+SG
insira-o	inserir+V.ele.ACC.3.M.SG+IMP+3+SG
insira-os	inserir+V.ele.ACC.3.M.PL+IMP+3+SG
insira-se	inserir+V.ele.REFL+IMP+3+SG
insira-te	inserir+V.tu.AD.2.SG+IMP+3+SG
insira-vos	inserir+V.vós.AD.2.PL+IMP+3+SG
insiro-a	inserir+V.ele.ACC.3.F.SG+PRS+1+SG
insiro-as	inserir+V.ele.ACC.3.F.PL+PRS+1+SG
insiro-lhe	inserir+V.ele.DAT.3.SG+PRS+1+SG
insiro-lhes	inserir+V.ele.DAT.3.PL+PRS+1+SG
insiro-me	inserir+V.eu.AD.1.SG+PRS+1+SG
insiro-nos	inserir+nós.AD.1.PL+PRS+1+SG
insiro-o	inserir+V.ele.ACC.3.M.SG+PRS+1+SG
insiro-os	inserir+V.ele.ACC.3.M.PL+PRS+1+SG
insiro-te	inserir+V.tu.AD.2.SG+PRS+1+SG
insiro-vos	inserir+V.vós.AD.2.PL+PRS+1+SG
insista-a	insistir+V.ele.ACC.3.F.SG+IMP+3+SG
insista-as	insistir+V.ele.ACC.3.F.PL+IMP+3+SG
insista-lhe	insistir+V.ele.DAT.3.SG+IMP+3+SG
insista-lhes	insistir+V.ele.DAT.3.PL+IMP+3+SG
insista-me	insistir+V.eu.AD.1.SG+IMP+3+SG
insistam-lhe	insistir+V.ele.DAT.3.SG+IMP+3+PL
insistam-lhes	insistir+V.ele.DAT.3.PL+IMP+3+PL
insistam-me	insistir+V.eu.AD.1.SG+IMP+3+PL
insistam-na	insistir+V.ele.ACC.3.F.SG+IMP+3+PL
insistam-nas	insistir+V.ele.ACC.3.F.PL+IMP+3+PL
insistam-no	insistir+V.ele.ACC.3.M.SG+IMP+3+PL
insistam-nos	insistir+V.ele.ACC.3.M.PL+IMP+3+PL
insistam-nos	insistir+V.nós.AD.1.PL+IMP+3+PL
insistamo-la	insistir+V.ele.ACC.3.F.SG+IMP+1+PL
insistamo-las	insistir+V.ele.ACC.3.F.PL+IMP+1+PL
insistamo-lo	insistir+V.ele.ACC.3.M.SG+IMP+1+PL
insistamo-los	insistir+V.ele.ACC.3.M.PL+IMP+1+PL
insistamo-nos	insistir+nós.AD.1.PL+IMP+1+PL
insistamos-lhe	insistir+V.ele.DAT.3.SG+IMP+1+PL
insistamos-lhes	insistir+V.ele.DAT.3.PL+IMP+1+PL
insistamos-me	insistir+V.eu.AD.1.SG+IMP+1+PL
insistamos-te	insistir+V.tu.AD.2.SG+IMP+1+PL
insistamos-vos	insistir+V.vós.AD.2.PL+IMP+1+PL
insistam-se	insistir+V.ele.REFL+IMP+3+PL
insistam-te	insistir+V.tu.AD.2.SG+IMP+3+PL
insistam-vos	insistir+V.vós.AD.2.PL+IMP+3+PL
insista-nos	insistir+nós.AD.1.PL+IMP+3+SG
insista-o	insistir+V.ele.ACC.3.M.SG+IMP+3+SG
insista-os	insistir+V.ele.ACC.3.M.PL+IMP+3+SG
insista-se	insistir+V.ele.REFL+IMP+3+SG
insista-te	insistir+V.tu.AD.2.SG+IMP+3+SG
insista-vos	insistir+V.vós.AD.2.PL+IMP+3+SG
insistia-a	insistir+V.ele.ACC.3.F.SG+IMPF+1+SG
insistia-a	insistir+V.ele.ACC.3.F.SG+IMPF+3+SG
insistia-as	insistir+V.ele.ACC.3.F.PL+IMPF+1+SG
insistia-as	insistir+V.ele.ACC.3.F.PL+IMPF+3+SG
insisti-a	insistir+V.ele.ACC.3.F.SG+PRF+1+SG
insistia-la	insistir+V.ele.ACC.3.F.SG+IMPF+2+SG
insistia-las	insistir+V.ele.ACC.3.F.PL+IMPF+2+SG
insistia-lhe	insistir+V.ele.DAT.3.SG+IMPF+1+SG
insistia-lhe	insistir+V.ele.DAT.3.SG+IMPF+3+SG
insistia-lhes	insistir+V.ele.DAT.3.PL+IMPF+1+SG
insistia-lhes	insistir+V.ele.DAT.3.PL+IMPF+3+SG
insistia-lo	insistir+V.ele.ACC.3.M.SG+IMPF+2+SG
insistia-los	insistir+V.ele.ACC.3.M.PL+IMPF+2+SG
insistia-me	insistir+V.eu.AD.1.SG+IMPF+1+SG
insistia-me	insistir+V.eu.AD.1.SG+IMPF+3+SG
insistiam-lhe	insistir+V.ele.DAT.3.SG+IMPF+3+PL
insistiam-lhes	insistir+V.ele.DAT.3.PL+IMPF+3+PL
insistiam-me	insistir+V.eu.AD.1.SG+IMPF+3+PL
insistiam-na	insistir+V.ele.ACC.3.F.SG+IMPF+3+PL
insistiam-nas	insistir+V.ele.ACC.3.F.PL+IMPF+3+PL
insistiam-no	insistir+V.ele.ACC.3.M.SG+IMPF+3+PL
insistiam-nos	insistir+V.ele.ACC.3.M.PL+IMPF+3+PL
insistiam-nos	insistir+V.nós.AD.1.PL+IMPF+3+PL
insistíamo-la	insistir+V.ele.ACC.3.F.SG+IMPF+1+PL
insistíamo-las	insistir+V.ele.ACC.3.F.PL+IMPF+1+PL
insistíamo-lo	insistir+V.ele.ACC.3.M.SG+IMPF+1+PL
insistíamo-los	insistir+V.ele.ACC.3.M.PL+IMPF+1+PL
insistíamo-nos	insistir+nós.AD.1.PL+IMPF+1+PL
insistíamos-lhe	insistir+V.ele.DAT.3.SG+IMPF+1+PL
insistíamos-lhes	insistir+V.ele.DAT.3.PL+IMPF+1+PL
insistíamos-me	insistir+V.eu.AD.1.SG+IMPF+1+PL
insistíamos-te	insistir+V.tu.AD.2.SG+IMPF+1+PL
insistíamos-vos	insistir+V.vós.AD.2.PL+IMPF+1+PL
insistiam-se	insistir+V.ele.REFL+IMPF+3+PL
insistiam-te	insistir+V.tu.AD.2.SG+IMPF+3+PL
insistiam-vos	insistir+V.vós.AD.2.PL+IMPF+3+PL
insistia-nos	insistir+nós.AD.1.PL+IMPF+1+SG
insistia-nos	insistir+nós.AD.1.PL+IMPF+2+SG
insistia-nos	insistir+nós.AD.1.PL+IMPF+3+SG
insistia-o	insistir+V.ele.ACC.3.M.SG+IMPF+1+SG
insistia-o	insistir+V.ele.ACC.3.M.SG+IMPF+3+SG
insistia-os	insistir+V.ele.ACC.3.M.PL+IMPF+1+SG
insistia-os	insistir+V.ele.ACC.3.M.PL+IMPF+3+SG
insistia-se	insistir+V.ele.REFL+IMPF+3+SG
insisti-as	insistir+V.ele.ACC.3.F.PL+PRF+1+SG
insistias-lhe	insistir+V.ele.DAT.3.SG+IMPF+2+SG
insistias-lhes	insistir+V.ele.DAT.3.PL+IMPF+2+SG
insistias-me	insistir+V.eu.AD.1.SG+IMPF+2+SG
insistias-te	insistir+V.tu.AD.2.SG+IMPF+2+SG
insistias-vos	insistir+V.vós.AD.2.PL+IMPF+2+SG
insistia-te	insistir+V.tu.AD.2.SG+IMPF+1+SG
insistia-te	insistir+V.tu.AD.2.SG+IMPF+3+SG
insistia-vos	insistir+V.vós.AD.2.PL+IMPF+1+SG
insistia-vos	insistir+V.vós.AD.2.PL+IMPF+3+SG
insistíei-la	insistir+V.ele.ACC.3.F.SG+IMPF+2+PL
insistíei-las	insistir+V.ele.ACC.3.F.PL+IMPF+2+PL
insistíei-lo	insistir+V.ele.ACC.3.M.SG+IMPF+2+PL
insistíei-los	insistir+V.ele.ACC.3.M.PL+IMPF+2+PL
insistíei-nos	insistir+nós.AD.1.PL+IMPF+2+PL
insistíeis-lhe	insistir+V.ele.DAT.3.SG+IMPF+2+PL
insistíeis-lhes	insistir+V.ele.DAT.3.PL+IMPF+2+PL
insistíeis-me	insistir+V.eu.AD.1.SG+IMPF+2+PL
insistíeis-te	insistir+V.tu.AD.2.SG+IMPF+2+PL
insistíeis-vos	insistir+V.vós.AD.2.PL+IMPF+2+PL
insisti-la-á	insistir+V.ele.ACC.3.F.SG+FUT+3+SG
insisti-la-ão	insistir+V.ele.ACC.3.F.SG+FUT+3+PL
insisti-la-ás	insistir+V.ele.ACC.3.F.SG+FUT+2+SG
insisti-la-ei	insistir+V.ele.ACC.3.F.SG+FUT+1+SG
insisti-la-eis	insistir+V.ele.ACC.3.F.SG+FUT+2+PL
insisti-la-emos	insistir+V.ele.ACC.3.F.SG+FUT+1+PL
insisti-la-ia	insistir+V.ele.ACC.3.F.SG+COND+1+SG
insisti-la-ia	insistir+V.ele.ACC.3.F.SG+COND+3+SG
insisti-la-iam	insistir+V.ele.ACC.3.F.SG+COND+3+PL
insisti-la-íamos	insistir+V.ele.ACC.3.F.SG+COND+1+PL
insisti-la-ias	insistir+V.ele.ACC.3.F.SG+COND+2+SG
insisti-la-íeis	insistir+V.ele.ACC.3.F.SG+COND+2+PL
insisti-la	insistir+V.ele.ACC.3.F.SG+INF+1+SG
insisti-la	insistir+V.ele.ACC.3.F.SG+INF+3+SG
insisti-la	insistir+V.ele.ACC.3.F.SG+SBJF+1+SG
insisti-la	insistir+V.ele.ACC.3.F.SG+SBJF+3+SG
insisti-las-á	insistir+V.ele.ACC.3.F.PL+FUT+3+SG
insisti-las-ão	insistir+V.ele.ACC.3.F.PL+FUT+3+PL
insisti-las-ás	insistir+V.ele.ACC.3.F.PL+FUT+2+SG
insisti-las-ei	insistir+V.ele.ACC.3.F.PL+FUT+1+SG
insisti-las-eis	insistir+V.ele.ACC.3.F.PL+FUT+2+PL
insisti-las-emos	insistir+V.ele.ACC.3.F.PL+FUT+1+PL
insisti-las-ia	insistir+V.ele.ACC.3.F.PL+COND+1+SG
insisti-las-ia	insistir+V.ele.ACC.3.F.PL+COND+3+SG
insisti-las-iam	insistir+V.ele.ACC.3.F.PL+COND+3+PL
insisti-las-íamos	insistir+V.ele.ACC.3.F.PL+COND+1+PL
insisti-las-ias	insistir+V.ele.ACC.3.F.PL+COND+2+SG
insisti-las-íeis	insistir+V.ele.ACC.3.F.PL+COND+2+PL
insisti-las	insistir+V.ele.ACC.3.F.PL+INF+1+SG
insisti-las	insistir+V.ele.ACC.3.F.PL+INF+3+SG
insisti-las	insistir+V.ele.ACC.3.F.PL+SBJF+1+SG
insisti-las	insistir+V.ele.ACC.3.F.PL+SBJF+3+SG
insisti-lhe	insistir+V.ele.DAT.3.SG+PRF+1+SG
insisti-lhes	insistir+V.ele.DAT.3.PL+PRF+1+SG
insisti-lo-á	insistir+V.ele.ACC.3.M.SG+FUT+3+SG
insisti-lo-ão	insistir+V.ele.ACC.3.M.SG+FUT+3+PL
insisti-lo-ás	insistir+V.ele.ACC.3.M.SG+FUT+2+SG
insisti-lo-ei	insistir+V.ele.ACC.3.M.SG+FUT+1+SG
insisti-lo-eis	insistir+V.ele.ACC.3.M.SG+FUT+2+PL
insisti-lo-emos	insistir+V.ele.ACC.3.M.SG+FUT+1+PL
insisti-lo-ia	insistir+V.ele.ACC.3.M.SG+COND+1+SG
insisti-lo-ia	insistir+V.ele.ACC.3.M.SG+COND+3+SG
insisti-lo-iam	insistir+V.ele.ACC.3.M.SG+COND+3+PL
insisti-lo-íamos	insistir+V.ele.ACC.3.M.SG+COND+1+PL
insisti-lo-ias	insistir+V.ele.ACC.3.M.SG+COND+2+SG
insisti-lo-íeis	insistir+V.ele.ACC.3.M.SG+COND+2+PL
insisti-lo	insistir+V.ele.ACC.3.M.SG+INF+1+SG
insisti-lo	insistir+V.ele.ACC.3.M.SG+INF+3+SG
insisti-lo	insistir+V.ele.ACC.3.M.SG+SBJF+1+SG
insisti-lo	insistir+V.ele.ACC.3.M.SG+SBJF+3+SG
insisti-los-á	insistir+V.ele.ACC.3.M.PL+FUT+3+SG
insisti-los-ão	insistir+V.ele.ACC.3.M.PL+FUT+3+PL
insisti-los-ás	insistir+V.ele.ACC.3.M.PL+FUT+2+SG
insisti-los-ei	insistir+V.ele.ACC.3.M.PL+FUT+1+SG
insisti-los-eis	insistir+V.ele.ACC.3.M.PL+FUT+2+PL
insisti-los-emos	insistir+V.ele.ACC.3.M.PL+FUT+1+PL
insisti-los-ia	insistir+V.ele.ACC.3.M.PL+COND+1+SG
insisti-los-ia	insistir+V.ele.ACC.3.M.PL+COND+3+SG
insisti-los-iam	insistir+V.ele.ACC.3.M.PL+COND+3+PL
insisti-los-íamos	insistir+V.ele.ACC.3.M.PL+COND+1+PL
insisti-los-ias	insistir+V.ele.ACC.3.M.PL+COND+2+SG
insisti-los-íeis	insistir+V.ele.ACC.3.M.PL+COND+2+PL
insisti-los	insistir+V.ele.ACC.3.M.PL+INF+1+SG
insisti-los	insistir+V.ele.ACC.3.M.PL+INF+3+SG
insisti-los	insistir+V.ele.ACC.3.M.PL+SBJF+1+SG
insisti-los	insistir+V.ele.ACC.3.M.PL+SBJF+3+SG
insisti-me	insistir+V.eu.AD.1.SG+PRF+1+SG
insistimo-la	insistir+V.ele.ACC.3.F.SG+PRF+1+PL
insistimo-las	insistir+V.ele.ACC.3.F.PL+PRF+1+PL
insistimo-lo	insistir+V.ele.ACC.3.M.SG+PRF+1+PL
insistimo-los	insistir+V.ele.ACC.3.M.PL+PRF+1+PL
insistimo-nos	insistir+nós.AD.1.PL+PRF+1+PL
insistimos-lhe	insistir+V.ele.DAT.3.SG+PRF+1+PL
insistimos-lhes	insistir+V.ele.DAT.3.PL+PRF+1+PL
insistimos-me	insistir+V.eu.AD.1.SG+PRF+1+PL
insistimos-te	insistir+V.tu.AD.2.SG+PRF+1+PL
insistimos-vos	insistir+V.vós.AD.2.PL+PRF+1+PL
insistindo-a	insistir+V.ele.ACC.3.F.SG+GRD
insistindo-as	insistir+V.ele.ACC.3.F.PL+GRD
insistindo-lhe	insistir+V.ele.DAT.3.SG+GRD
insistindo-lhes	insistir+V.ele.DAT.3.PL+GRD
insistindo-me	insistir+V.eu.AD.1.SG+GRD
insistindo-nos	insistir+nós.AD.1.PL+GRD
insistindo-o	insistir+V.ele.ACC.3.M.SG+GRD
insistindo-os	insistir+V.ele.ACC.3.M.PL+GRD
insistindo-se	insistir+V.ele.REFL+GRD
insistindo-te	insistir+V.tu.AD.2.SG+GRD
insistindo-vos	insistir+V.vós.AD.2.PL+GRD
insisti-nos	insistir+nós.AD.1.PL+PRF+1+SG
insisti-o	insistir+V.ele.ACC.3.M.SG+PRF+1+SG
insisti-os	insistir+V.ele.ACC.3.M.PL+PRF+1+SG
insistiram-lhe	insistir+V.ele.DAT.3.SG+PRF+3+PL
insistiram-lhes	insistir+V.ele.DAT.3.PL+PRF+3+PL
insistiram-me	insistir+V.eu.AD.1.SG+PRF+3+PL
insistiram-na	insistir+V.ele.ACC.3.F.SG+PRF+3+PL
insistiram-nas	insistir+V.ele.ACC.3.F.PL+PRF+3+PL
insistiram-no	insistir+V.ele.ACC.3.M.SG+PRF+3+PL
insistiram-nos	insistir+V.ele.ACC.3.M.PL+PRF+3+PL
insistiram-nos	insistir+V.nós.AD.1.PL+PRF+3+PL
insistiram-se	insistir+V.ele.REFL+PRF+3+PL
insistiram-te	insistir+V.tu.AD.2.SG+PRF+3+PL
insistiram-vos	insistir+V.vós.AD.2.PL+PRF+3+PL
insistirde-la	insistir+V.ele.ACC.3.F.SG+INF+2+PL
insistirde-la	insistir+V.ele.ACC.3.F.SG+SBJF+2+PL
insistirde-las	insistir+V.ele.ACC.3.F.PL+INF+2+PL
insistirde-las	insistir+V.ele.ACC.3.F.PL+SBJF+2+PL
insistirde-lo	insistir+V.ele.ACC.3.M.SG+INF+2+PL
insistirde-lo	insistir+V.ele.ACC.3.M.SG+SBJF+2+PL
insistirde-los	insistir+V.ele.ACC.3.M.PL+INF+2+PL
insistirde-los	insistir+V.ele.ACC.3.M.PL+SBJF+2+PL
insistirde-nos	insistir+nós.AD.1.PL+INF+2+PL
insistirde-nos	insistir+nós.AD.1.PL+SBJF+2+PL
insistirdes-lhe	insistir+V.ele.DAT.3.SG+INF+2+PL
insistirdes-lhe	insistir+V.ele.DAT.3.SG+SBJF+2+PL
insistirdes-lhes	insistir+V.ele.DAT.3.PL+INF+2+PL
insistirdes-lhes	insistir+V.ele.DAT.3.PL+SBJF+2+PL
insistirdes-me	insistir+V.eu.AD.1.SG+INF+2+PL
insistirdes-me	insistir+V.eu.AD.1.SG+SBJF+2+PL
insistirdes-te	insistir+V.tu.AD.2.SG+INF+2+PL
insistirdes-te	insistir+V.tu.AD.2.SG+SBJF+2+PL
insistirdes-vos	insistir+V.vós.AD.2.PL+INF+2+PL
insistirdes-vos	insistir+V.vós.AD.2.PL+SBJF+2+PL
insistire-la	insistir+V.ele.ACC.3.F.SG+INF+2+SG
insistire-la	insistir+V.ele.ACC.3.F.SG+SBJF+2+SG
insistire-las	insistir+V.ele.ACC.3.F.PL+INF+2+SG
insistire-las	insistir+V.ele.ACC.3.F.PL+SBJF+2+SG
insistire-lo	insistir+V.ele.ACC.3.M.SG+INF+2+SG
insistire-lo	insistir+V.ele.ACC.3.M.SG+SBJF+2+SG
insistire-los	insistir+V.ele.ACC.3.M.PL+INF+2+SG
insistire-los	insistir+V.ele.ACC.3.M.PL+SBJF+2+SG
insistirem-lhe	insistir+V.ele.DAT.3.SG+INF+3+PL
insistirem-lhe	insistir+V.ele.DAT.3.SG+SBJF+3+PL
insistirem-lhes	insistir+V.ele.DAT.3.PL+INF+3+PL
insistirem-lhes	insistir+V.ele.DAT.3.PL+SBJF+3+PL
insistirem-me	insistir+V.eu.AD.1.SG+INF+3+PL
insistirem-me	insistir+V.eu.AD.1.SG+SBJF+3+PL
insistirem-na	insistir+V.ele.ACC.3.F.SG+INF+3+PL
insistirem-na	insistir+V.ele.ACC.3.F.SG+SBJF+3+PL
insistirem-nas	insistir+V.ele.ACC.3.F.PL+INF+3+PL
insistirem-nas	insistir+V.ele.ACC.3.F.PL+SBJF+3+PL
insistirem-no	insistir+V.ele.ACC.3.M.SG+INF+3+PL
insistirem-no	insistir+V.ele.ACC.3.M.SG+SBJF+3+PL
insistirem-nos	insistir+V.ele.ACC.3.M.PL+INF+3+PL
insistirem-nos	insistir+V.ele.ACC.3.M.PL+SBJF+3+PL
insistirem-nos	insistir+V.nós.AD.1.PL+INF+3+PL
insistirem-nos	insistir+V.nós.AD.1.PL+SBJF+3+PL
insistirem-se	insistir+V.ele.REFL+INF+3+PL
insistirem-se	insistir+V.ele.REFL+SBJF+3+PL
insistirem-te	insistir+V.tu.AD.2.SG+INF+3+PL
insistirem-te	insistir+V.tu.AD.2.SG+SBJF+3+PL
insistirem-vos	insistir+V.vós.AD.2.PL+INF+3+PL
insistirem-vos	insistir+V.vós.AD.2.PL+SBJF+3+PL
insistire-nos	insistir+nós.AD.1.PL+INF+2+SG
insistire-nos	insistir+nós.AD.1.PL+SBJF+2+SG
insistires-lhe	insistir+V.ele.DAT.3.SG+INF+2+SG
insistires-lhe	insistir+V.ele.DAT.3.SG+SBJF+2+SG
insistires-lhes	insistir+V.ele.DAT.3.PL+INF+2+SG
insistires-lhes	insistir+V.ele.DAT.3.PL+SBJF+2+SG
insistires-me	insistir+V.eu.AD.1.SG+INF+2+SG
insistires-me	insistir+V.eu.AD.1.SG+SBJF+2+SG
insistires-te	insistir+V.tu.AD.2.SG+INF+2+SG
insistires-te	insistir+V.tu.AD.2.SG+SBJF+2+SG
insistires-vos	insistir+V.vós.AD.2.PL+INF+2+SG
insistires-vos	insistir+V.vós.AD.2.PL+SBJF+2+SG
insistir-lhe-á	insistir+V.ele.DAT.3.SG+FUT+3+SG
insistir-lhe-ão	insistir+V.ele.DAT.3.SG+FUT+3+PL
insistir-lhe-ás	insistir+V.ele.DAT.3.SG+FUT+2+SG
insistir-lhe-ei	insistir+V.ele.DAT.3.SG+FUT+1+SG
insistir-lhe-eis	insistir+V.ele.DAT.3.SG+FUT+2+PL
insistir-lhe-emos	insistir+V.ele.DAT.3.SG+FUT+1+PL
insistir-lhe-ia	insistir+V.ele.DAT.3.SG+COND+1+SG
insistir-lhe-ia	insistir+V.ele.DAT.3.SG+COND+3+SG
insistir-lhe-iam	insistir+V.ele.DAT.3.SG+COND+3+PL
insistir-lhe-íamos	insistir+V.ele.DAT.3.SG+COND+1+PL
insistir-lhe-ias	insistir+V.ele.DAT.3.SG+COND+2+SG
insistir-lhe-íeis	insistir+V.ele.DAT.3.SG+COND+2+PL
insistir-lhe	insistir+V.ele.DAT.3.SG+INF
insistir-lhe	insistir+V.ele.DAT.3.SG+INF+1+SG
insistir-lhe	insistir+V.ele.DAT.3.SG+INF+3+SG
insistir-lhe	insistir+V.ele.DAT.3.SG+SBJF+1+SG
insistir-lhe	insistir+V.ele.DAT.3.SG+SBJF+3+SG
insistir-lhes-á	insistir+V.ele.DAT.3.PL+FUT+3+SG
insistir-lhes-ão	insistir+V.ele.DAT.3.PL+FUT+3+PL
insistir-lhes-ás	insistir+V.ele.DAT.3.PL+FUT+2+SG
insistir-lhes-ei	insistir+V.ele.DAT.3.PL+FUT+1+SG
insistir-lhes-eis	insistir+V.ele.DAT.3.PL+FUT+2+PL
insistir-lhes-emos	insistir+V.ele.DAT.3.PL+FUT+1+PL
insistir-lhes-ia	insistir+V.ele.DAT.3.PL+COND+1+SG
insistir-lhes-ia	insistir+V.ele.DAT.3.PL+COND+3+SG
insistir-lhes-iam	insistir+V.ele.DAT.3.PL+COND+3+PL
insistir-lhes-íamos	insistir+V.ele.DAT.3.PL+COND+1+PL
insistir-lhes-ias	insistir+V.ele.DAT.3.PL+COND+2+SG
insistir-lhes-íeis	insistir+V.ele.DAT.3.PL+COND+2+PL
insistir-lhes	insistir+V.ele.DAT.3.PL+INF
insistir-lhes	insistir+V.ele.DAT.3.PL+INF+1+SG
insistir-lhes	insistir+V.ele.DAT.3.PL+INF+3+SG
insistir-lhes	insistir+V.ele.DAT.3.PL+SBJF+1+SG
insistir-lhes	insistir+V.ele.DAT.3.PL+SBJF+3+SG
insistir-me-á	insistir+V.eu.AD.1.SG+FUT+3+SG
insistir-me-ão	insistir+V.eu.AD.1.SG+FUT+3+PL
insistir-me-ás	insistir+V.eu.AD.1.SG+FUT+2+SG
insistir-me-ei	insistir+V.eu.AD.1.SG+FUT+1+SG
insistir-me-eis	insistir+V.eu.AD.1.SG+FUT+2+PL
insistir-me-emos	insistir+V.eu.AD.1.SG+FUT+1+PL
insistir-me-ia	insistir+V.eu.AD.1.SG+COND+1+SG
insistir-me-ia	insistir+V.eu.AD.1.SG+COND+3+SG
insistir-me-iam	insistir+V.eu.AD.1.SG+COND+3+PL
insistir-me-íamos	insistir+V.eu.AD.1.SG+COND+1+PL
insistir-me-ias	insistir+V.eu.AD.1.SG+COND+2+SG
insistir-me-íeis	insistir+V.eu.AD.1.SG+COND+2+PL
insistir-me	insistir+V.eu.AD.1.SG+INF
insistir-me	insistir+V.eu.AD.1.SG+INF+1+SG
insistir-me	insistir+V.eu.AD.1.SG+INF+3+SG
insistir-me	insistir+V.eu.AD.1.SG+SBJF+1+SG
insistir-me	insistir+V.eu.AD.1.SG+SBJF+3+SG
insistirmo-la	insistir+V.ele.ACC.3.F.SG+INF+1+PL
insistirmo-la	insistir+V.ele.ACC.3.F.SG+SBJF+1+PL
insistirmo-las	insistir+V.ele.ACC.3.F.PL+INF+1+PL
insistirmo-las	insistir+V.ele.ACC.3.F.PL+SBJF+1+PL
insistirmo-lo	insistir+V.ele.ACC.3.M.SG+INF+1+PL
insistirmo-lo	insistir+V.ele.ACC.3.M.SG+SBJF+1+PL
insistirmo-los	insistir+V.ele.ACC.3.M.PL+INF+1+PL
insistirmo-los	insistir+V.ele.ACC.3.M.PL+SBJF+1+PL
insistirmo-nos	insistir+nós.AD.1.PL+INF+1+PL
insistirmo-nos	insistir+nós.AD.1.PL+SBJF+1+PL
insistirmos-lhe	insistir+V.ele.DAT.3.SG+INF+1+PL
insistirmos-lhe	insistir+V.ele.DAT.3.SG+SBJF+1+PL
insistirmos-lhes	insistir+V.ele.DAT.3.PL+INF+1+PL
insistirmos-lhes	insistir+V.ele.DAT.3.PL+SBJF+1+PL
insistirmos-me	insistir+V.eu.AD.1.SG+INF+1+PL
insistirmos-me	insistir+V.eu.AD.1.SG+SBJF+1+PL
insistirmos-te	insistir+V.tu.AD.2.SG+INF+1+PL
insistirmos-te	insistir+V.tu.AD.2.SG+SBJF+1+PL
insistirmos-vos	insistir+V.vós.AD.2.PL+INF+1+PL
insistirmos-vos	insistir+V.vós.AD.2.PL+SBJF+1+PL
insistir-nos-á	insistir+nós.AD.1.PL+FUT+3+SG
insistir-nos-ão	insistir+nós.AD.1.PL+FUT+3+PL
insistir-nos-ás	insistir+nós.AD.1.PL+FUT+2+SG
insistir-nos-ei	insistir+nós.AD.1.PL+FUT+1+SG
insistir-nos-eis	insistir+nós.AD.1.PL+FUT+2+PL
insistir-nos-emos	insistir+nós.AD.1.PL+FUT+1+PL
insistir-nos-ia	insistir+nós.AD.1.PL+COND+1+SG
insistir-nos-ia	insistir+nós.AD.1.PL+COND+3+SG
insistir-nos-iam	insistir+nós.AD.1.PL+COND+3+PL
insistir-nos-íamos	insistir+nós.AD.1.PL+COND+1+PL
insistir-nos-ias	insistir+nós.AD.1.PL+COND+2+SG
insistir-nos-íeis	insistir+nós.AD.1.PL+COND+2+PL
insistir-nos	insistir+nós.AD.1.PL+INF
insistir-nos	insistir+nós.AD.1.PL+INF+1+SG
insistir-nos	insistir+nós.AD.1.PL+INF+3+SG
insistir-nos	insistir+nós.AD.1.PL+SBJF+1+SG
insistir-nos	insistir+nós.AD.1.PL+SBJF+3+SG
insistir-se-á	insistir+V.ele.REFL+FUT+3+SG
insistir-se-ão	insistir+V.ele.REFL+FUT+3+PL
insistir-se-ia	insistir+V.ele.REFL+COND+3+SG
insistir-se-iam	insistir+V.ele.REFL+COND+3+PL
insistir-se	insistir+V.ele.REFL+INF
insistir-se	insistir+V.ele.REFL+INF+3+SG
insistir-se	insistir+V.ele.REFL+SBJF+3+SG
insistir-te-á	insistir+V.tu.AD.2.SG+FUT+3+SG
insistir-te-ão	insistir+V.tu.AD.2.SG+FUT+3+PL
insistir-te-ás	insistir+V.tu.AD.2.SG+FUT+2+SG
insistir-te-ei	insistir+V.tu.AD.2.SG+FUT+1+SG
insistir-te-eis	insistir+V.tu.AD.2.SG+FUT+2+PL
insistir-te-emos	insistir+V.tu.AD.2.SG+FUT+1+PL
insistir-te-ia	insistir+V.tu.AD.2.SG+COND+1+SG
insistir-te-ia	insistir+V.tu.AD.2.SG+COND+3+SG
insistir-te-iam	insistir+V.tu.AD.2.SG+COND+3+PL
insistir-te-íamos	insistir+V.tu.AD.2.SG+COND+1+PL
insistir-te-ias	insistir+V.tu.AD.2.SG+COND+2+SG
insistir-te-íeis	insistir+V.tu.AD.2.SG+COND+2+PL
insistir-te	insistir+V.tu.AD.2.SG+INF
insistir-te	insistir+V.tu.AD.2.SG+INF+1+SG
insistir-te	insistir+V.tu.AD.2.SG+INF+3+SG
insistir-te	insistir+V.tu.AD.2.SG+SBJF+1+SG
insistir-te	insistir+V.tu.AD.2.SG+SBJF+3+SG
insistir-vos-á	insistir+V.vós.AD.2.PL+FUT+3+SG
insistir-vos-ão	insistir+V.vós.AD.2.PL+FUT+3+PL
insistir-vos-ás	insistir+V.vós.AD.2.PL+FUT+2+SG
insistir-vos-ei	insistir+V.vós.AD.2.PL+FUT+1+SG
insistir-vos-eis	insistir+V.vós.AD.2.PL+FUT+2+PL
insistir-vos-emos	insistir+V.vós.AD.2.PL+FUT+1+PL
insistir-vos-ia	insistir+V.vós.AD.2.PL+COND+1+SG
insistir-vos-ia	insistir+V.vós.AD.2.PL+COND+3+SG
insistir-vos-iam	insistir+V.vós.AD.2.PL+COND+3+PL
insistir-vos-íamos	insistir+V.vós.AD.2.PL+COND+1+PL
insistir-vos-ias	insistir+V.vós.AD.2.PL+COND+2+SG
insistir-vos-íeis	insistir+V.vós.AD.2.PL+COND+2+PL
insistir-vos	insistir+V.vós.AD.2.PL+INF
insistir-vos	insistir+V.vós.AD.2.PL+INF+1+SG
insistir-vos	insistir+V.vós.AD.2.PL+INF+3+SG
insistir-vos	insistir+V.vós.AD.2.PL+SBJF+1+SG
insistir-vos	insistir+V.vós.AD.2.PL+SBJF+3+SG
insististe-a	insistir+V.ele.ACC.3.F.SG+PRF+2+SG
insististe-as	insistir+V.ele.ACC.3.F.PL+PRF+2+SG
insististe-la	insistir+V.ele.ACC.3.F.SG+PRF+2+PL
insististe-las	insistir+V.ele.ACC.3.F.PL+PRF+2+PL
insististe-lhe	insistir+V.ele.DAT.3.SG+PRF+2+SG
insististe-lhes	insistir+V.ele.DAT.3.PL+PRF+2+SG
insististe-lo	insistir+V.ele.ACC.3.M.SG+PRF+2+PL
insististe-los	insistir+V.ele.ACC.3.M.PL+PRF+2+PL
insististe-me	insistir+V.eu.AD.1.SG+PRF+2+SG
insististe-nos	insistir+nós.AD.1.PL+PRF+2+PL
insististe-nos	insistir+nós.AD.1.PL+PRF+2+SG
insististe-o	insistir+V.ele.ACC.3.M.SG+PRF+2+SG
insististe-os	insistir+V.ele.ACC.3.M.PL+PRF+2+SG
insististes-lhe	insistir+V.ele.DAT.3.SG+PRF+2+PL
insististes-lhes	insistir+V.ele.DAT.3.PL+PRF+2+PL
insististes-me	insistir+V.eu.AD.1.SG+PRF+2+PL
insististes-te	insistir+V.tu.AD.2.SG+PRF+2+PL
insististes-vos	insistir+V.vós.AD.2.PL+PRF+2+PL
insististe-te	insistir+V.tu.AD.2.SG+PRF+2+SG
insististe-vos	insistir+V.vós.AD.2.PL+PRF+2+SG
insisti-te	insistir+V.tu.AD.2.SG+PRF+1+SG
insistiu-a	insistir+V.ele.ACC.3.F.SG+PRF+3+SG
insistiu-as	insistir+V.ele.ACC.3.F.PL+PRF+3+SG
insistiu-lhe	insistir+V.ele.DAT.3.SG+PRF+3+SG
insistiu-lhes	insistir+V.ele.DAT.3.PL+PRF+3+SG
insistiu-me	insistir+V.eu.AD.1.SG+PRF+3+SG
insistiu-nos	insistir+nós.AD.1.PL+PRF+3+SG
insistiu-o	insistir+V.ele.ACC.3.M.SG+PRF+3+SG
insistiu-os	insistir+V.ele.ACC.3.M.PL+PRF+3+SG
insistiu-se	insistir+V.ele.REFL+PRF+3+SG
insistiu-te	insistir+V.tu.AD.2.SG+PRF+3+SG
insistiu-vos	insistir+V.vós.AD.2.PL+PRF+3+SG
insisti-vos	insistir+V.vós.AD.2.PL+PRF+1+SG
insola-a	insolar+V.ele.ACC.3.F.SG+PRS+3+SG
insola-as	insolar+V.ele.ACC.3.F.PL+PRS+3+SG
insolai-la	insolar+V.ele.ACC.3.F.SG+PRS+2+PL
insolai-las	insolar+V.ele.ACC.3.F.PL+PRS+2+PL
insolai-lo	insolar+V.ele.ACC.3.M.SG+PRS+2+PL
insolai-los	insolar+V.ele.ACC.3.M.PL+PRS+2+PL
insolai-nos	insolar+nós.AD.1.PL+PRS+2+PL
insolais-lhe	insolar+V.ele.DAT.3.SG+PRS+2+PL
insolais-lhes	insolar+V.ele.DAT.3.PL+PRS+2+PL
insolais-me	insolar+V.eu.AD.1.SG+PRS+2+PL
insolais-te	insolar+V.tu.AD.2.SG+PRS+2+PL
insolais-vos	insolar+V.vós.AD.2.PL+PRS+2+PL
insolá-la-á	insolar+V.ele.ACC.3.F.SG+FUT+3+SG
insolá-la-ão	insolar+V.ele.ACC.3.F.SG+FUT+3+PL
insolá-la-ás	insolar+V.ele.ACC.3.F.SG+FUT+2+SG
insolá-la-ei	insolar+V.ele.ACC.3.F.SG+FUT+1+SG
insolá-la-eis	insolar+V.ele.ACC.3.F.SG+FUT+2+PL
insolá-la-emos	insolar+V.ele.ACC.3.F.SG+FUT+1+PL
insolá-la-ia	insolar+V.ele.ACC.3.F.SG+COND+1+SG
insolá-la-ia	insolar+V.ele.ACC.3.F.SG+COND+3+SG
insolá-la-iam	insolar+V.ele.ACC.3.F.SG+COND+3+PL
insolá-la-íamos	insolar+V.ele.ACC.3.F.SG+COND+1+PL
insolá-la-ias	insolar+V.ele.ACC.3.F.SG+COND+2+SG
insolá-la-íeis	insolar+V.ele.ACC.3.F.SG+COND+2+PL
insolá-la	insolar+V.ele.ACC.3.F.SG+INF+1+SG
insolá-la	insolar+V.ele.ACC.3.F.SG+INF+3+SG
insola-la	insolar+V.ele.ACC.3.F.SG+PRS+2+SG
insolá-la	insolar+V.ele.ACC.3.F.SG+SBJF+1+SG
insolá-la	insolar+V.ele.ACC.3.F.SG+SBJF+3+SG
insolá-las-á	insolar+V.ele.ACC.3.F.PL+FUT+3+SG
insolá-las-ão	insolar+V.ele.ACC.3.F.PL+FUT+3+PL
insolá-las-ás	insolar+V.ele.ACC.3.F.PL+FUT+2+SG
insolá-las-ei	insolar+V.ele.ACC.3.F.PL+FUT+1+SG
insolá-las-eis	insolar+V.ele.ACC.3.F.PL+FUT+2+PL
insolá-las-emos	insolar+V.ele.ACC.3.F.PL+FUT+1+PL
insolá-las-ia	insolar+V.ele.ACC.3.F.PL+COND+1+SG
insolá-las-ia	insolar+V.ele.ACC.3.F.PL+COND+3+SG
insolá-las-iam	insolar+V.ele.ACC.3.F.PL+COND+3+PL
insolá-las-íamos	insolar+V.ele.ACC.3.F.PL+COND+1+PL
insolá-las-ias	insolar+V.ele.ACC.3.F.PL+COND+2+SG
insolá-las-íeis	insolar+V.ele.ACC.3.F.PL+COND+2+PL
insolá-las	insolar+V.ele.ACC.3.F.PL+INF+1+SG
insolá-las	insolar+V.ele.ACC.3.F.PL+INF+3+SG
insola-las	insolar+V.ele.ACC.3.F.PL+PRS+2+SG
insolá-las	insolar+V.ele.ACC.3.F.PL+SBJF+1+SG
insolá-las	insolar+V.ele.ACC.3.F.PL+SBJF+3+SG
insola-lhe	insolar+V.ele.DAT.3.SG+PRS+3+SG
insola-lhes	insolar+V.ele.DAT.3.PL+PRS+3+SG
insolá-lo-á	insolar+V.ele.ACC.3.M.SG+FUT+3+SG
insolá-lo-ão	insolar+V.ele.ACC.3.M.SG+FUT+3+PL
insolá-lo-ás	insolar+V.ele.ACC.3.M.SG+FUT+2+SG
insolá-lo-ei	insolar+V.ele.ACC.3.M.SG+FUT+1+SG
insolá-lo-eis	insolar+V.ele.ACC.3.M.SG+FUT+2+PL
insolá-lo-emos	insolar+V.ele.ACC.3.M.SG+FUT+1+PL
insolá-lo-ia	insolar+V.ele.ACC.3.M.SG+COND+1+SG
insolá-lo-ia	insolar+V.ele.ACC.3.M.SG+COND+3+SG
insolá-lo-iam	insolar+V.ele.ACC.3.M.SG+COND+3+PL
insolá-lo-íamos	insolar+V.ele.ACC.3.M.SG+COND+1+PL
insolá-lo-ias	insolar+V.ele.ACC.3.M.SG+COND+2+SG
insolá-lo-íeis	insolar+V.ele.ACC.3.M.SG+COND+2+PL
insolá-lo	insolar+V.ele.ACC.3.M.SG+INF+1+SG
insolá-lo	insolar+V.ele.ACC.3.M.SG+INF+3+SG
insola-lo	insolar+V.ele.ACC.3.M.SG+PRS+2+SG
insolá-lo	insolar+V.ele.ACC.3.M.SG+SBJF+1+SG
insolá-lo	insolar+V.ele.ACC.3.M.SG+SBJF+3+SG
insolá-los-á	insolar+V.ele.ACC.3.M.PL+FUT+3+SG
insolá-los-ão	insolar+V.ele.ACC.3.M.PL+FUT+3+PL
insolá-los-ás	insolar+V.ele.ACC.3.M.PL+FUT+2+SG
insolá-los-ei	insolar+V.ele.ACC.3.M.PL+FUT+1+SG
insolá-los-eis	insolar+V.ele.ACC.3.M.PL+FUT+2+PL
insolá-los-emos	insolar+V.ele.ACC.3.M.PL+FUT+1+PL
insolá-los-ia	insolar+V.ele.ACC.3.M.PL+COND+1+SG
insolá-los-ia	insolar+V.ele.ACC.3.M.PL+COND+3+SG
insolá-los-iam	insolar+V.ele.ACC.3.M.PL+COND+3+PL
insolá-los-íamos	insolar+V.ele.ACC.3.M.PL+COND+1+PL
insolá-los-ias	insolar+V.ele.ACC.3.M.PL+COND+2+SG
insolá-los-íeis	insolar+V.ele.ACC.3.M.PL+COND+2+PL
insolá-los	insolar+V.ele.ACC.3.M.PL+INF+1+SG
insolá-los	insolar+V.ele.ACC.3.M.PL+INF+3+SG
insola-los	insolar+V.ele.ACC.3.M.PL+PRS+2+SG
insolá-los	insolar+V.ele.ACC.3.M.PL+SBJF+1+SG
insolá-los	insolar+V.ele.ACC.3.M.PL+SBJF+3+SG
insola-me	insolar+V.eu.AD.1.SG+PRS+3+SG
insolam-lhe	insolar+V.ele.DAT.3.SG+PRS+3+PL
insolam-lhes	insolar+V.ele.DAT.3.PL+PRS+3+PL
insolam-me	insolar+V.eu.AD.1.SG+PRS+3+PL
insolam-na	insolar+V.ele.ACC.3.F.SG+PRS+3+PL
insolam-nas	insolar+V.ele.ACC.3.F.PL+PRS+3+PL
insolam-no	insolar+V.ele.ACC.3.M.SG+PRS+3+PL
insolam-nos	insolar+V.ele.ACC.3.M.PL+PRS+3+PL
insolam-nos	insolar+V.nós.AD.1.PL+PRS+3+PL
insolamo-la	insolar+V.ele.ACC.3.F.SG+PRF+1+PL
insolamo-la	insolar+V.ele.ACC.3.F.SG+PRS+1+PL
insolamo-las	insolar+V.ele.ACC.3.F.PL+PRF+1+PL
insolamo-las	insolar+V.ele.ACC.3.F.PL+PRS+1+PL
insolamo-lo	insolar+V.ele.ACC.3.M.SG+PRF+1+PL
insolamo-lo	insolar+V.ele.ACC.3.M.SG+PRS+1+PL
insolamo-los	insolar+V.ele.ACC.3.M.PL+PRF+1+PL
insolamo-los	insolar+V.ele.ACC.3.M.PL+PRS+1+PL
insolamo-nos	insolar+nós.AD.1.PL+PRF+1+PL
insolamo-nos	insolar+nós.AD.1.PL+PRS+1+PL
insolamos-lhe	insolar+V.ele.DAT.3.SG+PRF+1+PL
insolamos-lhe	insolar+V.ele.DAT.3.SG+PRS+1+PL
insolamos-lhes	insolar+V.ele.DAT.3.PL+PRF+1+PL
insolamos-lhes	insolar+V.ele.DAT.3.PL+PRS+1+PL
insolamos-me	insolar+V.eu.AD.1.SG+PRF+1+PL
insolamos-me	insolar+V.eu.AD.1.SG+PRS+1+PL
insolamos-te	insolar+V.tu.AD.2.SG+PRF+1+PL
insolamos-te	insolar+V.tu.AD.2.SG+PRS+1+PL
insolamos-vos	insolar+V.vós.AD.2.PL+PRF+1+PL
insolamos-vos	insolar+V.vós.AD.2.PL+PRS+1+PL
insolam-se	insolar+V.ele.REFL+PRS+3+PL
insolam-te	insolar+V.tu.AD.2.SG+PRS+3+PL
insolam-vos	insolar+V.vós.AD.2.PL+PRS+3+PL
insolando-a	insolar+V.ele.ACC.3.F.SG+GRD
insolando-as	insolar+V.ele.ACC.3.F.PL+GRD
insolando-lhe	insolar+V.ele.DAT.3.SG+GRD
insolando-lhes	insolar+V.ele.DAT.3.PL+GRD
insolando-me	insolar+V.eu.AD.1.SG+GRD
insolando-nos	insolar+nós.AD.1.PL+GRD
insolando-o	insolar+V.ele.ACC.3.M.SG+GRD
insolando-os	insolar+V.ele.ACC.3.M.PL+GRD
insolando-se	insolar+V.ele.REFL+GRD
insolando-te	insolar+V.tu.AD.2.SG+GRD
insolando-vos	insolar+V.vós.AD.2.PL+GRD
insola-nos	insolar+nós.AD.1.PL+PRS+2+SG
insola-nos	insolar+nós.AD.1.PL+PRS+3+SG
insola-o	insolar+V.ele.ACC.3.M.SG+PRS+3+SG
insola-os	insolar+V.ele.ACC.3.M.PL+PRS+3+SG
insolara-a	insolar+V.ele.ACC.3.F.SG+PQP+1+SG
insolara-a	insolar+V.ele.ACC.3.F.SG+PQP+3+SG
insolara-as	insolar+V.ele.ACC.3.F.PL+PQP+1+SG
insolara-as	insolar+V.ele.ACC.3.F.PL+PQP+3+SG
insolara-la	insolar+V.ele.ACC.3.F.SG+PQP+2+SG
insolara-las	insolar+V.ele.ACC.3.F.PL+PQP+2+SG
insolara-lhe	insolar+V.ele.DAT.3.SG+PQP+1+SG
insolara-lhe	insolar+V.ele.DAT.3.SG+PQP+3+SG
insolara-lhes	insolar+V.ele.DAT.3.PL+PQP+1+SG
insolara-lhes	insolar+V.ele.DAT.3.PL+PQP+3+SG
insolara-lo	insolar+V.ele.ACC.3.M.SG+PQP+2+SG
insolara-los	insolar+V.ele.ACC.3.M.PL+PQP+2+SG
insolara-me	insolar+V.eu.AD.1.SG+PQP+1+SG
insolara-me	insolar+V.eu.AD.1.SG+PQP+3+SG
insolaram-lhe	insolar+V.ele.DAT.3.SG+PQP+3+PL
insolaram-lhe	insolar+V.ele.DAT.3.SG+PRF+3+PL
insolaram-lhes	insolar+V.ele.DAT.3.PL+PQP+3+PL
insolaram-lhes	insolar+V.ele.DAT.3.PL+PRF+3+PL
insolaram-me	insolar+V.eu.AD.1.SG+PQP+3+PL
insolaram-me	insolar+V.eu.AD.1.SG+PRF+3+PL
insolaram-na	insolar+V.ele.ACC.3.F.SG+PQP+3+PL
insolaram-na	insolar+V.ele.ACC.3.F.SG+PRF+3+PL
insolaram-nas	insolar+V.ele.ACC.3.F.PL+PQP+3+PL
insolaram-nas	insolar+V.ele.ACC.3.F.PL+PRF+3+PL
insolaram-no	insolar+V.ele.ACC.3.M.SG+PQP+3+PL
insolaram-no	insolar+V.ele.ACC.3.M.SG+PRF+3+PL
insolaram-nos	insolar+V.ele.ACC.3.M.PL+PQP+3+PL
insolaram-nos	insolar+V.ele.ACC.3.M.PL+PRF+3+PL
insolaram-nos	insolar+V.nós.AD.1.PL+PQP+3+PL
insolaram-nos	insolar+V.nós.AD.1.PL+PRF+3+PL
insoláramo-la	insolar+V.ele.ACC.3.F.SG+PQP+1+PL
insoláramo-las	insolar+V.ele.ACC.3.F.PL+PQP+1+PL
insoláramo-lo	insolar+V.ele.ACC.3.M.SG+PQP+1+PL
insoláramo-los	insolar+V.ele.ACC.3.M.PL+PQP+1+PL
insoláramo-nos	insolar+nós.AD.1.PL+PQP+1+PL
insoláramos-lhe	insolar+V.ele.DAT.3.SG+PQP+1+PL
insoláramos-lhes	insolar+V.ele.DAT.3.PL+PQP+1+PL
insoláramos-me	insolar+V.eu.AD.1.SG+PQP+1+PL
insoláramos-te	insolar+V.tu.AD.2.SG+PQP+1+PL
insoláramos-vos	insolar+V.vós.AD.2.PL+PQP+1+PL
insolaram-se	insolar+V.ele.REFL+PQP+3+PL
insolaram-se	insolar+V.ele.REFL+PRF+3+PL
insolaram-te	insolar+V.tu.AD.2.SG+PQP+3+PL
insolaram-te	insolar+V.tu.AD.2.SG+PRF+3+PL
insolaram-vos	insolar+V.vós.AD.2.PL+PQP+3+PL
insolaram-vos	insolar+V.vós.AD.2.PL+PRF+3+PL
insolara-nos	insolar+nós.AD.1.PL+PQP+1+SG
insolara-nos	insolar+nós.AD.1.PL+PQP+2+SG
insolara-nos	insolar+nós.AD.1.PL+PQP+3+SG
insolara-o	insolar+V.ele.ACC.3.M.SG+PQP+1+SG
insolara-o	insolar+V.ele.ACC.3.M.SG+PQP+3+SG
insolara-os	insolar+V.ele.ACC.3.M.PL+PQP+1+SG
insolara-os	insolar+V.ele.ACC.3.M.PL+PQP+3+SG
insolara-se	insolar+V.ele.REFL+PQP+1+SG
insolara-se	insolar+V.ele.REFL+PQP+3+SG
insolaras-lhe	insolar+V.ele.DAT.3.SG+PQP+2+SG
insolaras-lhes	insolar+V.ele.DAT.3.PL+PQP+2+SG
insolaras-me	insolar+V.eu.AD.1.SG+PQP+2+SG
insolaras-te	insolar+V.tu.AD.2.SG+PQP+2+SG
insolaras-vos	insolar+V.vós.AD.2.PL+PQP+2+SG
insolara-te	insolar+V.tu.AD.2.SG+PQP+1+SG
insolara-te	insolar+V.tu.AD.2.SG+PQP+3+SG
insolara-vos	insolar+V.vós.AD.2.PL+PQP+1+SG
insolara-vos	insolar+V.vós.AD.2.PL+PQP+3+SG
insolarde-la	insolar+V.ele.ACC.3.F.SG+INF+2+PL
insolarde-la	insolar+V.ele.ACC.3.F.SG+SBJF+2+PL
insolarde-las	insolar+V.ele.ACC.3.F.PL+INF+2+PL
insolarde-las	insolar+V.ele.ACC.3.F.PL+SBJF+2+PL
insolarde-lo	insolar+V.ele.ACC.3.M.SG+INF+2+PL
insolarde-lo	insolar+V.ele.ACC.3.M.SG+SBJF+2+PL
insolarde-los	insolar+V.ele.ACC.3.M.PL+INF+2+PL
insolarde-los	insolar+V.ele.ACC.3.M.PL+SBJF+2+PL
insolarde-nos	insolar+nós.AD.1.PL+INF+2+PL
insolarde-nos	insolar+nós.AD.1.PL+SBJF+2+PL
insolardes-lhe	insolar+V.ele.DAT.3.SG+INF+2+PL
insolardes-lhe	insolar+V.ele.DAT.3.SG+SBJF+2+PL
insolardes-lhes	insolar+V.ele.DAT.3.PL+INF+2+PL
insolardes-lhes	insolar+V.ele.DAT.3.PL+SBJF+2+PL
insolardes-me	insolar+V.eu.AD.1.SG+INF+2+PL
insolardes-me	insolar+V.eu.AD.1.SG+SBJF+2+PL
insolardes-te	insolar+V.tu.AD.2.SG+INF+2+PL
insolardes-te	insolar+V.tu.AD.2.SG+SBJF+2+PL
insolardes-vos	insolar+V.vós.AD.2.PL+INF+2+PL
insolardes-vos	insolar+V.vós.AD.2.PL+SBJF+2+PL
insolárei-la	insolar+V.ele.ACC.3.F.SG+PQP+2+PL
insolárei-las	insolar+V.ele.ACC.3.F.PL+PQP+2+PL
insolárei-lo	insolar+V.ele.ACC.3.M.SG+PQP+2+PL
insolárei-los	insolar+V.ele.ACC.3.M.PL+PQP+2+PL
insolárei-nos	insolar+nós.AD.1.PL+PQP+2+PL
insoláreis-lhe	insolar+V.ele.DAT.3.SG+PQP+2+PL
insoláreis-lhes	insolar+V.ele.DAT.3.PL+PQP+2+PL
insoláreis-me	insolar+V.eu.AD.1.SG+PQP+2+PL
insoláreis-te	insolar+V.tu.AD.2.SG+PQP+2+PL
insoláreis-vos	insolar+V.vós.AD.2.PL+PQP+2+PL
insolare-la	insolar+V.ele.ACC.3.F.SG+INF+2+SG
insolare-la	insolar+V.ele.ACC.3.F.SG+SBJF+2+SG
insolare-las	insolar+V.ele.ACC.3.F.PL+INF+2+SG
insolare-las	insolar+V.ele.ACC.3.F.PL+SBJF+2+SG
insolare-lo	insolar+V.ele.ACC.3.M.SG+INF+2+SG
insolare-lo	insolar+V.ele.ACC.3.M.SG+SBJF+2+SG
insolare-los	insolar+V.ele.ACC.3.M.PL+INF+2+SG
insolare-los	insolar+V.ele.ACC.3.M.PL+SBJF+2+SG
insolarem-lhe	insolar+V.ele.DAT.3.SG+INF+3+PL
insolarem-lhe	insolar+V.ele.DAT.3.SG+SBJF+3+PL
insolarem-lhes	insolar+V.ele.DAT.3.PL+INF+3+PL
insolarem-lhes	insolar+V.ele.DAT.3.PL+SBJF+3+PL
insolarem-me	insolar+V.eu.AD.1.SG+INF+3+PL
insolarem-me	insolar+V.eu.AD.1.SG+SBJF+3+PL
insolarem-na	insolar+V.ele.ACC.3.F.SG+INF+3+PL
insolarem-na	insolar+V.ele.ACC.3.F.SG+SBJF+3+PL
insolarem-nas	insolar+V.ele.ACC.3.F.PL+INF+3+PL
insolarem-nas	insolar+V.ele.ACC.3.F.PL+SBJF+3+PL
insolarem-no	insolar+V.ele.ACC.3.M.SG+INF+3+PL
insolarem-no	insolar+V.ele.ACC.3.M.SG+SBJF+3+PL
insolarem-nos	insolar+V.ele.ACC.3.M.PL+INF+3+PL
insolarem-nos	insolar+V.ele.ACC.3.M.PL+SBJF+3+PL
insolarem-nos	insolar+V.nós.AD.1.PL+INF+3+PL
insolarem-nos	insolar+V.nós.AD.1.PL+SBJF+3+PL
insolarem-se	insolar+V.ele.REFL+INF+3+PL
insolarem-se	insolar+V.ele.REFL+SBJF+3+PL
insolarem-te	insolar+V.tu.AD.2.SG+INF+3+PL
insolarem-te	insolar+V.tu.AD.2.SG+SBJF+3+PL
insolarem-vos	insolar+V.vós.AD.2.PL+INF+3+PL
insolarem-vos	insolar+V.vós.AD.2.PL+SBJF+3+PL
insolare-nos	insolar+nós.AD.1.PL+INF+2+SG
insolare-nos	insolar+nós.AD.1.PL+SBJF+2+SG
insolares-lhe	insolar+V.ele.DAT.3.SG+INF+2+SG
insolares-lhe	insolar+V.ele.DAT.3.SG+SBJF+2+SG
insolares-lhes	insolar+V.ele.DAT.3.PL+INF+2+SG
insolares-lhes	insolar+V.ele.DAT.3.PL+SBJF+2+SG
insolares-me	insolar+V.eu.AD.1.SG+INF+2+SG
insolares-me	insolar+V.eu.AD.1.SG+SBJF+2+SG
insolares-te	insolar+V.tu.AD.2.SG+INF+2+SG
insolares-te	insolar+V.tu.AD.2.SG+SBJF+2+SG
insolares-vos	insolar+V.vós.AD.2.PL+INF+2+SG
insolares-vos	insolar+V.vós.AD.2.PL+SBJF+2+SG
insolar-lhe-á	insolar+V.ele.DAT.3.SG+FUT+3+SG
insolar-lhe-ão	insolar+V.ele.DAT.3.SG+FUT+3+PL
insolar-lhe-ás	insolar+V.ele.DAT.3.SG+FUT+2+SG
insolar-lhe-ei	insolar+V.ele.DAT.3.SG+FUT+1+SG
insolar-lhe-eis	insolar+V.ele.DAT.3.SG+FUT+2+PL
insolar-lhe-emos	insolar+V.ele.DAT.3.SG+FUT+1+PL
insolar-lhe-ia	insolar+V.ele.DAT.3.SG+COND+1+SG
insolar-lhe-ia	insolar+V.ele.DAT.3.SG+COND+3+SG
insolar-lhe-iam	insolar+V.ele.DAT.3.SG+COND+3+PL
insolar-lhe-íamos	insolar+V.ele.DAT.3.SG+COND+1+PL
insolar-lhe-ias	insolar+V.ele.DAT.3.SG+COND+2+SG
insolar-lhe-íeis	insolar+V.ele.DAT.3.SG+COND+2+PL
insolar-lhe	insolar+V.ele.DAT.3.SG+INF
insolar-lhe	insolar+V.ele.DAT.3.SG+INF+1+SG
insolar-lhe	insolar+V.ele.DAT.3.SG+INF+3+SG
insolar-lhe	insolar+V.ele.DAT.3.SG+SBJF+1+SG
insolar-lhe	insolar+V.ele.DAT.3.SG+SBJF+3+SG
insolar-lhes-á	insolar+V.ele.DAT.3.PL+FUT+3+SG
insolar-lhes-ão	insolar+V.ele.DAT.3.PL+FUT+3+PL
insolar-lhes-ás	insolar+V.ele.DAT.3.PL+FUT+2+SG
insolar-lhes-ei	insolar+V.ele.DAT.3.PL+FUT+1+SG
insolar-lhes-eis	insolar+V.ele.DAT.3.PL+FUT+2+PL
insolar-lhes-emos	insolar+V.ele.DAT.3.PL+FUT+1+PL
insolar-lhes-ia	insolar+V.ele.DAT.3.PL+COND+1+SG
insolar-lhes-ia	insolar+V.ele.DAT.3.PL+COND+3+SG
insolar-lhes-iam	insolar+V.ele.DAT.3.PL+COND+3+PL
insolar-lhes-íamos	insolar+V.ele.DAT.3.PL+COND+1+PL
insolar-lhes-ias	insolar+V.ele.DAT.3.PL+COND+2+SG
insolar-lhes-íeis	insolar+V.ele.DAT.3.PL+COND+2+PL
insolar-lhes	insolar+V.ele.DAT.3.PL+INF
insolar-lhes	insolar+V.ele.DAT.3.PL+INF+1+SG
insolar-lhes	insolar+V.ele.DAT.3.PL+INF+3+SG
insolar-lhes	insolar+V.ele.DAT.3.PL+SBJF+1+SG
insolar-lhes	insolar+V.ele.DAT.3.PL+SBJF+3+SG
insolar-me-á	insolar+V.eu.AD.1.SG+FUT+3+SG
insolar-me-ão	insolar+V.eu.AD.1.SG+FUT+3+PL
insolar-me-ás	insolar+V.eu.AD.1.SG+FUT+2+SG
insolar-me-ei	insolar+V.eu.AD.1.SG+FUT+1+SG
insolar-me-eis	insolar+V.eu.AD.1.SG+FUT+2+PL
insolar-me-emos	insolar+V.eu.AD.1.SG+FUT+1+PL
insolar-me-ia	insolar+V.eu.AD.1.SG+COND+1+SG
insolar-me-ia	insolar+V.eu.AD.1.SG+COND+3+SG
insolar-me-iam	insolar+V.eu.AD.1.SG+COND+3+PL
insolar-me-íamos	insolar+V.eu.AD.1.SG+COND+1+PL
insolar-me-ias	insolar+V.eu.AD.1.SG+COND+2+SG
insolar-me-íeis	insolar+V.eu.AD.1.SG+COND+2+PL
insolar-me	insolar+V.eu.AD.1.SG+INF
insolar-me	insolar+V.eu.AD.1.SG+INF+1+SG
insolar-me	insolar+V.eu.AD.1.SG+INF+3+SG
insolar-me	insolar+V.eu.AD.1.SG+SBJF+1+SG
insolar-me	insolar+V.eu.AD.1.SG+SBJF+3+SG
insolarmo-la	insolar+V.ele.ACC.3.F.SG+INF+1+PL
insolarmo-la	insolar+V.ele.ACC.3.F.SG+SBJF+1+PL
insolarmo-las	insolar+V.ele.ACC.3.F.PL+INF+1+PL
insolarmo-las	insolar+V.ele.ACC.3.F.PL+SBJF+1+PL
insolarmo-lo	insolar+V.ele.ACC.3.M.SG+INF+1+PL
insolarmo-lo	insolar+V.ele.ACC.3.M.SG+SBJF+1+PL
insolarmo-los	insolar+V.ele.ACC.3.M.PL+INF+1+PL
insolarmo-los	insolar+V.ele.ACC.3.M.PL+SBJF+1+PL
insolarmo-nos	insolar+nós.AD.1.PL+INF+1+PL
insolarmo-nos	insolar+nós.AD.1.PL+SBJF+1+PL
insolarmos-lhe	insolar+V.ele.DAT.3.SG+INF+1+PL
insolarmos-lhe	insolar+V.ele.DAT.3.SG+SBJF+1+PL
insolarmos-lhes	insolar+V.ele.DAT.3.PL+INF+1+PL
insolarmos-lhes	insolar+V.ele.DAT.3.PL+SBJF+1+PL
insolarmos-me	insolar+V.eu.AD.1.SG+INF+1+PL
insolarmos-me	insolar+V.eu.AD.1.SG+SBJF+1+PL
insolarmos-te	insolar+V.tu.AD.2.SG+INF+1+PL
insolarmos-te	insolar+V.tu.AD.2.SG+SBJF+1+PL
insolarmos-vos	insolar+V.vós.AD.2.PL+INF+1+PL
insolarmos-vos	insolar+V.vós.AD.2.PL+SBJF+1+PL
insolar-nos-á	insolar+nós.AD.1.PL+FUT+3+SG
insolar-nos-ão	insolar+nós.AD.1.PL+FUT+3+PL
insolar-nos-ás	insolar+nós.AD.1.PL+FUT+2+SG
insolar-nos-ei	insolar+nós.AD.1.PL+FUT+1+SG
insolar-nos-eis	insolar+nós.AD.1.PL+FUT+2+PL
insolar-nos-emos	insolar+nós.AD.1.PL+FUT+1+PL
insolar-nos-ia	insolar+nós.AD.1.PL+COND+1+SG
insolar-nos-ia	insolar+nós.AD.1.PL+COND+3+SG
insolar-nos-iam	insolar+nós.AD.1.PL+COND+3+PL
insolar-nos-íamos	insolar+nós.AD.1.PL+COND+1+PL
insolar-nos-ias	insolar+nós.AD.1.PL+COND+2+SG
insolar-nos-íeis	insolar+nós.AD.1.PL+COND+2+PL
insolar-nos	insolar+nós.AD.1.PL+INF
insolar-nos	insolar+nós.AD.1.PL+INF+1+SG
insolar-nos	insolar+nós.AD.1.PL+INF+3+SG
insolar-nos	insolar+nós.AD.1.PL+SBJF+1+SG
insolar-nos	insolar+nós.AD.1.PL+SBJF+3+SG
insolar-se-á	insolar+V.ele.REFL+FUT+3+SG
insolar-se-ão	insolar+V.ele.REFL+FUT+3+PL
insolar-se-ia	insolar+V.ele.REFL+COND+3+SG
insolar-se-iam	insolar+V.ele.REFL+COND+3+PL
insolar-se	insolar+V.ele.REFL+INF
insolar-se	insolar+V.ele.REFL+INF+3+SG
insolar-se	insolar+V.ele.REFL+SBJF+3+SG
insolar-te-á	insolar+V.tu.AD.2.SG+FUT+3+SG
insolar-te-ão	insolar+V.tu.AD.2.SG+FUT+3+PL
insolar-te-ás	insolar+V.tu.AD.2.SG+FUT+2+SG
insolar-te-ei	insolar+V.tu.AD.2.SG+FUT+1+SG
insolar-te-eis	insolar+V.tu.AD.2.SG+FUT+2+PL
insolar-te-emos	insolar+V.tu.AD.2.SG+FUT+1+PL
insolar-te-ia	insolar+V.tu.AD.2.SG+COND+1+SG
insolar-te-ia	insolar+V.tu.AD.2.SG+COND+3+SG
insolar-te-iam	insolar+V.tu.AD.2.SG+COND+3+PL
insolar-te-íamos	insolar+V.tu.AD.2.SG+COND+1+PL
insolar-te-ias	insolar+V.tu.AD.2.SG+COND+2+SG
insolar-te-íeis	insolar+V.tu.AD.2.SG+COND+2+PL
insolar-te	insolar+V.tu.AD.2.SG+INF
insolar-te	insolar+V.tu.AD.2.SG+INF+1+SG
insolar-te	insolar+V.tu.AD.2.SG+INF+3+SG
insolar-te	insolar+V.tu.AD.2.SG+SBJF+1+SG
insolar-te	insolar+V.tu.AD.2.SG+SBJF+3+SG
insolar-vos-á	insolar+V.vós.AD.2.PL+FUT+3+SG
insolar-vos-ão	insolar+V.vós.AD.2.PL+FUT+3+PL
insolar-vos-ás	insolar+V.vós.AD.2.PL+FUT+2+SG
insolar-vos-ei	insolar+V.vós.AD.2.PL+FUT+1+SG
insolar-vos-eis	insolar+V.vós.AD.2.PL+FUT+2+PL
insolar-vos-emos	insolar+V.vós.AD.2.PL+FUT+1+PL
insolar-vos-ia	insolar+V.vós.AD.2.PL+COND+1+SG
insolar-vos-ia	insolar+V.vós.AD.2.PL+COND+3+SG
insolar-vos-iam	insolar+V.vós.AD.2.PL+COND+3+PL
insolar-vos-íamos	insolar+V.vós.AD.2.PL+COND+1+PL
insolar-vos-ias	insolar+V.vós.AD.2.PL+COND+2+SG
insolar-vos-íeis	insolar+V.vós.AD.2.PL+COND+2+PL
insolar-vos	insolar+V.vós.AD.2.PL+INF
insolar-vos	insolar+V.vós.AD.2.PL+INF+1+SG
insolar-vos	insolar+V.vós.AD.2.PL+INF+3+SG
insolar-vos	insolar+V.vós.AD.2.PL+SBJF+1+SG
insolar-vos	insolar+V.vós.AD.2.PL+SBJF+3+SG
insola-se	insolar+V.ele.REFL+PRS+3+SG
insolas-lhe	insolar+V.ele.DAT.3.SG+PRS+2+SG
insolas-lhes	insolar+V.ele.DAT.3.PL+PRS+2+SG
insolas-me	insolar+V.eu.AD.1.SG+PRS+2+SG
insolaste-a	insolar+V.ele.ACC.3.F.SG+PRF+2+SG
insolaste-as	insolar+V.ele.ACC.3.F.PL+PRF+2+SG
insolas-te	insolar+V.tu.AD.2.SG+PRS+2+SG
insolaste-la	insolar+V.ele.ACC.3.F.SG+PRF+2+PL
insolaste-las	insolar+V.ele.ACC.3.F.PL+PRF+2+PL
insolaste-lhe	insolar+V.ele.DAT.3.SG+PRF+2+SG
insolaste-lhes	insolar+V.ele.DAT.3.PL+PRF+2+SG
insolaste-lo	insolar+V.ele.ACC.3.M.SG+PRF+2+PL
insolaste-los	insolar+V.ele.ACC.3.M.PL+PRF+2+PL
insolaste-me	insolar+V.eu.AD.1.SG+PRF+2+SG
insolaste-nos	insolar+nós.AD.1.PL+PRF+2+PL
insolaste-nos	insolar+nós.AD.1.PL+PRF+2+SG
insolaste-o	insolar+V.ele.ACC.3.M.SG+PRF+2+SG
insolaste-os	insolar+V.ele.ACC.3.M.PL+PRF+2+SG
insolastes-lhe	insolar+V.ele.DAT.3.SG+PRF+2+PL
insolastes-lhes	insolar+V.ele.DAT.3.PL+PRF+2+PL
insolastes-me	insolar+V.eu.AD.1.SG+PRF+2+PL
insolastes-te	insolar+V.tu.AD.2.SG+PRF+2+PL
insolastes-vos	insolar+V.vós.AD.2.PL+PRF+2+PL
insolaste-te	insolar+V.tu.AD.2.SG+PRF+2+SG
insolaste-vos	insolar+V.vós.AD.2.PL+PRF+2+SG
insolas-vos	insolar+V.vós.AD.2.PL+PRS+2+SG
insola-te	insolar+V.tu.AD.2.SG+PRS+3+SG
insolava-a	insolar+V.ele.ACC.3.F.SG+IMPF+1+SG
insolava-a	insolar+V.ele.ACC.3.F.SG+IMPF+3+SG
insolava-as	insolar+V.ele.ACC.3.F.PL+IMPF+1+SG
insolava-as	insolar+V.ele.ACC.3.F.PL+IMPF+3+SG
insolava-la	insolar+V.ele.ACC.3.F.SG+IMPF+2+SG
insolava-las	insolar+V.ele.ACC.3.F.PL+IMPF+2+SG
