liofilizar-te-á	liofilizar+V.tu.AD.2.SG+FUT+3+SG
liofilizar-te-ão	liofilizar+V.tu.AD.2.SG+FUT+3+PL
liofilizar-te-ás	liofilizar+V.tu.AD.2.SG+FUT+2+SG
liofilizar-te-ei	liofilizar+V.tu.AD.2.SG+FUT+1+SG
liofilizar-te-eis	liofilizar+V.tu.AD.2.SG+FUT+2+PL
liofilizar-te-emos	liofilizar+V.tu.AD.2.SG+FUT+1+PL
liofilizar-te-ia	liofilizar+V.tu.AD.2.SG+COND+1+SG
liofilizar-te-ia	liofilizar+V.tu.AD.2.SG+COND+3+SG
liofilizar-te-iam	liofilizar+V.tu.AD.2.SG+COND+3+PL
liofilizar-te-íamos	liofilizar+V.tu.AD.2.SG+COND+1+PL
liofilizar-te-ias	liofilizar+V.tu.AD.2.SG+COND+2+SG
liofilizar-te-íeis	liofilizar+V.tu.AD.2.SG+COND+2+PL
liofilizar-te	liofilizar+V.tu.AD.2.SG+INF
liofilizar-te	liofilizar+V.tu.AD.2.SG+INF+1+SG
liofilizar-te	liofilizar+V.tu.AD.2.SG+INF+3+SG
liofilizar-te	liofilizar+V.tu.AD.2.SG+SBJF+1+SG
liofilizar-te	liofilizar+V.tu.AD.2.SG+SBJF+3+SG
liofilizar-vos-á	liofilizar+V.vós.AD.2.PL+FUT+3+SG
liofilizar-vos-ão	liofilizar+V.vós.AD.2.PL+FUT+3+PL
liofilizar-vos-ás	liofilizar+V.vós.AD.2.PL+FUT+2+SG
liofilizar-vos-ei	liofilizar+V.vós.AD.2.PL+FUT+1+SG
liofilizar-vos-eis	liofilizar+V.vós.AD.2.PL+FUT+2+PL
liofilizar-vos-emos	liofilizar+V.vós.AD.2.PL+FUT+1+PL
liofilizar-vos-ia	liofilizar+V.vós.AD.2.PL+COND+1+SG
liofilizar-vos-ia	liofilizar+V.vós.AD.2.PL+COND+3+SG
liofilizar-vos-iam	liofilizar+V.vós.AD.2.PL+COND+3+PL
liofilizar-vos-íamos	liofilizar+V.vós.AD.2.PL+COND+1+PL
liofilizar-vos-ias	liofilizar+V.vós.AD.2.PL+COND+2+SG
liofilizar-vos-íeis	liofilizar+V.vós.AD.2.PL+COND+2+PL
liofilizar-vos	liofilizar+V.vós.AD.2.PL+INF
liofilizar-vos	liofilizar+V.vós.AD.2.PL+INF+1+SG
liofilizar-vos	liofilizar+V.vós.AD.2.PL+INF+3+SG
liofilizar-vos	liofilizar+V.vós.AD.2.PL+SBJF+1+SG
liofilizar-vos	liofilizar+V.vós.AD.2.PL+SBJF+3+SG
liofiliza-se	liofilizar+V.ele.REFL+PRS+3+SG
liofilizas-lhe	liofilizar+V.ele.DAT.3.SG+PRS+2+SG
liofilizas-lhes	liofilizar+V.ele.DAT.3.PL+PRS+2+SG
liofilizas-me	liofilizar+V.eu.AD.1.SG+PRS+2+SG
liofilizaste-a	liofilizar+V.ele.ACC.3.F.SG+PRF+2+SG
liofilizaste-as	liofilizar+V.ele.ACC.3.F.PL+PRF+2+SG
liofilizaste-la	liofilizar+V.ele.ACC.3.F.SG+PRF+2+PL
liofilizaste-las	liofilizar+V.ele.ACC.3.F.PL+PRF+2+PL
liofilizaste-lhe	liofilizar+V.ele.DAT.3.SG+PRF+2+SG
liofilizaste-lhes	liofilizar+V.ele.DAT.3.PL+PRF+2+SG
liofilizas-te	liofilizar+V.tu.AD.2.SG+PRS+2+SG
liofilizaste-lo	liofilizar+V.ele.ACC.3.M.SG+PRF+2+PL
liofilizaste-los	liofilizar+V.ele.ACC.3.M.PL+PRF+2+PL
liofilizaste-me	liofilizar+V.eu.AD.1.SG+PRF+2+SG
liofilizaste-nos	liofilizar+nós.AD.1.PL+PRF+2+PL
liofilizaste-nos	liofilizar+nós.AD.1.PL+PRF+2+SG
liofilizaste-o	liofilizar+V.ele.ACC.3.M.SG+PRF+2+SG
liofilizaste-os	liofilizar+V.ele.ACC.3.M.PL+PRF+2+SG
liofilizastes-lhe	liofilizar+V.ele.DAT.3.SG+PRF+2+PL
liofilizastes-lhes	liofilizar+V.ele.DAT.3.PL+PRF+2+PL
liofilizastes-me	liofilizar+V.eu.AD.1.SG+PRF+2+PL
liofilizastes-te	liofilizar+V.tu.AD.2.SG+PRF+2+PL
liofilizastes-vos	liofilizar+V.vós.AD.2.PL+PRF+2+PL
liofilizaste-te	liofilizar+V.tu.AD.2.SG+PRF+2+SG
liofilizaste-vos	liofilizar+V.vós.AD.2.PL+PRF+2+SG
liofilizas-vos	liofilizar+V.vós.AD.2.PL+PRS+2+SG
liofiliza-te	liofilizar+V.tu.AD.2.SG+PRS+3+SG
liofilizava-a	liofilizar+V.ele.ACC.3.F.SG+IMPF+1+SG
liofilizava-a	liofilizar+V.ele.ACC.3.F.SG+IMPF+3+SG
liofilizava-as	liofilizar+V.ele.ACC.3.F.PL+IMPF+1+SG
liofilizava-as	liofilizar+V.ele.ACC.3.F.PL+IMPF+3+SG
liofilizava-la	liofilizar+V.ele.ACC.3.F.SG+IMPF+2+SG
liofilizava-las	liofilizar+V.ele.ACC.3.F.PL+IMPF+2+SG
liofilizava-lhe	liofilizar+V.ele.DAT.3.SG+IMPF+1+SG
liofilizava-lhe	liofilizar+V.ele.DAT.3.SG+IMPF+3+SG
liofilizava-lhes	liofilizar+V.ele.DAT.3.PL+IMPF+1+SG
liofilizava-lhes	liofilizar+V.ele.DAT.3.PL+IMPF+3+SG
liofilizava-lo	liofilizar+V.ele.ACC.3.M.SG+IMPF+2+SG
liofilizava-los	liofilizar+V.ele.ACC.3.M.PL+IMPF+2+SG
liofilizava-me	liofilizar+V.eu.AD.1.SG+IMPF+1+SG
liofilizava-me	liofilizar+V.eu.AD.1.SG+IMPF+3+SG
liofilizavam-lhe	liofilizar+V.ele.DAT.3.SG+IMPF+3+PL
liofilizavam-lhes	liofilizar+V.ele.DAT.3.PL+IMPF+3+PL
liofilizavam-me	liofilizar+V.eu.AD.1.SG+IMPF+3+PL
liofilizavam-na	liofilizar+V.ele.ACC.3.F.SG+IMPF+3+PL
liofilizavam-nas	liofilizar+V.ele.ACC.3.F.PL+IMPF+3+PL
liofilizavam-no	liofilizar+V.ele.ACC.3.M.SG+IMPF+3+PL
liofilizavam-nos	liofilizar+V.ele.ACC.3.M.PL+IMPF+3+PL
liofilizavam-nos	liofilizar+V.nós.AD.1.PL+IMPF+3+PL
liofilizávamo-la	liofilizar+V.ele.ACC.3.F.SG+IMPF+1+PL
liofilizávamo-las	liofilizar+V.ele.ACC.3.F.PL+IMPF+1+PL
liofilizávamo-lo	liofilizar+V.ele.ACC.3.M.SG+IMPF+1+PL
liofilizávamo-los	liofilizar+V.ele.ACC.3.M.PL+IMPF+1+PL
liofilizávamo-nos	liofilizar+nós.AD.1.PL+IMPF+1+PL
liofilizávamos-lhe	liofilizar+V.ele.DAT.3.SG+IMPF+1+PL
liofilizávamos-lhes	liofilizar+V.ele.DAT.3.PL+IMPF+1+PL
liofilizávamos-me	liofilizar+V.eu.AD.1.SG+IMPF+1+PL
liofilizávamos-te	liofilizar+V.tu.AD.2.SG+IMPF+1+PL
liofilizávamos-vos	liofilizar+V.vós.AD.2.PL+IMPF+1+PL
liofilizavam-se	liofilizar+V.ele.REFL+IMPF+3+PL
liofilizavam-te	liofilizar+V.tu.AD.2.SG+IMPF+3+PL
liofilizavam-vos	liofilizar+V.vós.AD.2.PL+IMPF+3+PL
liofilizava-nos	liofilizar+nós.AD.1.PL+IMPF+1+SG
liofilizava-nos	liofilizar+nós.AD.1.PL+IMPF+2+SG
liofilizava-nos	liofilizar+nós.AD.1.PL+IMPF+3+SG
liofilizava-o	liofilizar+V.ele.ACC.3.M.SG+IMPF+1+SG
liofilizava-o	liofilizar+V.ele.ACC.3.M.SG+IMPF+3+SG
liofilizava-os	liofilizar+V.ele.ACC.3.M.PL+IMPF+1+SG
liofilizava-os	liofilizar+V.ele.ACC.3.M.PL+IMPF+3+SG
liofilizava-se	liofilizar+V.ele.REFL+IMPF+1+SG
liofilizava-se	liofilizar+V.ele.REFL+IMPF+3+SG
liofilizavas-lhe	liofilizar+V.ele.DAT.3.SG+IMPF+2+SG
liofilizavas-lhes	liofilizar+V.ele.DAT.3.PL+IMPF+2+SG
liofilizavas-me	liofilizar+V.eu.AD.1.SG+IMPF+2+SG
liofilizavas-te	liofilizar+V.tu.AD.2.SG+IMPF+2+SG
liofilizavas-vos	liofilizar+V.vós.AD.2.PL+IMPF+2+SG
liofilizava-te	liofilizar+V.tu.AD.2.SG+IMPF+1+SG
liofilizava-te	liofilizar+V.tu.AD.2.SG+IMPF+3+SG
liofilizava-vos	liofilizar+V.vós.AD.2.PL+IMPF+1+SG
liofilizava-vos	liofilizar+V.vós.AD.2.PL+IMPF+3+SG
liofilizávei-la	liofilizar+V.ele.ACC.3.F.SG+IMPF+2+PL
liofilizávei-las	liofilizar+V.ele.ACC.3.F.PL+IMPF+2+PL
liofilizávei-lo	liofilizar+V.ele.ACC.3.M.SG+IMPF+2+PL
liofilizávei-los	liofilizar+V.ele.ACC.3.M.PL+IMPF+2+PL
liofilizávei-nos	liofilizar+nós.AD.1.PL+IMPF+2+PL
liofilizáveis-lhe	liofilizar+V.ele.DAT.3.SG+IMPF+2+PL
liofilizáveis-lhes	liofilizar+V.ele.DAT.3.PL+IMPF+2+PL
liofilizáveis-me	liofilizar+V.eu.AD.1.SG+IMPF+2+PL
liofilizáveis-te	liofilizar+V.tu.AD.2.SG+IMPF+2+PL
liofilizáveis-vos	liofilizar+V.vós.AD.2.PL+IMPF+2+PL
liofiliza-vos	liofilizar+V.vós.AD.2.PL+PRS+3+SG
liofilize-a	liofilizar+V.ele.ACC.3.F.SG+IMP+3+SG
liofilize-as	liofilizar+V.ele.ACC.3.F.PL+IMP+3+SG
liofilizei-a	liofilizar+V.ele.ACC.3.F.SG+PRF+1+SG
liofilizei-as	liofilizar+V.ele.ACC.3.F.PL+PRF+1+SG
liofilizei-lhe	liofilizar+V.ele.DAT.3.SG+PRF+1+SG
liofilizei-lhes	liofilizar+V.ele.DAT.3.PL+PRF+1+SG
liofilizei-me	liofilizar+V.eu.AD.1.SG+PRF+1+SG
liofilizei-nos	liofilizar+nós.AD.1.PL+PRF+1+SG
liofilizei-o	liofilizar+V.ele.ACC.3.M.SG+PRF+1+SG
liofilizei-os	liofilizar+V.ele.ACC.3.M.PL+PRF+1+SG
liofilizei-te	liofilizar+V.tu.AD.2.SG+PRF+1+SG
liofilizei-vos	liofilizar+V.vós.AD.2.PL+PRF+1+SG
liofilize-lhe	liofilizar+V.ele.DAT.3.SG+IMP+3+SG
liofilize-lhes	liofilizar+V.ele.DAT.3.PL+IMP+3+SG
liofilize-me	liofilizar+V.eu.AD.1.SG+IMP+3+SG
liofilizem-lhe	liofilizar+V.ele.DAT.3.SG+IMP+3+PL
liofilizem-lhes	liofilizar+V.ele.DAT.3.PL+IMP+3+PL
liofilizem-me	liofilizar+V.eu.AD.1.SG+IMP+3+PL
liofilizem-na	liofilizar+V.ele.ACC.3.F.SG+IMP+3+PL
liofilizem-nas	liofilizar+V.ele.ACC.3.F.PL+IMP+3+PL
liofilizem-no	liofilizar+V.ele.ACC.3.M.SG+IMP+3+PL
liofilizem-nos	liofilizar+V.ele.ACC.3.M.PL+IMP+3+PL
liofilizem-nos	liofilizar+V.nós.AD.1.PL+IMP+3+PL
liofilizemo-la	liofilizar+V.ele.ACC.3.F.SG+IMP+1+PL
liofilizemo-las	liofilizar+V.ele.ACC.3.F.PL+IMP+1+PL
liofilizemo-lo	liofilizar+V.ele.ACC.3.M.SG+IMP+1+PL
liofilizemo-los	liofilizar+V.ele.ACC.3.M.PL+IMP+1+PL
liofilizemo-nos	liofilizar+nós.AD.1.PL+IMP+1+PL
liofilizemos-lhe	liofilizar+V.ele.DAT.3.SG+IMP+1+PL
liofilizemos-lhes	liofilizar+V.ele.DAT.3.PL+IMP+1+PL
liofilizemos-me	liofilizar+V.eu.AD.1.SG+IMP+1+PL
liofilizemos-te	liofilizar+V.tu.AD.2.SG+IMP+1+PL
liofilizemos-vos	liofilizar+V.vós.AD.2.PL+IMP+1+PL
liofilizem-se	liofilizar+V.ele.REFL+IMP+3+PL
liofilizem-te	liofilizar+V.tu.AD.2.SG+IMP+3+PL
liofilizem-vos	liofilizar+V.vós.AD.2.PL+IMP+3+PL
liofilize-nos	liofilizar+nós.AD.1.PL+IMP+3+SG
liofilize-o	liofilizar+V.ele.ACC.3.M.SG+IMP+3+SG
liofilize-os	liofilizar+V.ele.ACC.3.M.PL+IMP+3+SG
liofilize-se	liofilizar+V.ele.REFL+IMP+3+SG
liofilize-te	liofilizar+V.tu.AD.2.SG+IMP+3+SG
liofilize-vos	liofilizar+V.vós.AD.2.PL+IMP+3+SG
liofilizo-a	liofilizar+V.ele.ACC.3.F.SG+PRS+1+SG
liofilizo-as	liofilizar+V.ele.ACC.3.F.PL+PRS+1+SG
liofilizo-lhe	liofilizar+V.ele.DAT.3.SG+PRS+1+SG
liofilizo-lhes	liofilizar+V.ele.DAT.3.PL+PRS+1+SG
liofilizo-me	liofilizar+V.eu.AD.1.SG+PRS+1+SG
liofilizo-nos	liofilizar+nós.AD.1.PL+PRS+1+SG
liofilizo-o	liofilizar+V.ele.ACC.3.M.SG+PRS+1+SG
liofilizo-os	liofilizar+V.ele.ACC.3.M.PL+PRS+1+SG
liofilizo-te	liofilizar+V.tu.AD.2.SG+PRS+1+SG
liofilizou-a	liofilizar+V.ele.ACC.3.F.SG+PRF+3+SG
liofilizou-as	liofilizar+V.ele.ACC.3.F.PL+PRF+3+SG
liofilizou-lhe	liofilizar+V.ele.DAT.3.SG+PRF+3+SG
liofilizou-lhes	liofilizar+V.ele.DAT.3.PL+PRF+3+SG
liofilizou-me	liofilizar+V.eu.AD.1.SG+PRF+3+SG
liofilizou-nos	liofilizar+nós.AD.1.PL+PRF+3+SG
liofilizou-o	liofilizar+V.ele.ACC.3.M.SG+PRF+3+SG
liofilizou-os	liofilizar+V.ele.ACC.3.M.PL+PRF+3+SG
liofilizou-se	liofilizar+V.ele.REFL+PRF+3+SG
liofilizou-te	liofilizar+V.tu.AD.2.SG+PRF+3+SG
liofilizou-vos	liofilizar+V.vós.AD.2.PL+PRF+3+SG
liofilizo-vos	liofilizar+V.vós.AD.2.PL+PRS+1+SG
li-o	ler+V.ele.ACC.3.M.SG+PRF+1+SG
lio-lhe	liar+V.ele.DAT.3.SG+PRS+1+SG
lio-lhes	liar+V.ele.DAT.3.PL+PRS+1+SG
lio-me	liar+V.eu.AD.1.SG+PRS+1+SG
lio-nos	liar+nós.AD.1.PL+PRS+1+SG
lio-o	liar+V.ele.ACC.3.M.SG+PRS+1+SG
lio-os	liar+V.ele.ACC.3.M.PL+PRS+1+SG
li-os	ler+V.ele.ACC.3.M.PL+PRF+1+SG
lio-te	liar+V.tu.AD.2.SG+PRS+1+SG
liou-a	liar+V.ele.ACC.3.F.SG+PRF+3+SG
liou-as	liar+V.ele.ACC.3.F.PL+PRF+3+SG
liou-lhe	liar+V.ele.DAT.3.SG+PRF+3+SG
liou-lhes	liar+V.ele.DAT.3.PL+PRF+3+SG
liou-me	liar+V.eu.AD.1.SG+PRF+3+SG
liou-nos	liar+nós.AD.1.PL+PRF+3+SG
liou-o	liar+V.ele.ACC.3.M.SG+PRF+3+SG
liou-os	liar+V.ele.ACC.3.M.PL+PRF+3+SG
liou-se	liar+V.ele.REFL+PRF+3+SG
liou-te	liar+V.tu.AD.2.SG+PRF+3+SG
liou-vos	liar+V.vós.AD.2.PL+PRF+3+SG
lio-vos	liar+V.vós.AD.2.PL+PRS+1+SG
liquefaça-a	liquefazer+V.ele.ACC.3.F.SG+IMP+3+SG
liquefaça-as	liquefazer+V.ele.ACC.3.F.PL+IMP+3+SG
liquefaça-lhe	liquefazer+V.ele.DAT.3.SG+IMP+3+SG
liquefaça-lhes	liquefazer+V.ele.DAT.3.PL+IMP+3+SG
liquefaça-me	liquefazer+V.eu.AD.1.SG+IMP+3+SG
liquefaçam-lhe	liquefazer+V.ele.DAT.3.SG+IMP+3+PL
liquefaçam-lhes	liquefazer+V.ele.DAT.3.PL+IMP+3+PL
liquefaçam-me	liquefazer+V.eu.AD.1.SG+IMP+3+PL
liquefaçam-na	liquefazer+V.ele.ACC.3.F.SG+IMP+3+PL
liquefaçam-nas	liquefazer+V.ele.ACC.3.F.PL+IMP+3+PL
liquefaçam-no	liquefazer+V.ele.ACC.3.M.SG+IMP+3+PL
liquefaçam-nos	liquefazer+nós.AD.1.PL+IMP+3+PL
liquefaçamo-la	liquefazer+V.ele.ACC.3.F.SG+IMP+1+PL
liquefaçamo-las	liquefazer+V.ele.ACC.3.F.PL+IMP+1+PL
liquefaçamo-lo	liquefazer+V.ele.ACC.3.M.SG+IMP+1+PL
liquefaçamo-los	liquefazer+V.ele.ACC.3.M.PL+IMP+1+PL
liquefaçamo-nos	liquefazer+nós.AD.1.PL+IMP+1+PL
liquefaçamos-lhe	liquefazer+V.ele.DAT.3.SG+IMP+1+PL
liquefaçamos-lhes	liquefazer+V.ele.DAT.3.PL+IMP+1+PL
liquefaçamos-me	liquefazer+V.eu.AD.1.SG+IMP+1+PL
liquefaçamos-te	liquefazer+V.tu.AD.2.SG+IMP+1+PL
liquefaçamos-vos	liquefazer+V.vós.AD.2.PL+IMP+1+PL
liquefaçam-se	liquefazer+V.ele.REFL+IMP+3+PL
liquefaçam-te	liquefazer+V.tu.AD.2.SG+IMP+3+PL
liquefaçam-vos	liquefazer+V.vós.AD.2.PL+IMP+3+PL
liquefaça-nos	liquefazer+nós.AD.1.PL+IMP+3+SG
liquefaça-o	liquefazer+V.ele.ACC.3.M.SG+IMP+3+SG
liquefaça-os	liquefazer+V.ele.ACC.3.M.PL+IMP+3+SG
liquefaça-se	liquefazer+V.ele.REFL+IMP+3+SG
liquefaça-te	liquefazer+V.tu.AD.2.SG+IMP+3+SG
liquefaça-vos	liquefazer+V.vós.AD.2.PL+IMP+3+SG
liquefaço-a	liquefazer+V.ele.ACC.3.F.SG+PRS+1+SG
liquefaço-as	liquefazer+V.ele.ACC.3.F.PL+PRS+1+SG
liquefaço-lhe	liquefazer+V.ele.DAT.3.SG+PRS+1+SG
liquefaço-lhes	liquefazer+V.ele.DAT.3.PL+PRS+1+SG
liquefaço-me	liquefazer+V.eu.AD.1.SG+PRS+1+SG
liquefaço-nos	liquefazer+nós.AD.1.PL+PRS+1+SG
liquefaço-o	liquefazer+V.ele.ACC.3.M.SG+PRS+1+SG
liquefaço-os	liquefazer+V.ele.ACC.3.M.PL+PRS+1+SG
liquefaço-te	liquefazer+V.tu.AD.2.SG+PRS+1+SG
liquefaço-vos	liquefazer+V.vós.AD.2.PL+PRS+1+SG
liquefá-la-á	liquefazer+V.ele.ACC.3.F.SG+FUT+3+SG
liquefá-la-ão	liquefazer+V.ele.ACC.3.F.SG+FUT+3+PL
liquefá-la-ás	liquefazer+V.ele.ACC.3.F.SG+FUT+2+SG
liquefá-la-ei	liquefazer+V.ele.ACC.3.F.SG+FUT+1+SG
liquefá-la-eis	liquefazer+V.ele.ACC.3.F.SG+FUT+2+PL
liquefá-la-emos	liquefazer+V.ele.ACC.3.F.SG+FUT+1+PL
liquefá-la-ia	liquefazer+V.ele.ACC.3.F.SG+COND+1+SG
liquefá-la-ia	liquefazer+V.ele.ACC.3.F.SG+COND+3+SG
liquefá-la-iam	liquefazer+V.ele.ACC.3.F.SG+COND+3+PL
liquefá-la-íamos	liquefazer+V.ele.ACC.3.F.SG+COND+1+PL
liquefá-la-ias	liquefazer+V.ele.ACC.3.F.SG+COND+2+SG
liquefá-la-íeis	liquefazer+V.ele.ACC.3.F.SG+COND+2+PL
liquefá-las-á	liquefazer+V.ele.ACC.3.F.PL+FUT+3+SG
liquefá-las-ão	liquefazer+V.ele.ACC.3.F.PL+FUT+3+PL
liquefá-las-ás	liquefazer+V.ele.ACC.3.F.PL+FUT+2+SG
liquefá-las-ei	liquefazer+V.ele.ACC.3.F.PL+FUT+1+SG
liquefá-las-eis	liquefazer+V.ele.ACC.3.F.PL+FUT+2+PL
liquefá-las-emos	liquefazer+V.ele.ACC.3.F.PL+FUT+1+PL
liquefá-las-ia	liquefazer+V.ele.ACC.3.F.PL+COND+1+SG
liquefá-las-ia	liquefazer+V.ele.ACC.3.F.PL+COND+3+SG
liquefá-las-iam	liquefazer+V.ele.ACC.3.F.PL+COND+3+PL
liquefá-las-íamos	liquefazer+V.ele.ACC.3.F.PL+COND+1+PL
liquefá-las-ias	liquefazer+V.ele.ACC.3.F.PL+COND+2+SG
liquefá-las-íeis	liquefazer+V.ele.ACC.3.F.PL+COND+2+PL
liquefá-lo-á	liquefazer+V.ele.ACC.3.M.SG+FUT+3+SG
liquefá-lo-ão	liquefazer+V.ele.ACC.3.M.SG+FUT+3+PL
liquefá-lo-ás	liquefazer+V.ele.ACC.3.M.SG+FUT+2+SG
liquefá-lo-ei	liquefazer+V.ele.ACC.3.M.SG+FUT+1+SG
liquefá-lo-eis	liquefazer+V.ele.ACC.3.M.SG+FUT+2+PL
liquefá-lo-emos	liquefazer+V.ele.ACC.3.M.SG+FUT+1+PL
liquefá-lo-ia	liquefazer+V.ele.ACC.3.M.SG+COND+1+SG
liquefá-lo-ia	liquefazer+V.ele.ACC.3.M.SG+COND+3+SG
liquefá-lo-iam	liquefazer+V.ele.ACC.3.M.SG+COND+3+PL
liquefá-lo-íamos	liquefazer+V.ele.ACC.3.M.SG+COND+1+PL
liquefá-lo-ias	liquefazer+V.ele.ACC.3.M.SG+COND+2+SG
liquefá-lo-íeis	liquefazer+V.ele.ACC.3.M.SG+COND+2+PL
liquefá-los-á	liquefazer+V.ele.ACC.3.M.PL+FUT+3+SG
liquefá-los-ão	liquefazer+V.ele.ACC.3.M.PL+FUT+3+PL
liquefá-los-ás	liquefazer+V.ele.ACC.3.M.PL+FUT+2+SG
liquefá-los-ei	liquefazer+V.ele.ACC.3.M.PL+FUT+1+SG
liquefá-los-eis	liquefazer+V.ele.ACC.3.M.PL+FUT+2+PL
liquefá-los-emos	liquefazer+V.ele.ACC.3.M.PL+FUT+1+PL
liquefá-los-ia	liquefazer+V.ele.ACC.3.M.PL+COND+1+SG
liquefá-los-ia	liquefazer+V.ele.ACC.3.M.PL+COND+3+SG
liquefá-los-iam	liquefazer+V.ele.ACC.3.M.PL+COND+3+PL
liquefá-los-íamos	liquefazer+V.ele.ACC.3.M.PL+COND+1+PL
liquefá-los-ias	liquefazer+V.ele.ACC.3.M.PL+COND+2+SG
liquefá-los-íeis	liquefazer+V.ele.ACC.3.M.PL+COND+2+PL
liquefar-lhe-á	liquefazer+V.ele.DAT.3.SG+FUT+3+SG
liquefar-lhe-ão	liquefazer+V.ele.DAT.3.SG+FUT+3+PL
liquefar-lhe-ás	liquefazer+V.ele.DAT.3.SG+FUT+2+SG
liquefar-lhe-ei	liquefazer+V.ele.DAT.3.SG+FUT+1+SG
liquefar-lhe-eis	liquefazer+V.ele.DAT.3.SG+FUT+2+PL
liquefar-lhe-emos	liquefazer+V.ele.DAT.3.SG+FUT+1+PL
liquefar-lhe-ia	liquefazer+V.ele.DAT.3.SG+COND+1+SG
liquefar-lhe-ia	liquefazer+V.ele.DAT.3.SG+COND+3+SG
liquefar-lhe-iam	liquefazer+V.ele.DAT.3.SG+COND+3+PL
liquefar-lhe-íamos	liquefazer+V.ele.DAT.3.SG+COND+1+PL
liquefar-lhe-ias	liquefazer+V.ele.DAT.3.SG+COND+2+SG
liquefar-lhe-íeis	liquefazer+V.ele.DAT.3.SG+COND+2+PL
liquefar-lhes-á	liquefazer+V.ele.DAT.3.PL+FUT+3+SG
liquefar-lhes-ão	liquefazer+V.ele.DAT.3.PL+FUT+3+PL
liquefar-lhes-ás	liquefazer+V.ele.DAT.3.PL+FUT+2+SG
liquefar-lhes-ei	liquefazer+V.ele.DAT.3.PL+FUT+1+SG
liquefar-lhes-eis	liquefazer+V.ele.DAT.3.PL+FUT+2+PL
liquefar-lhes-emos	liquefazer+V.ele.DAT.3.PL+FUT+1+PL
liquefar-lhes-ia	liquefazer+V.ele.DAT.3.PL+COND+1+SG
liquefar-lhes-ia	liquefazer+V.ele.DAT.3.PL+COND+3+SG
liquefar-lhes-iam	liquefazer+V.ele.DAT.3.PL+COND+3+PL
liquefar-lhes-íamos	liquefazer+V.ele.DAT.3.PL+COND+1+PL
liquefar-lhes-ias	liquefazer+V.ele.DAT.3.PL+COND+2+SG
liquefar-lhes-íeis	liquefazer+V.ele.DAT.3.PL+COND+2+PL
liquefar-me-á	liquefazer+V.eu.AD.1.SG+FUT+3+SG
liquefar-me-ão	liquefazer+V.eu.AD.1.SG+FUT+3+PL
liquefar-me-ás	liquefazer+V.eu.AD.1.SG+FUT+2+SG
liquefar-me-ei	liquefazer+V.eu.AD.1.SG+FUT+1+SG
liquefar-me-eis	liquefazer+V.eu.AD.1.SG+FUT+2+PL
liquefar-me-emos	liquefazer+V.eu.AD.1.SG+FUT+1+PL
liquefar-me-ia	liquefazer+V.eu.AD.1.SG+COND+1+SG
liquefar-me-ia	liquefazer+V.eu.AD.1.SG+COND+3+SG
liquefar-me-iam	liquefazer+V.eu.AD.1.SG+COND+3+PL
liquefar-me-íamos	liquefazer+V.eu.AD.1.SG+COND+1+PL
liquefar-me-ias	liquefazer+V.eu.AD.1.SG+COND+2+SG
liquefar-me-íeis	liquefazer+V.eu.AD.1.SG+COND+2+PL
liquefar-nos-á	liquefazer+nós.AD.1.PL+FUT+3+SG
liquefar-nos-ão	liquefazer+nós.AD.1.PL+FUT+3+PL
liquefar-nos-ás	liquefazer+nós.AD.1.PL+FUT+2+SG
liquefar-nos-ei	liquefazer+nós.AD.1.PL+FUT+1+SG
liquefar-nos-eis	liquefazer+nós.AD.1.PL+FUT+2+PL
liquefar-nos-emos	liquefazer+nós.AD.1.PL+FUT+1+PL
liquefar-nos-ia	liquefazer+nós.AD.1.PL+COND+1+SG
liquefar-nos-ia	liquefazer+nós.AD.1.PL+COND+3+SG
liquefar-nos-iam	liquefazer+nós.AD.1.PL+COND+3+PL
liquefar-nos-íamos	liquefazer+nós.AD.1.PL+COND+1+PL
liquefar-nos-ias	liquefazer+nós.AD.1.PL+COND+2+SG
liquefar-nos-íeis	liquefazer+nós.AD.1.PL+COND+2+PL
liquefar-se-á	liquefazer+V.ele.REFL+FUT+3+SG
liquefar-se-ão	liquefazer+V.ele.REFL+FUT+3+PL
liquefar-se-ia	liquefazer+V.ele.REFL+COND+3+SG
liquefar-se-iam	liquefazer+V.ele.REFL+COND+3+PL
liquefar-te-á	liquefazer+V.tu.AD.2.SG+FUT+3+SG
liquefar-te-ão	liquefazer+V.tu.AD.2.SG+FUT+3+PL
liquefar-te-ás	liquefazer+V.tu.AD.2.SG+FUT+2+SG
liquefar-te-ei	liquefazer+V.tu.AD.2.SG+FUT+1+SG
liquefar-te-eis	liquefazer+V.tu.AD.2.SG+FUT+2+PL
liquefar-te-emos	liquefazer+V.tu.AD.2.SG+FUT+1+PL
liquefar-te-ia	liquefazer+V.tu.AD.2.SG+COND+1+SG
liquefar-te-ia	liquefazer+V.tu.AD.2.SG+COND+3+SG
liquefar-te-iam	liquefazer+V.tu.AD.2.SG+COND+3+PL
liquefar-te-íamos	liquefazer+V.tu.AD.2.SG+COND+1+PL
liquefar-te-ias	liquefazer+V.tu.AD.2.SG+COND+2+SG
liquefar-te-íeis	liquefazer+V.tu.AD.2.SG+COND+2+PL
liquefar-vos-á	liquefazer+V.vós.AD.2.PL+FUT+3+SG
liquefar-vos-ão	liquefazer+V.vós.AD.2.PL+FUT+3+PL
liquefar-vos-ás	liquefazer+V.vós.AD.2.PL+FUT+2+SG
liquefar-vos-ei	liquefazer+V.vós.AD.2.PL+FUT+1+SG
liquefar-vos-eis	liquefazer+V.vós.AD.2.PL+FUT+2+PL
liquefar-vos-emos	liquefazer+V.vós.AD.2.PL+FUT+1+PL
liquefar-vos-ia	liquefazer+V.vós.AD.2.PL+COND+1+SG
liquefar-vos-ia	liquefazer+V.vós.AD.2.PL+COND+3+SG
liquefar-vos-iam	liquefazer+V.vós.AD.2.PL+COND+3+PL
liquefar-vos-íamos	liquefazer+V.vós.AD.2.PL+COND+1+PL
liquefar-vos-ias	liquefazer+V.vós.AD.2.PL+COND+2+SG
liquefar-vos-íeis	liquefazer+V.vós.AD.2.PL+COND+2+PL
liquefaz-a	liquefazer+V.ele.ACC.3.F.SG+PRS+3+SG
liquefaz-as	liquefazer+V.ele.ACC.3.F.PL+PRS+3+SG
liquefazei-la	liquefazer+V.ele.ACC.3.F.SG+PRS+2+PL
liquefazei-las	liquefazer+V.ele.ACC.3.F.PL+PRS+2+PL
liquefazei-lo	liquefazer+V.ele.ACC.3.M.SG+PRS+2+PL
liquefazei-los	liquefazer+V.ele.ACC.3.M.PL+PRS+2+PL
liquefazei-nos	liquefazer+nós.AD.1.PL+PRS+2+PL
liquefazeis-lhe	liquefazer+V.ele.DAT.3.SG+PRS+2+PL
liquefazeis-lhes	liquefazer+V.ele.DAT.3.PL+PRS+2+PL
liquefazeis-me	liquefazer+V.eu.AD.1.SG+PRS+2+PL
liquefazeis-te	liquefazer+V.tu.AD.2.SG+PRS+2+PL
liquefazeis-vos	liquefazer+V.vós.AD.2.PL+PRS+2+PL
liquefazê-la	liquefazer+V.ele.ACC.3.F.SG+INF
liquefazê-la	liquefazer+V.ele.ACC.3.F.SG+INF+1+SG
liquefazê-la	liquefazer+V.ele.ACC.3.F.SG+INF+3+SG
liquefaze-la	liquefazer+V.ele.ACC.3.F.SG+PRS+2+SG
liquefazê-las	liquefazer+V.ele.ACC.3.F.PL+INF
liquefazê-las	liquefazer+V.ele.ACC.3.F.PL+INF+1+SG
liquefazê-las	liquefazer+V.ele.ACC.3.F.PL+INF+3+SG
liquefaze-las	liquefazer+V.ele.ACC.3.F.PL+PRS+2+SG
liquefazê-lo	liquefazer+V.ele.ACC.3.M.SG+INF
liquefazê-lo	liquefazer+V.ele.ACC.3.M.SG+INF+1+SG
liquefazê-lo	liquefazer+V.ele.ACC.3.M.SG+INF+3+SG
liquefaze-lo	liquefazer+V.ele.ACC.3.M.SG+PRS+2+SG
liquefazê-los	liquefazer+V.ele.ACC.3.M.PL+INF
liquefazê-los	liquefazer+V.ele.ACC.3.M.PL+INF+1+SG
liquefazê-los	liquefazer+V.ele.ACC.3.M.PL+INF+3+SG
liquefaze-los	liquefazer+V.ele.ACC.3.M.PL+PRS+2+SG
liquefazem-lhe	liquefazer+V.ele.DAT.3.SG+PRS+3+PL
liquefazem-lhes	liquefazer+V.ele.DAT.3.PL+PRS+3+PL
liquefazem-me	liquefazer+V.eu.AD.1.SG+PRS+3+PL
liquefazem-na	liquefazer+V.ele.ACC.3.F.SG+PRS+3+PL
liquefazem-nas	liquefazer+V.ele.ACC.3.F.PL+PRS+3+PL
liquefazem-no	liquefazer+V.ele.ACC.3.M.SG+PRS+3+PL
liquefazem-nos	liquefazer+V.ele.ACC.3.M.PL+PRS+3+PL
liquefazem-nos	liquefazer+V.nós.AD.1.PL+PRS+3+PL
liquefazemo-la	liquefazer+V.ele.ACC.3.F.SG+PRS+1+PL
liquefazemo-las	liquefazer+V.ele.ACC.3.F.PL+PRS+1+PL
liquefazemo-lo	liquefazer+V.ele.ACC.3.M.SG+PRS+1+PL
liquefazemo-los	liquefazer+V.ele.ACC.3.M.PL+PRS+1+PL
liquefazemo-nos	liquefazer+nós.AD.1.PL+PRS+1+PL
liquefazemos-lhe	liquefazer+V.ele.DAT.3.SG+PRS+1+PL
liquefazemos-lhes	liquefazer+V.ele.DAT.3.PL+PRS+1+PL
liquefazemos-me	liquefazer+V.eu.AD.1.SG+PRS+1+PL
liquefazemos-te	liquefazer+V.tu.AD.2.SG+PRS+1+PL
liquefazemos-vos	liquefazer+V.vós.AD.2.PL+PRS+1+PL
liquefazem-se	liquefazer+V.ele.REFL+PRS+3+PL
liquefazem-te	liquefazer+V.tu.AD.2.SG+PRS+3+PL
liquefazem-vos	liquefazer+V.vós.AD.2.PL+PRS+3+PL
liquefazendo-a	liquefazer+V.ele.ACC.3.F.SG+GRD
liquefazendo-as	liquefazer+V.ele.ACC.3.F.PL+GRD
liquefazendo-lhe	liquefazer+V.ele.DAT.3.SG+GRD
liquefazendo-lhes	liquefazer+V.ele.DAT.3.PL+GRD
liquefazendo-me	liquefazer+V.eu.AD.1.SG+GRD
liquefazendo-nos	liquefazer+nós.AD.1.PL+GRD
liquefazendo-o	liquefazer+V.ele.ACC.3.M.SG+GRD
liquefazendo-os	liquefazer+V.ele.ACC.3.M.PL+GRD
liquefazendo-se	liquefazer+V.ele.REFL+GRD
liquefazendo-te	liquefazer+V.tu.AD.2.SG+GRD
liquefazendo-vos	liquefazer+V.vós.AD.2.PL+GRD
liquefaze-nos	liquefazer+nós.AD.1.PL+PRS+2+SG
liquefazerde-la	liquefazer+V.ele.ACC.3.F.SG+INF+2+PL
liquefazerde-las	liquefazer+V.ele.ACC.3.F.PL+INF+2+PL
liquefazerde-lo	liquefazer+V.ele.ACC.3.M.SG+INF+2+PL
liquefazerde-los	liquefazer+V.ele.ACC.3.M.PL+INF+2+PL
liquefazerde-nos	liquefazer+nós.AD.1.PL+INF+2+PL
liquefazerdes-lhe	liquefazer+V.ele.DAT.3.SG+INF+2+PL
liquefazerdes-lhes	liquefazer+V.ele.DAT.3.PL+INF+2+PL
liquefazerdes-me	liquefazer+V.eu.AD.1.SG+INF+2+PL
liquefazerdes-te	liquefazer+V.tu.AD.2.SG+INF+2+PL
liquefazerdes-vos	liquefazer+V.vós.AD.2.PL+INF+2+PL
liquefazere-la	liquefazer+V.ele.ACC.3.F.SG+INF+2+SG
liquefazere-las	liquefazer+V.ele.ACC.3.F.PL+INF+2+SG
liquefazere-lo	liquefazer+V.ele.ACC.3.M.SG+INF+2+SG
liquefazere-los	liquefazer+V.ele.ACC.3.M.PL+INF+2+SG
liquefazerem-lhe	liquefazer+V.ele.DAT.3.SG+INF+3+PL
liquefazerem-lhes	liquefazer+V.ele.DAT.3.PL+INF+3+PL
liquefazerem-me	liquefazer+V.eu.AD.1.SG+INF+3+PL
liquefazerem-na	liquefazer+V.ele.ACC.3.F.SG+INF+3+PL
liquefazerem-nas	liquefazer+V.ele.ACC.3.F.PL+INF+3+PL
liquefazerem-no	liquefazer+V.ele.ACC.3.M.SG+INF+3+PL
liquefazerem-nos	liquefazer+V.ele.ACC.3.M.PL+INF+3+PL
liquefazerem-nos	liquefazer+V.nós.AD.1.PL+INF+3+PL
liquefazerem-se	liquefazer+V.ele.REFL+INF+3+PL
liquefazerem-te	liquefazer+V.tu.AD.2.SG+INF+3+PL
liquefazerem-vos	liquefazer+V.vós.AD.2.PL+INF+3+PL
liquefazere-nos	liquefazer+nós.AD.1.PL+INF+2+SG
liquefazeres-lhe	liquefazer+V.ele.DAT.3.SG+INF+2+SG
liquefazeres-lhes	liquefazer+V.ele.DAT.3.PL+INF+2+SG
liquefazeres-me	liquefazer+V.eu.AD.1.SG+INF+2+SG
liquefazeres-te	liquefazer+V.tu.AD.2.SG+INF+2+SG
liquefazeres-vos	liquefazer+V.vós.AD.2.PL+INF+2+SG
liquefazer-lhe	liquefazer+V.ele.DAT.3.SG+INF
liquefazer-lhe	liquefazer+V.ele.DAT.3.SG+INF+1+SG
liquefazer-lhe	liquefazer+V.ele.DAT.3.SG+INF+3+SG
liquefazer-lhes	liquefazer+V.ele.DAT.3.PL+INF
liquefazer-lhes	liquefazer+V.ele.DAT.3.PL+INF+1+SG
liquefazer-lhes	liquefazer+V.ele.DAT.3.PL+INF+3+SG
liquefazer-me	liquefazer+V.eu.AD.1.SG+INF
liquefazer-me	liquefazer+V.eu.AD.1.SG+INF+1+SG
liquefazer-me	liquefazer+V.eu.AD.1.SG+INF+3+SG
liquefazermo-la	liquefazer+V.ele.ACC.3.F.SG+INF+1+PL
liquefazermo-las	liquefazer+V.ele.ACC.3.F.PL+INF+1+PL
liquefazermo-lo	liquefazer+V.ele.ACC.3.M.SG+INF+1+PL
liquefazermo-los	liquefazer+V.ele.ACC.3.M.PL+INF+1+PL
liquefazermo-nos	liquefazer+nós.AD.1.PL+INF+1+PL
liquefazermos-lhe	liquefazer+V.ele.DAT.3.SG+INF+1+PL
liquefazermos-lhes	liquefazer+V.ele.DAT.3.PL+INF+1+PL
liquefazermos-me	liquefazer+V.eu.AD.1.SG+INF+1+PL
liquefazermos-te	liquefazer+V.tu.AD.2.SG+INF+1+PL
liquefazermos-vos	liquefazer+V.vós.AD.2.PL+INF+1+PL
liquefazer-nos	liquefazer+nós.AD.1.PL+INF
liquefazer-nos	liquefazer+nós.AD.1.PL+INF+1+SG
liquefazer-nos	liquefazer+nós.AD.1.PL+INF+3+SG
liquefazer-se	liquefazer+V.ele.REFL+INF
liquefazer-se	liquefazer+V.ele.REFL+INF+3+SG
liquefazer-te	liquefazer+V.tu.AD.2.SG+INF
liquefazer-te	liquefazer+V.tu.AD.2.SG+INF+1+SG
liquefazer-te	liquefazer+V.tu.AD.2.SG+INF+3+SG
liquefazer-vos	liquefazer+V.vós.AD.2.PL+INF
liquefazer-vos	liquefazer+V.vós.AD.2.PL+INF+1+SG
liquefazer-vos	liquefazer+V.vós.AD.2.PL+INF+3+SG
liquefazes-lhe	liquefazer+V.ele.DAT.3.SG+PRS+2+SG
liquefazes-lhes	liquefazer+V.ele.DAT.3.PL+PRS+2+SG
liquefazes-me	liquefazer+V.eu.AD.1.SG+PRS+2+SG
liquefazes-te	liquefazer+V.tu.AD.2.SG+PRS+2+SG
liquefazes-vos	liquefazer+V.vós.AD.2.PL+PRS+2+SG
liquefazia-a	liquefazer+V.ele.ACC.3.F.SG+IMPF+1+SG
liquefazia-a	liquefazer+V.ele.ACC.3.F.SG+IMPF+3+SG
liquefazia-as	liquefazer+V.ele.ACC.3.F.PL+IMPF+1+SG
liquefazia-as	liquefazer+V.ele.ACC.3.F.PL+IMPF+3+SG
liquefazia-la	liquefazer+V.ele.ACC.3.F.SG+IMPF+2+SG
liquefazia-las	liquefazer+V.ele.ACC.3.F.PL+IMPF+2+SG
liquefazia-lhe	liquefazer+V.ele.DAT.3.SG+IMPF+1+SG
liquefazia-lhe	liquefazer+V.ele.DAT.3.SG+IMPF+3+SG
liquefazia-lhes	liquefazer+V.ele.DAT.3.PL+IMPF+1+SG
liquefazia-lhes	liquefazer+V.ele.DAT.3.PL+IMPF+3+SG
liquefazia-lo	liquefazer+V.ele.ACC.3.M.SG+IMPF+2+SG
liquefazia-los	liquefazer+V.ele.ACC.3.M.PL+IMPF+2+SG
liquefazia-me	liquefazer+V.eu.AD.1.SG+IMPF+1+SG
liquefazia-me	liquefazer+V.eu.AD.1.SG+IMPF+3+SG
liquefaziam-lhe	liquefazer+V.ele.DAT.3.SG+IMPF+3+PL
liquefaziam-lhes	liquefazer+V.ele.DAT.3.PL+IMPF+3+PL
liquefaziam-me	liquefazer+V.eu.AD.1.SG+IMPF+3+PL
liquefaziam-na	liquefazer+V.ele.ACC.3.F.SG+IMPF+3+PL
liquefaziam-nas	liquefazer+V.ele.ACC.3.F.PL+IMPF+3+PL
liquefaziam-no	liquefazer+V.ele.ACC.3.M.SG+IMPF+3+PL
liquefaziam-nos	liquefazer+V.ele.ACC.3.M.PL+IMPF+3+PL
liquefaziam-nos	liquefazer+V.nós.AD.1.PL+IMPF+3+PL
liquefazíamo-la	liquefazer+V.ele.ACC.3.F.SG+IMPF+1+PL
liquefazíamo-las	liquefazer+V.ele.ACC.3.F.PL+IMPF+1+PL
liquefazíamo-lo	liquefazer+V.ele.ACC.3.M.SG+IMPF+1+PL
liquefazíamo-los	liquefazer+V.ele.ACC.3.M.PL+IMPF+1+PL
liquefazíamo-nos	liquefazer+nós.AD.1.PL+IMPF+1+PL
liquefazíamos-lhe	liquefazer+V.ele.DAT.3.SG+IMPF+1+PL
liquefazíamos-lhes	liquefazer+V.ele.DAT.3.PL+IMPF+1+PL
liquefazíamos-me	liquefazer+V.eu.AD.1.SG+IMPF+1+PL
liquefazíamos-te	liquefazer+V.tu.AD.2.SG+IMPF+1+PL
liquefazíamos-vos	liquefazer+V.vós.AD.2.PL+IMPF+1+PL
liquefaziam-se	liquefazer+V.ele.REFL+IMPF+3+PL
liquefaziam-te	liquefazer+V.tu.AD.2.SG+IMPF+3+PL
liquefaziam-vos	liquefazer+V.vós.AD.2.PL+IMPF+3+PL
liquefazia-nos	liquefazer+nós.AD.1.PL+IMPF+1+SG
liquefazia-nos	liquefazer+nós.AD.1.PL+IMPF+2+SG
liquefazia-nos	liquefazer+nós.AD.1.PL+IMPF+3+SG
liquefazia-o	liquefazer+V.ele.ACC.3.M.SG+IMPF+1+SG
liquefazia-o	liquefazer+V.ele.ACC.3.M.SG+IMPF+3+SG
liquefazia-os	liquefazer+V.ele.ACC.3.M.PL+IMPF+1+SG
liquefazia-os	liquefazer+V.ele.ACC.3.M.PL+IMPF+3+SG
liquefazia-se	liquefazer+V.ele.REFL+IMPF+3+SG
liquefazias-lhe	liquefazer+V.ele.DAT.3.SG+IMPF+2+SG
liquefazias-lhes	liquefazer+V.ele.DAT.3.PL+IMPF+2+SG
liquefazias-me	liquefazer+V.eu.AD.1.SG+IMPF+2+SG
liquefazias-te	liquefazer+V.tu.AD.2.SG+IMPF+2+SG
liquefazias-vos	liquefazer+V.vós.AD.2.PL+IMPF+2+SG
liquefazia-te	liquefazer+V.tu.AD.2.SG+IMPF+1+SG
liquefazia-te	liquefazer+V.tu.AD.2.SG+IMPF+3+SG
liquefazia-vos	liquefazer+V.vós.AD.2.PL+IMPF+1+SG
liquefazia-vos	liquefazer+V.vós.AD.2.PL+IMPF+3+SG
liquefazíei-la	liquefazer+V.ele.ACC.3.F.SG+IMPF+2+PL
liquefazíei-las	liquefazer+V.ele.ACC.3.F.PL+IMPF+2+PL
liquefazíei-lo	liquefazer+V.ele.ACC.3.M.SG+IMPF+2+PL
liquefazíei-los	liquefazer+V.ele.ACC.3.M.PL+IMPF+2+PL
liquefazíei-nos	liquefazer+nós.AD.1.PL+IMPF+2+PL
liquefazíeis-lhe	liquefazer+V.ele.DAT.3.SG+IMPF+2+PL
liquefazíeis-lhes	liquefazer+V.ele.DAT.3.PL+IMPF+2+PL
liquefazíeis-me	liquefazer+V.eu.AD.1.SG+IMPF+2+PL
liquefazíeis-te	liquefazer+V.tu.AD.2.SG+IMPF+2+PL
liquefazíeis-vos	liquefazer+V.vós.AD.2.PL+IMPF+2+PL
liquefaz-lhe	liquefazer+V.ele.DAT.3.SG+PRS+3+SG
liquefaz-lhes	liquefazer+V.ele.DAT.3.PL+PRS+3+SG
liquefaz-me	liquefazer+V.eu.AD.1.SG+PRS+3+SG
liquefaz-nos	liquefazer+nós.AD.1.PL+PRS+3+SG
liquefaz-o	liquefazer+V.ele.ACC.3.M.SG+PRS+3+SG
liquefaz-os	liquefazer+V.ele.ACC.3.M.PL+PRS+3+SG
liquefaz-se	liquefazer+V.ele.REFL+PRS+3+SG
liquefaz-te	liquefazer+V.tu.AD.2.SG+PRS+3+SG
liquefaz-vos	liquefazer+V.vós.AD.2.PL+PRS+3+SG
liquefez-lhe	liquefazer+V.ele.DAT.3.SG+PRF+3+SG
liquefez-lhes	liquefazer+V.ele.DAT.3.PL+PRF+3+SG
liquefez-me	liquefazer+V.eu.AD.1.SG+PRF+3+SG
liquefez-nos	liquefazer+nós.AD.1.PL+PRF+3+SG
liquefez-se	liquefazer+V.ele.REFL+PRF+3+SG
liquefez-te	liquefazer+V.tu.AD.2.SG+PRF+3+SG
liquefez-vos	liquefazer+V.vós.AD.2.PL+PRF+3+SG
liquefi-la	liquefazer+V.ele.ACC.3.F.SG+PRF+1+SG
liquefi-las	liquefazer+V.ele.ACC.3.F.PL+PRF+1+SG
liquefi-lo	liquefazer+V.ele.ACC.3.M.SG+PRF+1+SG
liquefi-los	liquefazer+V.ele.ACC.3.M.PL+PRF+1+SG
liquefizê-la	liquefazer+V.ele.ACC.3.F.SG+PRF+3+SG
liquefizé-la	liquefazer+V.ele.ACC.3.F.SG+SBJF+1+SG
liquefizé-la	liquefazer+V.ele.ACC.3.F.SG+SBJF+3+SG
liquefizê-las	liquefazer+V.ele.ACC.3.F.PL+PRF+3+SG
liquefizé-las	liquefazer+V.ele.ACC.3.F.PL+SBJF+1+SG
liquefizé-las	liquefazer+V.ele.ACC.3.F.PL+SBJF+3+SG
liquefizê-lo	liquefazer+V.ele.ACC.3.M.SG+PRF+3+SG
liquefizé-lo	liquefazer+V.ele.ACC.3.M.SG+SBJF+1+SG
liquefizé-lo	liquefazer+V.ele.ACC.3.M.SG+SBJF+3+SG
liquefizê-los	liquefazer+V.ele.ACC.3.M.PL+PRF+3+SG
liquefizé-los	liquefazer+V.ele.ACC.3.M.PL+SBJF+1+SG
liquefizé-los	liquefazer+V.ele.ACC.3.M.PL+SBJF+3+SG
liquefizemo-la	liquefazer+V.ele.ACC.3.F.SG+PRF+1+PL
liquefizemo-las	liquefazer+V.ele.ACC.3.F.PL+PRF+1+PL
liquefizemo-lo	liquefazer+V.ele.ACC.3.M.SG+PRF+1+PL
liquefizemo-los	liquefazer+V.ele.ACC.3.M.PL+PRF+1+PL
liquefizemo-nos	liquefazer+nós.AD.1.PL+PRF+1+PL
liquefizemos-lhe	liquefazer+V.ele.DAT.3.SG+PRF+1+PL
liquefizemos-lhes	liquefazer+V.ele.DAT.3.PL+PRF+1+PL
liquefizemos-me	liquefazer+V.eu.AD.1.SG+PRF+1+PL
liquefizemos-te	liquefazer+V.tu.AD.2.SG+PRF+1+PL
liquefizemos-vos	liquefazer+V.vós.AD.2.PL+PRF+1+PL
liquefizera-a	liquefazer+V.ele.ACC.3.F.SG+PQP+1+SG
liquefizera-a	liquefazer+V.ele.ACC.3.F.SG+PQP+3+SG
liquefizera-as	liquefazer+V.ele.ACC.3.F.PL+PQP+1+SG
liquefizera-as	liquefazer+V.ele.ACC.3.F.PL+PQP+3+SG
liquefizera-la	liquefazer+V.ele.ACC.3.F.SG+PQP+2+SG
liquefizera-las	liquefazer+V.ele.ACC.3.F.PL+PQP+2+SG
liquefizera-lhe	liquefazer+V.ele.DAT.3.SG+PQP+1+SG
liquefizera-lhe	liquefazer+V.ele.DAT.3.SG+PQP+3+SG
liquefizera-lhes	liquefazer+V.ele.DAT.3.PL+PQP+1+SG
liquefizera-lhes	liquefazer+V.ele.DAT.3.PL+PQP+3+SG
liquefizera-lo	liquefazer+V.ele.ACC.3.M.SG+PQP+2+SG
liquefizera-los	liquefazer+V.ele.ACC.3.M.PL+PQP+2+SG
liquefizera-me	liquefazer+V.eu.AD.1.SG+PQP+1+SG
liquefizera-me	liquefazer+V.eu.AD.1.SG+PQP+3+SG
liquefizeram-lhe	liquefazer+V.ele.DAT.3.SG+PQP+3+PL
liquefizeram-lhe	liquefazer+V.ele.DAT.3.SG+PRF+3+PL
liquefizeram-lhes	liquefazer+V.ele.DAT.3.PL+PQP+3+PL
liquefizeram-lhes	liquefazer+V.ele.DAT.3.PL+PRF+3+PL
liquefizeram-me	liquefazer+V.eu.AD.1.SG+PQP+3+PL
liquefizeram-me	liquefazer+V.eu.AD.1.SG+PRF+3+PL
liquefizeram-na	liquefazer+V.ele.ACC.3.F.SG+PQP+3+PL
liquefizeram-na	liquefazer+V.ele.ACC.3.F.SG+PRF+3+PL
liquefizeram-nas	liquefazer+V.ele.ACC.3.F.PL+PQP+3+PL
liquefizeram-nas	liquefazer+V.ele.ACC.3.F.PL+PRF+3+PL
liquefizeram-no	liquefazer+V.ele.ACC.3.M.SG+PQP+3+PL
liquefizeram-no	liquefazer+V.ele.ACC.3.M.SG+PRF+3+PL
liquefizeram-nos	liquefazer+V.ele.ACC.3.M.PL+PQP+3+PL
liquefizeram-nos	liquefazer+V.ele.ACC.3.M.PL+PRF+3+PL
liquefizeram-nos	liquefazer+V.nós.AD.1.PL+PQP+3+PL
liquefizeram-nos	liquefazer+V.nós.AD.1.PL+PRF+3+PL
liquefizéramo-la	liquefazer+V.ele.ACC.3.F.SG+PQP+1+PL
liquefizéramo-las	liquefazer+V.ele.ACC.3.F.PL+PQP+1+PL
liquefizéramo-lo	liquefazer+V.ele.ACC.3.M.SG+PQP+1+PL
liquefizéramo-los	liquefazer+V.ele.ACC.3.M.PL+PQP+1+PL
liquefizéramo-nos	liquefazer+nós.AD.1.PL+PQP+1+PL
liquefizéramos-lhe	liquefazer+V.ele.DAT.3.SG+PQP+1+PL
liquefizéramos-lhes	liquefazer+V.ele.DAT.3.PL+PQP+1+PL
liquefizéramos-me	liquefazer+V.eu.AD.1.SG+PQP+1+PL
liquefizéramos-te	liquefazer+V.tu.AD.2.SG+PQP+1+PL
liquefizéramos-vos	liquefazer+V.vós.AD.2.PL+PQP+1+PL
liquefizeram-se	liquefazer+V.ele.REFL+PQP+3+PL
liquefizeram-se	liquefazer+V.ele.REFL+PRF+3+PL
liquefizeram-te	liquefazer+V.tu.AD.2.SG+PQP+3+PL
liquefizeram-te	liquefazer+V.tu.AD.2.SG+PRF+3+PL
liquefizeram-vos	liquefazer+V.vós.AD.2.PL+PQP+3+PL
liquefizeram-vos	liquefazer+V.vós.AD.2.PL+PRF+3+PL
liquefizera-nos	liquefazer+nós.AD.1.PL+PQP+1+SG
liquefizera-nos	liquefazer+nós.AD.1.PL+PQP+2+SG
liquefizera-nos	liquefazer+nós.AD.1.PL+PQP+3+SG
liquefizera-o	liquefazer+V.ele.ACC.3.M.SG+PQP+1+SG
liquefizera-o	liquefazer+V.ele.ACC.3.M.SG+PQP+3+SG
liquefizera-os	liquefazer+V.ele.ACC.3.M.PL+PQP+1+SG
liquefizera-os	liquefazer+V.ele.ACC.3.M.PL+PQP+3+SG
liquefizera-se	liquefazer+V.ele.REFL+PQP+3+SG
liquefizeras-lhe	liquefazer+V.ele.DAT.3.SG+PQP+2+SG
liquefizeras-lhes	liquefazer+V.ele.DAT.3.PL+PQP+2+SG
liquefizeras-me	liquefazer+V.eu.AD.1.SG+PQP+2+SG
liquefizeras-te	liquefazer+V.tu.AD.2.SG+PQP+2+SG
liquefizeras-vos	liquefazer+V.vós.AD.2.PL+PQP+2+SG
liquefizera-te	liquefazer+V.tu.AD.2.SG+PQP+1+SG
liquefizera-te	liquefazer+V.tu.AD.2.SG+PQP+3+SG
liquefizera-vos	liquefazer+V.vós.AD.2.PL+PQP+1+SG
liquefizera-vos	liquefazer+V.vós.AD.2.PL+PQP+3+SG
liquefizerde-la	liquefazer+V.ele.ACC.3.F.SG+SBJF+2+PL
liquefizerde-las	liquefazer+V.ele.ACC.3.F.PL+SBJF+2+PL
liquefizerde-lo	liquefazer+V.ele.ACC.3.M.SG+SBJF+2+PL
liquefizerde-los	liquefazer+V.ele.ACC.3.M.PL+SBJF+2+PL
liquefizerde-nos	liquefazer+nós.AD.1.PL+SBJF+2+PL
liquefizerdes-lhe	liquefazer+V.ele.DAT.3.SG+SBJF+2+PL
liquefizerdes-lhes	liquefazer+V.ele.DAT.3.PL+SBJF+2+PL
liquefizerdes-me	liquefazer+V.eu.AD.1.SG+SBJF+2+PL
liquefizerdes-te	liquefazer+V.tu.AD.2.SG+SBJF+2+PL
liquefizerdes-vos	liquefazer+V.vós.AD.2.PL+SBJF+2+PL
liquefizérei-la	liquefazer+V.ele.ACC.3.F.SG+PQP+2+PL
liquefizérei-las	liquefazer+V.ele.ACC.3.F.PL+PQP+2+PL
liquefizérei-lo	liquefazer+V.ele.ACC.3.M.SG+PQP+2+PL
liquefizérei-los	liquefazer+V.ele.ACC.3.M.PL+PQP+2+PL
liquefizérei-nos	liquefazer+nós.AD.1.PL+PQP+2+PL
liquefizéreis-lhe	liquefazer+V.ele.DAT.3.SG+PQP+2+PL
liquefizéreis-lhes	liquefazer+V.ele.DAT.3.PL+PQP+2+PL
liquefizéreis-me	liquefazer+V.eu.AD.1.SG+PQP+2+PL
liquefizéreis-te	liquefazer+V.tu.AD.2.SG+PQP+2+PL
liquefizéreis-vos	liquefazer+V.vós.AD.2.PL+PQP+2+PL
liquefizere-la	liquefazer+V.ele.ACC.3.F.SG+SBJF+2+SG
liquefizere-las	liquefazer+V.ele.ACC.3.F.PL+SBJF+2+SG
liquefizere-lo	liquefazer+V.ele.ACC.3.M.SG+SBJF+2+SG
liquefizere-los	liquefazer+V.ele.ACC.3.M.PL+SBJF+2+SG
liquefizerem-lhe	liquefazer+V.ele.DAT.3.SG+SBJF+3+PL
liquefizerem-lhes	liquefazer+V.ele.DAT.3.PL+SBJF+3+PL
liquefizerem-me	liquefazer+V.eu.AD.1.SG+SBJF+3+PL
liquefizerem-na	liquefazer+V.ele.ACC.3.F.SG+SBJF+3+PL
liquefizerem-nas	liquefazer+V.ele.ACC.3.F.PL+SBJF+3+PL
liquefizerem-no	liquefazer+V.ele.ACC.3.M.SG+SBJF+3+PL
liquefizerem-nos	liquefazer+V.ele.ACC.3.M.PL+SBJF+3+PL
liquefizerem-nos	liquefazer+V.nós.AD.1.PL+SBJF+3+PL
liquefizerem-se	liquefazer+V.ele.REFL+SBJF+3+PL
liquefizerem-te	liquefazer+V.tu.AD.2.SG+SBJF+3+PL
liquefizerem-vos	liquefazer+V.vós.AD.2.PL+SBJF+3+PL
liquefizere-nos	liquefazer+nós.AD.1.PL+SBJF+2+SG
liquefizeres-lhe	liquefazer+V.ele.DAT.3.SG+SBJF+2+SG
liquefizeres-lhes	liquefazer+V.ele.DAT.3.PL+SBJF+2+SG
liquefizeres-me	liquefazer+V.eu.AD.1.SG+SBJF+2+SG
liquefizeres-te	liquefazer+V.tu.AD.2.SG+SBJF+2+SG
liquefizeres-vos	liquefazer+V.vós.AD.2.PL+SBJF+2+SG
liquefizermo-la	liquefazer+V.ele.ACC.3.F.SG+SBJF+1+PL
liquefizermo-las	liquefazer+V.ele.ACC.3.F.PL+SBJF+1+PL
liquefizermo-lo	liquefazer+V.ele.ACC.3.M.SG+SBJF+1+PL
liquefizermo-los	liquefazer+V.ele.ACC.3.M.PL+SBJF+1+PL
liquefizermo-nos	liquefazer+nós.AD.1.PL+SBJF+1+PL
liquefizermos-lhe	liquefazer+V.ele.DAT.3.SG+SBJF+1+PL
liquefizermos-lhes	liquefazer+V.ele.DAT.3.PL+SBJF+1+PL
liquefizermos-me	liquefazer+V.eu.AD.1.SG+SBJF+1+PL
liquefizermos-te	liquefazer+V.tu.AD.2.SG+SBJF+1+PL
liquefizermos-vos	liquefazer+V.vós.AD.2.PL+SBJF+1+PL
liquefizeste-a	liquefazer+V.ele.ACC.3.F.SG+PRF+2+SG
liquefizeste-as	liquefazer+V.ele.ACC.3.F.PL+PRF+2+SG
liquefizeste-la	liquefazer+V.ele.ACC.3.F.SG+PRF+2+PL
liquefizeste-las	liquefazer+V.ele.ACC.3.F.PL+PRF+2+PL
liquefizeste-lhe	liquefazer+V.ele.DAT.3.SG+PRF+2+SG
liquefizeste-lhes	liquefazer+V.ele.DAT.3.PL+PRF+2+SG
liquefizeste-lo	liquefazer+V.ele.ACC.3.M.SG+PRF+2+PL
liquefizeste-los	liquefazer+V.ele.ACC.3.M.PL+PRF+2+PL
liquefizeste-me	liquefazer+V.eu.AD.1.SG+PRF+2+SG
liquefizeste-nos	liquefazer+nós.AD.1.PL+PRF+2+PL
liquefizeste-nos	liquefazer+nós.AD.1.PL+PRF+2+SG
liquefizeste-o	liquefazer+V.ele.ACC.3.M.SG+PRF+2+SG
liquefizeste-os	liquefazer+V.ele.ACC.3.M.PL+PRF+2+SG
liquefizestes-lhe	liquefazer+V.ele.DAT.3.SG+PRF+2+PL
liquefizestes-lhes	liquefazer+V.ele.DAT.3.PL+PRF+2+PL
liquefizestes-me	liquefazer+V.eu.AD.1.SG+PRF+2+PL
liquefizestes-te	liquefazer+V.tu.AD.2.SG+PRF+2+PL
liquefizestes-vos	liquefazer+V.vós.AD.2.PL+PRF+2+PL
liquefizeste-te	liquefazer+V.tu.AD.2.SG+PRF+2+SG
liquefizeste-vos	liquefazer+V.vós.AD.2.PL+PRF+2+SG
liquefiz-lhe	liquefazer+V.ele.DAT.3.SG+PRF+1+SG
liquefiz-lhes	liquefazer+V.ele.DAT.3.PL+PRF+1+SG
liquefiz-me	liquefazer+V.eu.AD.1.SG+PRF+1+SG
liquefiz-nos	liquefazer+nós.AD.1.PL+PRF+1+SG
liquefiz-te	liquefazer+V.tu.AD.2.SG+PRF+1+SG
liquefiz-vos	liquefazer+V.vós.AD.2.PL+PRF+1+SG
liquesça-a	liquescer+V.ele.ACC.3.F.SG+IMP+3+SG
liquesça-as	liquescer+V.ele.ACC.3.F.PL+IMP+3+SG
liquesça-lhe	liquescer+V.ele.DAT.3.SG+IMP+3+SG
liquesça-lhes	liquescer+V.ele.DAT.3.PL+IMP+3+SG
liquesça-me	liquescer+V.eu.AD.1.SG+IMP+3+SG
liquesçam-lhe	liquescer+V.ele.DAT.3.SG+IMP+3+PL
liquesçam-lhes	liquescer+V.ele.DAT.3.PL+IMP+3+PL
liquesçam-me	liquescer+V.eu.AD.1.SG+IMP+3+PL
liquesçam-na	liquescer+V.ele.ACC.3.F.SG+IMP+3+PL
liquesçam-nas	liquescer+V.ele.ACC.3.F.PL+IMP+3+PL
liquesçam-no	liquescer+V.ele.ACC.3.M.SG+IMP+3+PL
liquesçam-nos	liquescer+nós.AD.1.PL+IMP+3+PL
liquesçamo-la	liquescer+V.ele.ACC.3.F.SG+IMP+1+PL
liquesçamo-las	liquescer+V.ele.ACC.3.F.PL+IMP+1+PL
liquesçamo-lo	liquescer+V.ele.ACC.3.M.SG+IMP+1+PL
liquesçamo-los	liquescer+V.ele.ACC.3.M.PL+IMP+1+PL
liquesçamo-nos	liquescer+nós.AD.1.PL+IMP+1+PL
liquesçamos-lhe	liquescer+V.ele.DAT.3.SG+IMP+1+PL
liquesçamos-lhes	liquescer+V.ele.DAT.3.PL+IMP+1+PL
liquesçamos-me	liquescer+V.eu.AD.1.SG+IMP+1+PL
liquesçamos-te	liquescer+V.tu.AD.2.SG+IMP+1+PL
liquesçamos-vos	liquescer+V.vós.AD.2.PL+IMP+1+PL
liquesçam-se	liquescer+V.ele.REFL+IMP+3+PL
liquesçam-te	liquescer+V.tu.AD.2.SG+IMP+3+PL
liquesçam-vos	liquescer+V.vós.AD.2.PL+IMP+3+PL
liquesça-nos	liquescer+nós.AD.1.PL+IMP+3+SG
liquesça-o	liquescer+V.ele.ACC.3.M.SG+IMP+3+SG
liquesça-os	liquescer+V.ele.ACC.3.M.PL+IMP+3+SG
liquesça-se	liquescer+V.ele.REFL+IMP+3+SG
liquesça-te	liquescer+V.tu.AD.2.SG+IMP+3+SG
liquesça-vos	liquescer+V.vós.AD.2.PL+IMP+3+SG
liquescei-la	liquescer+V.ele.ACC.3.F.SG+PRS+2+PL
liquescei-las	liquescer+V.ele.ACC.3.F.PL+PRS+2+PL
liquescei-lo	liquescer+V.ele.ACC.3.M.SG+PRS+2+PL
liquescei-los	liquescer+V.ele.ACC.3.M.PL+PRS+2+PL
liquescei-nos	liquescer+nós.AD.1.PL+PRS+2+PL
liquesceis-lhe	liquescer+V.ele.DAT.3.SG+PRS+2+PL
liquesceis-lhes	liquescer+V.ele.DAT.3.PL+PRS+2+PL
liquesceis-me	liquescer+V.eu.AD.1.SG+PRS+2+PL
liquesceis-te	liquescer+V.tu.AD.2.SG+PRS+2+PL
liquesceis-vos	liquescer+V.vós.AD.2.PL+PRS+2+PL
liquescê-la-á	liquescer+V.ele.ACC.3.F.SG+FUT+3+SG
liquescê-la-ão	liquescer+V.ele.ACC.3.F.SG+FUT+3+PL
liquescê-la-ás	liquescer+V.ele.ACC.3.F.SG+FUT+2+SG
liquescê-la-ei	liquescer+V.ele.ACC.3.F.SG+FUT+1+SG
liquescê-la-eis	liquescer+V.ele.ACC.3.F.SG+FUT+2+PL
liquescê-la-emos	liquescer+V.ele.ACC.3.F.SG+FUT+1+PL
liquescê-la-ia	liquescer+V.ele.ACC.3.F.SG+COND+1+SG
liquescê-la-ia	liquescer+V.ele.ACC.3.F.SG+COND+3+SG
liquescê-la-iam	liquescer+V.ele.ACC.3.F.SG+COND+3+PL
liquescê-la-íamos	liquescer+V.ele.ACC.3.F.SG+COND+1+PL
liquescê-la-ias	liquescer+V.ele.ACC.3.F.SG+COND+2+SG
liquescê-la-íeis	liquescer+V.ele.ACC.3.F.SG+COND+2+PL
liquescê-la	liquescer+V.ele.ACC.3.F.SG+INF
liquescê-la	liquescer+V.ele.ACC.3.F.SG+INF+1+SG
liquescê-la	liquescer+V.ele.ACC.3.F.SG+INF+3+SG
liquesce-la	liquescer+V.ele.ACC.3.F.SG+PRS+2+SG
liquescê-la	liquescer+V.ele.ACC.3.F.SG+SBJF+1+SG
liquescê-la	liquescer+V.ele.ACC.3.F.SG+SBJF+3+SG
liquescê-las-á	liquescer+V.ele.ACC.3.F.PL+FUT+3+SG
liquescê-las-ão	liquescer+V.ele.ACC.3.F.PL+FUT+3+PL
liquescê-las-ás	liquescer+V.ele.ACC.3.F.PL+FUT+2+SG
liquescê-las-ei	liquescer+V.ele.ACC.3.F.PL+FUT+1+SG
liquescê-las-eis	liquescer+V.ele.ACC.3.F.PL+FUT+2+PL
liquescê-las-emos	liquescer+V.ele.ACC.3.F.PL+FUT+1+PL
liquescê-las-ia	liquescer+V.ele.ACC.3.F.PL+COND+1+SG
liquescê-las-ia	liquescer+V.ele.ACC.3.F.PL+COND+3+SG
liquescê-las-iam	liquescer+V.ele.ACC.3.F.PL+COND+3+PL
liquescê-las-íamos	liquescer+V.ele.ACC.3.F.PL+COND+1+PL
liquescê-las-ias	liquescer+V.ele.ACC.3.F.PL+COND+2+SG
liquescê-las-íeis	liquescer+V.ele.ACC.3.F.PL+COND+2+PL
liquescê-las	liquescer+V.ele.ACC.3.F.PL+INF
liquescê-las	liquescer+V.ele.ACC.3.F.PL+INF+1+SG
liquescê-las	liquescer+V.ele.ACC.3.F.PL+INF+3+SG
liquesce-las	liquescer+V.ele.ACC.3.F.PL+PRS+2+SG
liquescê-las	liquescer+V.ele.ACC.3.F.PL+SBJF+1+SG
liquescê-las	liquescer+V.ele.ACC.3.F.PL+SBJF+3+SG
liquescê-lo-á	liquescer+V.ele.ACC.3.M.SG+FUT+3+SG
liquescê-lo-ão	liquescer+V.ele.ACC.3.M.SG+FUT+3+PL
liquescê-lo-ás	liquescer+V.ele.ACC.3.M.SG+FUT+2+SG
liquescê-lo-ei	liquescer+V.ele.ACC.3.M.SG+FUT+1+SG
liquescê-lo-eis	liquescer+V.ele.ACC.3.M.SG+FUT+2+PL
liquescê-lo-emos	liquescer+V.ele.ACC.3.M.SG+FUT+1+PL
liquescê-lo-ia	liquescer+V.ele.ACC.3.M.SG+COND+1+SG
liquescê-lo-ia	liquescer+V.ele.ACC.3.M.SG+COND+3+SG
liquescê-lo-iam	liquescer+V.ele.ACC.3.M.SG+COND+3+PL
liquescê-lo-íamos	liquescer+V.ele.ACC.3.M.SG+COND+1+PL
liquescê-lo-ias	liquescer+V.ele.ACC.3.M.SG+COND+2+SG
liquescê-lo-íeis	liquescer+V.ele.ACC.3.M.SG+COND+2+PL
liquescê-lo	liquescer+V.ele.ACC.3.M.SG+INF
liquescê-lo	liquescer+V.ele.ACC.3.M.SG+INF+1+SG
liquescê-lo	liquescer+V.ele.ACC.3.M.SG+INF+3+SG
liquesce-lo	liquescer+V.ele.ACC.3.M.SG+PRS+2+SG
liquescê-lo	liquescer+V.ele.ACC.3.M.SG+SBJF+1+SG
liquescê-lo	liquescer+V.ele.ACC.3.M.SG+SBJF+3+SG
liquescê-los-á	liquescer+V.ele.ACC.3.M.PL+FUT+3+SG
liquescê-los-ão	liquescer+V.ele.ACC.3.M.PL+FUT+3+PL
liquescê-los-ás	liquescer+V.ele.ACC.3.M.PL+FUT+2+SG
liquescê-los-ei	liquescer+V.ele.ACC.3.M.PL+FUT+1+SG
liquescê-los-eis	liquescer+V.ele.ACC.3.M.PL+FUT+2+PL
liquescê-los-emos	liquescer+V.ele.ACC.3.M.PL+FUT+1+PL
liquescê-los-ia	liquescer+V.ele.ACC.3.M.PL+COND+1+SG
liquescê-los-ia	liquescer+V.ele.ACC.3.M.PL+COND+3+SG
liquescê-los-iam	liquescer+V.ele.ACC.3.M.PL+COND+3+PL
liquescê-los-íamos	liquescer+V.ele.ACC.3.M.PL+COND+1+PL
liquescê-los-ias	liquescer+V.ele.ACC.3.M.PL+COND+2+SG
liquescê-los-íeis	liquescer+V.ele.ACC.3.M.PL+COND+2+PL
liquescê-los	liquescer+V.ele.ACC.3.M.PL+INF
liquescê-los	liquescer+V.ele.ACC.3.M.PL+INF+1+SG
liquescê-los	liquescer+V.ele.ACC.3.M.PL+INF+3+SG
liquesce-los	liquescer+V.ele.ACC.3.M.PL+PRS+2+SG
liquescê-los	liquescer+V.ele.ACC.3.M.PL+SBJF+1+SG
liquescê-los	liquescer+V.ele.ACC.3.M.PL+SBJF+3+SG
liquescem-lhe	liquescer+V.ele.DAT.3.SG+PRS+3+PL
liquescem-lhes	liquescer+V.ele.DAT.3.PL+PRS+3+PL
liquescem-me	liquescer+V.eu.AD.1.SG+PRS+3+PL
liquescem-na	liquescer+V.ele.ACC.3.F.SG+PRS+3+PL
liquescem-nas	liquescer+V.ele.ACC.3.F.PL+PRS+3+PL
liquescem-no	liquescer+V.ele.ACC.3.M.SG+PRS+3+PL
liquescem-nos	liquescer+V.ele.ACC.3.M.PL+PRS+3+PL
liquescem-nos	liquescer+V.nós.AD.1.PL+PRS+3+PL
liquescemo-la	liquescer+V.ele.ACC.3.F.SG+PRF+1+PL
liquescemo-la	liquescer+V.ele.ACC.3.F.SG+PRS+1+PL
liquescemo-las	liquescer+V.ele.ACC.3.F.PL+PRF+1+PL
liquescemo-las	liquescer+V.ele.ACC.3.F.PL+PRS+1+PL
liquescemo-lo	liquescer+V.ele.ACC.3.M.SG+PRF+1+PL
liquescemo-lo	liquescer+V.ele.ACC.3.M.SG+PRS+1+PL
liquescemo-los	liquescer+V.ele.ACC.3.M.PL+PRF+1+PL
liquescemo-los	liquescer+V.ele.ACC.3.M.PL+PRS+1+PL
liquescemo-nos	liquescer+nós.AD.1.PL+PRF+1+PL
liquescemo-nos	liquescer+nós.AD.1.PL+PRS+1+PL
liquescemos-lhe	liquescer+V.ele.DAT.3.SG+PRF+1+PL
liquescemos-lhe	liquescer+V.ele.DAT.3.SG+PRS+1+PL
liquescemos-lhes	liquescer+V.ele.DAT.3.PL+PRF+1+PL
liquescemos-lhes	liquescer+V.ele.DAT.3.PL+PRS+1+PL
liquescemos-me	liquescer+V.eu.AD.1.SG+PRF+1+PL
liquescemos-me	liquescer+V.eu.AD.1.SG+PRS+1+PL
liquescemos-te	liquescer+V.tu.AD.2.SG+PRF+1+PL
liquescemos-te	liquescer+V.tu.AD.2.SG+PRS+1+PL
liquescemos-vos	liquescer+V.vós.AD.2.PL+PRF+1+PL
liquescemos-vos	liquescer+V.vós.AD.2.PL+PRS+1+PL
liquescem-se	liquescer+V.ele.REFL+PRS+3+PL
liquescem-te	liquescer+V.tu.AD.2.SG+PRS+3+PL
liquescem-vos	liquescer+V.vós.AD.2.PL+PRS+3+PL
liquescendo-a	liquescer+V.ele.ACC.3.F.SG+GRD
liquescendo-as	liquescer+V.ele.ACC.3.F.PL+GRD
liquescendo-lhe	liquescer+V.ele.DAT.3.SG+GRD
liquescendo-lhes	liquescer+V.ele.DAT.3.PL+GRD
liquescendo-me	liquescer+V.eu.AD.1.SG+GRD
liquescendo-nos	liquescer+nós.AD.1.PL+GRD
liquescendo-o	liquescer+V.ele.ACC.3.M.SG+GRD
liquescendo-os	liquescer+V.ele.ACC.3.M.PL+GRD
liquescendo-se	liquescer+V.ele.REFL+GRD
liquescendo-te	liquescer+V.tu.AD.2.SG+GRD
liquescendo-vos	liquescer+V.vós.AD.2.PL+GRD
liquesce-nos	liquescer+nós.AD.1.PL+PRS+2+SG
liquescera-a	liquescer+V.ele.ACC.3.F.SG+PQP+1+SG
liquescera-a	liquescer+V.ele.ACC.3.F.SG+PQP+3+SG
liquescera-as	liquescer+V.ele.ACC.3.F.PL+PQP+1+SG
liquescera-as	liquescer+V.ele.ACC.3.F.PL+PQP+3+SG
liquescera-la	liquescer+V.ele.ACC.3.F.SG+PQP+2+SG
liquescera-las	liquescer+V.ele.ACC.3.F.PL+PQP+2+SG
liquescera-lhe	liquescer+V.ele.DAT.3.SG+PQP+1+SG
liquescera-lhe	liquescer+V.ele.DAT.3.SG+PQP+3+SG
liquescera-lhes	liquescer+V.ele.DAT.3.PL+PQP+1+SG
liquescera-lhes	liquescer+V.ele.DAT.3.PL+PQP+3+SG
liquescera-lo	liquescer+V.ele.ACC.3.M.SG+PQP+2+SG
liquescera-los	liquescer+V.ele.ACC.3.M.PL+PQP+2+SG
liquescera-me	liquescer+V.eu.AD.1.SG+PQP+1+SG
liquescera-me	liquescer+V.eu.AD.1.SG+PQP+3+SG
liquesceram-lhe	liquescer+V.ele.DAT.3.SG+PQP+3+PL
liquesceram-lhe	liquescer+V.ele.DAT.3.SG+PRF+3+PL
liquesceram-lhes	liquescer+V.ele.DAT.3.PL+PQP+3+PL
liquesceram-lhes	liquescer+V.ele.DAT.3.PL+PRF+3+PL
liquesceram-me	liquescer+V.eu.AD.1.SG+PQP+3+PL
liquesceram-me	liquescer+V.eu.AD.1.SG+PRF+3+PL
liquesceram-na	liquescer+V.ele.ACC.3.F.SG+PQP+3+PL
liquesceram-na	liquescer+V.ele.ACC.3.F.SG+PRF+3+PL
liquesceram-nas	liquescer+V.ele.ACC.3.F.PL+PQP+3+PL
liquesceram-nas	liquescer+V.ele.ACC.3.F.PL+PRF+3+PL
liquesceram-no	liquescer+V.ele.ACC.3.M.SG+PQP+3+PL
liquesceram-no	liquescer+V.ele.ACC.3.M.SG+PRF+3+PL
liquesceram-nos	liquescer+V.ele.ACC.3.M.PL+PQP+3+PL
liquesceram-nos	liquescer+V.ele.ACC.3.M.PL+PRF+3+PL
liquesceram-nos	liquescer+V.nós.AD.1.PL+PQP+3+PL
liquesceram-nos	liquescer+V.nós.AD.1.PL+PRF+3+PL
liquescêramo-la	liquescer+V.ele.ACC.3.F.SG+PQP+1+PL
liquescêramo-las	liquescer+V.ele.ACC.3.F.PL+PQP+1+PL
liquescêramo-lo	liquescer+V.ele.ACC.3.M.SG+PQP+1+PL
liquescêramo-los	liquescer+V.ele.ACC.3.M.PL+PQP+1+PL
liquescêramo-nos	liquescer+nós.AD.1.PL+PQP+1+PL
liquescêramos-lhe	liquescer+V.ele.DAT.3.SG+PQP+1+PL
liquescêramos-lhes	liquescer+V.ele.DAT.3.PL+PQP+1+PL
liquescêramos-me	liquescer+V.eu.AD.1.SG+PQP+1+PL
liquescêramos-te	liquescer+V.tu.AD.2.SG+PQP+1+PL
liquescêramos-vos	liquescer+V.vós.AD.2.PL+PQP+1+PL
liquesceram-se	liquescer+V.ele.REFL+PQP+3+PL
liquesceram-se	liquescer+V.ele.REFL+PRF+3+PL
liquesceram-te	liquescer+V.tu.AD.2.SG+PQP+3+PL
liquesceram-te	liquescer+V.tu.AD.2.SG+PRF+3+PL
liquesceram-vos	liquescer+V.vós.AD.2.PL+PQP+3+PL
liquesceram-vos	liquescer+V.vós.AD.2.PL+PRF+3+PL
liquescera-nos	liquescer+nós.AD.1.PL+PQP+1+SG
liquescera-nos	liquescer+nós.AD.1.PL+PQP+2+SG
liquescera-nos	liquescer+nós.AD.1.PL+PQP+3+SG
liquescera-o	liquescer+V.ele.ACC.3.M.SG+PQP+1+SG
liquescera-o	liquescer+V.ele.ACC.3.M.SG+PQP+3+SG
liquescera-os	liquescer+V.ele.ACC.3.M.PL+PQP+1+SG
liquescera-os	liquescer+V.ele.ACC.3.M.PL+PQP+3+SG
liquescera-se	liquescer+V.ele.REFL+PQP+3+SG
liquesceras-lhe	liquescer+V.ele.DAT.3.SG+PQP+2+SG
liquesceras-lhes	liquescer+V.ele.DAT.3.PL+PQP+2+SG
liquesceras-me	liquescer+V.eu.AD.1.SG+PQP+2+SG
liquesceras-te	liquescer+V.tu.AD.2.SG+PQP+2+SG
liquesceras-vos	liquescer+V.vós.AD.2.PL+PQP+2+SG
liquescera-te	liquescer+V.tu.AD.2.SG+PQP+1+SG
liquescera-te	liquescer+V.tu.AD.2.SG+PQP+3+SG
liquescera-vos	liquescer+V.vós.AD.2.PL+PQP+1+SG
liquescera-vos	liquescer+V.vós.AD.2.PL+PQP+3+SG
liquescerde-la	liquescer+V.ele.ACC.3.F.SG+INF+2+PL
liquescerde-la	liquescer+V.ele.ACC.3.F.SG+SBJF+2+PL
liquescerde-las	liquescer+V.ele.ACC.3.F.PL+INF+2+PL
liquescerde-las	liquescer+V.ele.ACC.3.F.PL+SBJF+2+PL
liquescerde-lo	liquescer+V.ele.ACC.3.M.SG+INF+2+PL
liquescerde-lo	liquescer+V.ele.ACC.3.M.SG+SBJF+2+PL
liquescerde-los	liquescer+V.ele.ACC.3.M.PL+INF+2+PL
liquescerde-los	liquescer+V.ele.ACC.3.M.PL+SBJF+2+PL
liquescerde-nos	liquescer+nós.AD.1.PL+INF+2+PL
liquescerde-nos	liquescer+nós.AD.1.PL+SBJF+2+PL
liquescerdes-lhe	liquescer+V.ele.DAT.3.SG+INF+2+PL
liquescerdes-lhe	liquescer+V.ele.DAT.3.SG+SBJF+2+PL
liquescerdes-lhes	liquescer+V.ele.DAT.3.PL+INF+2+PL
liquescerdes-lhes	liquescer+V.ele.DAT.3.PL+SBJF+2+PL
liquescerdes-me	liquescer+V.eu.AD.1.SG+INF+2+PL
liquescerdes-me	liquescer+V.eu.AD.1.SG+SBJF+2+PL
liquescerdes-te	liquescer+V.tu.AD.2.SG+INF+2+PL
liquescerdes-te	liquescer+V.tu.AD.2.SG+SBJF+2+PL
liquescerdes-vos	liquescer+V.vós.AD.2.PL+INF+2+PL
liquescerdes-vos	liquescer+V.vós.AD.2.PL+SBJF+2+PL
liquescêrei-la	liquescer+V.ele.ACC.3.F.SG+PQP+2+PL
liquescêrei-las	liquescer+V.ele.ACC.3.F.PL+PQP+2+PL
liquescêrei-lo	liquescer+V.ele.ACC.3.M.SG+PQP+2+PL
liquescêrei-los	liquescer+V.ele.ACC.3.M.PL+PQP+2+PL
liquescêrei-nos	liquescer+nós.AD.1.PL+PQP+2+PL
liquescêreis-lhe	liquescer+V.ele.DAT.3.SG+PQP+2+PL
liquescêreis-lhes	liquescer+V.ele.DAT.3.PL+PQP+2+PL
liquescêreis-me	liquescer+V.eu.AD.1.SG+PQP+2+PL
liquescêreis-te	liquescer+V.tu.AD.2.SG+PQP+2+PL
liquescêreis-vos	liquescer+V.vós.AD.2.PL+PQP+2+PL
liquescere-la	liquescer+V.ele.ACC.3.F.SG+INF+2+SG
liquescere-la	liquescer+V.ele.ACC.3.F.SG+SBJF+2+SG
liquescere-las	liquescer+V.ele.ACC.3.F.PL+INF+2+SG
liquescere-las	liquescer+V.ele.ACC.3.F.PL+SBJF+2+SG
liquescere-lo	liquescer+V.ele.ACC.3.M.SG+INF+2+SG
liquescere-lo	liquescer+V.ele.ACC.3.M.SG+SBJF+2+SG
