multigrafar-lhe-á	multigrafar+V.ele.DAT.3.SG+FUT+3+SG
multigrafar-lhe-ão	multigrafar+V.ele.DAT.3.SG+FUT+3+PL
multigrafar-lhe-ás	multigrafar+V.ele.DAT.3.SG+FUT+2+SG
multigrafar-lhe-ei	multigrafar+V.ele.DAT.3.SG+FUT+1+SG
multigrafar-lhe-eis	multigrafar+V.ele.DAT.3.SG+FUT+2+PL
multigrafar-lhe-emos	multigrafar+V.ele.DAT.3.SG+FUT+1+PL
multigrafar-lhe-iam	multigrafar+V.ele.DAT.3.SG+COND+3+PL
multigrafar-lhe-íamos	multigrafar+V.ele.DAT.3.SG+COND+1+PL
multigrafar-lhe-ia	multigrafar+V.ele.DAT.3.SG+COND+1+SG
multigrafar-lhe-ia	multigrafar+V.ele.DAT.3.SG+COND+3+SG
multigrafar-lhe-ias	multigrafar+V.ele.DAT.3.SG+COND+2+SG
multigrafar-lhe-íeis	multigrafar+V.ele.DAT.3.SG+COND+2+PL
multigrafar-lhe	multigrafar+V.ele.DAT.3.SG+INF
multigrafar-lhe	multigrafar+V.ele.DAT.3.SG+INF+1+SG
multigrafar-lhe	multigrafar+V.ele.DAT.3.SG+INF+3+SG
multigrafar-lhe	multigrafar+V.ele.DAT.3.SG+SBJF+1+SG
multigrafar-lhe	multigrafar+V.ele.DAT.3.SG+SBJF+3+SG
multigrafar-lhes-á	multigrafar+V.ele.DAT.3.PL+FUT+3+SG
multigrafar-lhes-ão	multigrafar+V.ele.DAT.3.PL+FUT+3+PL
multigrafar-lhes-ás	multigrafar+V.ele.DAT.3.PL+FUT+2+SG
multigrafar-lhes-ei	multigrafar+V.ele.DAT.3.PL+FUT+1+SG
multigrafar-lhes-eis	multigrafar+V.ele.DAT.3.PL+FUT+2+PL
multigrafar-lhes-emos	multigrafar+V.ele.DAT.3.PL+FUT+1+PL
multigrafar-lhes-iam	multigrafar+V.ele.DAT.3.PL+COND+3+PL
multigrafar-lhes-íamos	multigrafar+V.ele.DAT.3.PL+COND+1+PL
multigrafar-lhes-ia	multigrafar+V.ele.DAT.3.PL+COND+1+SG
multigrafar-lhes-ia	multigrafar+V.ele.DAT.3.PL+COND+3+SG
multigrafar-lhes-ias	multigrafar+V.ele.DAT.3.PL+COND+2+SG
multigrafar-lhes-íeis	multigrafar+V.ele.DAT.3.PL+COND+2+PL
multigrafar-lhes	multigrafar+V.ele.DAT.3.PL+INF
multigrafar-lhes	multigrafar+V.ele.DAT.3.PL+INF+1+SG
multigrafar-lhes	multigrafar+V.ele.DAT.3.PL+INF+3+SG
multigrafar-lhes	multigrafar+V.ele.DAT.3.PL+SBJF+1+SG
multigrafar-lhes	multigrafar+V.ele.DAT.3.PL+SBJF+3+SG
multigrafar-me-á	multigrafar+V.eu.AD.1.SG+FUT+3+SG
multigrafar-me-ão	multigrafar+V.eu.AD.1.SG+FUT+3+PL
multigrafar-me-ás	multigrafar+V.eu.AD.1.SG+FUT+2+SG
multigrafar-me-ei	multigrafar+V.eu.AD.1.SG+FUT+1+SG
multigrafar-me-eis	multigrafar+V.eu.AD.1.SG+FUT+2+PL
multigrafar-me-emos	multigrafar+V.eu.AD.1.SG+FUT+1+PL
multigrafar-me-iam	multigrafar+V.eu.AD.1.SG+COND+3+PL
multigrafar-me-íamos	multigrafar+V.eu.AD.1.SG+COND+1+PL
multigrafar-me-ia	multigrafar+V.eu.AD.1.SG+COND+1+SG
multigrafar-me-ia	multigrafar+V.eu.AD.1.SG+COND+3+SG
multigrafar-me-ias	multigrafar+V.eu.AD.1.SG+COND+2+SG
multigrafar-me-íeis	multigrafar+V.eu.AD.1.SG+COND+2+PL
multigrafar-me	multigrafar+V.eu.AD.1.SG+INF
multigrafar-me	multigrafar+V.eu.AD.1.SG+INF+1+SG
multigrafar-me	multigrafar+V.eu.AD.1.SG+INF+3+SG
multigrafar-me	multigrafar+V.eu.AD.1.SG+SBJF+1+SG
multigrafar-me	multigrafar+V.eu.AD.1.SG+SBJF+3+SG
multigrafarmo-la	multigrafar+V.ele.ACC.3.F.SG+INF+1+PL
multigrafarmo-la	multigrafar+V.ele.ACC.3.F.SG+SBJF+1+PL
multigrafarmo-las	multigrafar+V.ele.ACC.3.F.PL+INF+1+PL
multigrafarmo-las	multigrafar+V.ele.ACC.3.F.PL+SBJF+1+PL
multigrafarmo-lo	multigrafar+V.ele.ACC.3.M.SG+INF+1+PL
multigrafarmo-lo	multigrafar+V.ele.ACC.3.M.SG+SBJF+1+PL
multigrafarmo-los	multigrafar+V.ele.ACC.3.M.PL+INF+1+PL
multigrafarmo-los	multigrafar+V.ele.ACC.3.M.PL+SBJF+1+PL
multigrafarmo-nos	multigrafar+nós.AD.1.PL+INF+1+PL
multigrafarmo-nos	multigrafar+nós.AD.1.PL+SBJF+1+PL
multigrafarmos-lhe	multigrafar+V.ele.DAT.3.SG+INF+1+PL
multigrafarmos-lhe	multigrafar+V.ele.DAT.3.SG+SBJF+1+PL
multigrafarmos-lhes	multigrafar+V.ele.DAT.3.PL+INF+1+PL
multigrafarmos-lhes	multigrafar+V.ele.DAT.3.PL+SBJF+1+PL
multigrafarmos-me	multigrafar+V.eu.AD.1.SG+INF+1+PL
multigrafarmos-me	multigrafar+V.eu.AD.1.SG+SBJF+1+PL
multigrafarmos-te	multigrafar+V.tu.AD.2.SG+INF+1+PL
multigrafarmos-te	multigrafar+V.tu.AD.2.SG+SBJF+1+PL
multigrafarmos-vos	multigrafar+V.vós.AD.2.PL+INF+1+PL
multigrafarmos-vos	multigrafar+V.vós.AD.2.PL+SBJF+1+PL
multigrafar-nos-á	multigrafar+nós.AD.1.PL+FUT+3+SG
multigrafar-nos-ão	multigrafar+nós.AD.1.PL+FUT+3+PL
multigrafar-nos-ás	multigrafar+nós.AD.1.PL+FUT+2+SG
multigrafar-nos-ei	multigrafar+nós.AD.1.PL+FUT+1+SG
multigrafar-nos-eis	multigrafar+nós.AD.1.PL+FUT+2+PL
multigrafar-nos-emos	multigrafar+nós.AD.1.PL+FUT+1+PL
multigrafar-nos-iam	multigrafar+nós.AD.1.PL+COND+3+PL
multigrafar-nos-íamos	multigrafar+nós.AD.1.PL+COND+1+PL
multigrafar-nos-ia	multigrafar+nós.AD.1.PL+COND+1+SG
multigrafar-nos-ia	multigrafar+nós.AD.1.PL+COND+3+SG
multigrafar-nos-ias	multigrafar+nós.AD.1.PL+COND+2+SG
multigrafar-nos-íeis	multigrafar+nós.AD.1.PL+COND+2+PL
multigrafar-nos	multigrafar+nós.AD.1.PL+INF
multigrafar-nos	multigrafar+nós.AD.1.PL+INF+1+SG
multigrafar-nos	multigrafar+nós.AD.1.PL+INF+3+SG
multigrafar-nos	multigrafar+nós.AD.1.PL+SBJF+1+SG
multigrafar-nos	multigrafar+nós.AD.1.PL+SBJF+3+SG
multigrafar-se-á	multigrafar+V.ele.REFL+FUT+3+SG
multigrafar-se-ão	multigrafar+V.ele.REFL+FUT+3+PL
multigrafar-se-iam	multigrafar+V.ele.REFL+COND+3+PL
multigrafar-se-ia	multigrafar+V.ele.REFL+COND+3+SG
multigrafar-se	multigrafar+V.ele.REFL+INF
multigrafar-se	multigrafar+V.ele.REFL+INF+3+SG
multigrafar-se	multigrafar+V.ele.REFL+SBJF+3+SG
multigrafar-te-á	multigrafar+V.tu.AD.2.SG+FUT+3+SG
multigrafar-te-ão	multigrafar+V.tu.AD.2.SG+FUT+3+PL
multigrafar-te-ás	multigrafar+V.tu.AD.2.SG+FUT+2+SG
multigrafar-te-ei	multigrafar+V.tu.AD.2.SG+FUT+1+SG
multigrafar-te-eis	multigrafar+V.tu.AD.2.SG+FUT+2+PL
multigrafar-te-emos	multigrafar+V.tu.AD.2.SG+FUT+1+PL
multigrafar-te-iam	multigrafar+V.tu.AD.2.SG+COND+3+PL
multigrafar-te-íamos	multigrafar+V.tu.AD.2.SG+COND+1+PL
multigrafar-te-ia	multigrafar+V.tu.AD.2.SG+COND+1+SG
multigrafar-te-ia	multigrafar+V.tu.AD.2.SG+COND+3+SG
multigrafar-te-ias	multigrafar+V.tu.AD.2.SG+COND+2+SG
multigrafar-te-íeis	multigrafar+V.tu.AD.2.SG+COND+2+PL
multigrafar-te	multigrafar+V.tu.AD.2.SG+INF
multigrafar-te	multigrafar+V.tu.AD.2.SG+INF+1+SG
multigrafar-te	multigrafar+V.tu.AD.2.SG+INF+3+SG
multigrafar-te	multigrafar+V.tu.AD.2.SG+SBJF+1+SG
multigrafar-te	multigrafar+V.tu.AD.2.SG+SBJF+3+SG
multigrafar-vos-á	multigrafar+V.vós.AD.2.PL+FUT+3+SG
multigrafar-vos-ão	multigrafar+V.vós.AD.2.PL+FUT+3+PL
multigrafar-vos-ás	multigrafar+V.vós.AD.2.PL+FUT+2+SG
multigrafar-vos-ei	multigrafar+V.vós.AD.2.PL+FUT+1+SG
multigrafar-vos-eis	multigrafar+V.vós.AD.2.PL+FUT+2+PL
multigrafar-vos-emos	multigrafar+V.vós.AD.2.PL+FUT+1+PL
multigrafar-vos-iam	multigrafar+V.vós.AD.2.PL+COND+3+PL
multigrafar-vos-íamos	multigrafar+V.vós.AD.2.PL+COND+1+PL
multigrafar-vos-ia	multigrafar+V.vós.AD.2.PL+COND+1+SG
multigrafar-vos-ia	multigrafar+V.vós.AD.2.PL+COND+3+SG
multigrafar-vos-ias	multigrafar+V.vós.AD.2.PL+COND+2+SG
multigrafar-vos-íeis	multigrafar+V.vós.AD.2.PL+COND+2+PL
multigrafar-vos	multigrafar+V.vós.AD.2.PL+INF
multigrafar-vos	multigrafar+V.vós.AD.2.PL+INF+1+SG
multigrafar-vos	multigrafar+V.vós.AD.2.PL+INF+3+SG
multigrafar-vos	multigrafar+V.vós.AD.2.PL+SBJF+1+SG
multigrafar-vos	multigrafar+V.vós.AD.2.PL+SBJF+3+SG
multigrafa-se	multigrafar+V.ele.REFL+PRS+3+SG
multigrafas-lhe	multigrafar+V.ele.DAT.3.SG+PRS+2+SG
multigrafas-lhes	multigrafar+V.ele.DAT.3.PL+PRS+2+SG
multigrafas-me	multigrafar+V.eu.AD.1.SG+PRS+2+SG
multigrafaste-a	multigrafar+V.ele.ACC.3.F.SG+PRF+2+SG
multigrafaste-as	multigrafar+V.ele.ACC.3.F.PL+PRF+2+SG
multigrafaste-la	multigrafar+V.ele.ACC.3.F.SG+PRF+2+PL
multigrafaste-las	multigrafar+V.ele.ACC.3.F.PL+PRF+2+PL
multigrafaste-lhe	multigrafar+V.ele.DAT.3.SG+PRF+2+SG
multigrafaste-lhes	multigrafar+V.ele.DAT.3.PL+PRF+2+SG
multigrafaste-lo	multigrafar+V.ele.ACC.3.M.SG+PRF+2+PL
multigrafaste-los	multigrafar+V.ele.ACC.3.M.PL+PRF+2+PL
multigrafaste-me	multigrafar+V.eu.AD.1.SG+PRF+2+SG
multigrafas-te	multigrafar+V.tu.AD.2.SG+PRS+2+SG
multigrafaste-nos	multigrafar+nós.AD.1.PL+PRF+2+PL
multigrafaste-nos	multigrafar+nós.AD.1.PL+PRF+2+SG
multigrafaste-o	multigrafar+V.ele.ACC.3.M.SG+PRF+2+SG
multigrafaste-os	multigrafar+V.ele.ACC.3.M.PL+PRF+2+SG
multigrafastes-lhe	multigrafar+V.ele.DAT.3.SG+PRF+2+PL
multigrafastes-lhes	multigrafar+V.ele.DAT.3.PL+PRF+2+PL
multigrafastes-me	multigrafar+V.eu.AD.1.SG+PRF+2+PL
multigrafastes-te	multigrafar+V.tu.AD.2.SG+PRF+2+PL
multigrafastes-vos	multigrafar+V.vós.AD.2.PL+PRF+2+PL
multigrafaste-te	multigrafar+V.tu.AD.2.SG+PRF+2+SG
multigrafaste-vos	multigrafar+V.vós.AD.2.PL+PRF+2+SG
multigrafas-vos	multigrafar+V.vós.AD.2.PL+PRS+2+SG
multigrafa-te	multigrafar+V.tu.AD.2.SG+PRS+3+SG
multigrafava-a	multigrafar+V.ele.ACC.3.F.SG+IMPF+1+SG
multigrafava-a	multigrafar+V.ele.ACC.3.F.SG+IMPF+3+SG
multigrafava-as	multigrafar+V.ele.ACC.3.F.PL+IMPF+1+SG
multigrafava-as	multigrafar+V.ele.ACC.3.F.PL+IMPF+3+SG
multigrafava-la	multigrafar+V.ele.ACC.3.F.SG+IMPF+2+SG
multigrafava-las	multigrafar+V.ele.ACC.3.F.PL+IMPF+2+SG
multigrafava-lhe	multigrafar+V.ele.DAT.3.SG+IMPF+1+SG
multigrafava-lhe	multigrafar+V.ele.DAT.3.SG+IMPF+3+SG
multigrafava-lhes	multigrafar+V.ele.DAT.3.PL+IMPF+1+SG
multigrafava-lhes	multigrafar+V.ele.DAT.3.PL+IMPF+3+SG
multigrafava-lo	multigrafar+V.ele.ACC.3.M.SG+IMPF+2+SG
multigrafava-los	multigrafar+V.ele.ACC.3.M.PL+IMPF+2+SG
multigrafava-me	multigrafar+V.eu.AD.1.SG+IMPF+1+SG
multigrafava-me	multigrafar+V.eu.AD.1.SG+IMPF+3+SG
multigrafavam-lhe	multigrafar+V.ele.DAT.3.SG+IMPF+3+PL
multigrafavam-lhes	multigrafar+V.ele.DAT.3.PL+IMPF+3+PL
multigrafavam-me	multigrafar+V.eu.AD.1.SG+IMPF+3+PL
multigrafavam-na	multigrafar+V.ele.ACC.3.F.SG+IMPF+3+PL
multigrafavam-nas	multigrafar+V.ele.ACC.3.F.PL+IMPF+3+PL
multigrafavam-no	multigrafar+V.ele.ACC.3.M.SG+IMPF+3+PL
multigrafavam-nos	multigrafar+V.ele.ACC.3.M.PL+IMPF+3+PL
multigrafavam-nos	multigrafar+V.nós.AD.1.PL+IMPF+3+PL
multigrafávamo-la	multigrafar+V.ele.ACC.3.F.SG+IMPF+1+PL
multigrafávamo-las	multigrafar+V.ele.ACC.3.F.PL+IMPF+1+PL
multigrafávamo-lo	multigrafar+V.ele.ACC.3.M.SG+IMPF+1+PL
multigrafávamo-los	multigrafar+V.ele.ACC.3.M.PL+IMPF+1+PL
multigrafávamo-nos	multigrafar+nós.AD.1.PL+IMPF+1+PL
multigrafávamos-lhe	multigrafar+V.ele.DAT.3.SG+IMPF+1+PL
multigrafávamos-lhes	multigrafar+V.ele.DAT.3.PL+IMPF+1+PL
multigrafávamos-me	multigrafar+V.eu.AD.1.SG+IMPF+1+PL
multigrafávamos-te	multigrafar+V.tu.AD.2.SG+IMPF+1+PL
multigrafávamos-vos	multigrafar+V.vós.AD.2.PL+IMPF+1+PL
multigrafavam-se	multigrafar+V.ele.REFL+IMPF+3+PL
multigrafavam-te	multigrafar+V.tu.AD.2.SG+IMPF+3+PL
multigrafavam-vos	multigrafar+V.vós.AD.2.PL+IMPF+3+PL
multigrafava-nos	multigrafar+nós.AD.1.PL+IMPF+1+SG
multigrafava-nos	multigrafar+nós.AD.1.PL+IMPF+2+SG
multigrafava-nos	multigrafar+nós.AD.1.PL+IMPF+3+SG
multigrafava-o	multigrafar+V.ele.ACC.3.M.SG+IMPF+1+SG
multigrafava-o	multigrafar+V.ele.ACC.3.M.SG+IMPF+3+SG
multigrafava-os	multigrafar+V.ele.ACC.3.M.PL+IMPF+1+SG
multigrafava-os	multigrafar+V.ele.ACC.3.M.PL+IMPF+3+SG
multigrafava-se	multigrafar+V.ele.REFL+IMPF+1+SG
multigrafava-se	multigrafar+V.ele.REFL+IMPF+3+SG
multigrafavas-lhe	multigrafar+V.ele.DAT.3.SG+IMPF+2+SG
multigrafavas-lhes	multigrafar+V.ele.DAT.3.PL+IMPF+2+SG
multigrafavas-me	multigrafar+V.eu.AD.1.SG+IMPF+2+SG
multigrafavas-te	multigrafar+V.tu.AD.2.SG+IMPF+2+SG
multigrafavas-vos	multigrafar+V.vós.AD.2.PL+IMPF+2+SG
multigrafava-te	multigrafar+V.tu.AD.2.SG+IMPF+1+SG
multigrafava-te	multigrafar+V.tu.AD.2.SG+IMPF+3+SG
multigrafava-vos	multigrafar+V.vós.AD.2.PL+IMPF+1+SG
multigrafava-vos	multigrafar+V.vós.AD.2.PL+IMPF+3+SG
multigrafávei-la	multigrafar+V.ele.ACC.3.F.SG+IMPF+2+PL
multigrafávei-las	multigrafar+V.ele.ACC.3.F.PL+IMPF+2+PL
multigrafávei-lo	multigrafar+V.ele.ACC.3.M.SG+IMPF+2+PL
multigrafávei-los	multigrafar+V.ele.ACC.3.M.PL+IMPF+2+PL
multigrafávei-nos	multigrafar+nós.AD.1.PL+IMPF+2+PL
multigrafáveis-lhe	multigrafar+V.ele.DAT.3.SG+IMPF+2+PL
multigrafáveis-lhes	multigrafar+V.ele.DAT.3.PL+IMPF+2+PL
multigrafáveis-me	multigrafar+V.eu.AD.1.SG+IMPF+2+PL
multigrafáveis-te	multigrafar+V.tu.AD.2.SG+IMPF+2+PL
multigrafáveis-vos	multigrafar+V.vós.AD.2.PL+IMPF+2+PL
multigrafa-vos	multigrafar+V.vós.AD.2.PL+PRS+3+SG
multigrafe-a	multigrafar+V.ele.ACC.3.F.SG+IMP+3+SG
multigrafe-as	multigrafar+V.ele.ACC.3.F.PL+IMP+3+SG
multigrafei-a	multigrafar+V.ele.ACC.3.F.SG+PRF+1+SG
multigrafei-as	multigrafar+V.ele.ACC.3.F.PL+PRF+1+SG
multigrafei-lhe	multigrafar+V.ele.DAT.3.SG+PRF+1+SG
multigrafei-lhes	multigrafar+V.ele.DAT.3.PL+PRF+1+SG
multigrafei-me	multigrafar+V.eu.AD.1.SG+PRF+1+SG
multigrafei-nos	multigrafar+nós.AD.1.PL+PRF+1+SG
multigrafei-o	multigrafar+V.ele.ACC.3.M.SG+PRF+1+SG
multigrafei-os	multigrafar+V.ele.ACC.3.M.PL+PRF+1+SG
multigrafei-te	multigrafar+V.tu.AD.2.SG+PRF+1+SG
multigrafei-vos	multigrafar+V.vós.AD.2.PL+PRF+1+SG
multigrafe-lhe	multigrafar+V.ele.DAT.3.SG+IMP+3+SG
multigrafe-lhes	multigrafar+V.ele.DAT.3.PL+IMP+3+SG
multigrafe-me	multigrafar+V.eu.AD.1.SG+IMP+3+SG
multigrafem-lhe	multigrafar+V.ele.DAT.3.SG+IMP+3+PL
multigrafem-lhes	multigrafar+V.ele.DAT.3.PL+IMP+3+PL
multigrafem-me	multigrafar+V.eu.AD.1.SG+IMP+3+PL
multigrafem-na	multigrafar+V.ele.ACC.3.F.SG+IMP+3+PL
multigrafem-nas	multigrafar+V.ele.ACC.3.F.PL+IMP+3+PL
multigrafem-no	multigrafar+V.ele.ACC.3.M.SG+IMP+3+PL
multigrafem-nos	multigrafar+V.ele.ACC.3.M.PL+IMP+3+PL
multigrafem-nos	multigrafar+V.nós.AD.1.PL+IMP+3+PL
multigrafemo-la	multigrafar+V.ele.ACC.3.F.SG+IMP+1+PL
multigrafemo-las	multigrafar+V.ele.ACC.3.F.PL+IMP+1+PL
multigrafemo-lo	multigrafar+V.ele.ACC.3.M.SG+IMP+1+PL
multigrafemo-los	multigrafar+V.ele.ACC.3.M.PL+IMP+1+PL
multigrafemo-nos	multigrafar+nós.AD.1.PL+IMP+1+PL
multigrafemos-lhe	multigrafar+V.ele.DAT.3.SG+IMP+1+PL
multigrafemos-lhes	multigrafar+V.ele.DAT.3.PL+IMP+1+PL
multigrafemos-me	multigrafar+V.eu.AD.1.SG+IMP+1+PL
multigrafemos-te	multigrafar+V.tu.AD.2.SG+IMP+1+PL
multigrafemos-vos	multigrafar+V.vós.AD.2.PL+IMP+1+PL
multigrafem-se	multigrafar+V.ele.REFL+IMP+3+PL
multigrafem-te	multigrafar+V.tu.AD.2.SG+IMP+3+PL
multigrafem-vos	multigrafar+V.vós.AD.2.PL+IMP+3+PL
multigrafe-nos	multigrafar+nós.AD.1.PL+IMP+3+SG
multigrafe-o	multigrafar+V.ele.ACC.3.M.SG+IMP+3+SG
multigrafe-os	multigrafar+V.ele.ACC.3.M.PL+IMP+3+SG
multigrafe-se	multigrafar+V.ele.REFL+IMP+3+SG
multigrafe-te	multigrafar+V.tu.AD.2.SG+IMP+3+SG
multigrafe-vos	multigrafar+V.vós.AD.2.PL+IMP+3+SG
multigrafo-a	multigrafar+V.ele.ACC.3.F.SG+PRS+1+SG
multigrafo-as	multigrafar+V.ele.ACC.3.F.PL+PRS+1+SG
multigrafo-lhe	multigrafar+V.ele.DAT.3.SG+PRS+1+SG
multigrafo-lhes	multigrafar+V.ele.DAT.3.PL+PRS+1+SG
multigrafo-me	multigrafar+V.eu.AD.1.SG+PRS+1+SG
multigrafo-nos	multigrafar+nós.AD.1.PL+PRS+1+SG
multigrafo-o	multigrafar+V.ele.ACC.3.M.SG+PRS+1+SG
multigrafo-os	multigrafar+V.ele.ACC.3.M.PL+PRS+1+SG
multigrafo-te	multigrafar+V.tu.AD.2.SG+PRS+1+SG
multigrafou-a	multigrafar+V.ele.ACC.3.F.SG+PRF+3+SG
multigrafou-as	multigrafar+V.ele.ACC.3.F.PL+PRF+3+SG
multigrafou-lhe	multigrafar+V.ele.DAT.3.SG+PRF+3+SG
multigrafou-lhes	multigrafar+V.ele.DAT.3.PL+PRF+3+SG
multigrafou-me	multigrafar+V.eu.AD.1.SG+PRF+3+SG
multigrafou-nos	multigrafar+nós.AD.1.PL+PRF+3+SG
multigrafou-o	multigrafar+V.ele.ACC.3.M.SG+PRF+3+SG
multigrafou-os	multigrafar+V.ele.ACC.3.M.PL+PRF+3+SG
multigrafou-se	multigrafar+V.ele.REFL+PRF+3+SG
multigrafou-te	multigrafar+V.tu.AD.2.SG+PRF+3+SG
multigrafou-vos	multigrafar+V.vós.AD.2.PL+PRF+3+SG
multigrafo-vos	multigrafar+V.vós.AD.2.PL+PRS+1+SG
multiparta-a	multipartir+V.ele.ACC.3.F.SG+IMP+3+SG
multiparta-as	multipartir+V.ele.ACC.3.F.PL+IMP+3+SG
multiparta-lhe	multipartir+V.ele.DAT.3.SG+IMP+3+SG
multiparta-lhes	multipartir+V.ele.DAT.3.PL+IMP+3+SG
multiparta-me	multipartir+V.eu.AD.1.SG+IMP+3+SG
multipartam-lhe	multipartir+V.ele.DAT.3.SG+IMP+3+PL
multipartam-lhes	multipartir+V.ele.DAT.3.PL+IMP+3+PL
multipartam-me	multipartir+V.eu.AD.1.SG+IMP+3+PL
multipartam-na	multipartir+V.ele.ACC.3.F.SG+IMP+3+PL
multipartam-nas	multipartir+V.ele.ACC.3.F.PL+IMP+3+PL
multipartam-no	multipartir+V.ele.ACC.3.M.SG+IMP+3+PL
multipartam-nos	multipartir+V.ele.ACC.3.M.PL+IMP+3+PL
multipartam-nos	multipartir+V.nós.AD.1.PL+IMP+3+PL
multipartamo-la	multipartir+V.ele.ACC.3.F.SG+IMP+1+PL
multipartamo-las	multipartir+V.ele.ACC.3.F.PL+IMP+1+PL
multipartamo-lo	multipartir+V.ele.ACC.3.M.SG+IMP+1+PL
multipartamo-los	multipartir+V.ele.ACC.3.M.PL+IMP+1+PL
multipartamo-nos	multipartir+nós.AD.1.PL+IMP+1+PL
multipartamos-lhe	multipartir+V.ele.DAT.3.SG+IMP+1+PL
multipartamos-lhes	multipartir+V.ele.DAT.3.PL+IMP+1+PL
multipartamos-me	multipartir+V.eu.AD.1.SG+IMP+1+PL
multipartamos-te	multipartir+V.tu.AD.2.SG+IMP+1+PL
multipartamos-vos	multipartir+V.vós.AD.2.PL+IMP+1+PL
multipartam-se	multipartir+V.ele.REFL+IMP+3+PL
multipartam-te	multipartir+V.tu.AD.2.SG+IMP+3+PL
multipartam-vos	multipartir+V.vós.AD.2.PL+IMP+3+PL
multiparta-nos	multipartir+nós.AD.1.PL+IMP+3+SG
multiparta-o	multipartir+V.ele.ACC.3.M.SG+IMP+3+SG
multiparta-os	multipartir+V.ele.ACC.3.M.PL+IMP+3+SG
multiparta-se	multipartir+V.ele.REFL+IMP+3+SG
multiparta-te	multipartir+V.tu.AD.2.SG+IMP+3+SG
multiparta-vos	multipartir+V.vós.AD.2.PL+IMP+3+SG
multipartia-a	multipartir+V.ele.ACC.3.F.SG+IMPF+1+SG
multipartia-a	multipartir+V.ele.ACC.3.F.SG+IMPF+3+SG
multipartia-as	multipartir+V.ele.ACC.3.F.PL+IMPF+1+SG
multipartia-as	multipartir+V.ele.ACC.3.F.PL+IMPF+3+SG
multipartia-la	multipartir+V.ele.ACC.3.F.SG+IMPF+2+SG
multipartia-las	multipartir+V.ele.ACC.3.F.PL+IMPF+2+SG
multipartia-lhe	multipartir+V.ele.DAT.3.SG+IMPF+1+SG
multipartia-lhe	multipartir+V.ele.DAT.3.SG+IMPF+3+SG
multipartia-lhes	multipartir+V.ele.DAT.3.PL+IMPF+1+SG
multipartia-lhes	multipartir+V.ele.DAT.3.PL+IMPF+3+SG
multipartia-lo	multipartir+V.ele.ACC.3.M.SG+IMPF+2+SG
multipartia-los	multipartir+V.ele.ACC.3.M.PL+IMPF+2+SG
multipartia-me	multipartir+V.eu.AD.1.SG+IMPF+1+SG
multipartia-me	multipartir+V.eu.AD.1.SG+IMPF+3+SG
multipartiam-lhe	multipartir+V.ele.DAT.3.SG+IMPF+3+PL
multipartiam-lhes	multipartir+V.ele.DAT.3.PL+IMPF+3+PL
multipartiam-me	multipartir+V.eu.AD.1.SG+IMPF+3+PL
multipartiam-na	multipartir+V.ele.ACC.3.F.SG+IMPF+3+PL
multipartiam-nas	multipartir+V.ele.ACC.3.F.PL+IMPF+3+PL
multipartiam-no	multipartir+V.ele.ACC.3.M.SG+IMPF+3+PL
multipartiam-nos	multipartir+V.ele.ACC.3.M.PL+IMPF+3+PL
multipartiam-nos	multipartir+V.nós.AD.1.PL+IMPF+3+PL
multipartíamo-la	multipartir+V.ele.ACC.3.F.SG+IMPF+1+PL
multipartíamo-las	multipartir+V.ele.ACC.3.F.PL+IMPF+1+PL
multipartíamo-lo	multipartir+V.ele.ACC.3.M.SG+IMPF+1+PL
multipartíamo-los	multipartir+V.ele.ACC.3.M.PL+IMPF+1+PL
multipartíamo-nos	multipartir+nós.AD.1.PL+IMPF+1+PL
multipartíamos-lhe	multipartir+V.ele.DAT.3.SG+IMPF+1+PL
multipartíamos-lhes	multipartir+V.ele.DAT.3.PL+IMPF+1+PL
multipartíamos-me	multipartir+V.eu.AD.1.SG+IMPF+1+PL
multipartíamos-te	multipartir+V.tu.AD.2.SG+IMPF+1+PL
multipartíamos-vos	multipartir+V.vós.AD.2.PL+IMPF+1+PL
multipartiam-se	multipartir+V.ele.REFL+IMPF+3+PL
multipartiam-te	multipartir+V.tu.AD.2.SG+IMPF+3+PL
multiparti-a	multipartir+V.ele.ACC.3.F.SG+PRF+1+SG
multipartiam-vos	multipartir+V.vós.AD.2.PL+IMPF+3+PL
multipartia-nos	multipartir+nós.AD.1.PL+IMPF+1+SG
multipartia-nos	multipartir+nós.AD.1.PL+IMPF+2+SG
multipartia-nos	multipartir+nós.AD.1.PL+IMPF+3+SG
multipartia-o	multipartir+V.ele.ACC.3.M.SG+IMPF+1+SG
multipartia-o	multipartir+V.ele.ACC.3.M.SG+IMPF+3+SG
multipartia-os	multipartir+V.ele.ACC.3.M.PL+IMPF+1+SG
multipartia-os	multipartir+V.ele.ACC.3.M.PL+IMPF+3+SG
multipartia-se	multipartir+V.ele.REFL+IMPF+3+SG
multipartias-lhe	multipartir+V.ele.DAT.3.SG+IMPF+2+SG
multipartias-lhes	multipartir+V.ele.DAT.3.PL+IMPF+2+SG
multipartias-me	multipartir+V.eu.AD.1.SG+IMPF+2+SG
multiparti-as	multipartir+V.ele.ACC.3.F.PL+PRF+1+SG
multipartias-te	multipartir+V.tu.AD.2.SG+IMPF+2+SG
multipartias-vos	multipartir+V.vós.AD.2.PL+IMPF+2+SG
multipartia-te	multipartir+V.tu.AD.2.SG+IMPF+1+SG
multipartia-te	multipartir+V.tu.AD.2.SG+IMPF+3+SG
multipartia-vos	multipartir+V.vós.AD.2.PL+IMPF+1+SG
multipartia-vos	multipartir+V.vós.AD.2.PL+IMPF+3+SG
multipartíei-la	multipartir+V.ele.ACC.3.F.SG+IMPF+2+PL
multipartíei-las	multipartir+V.ele.ACC.3.F.PL+IMPF+2+PL
multipartíei-lo	multipartir+V.ele.ACC.3.M.SG+IMPF+2+PL
multipartíei-los	multipartir+V.ele.ACC.3.M.PL+IMPF+2+PL
multipartíei-nos	multipartir+nós.AD.1.PL+IMPF+2+PL
multipartíeis-lhe	multipartir+V.ele.DAT.3.SG+IMPF+2+PL
multipartíeis-lhes	multipartir+V.ele.DAT.3.PL+IMPF+2+PL
multipartíeis-me	multipartir+V.eu.AD.1.SG+IMPF+2+PL
multipartíeis-te	multipartir+V.tu.AD.2.SG+IMPF+2+PL
multipartíeis-vos	multipartir+V.vós.AD.2.PL+IMPF+2+PL
multiparti-la-á	multipartir+V.ele.ACC.3.F.SG+FUT+3+SG
multiparti-la-ão	multipartir+V.ele.ACC.3.F.SG+FUT+3+PL
multiparti-la-ás	multipartir+V.ele.ACC.3.F.SG+FUT+2+SG
multiparti-la-ei	multipartir+V.ele.ACC.3.F.SG+FUT+1+SG
multiparti-la-eis	multipartir+V.ele.ACC.3.F.SG+FUT+2+PL
multiparti-la-emos	multipartir+V.ele.ACC.3.F.SG+FUT+1+PL
multiparti-la-iam	multipartir+V.ele.ACC.3.F.SG+COND+3+PL
multiparti-la-íamos	multipartir+V.ele.ACC.3.F.SG+COND+1+PL
multiparti-la-ia	multipartir+V.ele.ACC.3.F.SG+COND+1+SG
multiparti-la-ia	multipartir+V.ele.ACC.3.F.SG+COND+3+SG
multiparti-la-ias	multipartir+V.ele.ACC.3.F.SG+COND+2+SG
multiparti-la-íeis	multipartir+V.ele.ACC.3.F.SG+COND+2+PL
multiparti-la	multipartir+V.ele.ACC.3.F.SG+INF+1+SG
multiparti-la	multipartir+V.ele.ACC.3.F.SG+INF+3+SG
multiparti-la	multipartir+V.ele.ACC.3.F.SG+SBJF+1+SG
multiparti-la	multipartir+V.ele.ACC.3.F.SG+SBJF+3+SG
multiparti-las-á	multipartir+V.ele.ACC.3.F.PL+FUT+3+SG
multiparti-las-ão	multipartir+V.ele.ACC.3.F.PL+FUT+3+PL
multiparti-las-ás	multipartir+V.ele.ACC.3.F.PL+FUT+2+SG
multiparti-las-ei	multipartir+V.ele.ACC.3.F.PL+FUT+1+SG
multiparti-las-eis	multipartir+V.ele.ACC.3.F.PL+FUT+2+PL
multiparti-las-emos	multipartir+V.ele.ACC.3.F.PL+FUT+1+PL
multiparti-las-iam	multipartir+V.ele.ACC.3.F.PL+COND+3+PL
multiparti-las-íamos	multipartir+V.ele.ACC.3.F.PL+COND+1+PL
multiparti-las-ia	multipartir+V.ele.ACC.3.F.PL+COND+1+SG
multiparti-las-ia	multipartir+V.ele.ACC.3.F.PL+COND+3+SG
multiparti-las-ias	multipartir+V.ele.ACC.3.F.PL+COND+2+SG
multiparti-las-íeis	multipartir+V.ele.ACC.3.F.PL+COND+2+PL
multiparti-las	multipartir+V.ele.ACC.3.F.PL+INF+1+SG
multiparti-las	multipartir+V.ele.ACC.3.F.PL+INF+3+SG
multiparti-las	multipartir+V.ele.ACC.3.F.PL+SBJF+1+SG
multiparti-las	multipartir+V.ele.ACC.3.F.PL+SBJF+3+SG
multiparti-lhe	multipartir+V.ele.DAT.3.SG+PRF+1+SG
multiparti-lhes	multipartir+V.ele.DAT.3.PL+PRF+1+SG
multiparti-lo-á	multipartir+V.ele.ACC.3.M.SG+FUT+3+SG
multiparti-lo-ão	multipartir+V.ele.ACC.3.M.SG+FUT+3+PL
multiparti-lo-ás	multipartir+V.ele.ACC.3.M.SG+FUT+2+SG
multiparti-lo-ei	multipartir+V.ele.ACC.3.M.SG+FUT+1+SG
multiparti-lo-eis	multipartir+V.ele.ACC.3.M.SG+FUT+2+PL
multiparti-lo-emos	multipartir+V.ele.ACC.3.M.SG+FUT+1+PL
multiparti-lo-iam	multipartir+V.ele.ACC.3.M.SG+COND+3+PL
multiparti-lo-íamos	multipartir+V.ele.ACC.3.M.SG+COND+1+PL
multiparti-lo-ia	multipartir+V.ele.ACC.3.M.SG+COND+1+SG
multiparti-lo-ia	multipartir+V.ele.ACC.3.M.SG+COND+3+SG
multiparti-lo-ias	multipartir+V.ele.ACC.3.M.SG+COND+2+SG
multiparti-lo-íeis	multipartir+V.ele.ACC.3.M.SG+COND+2+PL
multiparti-lo	multipartir+V.ele.ACC.3.M.SG+INF+1+SG
multiparti-lo	multipartir+V.ele.ACC.3.M.SG+INF+3+SG
multiparti-lo	multipartir+V.ele.ACC.3.M.SG+SBJF+1+SG
multiparti-lo	multipartir+V.ele.ACC.3.M.SG+SBJF+3+SG
multiparti-los-á	multipartir+V.ele.ACC.3.M.PL+FUT+3+SG
multiparti-los-ão	multipartir+V.ele.ACC.3.M.PL+FUT+3+PL
multiparti-los-ás	multipartir+V.ele.ACC.3.M.PL+FUT+2+SG
multiparti-los-ei	multipartir+V.ele.ACC.3.M.PL+FUT+1+SG
multiparti-los-eis	multipartir+V.ele.ACC.3.M.PL+FUT+2+PL
multiparti-los-emos	multipartir+V.ele.ACC.3.M.PL+FUT+1+PL
multiparti-los-iam	multipartir+V.ele.ACC.3.M.PL+COND+3+PL
multiparti-los-íamos	multipartir+V.ele.ACC.3.M.PL+COND+1+PL
multiparti-los-ia	multipartir+V.ele.ACC.3.M.PL+COND+1+SG
multiparti-los-ia	multipartir+V.ele.ACC.3.M.PL+COND+3+SG
multiparti-los-ias	multipartir+V.ele.ACC.3.M.PL+COND+2+SG
multiparti-los-íeis	multipartir+V.ele.ACC.3.M.PL+COND+2+PL
multiparti-los	multipartir+V.ele.ACC.3.M.PL+INF+1+SG
multiparti-los	multipartir+V.ele.ACC.3.M.PL+INF+3+SG
multiparti-los	multipartir+V.ele.ACC.3.M.PL+SBJF+1+SG
multiparti-los	multipartir+V.ele.ACC.3.M.PL+SBJF+3+SG
multiparti-me	multipartir+V.eu.AD.1.SG+PRF+1+SG
multipartimo-la	multipartir+V.ele.ACC.3.F.SG+PRF+1+PL
multipartimo-las	multipartir+V.ele.ACC.3.F.PL+PRF+1+PL
multipartimo-lo	multipartir+V.ele.ACC.3.M.SG+PRF+1+PL
multipartimo-los	multipartir+V.ele.ACC.3.M.PL+PRF+1+PL
multipartimo-nos	multipartir+nós.AD.1.PL+PRF+1+PL
multipartimos-lhe	multipartir+V.ele.DAT.3.SG+PRF+1+PL
multipartimos-lhes	multipartir+V.ele.DAT.3.PL+PRF+1+PL
multipartimos-me	multipartir+V.eu.AD.1.SG+PRF+1+PL
multipartimos-te	multipartir+V.tu.AD.2.SG+PRF+1+PL
multipartimos-vos	multipartir+V.vós.AD.2.PL+PRF+1+PL
multipartindo-a	multipartir+V.ele.ACC.3.F.SG+GRD
multipartindo-as	multipartir+V.ele.ACC.3.F.PL+GRD
multipartindo-lhe	multipartir+V.ele.DAT.3.SG+GRD
multipartindo-lhes	multipartir+V.ele.DAT.3.PL+GRD
multipartindo-me	multipartir+V.eu.AD.1.SG+GRD
multipartindo-nos	multipartir+nós.AD.1.PL+GRD
multipartindo-o	multipartir+V.ele.ACC.3.M.SG+GRD
multipartindo-os	multipartir+V.ele.ACC.3.M.PL+GRD
multipartindo-se	multipartir+V.ele.REFL+GRD
multipartindo-te	multipartir+V.tu.AD.2.SG+GRD
multipartindo-vos	multipartir+V.vós.AD.2.PL+GRD
multiparti-nos	multipartir+nós.AD.1.PL+PRF+1+SG
multiparti-o	multipartir+V.ele.ACC.3.M.SG+PRF+1+SG
multiparti-os	multipartir+V.ele.ACC.3.M.PL+PRF+1+SG
multipartiram-lhe	multipartir+V.ele.DAT.3.SG+PRF+3+PL
multipartiram-lhes	multipartir+V.ele.DAT.3.PL+PRF+3+PL
multipartiram-me	multipartir+V.eu.AD.1.SG+PRF+3+PL
multipartiram-na	multipartir+V.ele.ACC.3.F.SG+PRF+3+PL
multipartiram-nas	multipartir+V.ele.ACC.3.F.PL+PRF+3+PL
multipartiram-no	multipartir+V.ele.ACC.3.M.SG+PRF+3+PL
multipartiram-nos	multipartir+V.ele.ACC.3.M.PL+PRF+3+PL
multipartiram-nos	multipartir+V.nós.AD.1.PL+PRF+3+PL
multipartiram-se	multipartir+V.ele.REFL+PRF+3+PL
multipartiram-te	multipartir+V.tu.AD.2.SG+PRF+3+PL
multipartiram-vos	multipartir+V.vós.AD.2.PL+PRF+3+PL
multipartirde-la	multipartir+V.ele.ACC.3.F.SG+INF+2+PL
multipartirde-la	multipartir+V.ele.ACC.3.F.SG+SBJF+2+PL
multipartirde-las	multipartir+V.ele.ACC.3.F.PL+INF+2+PL
multipartirde-las	multipartir+V.ele.ACC.3.F.PL+SBJF+2+PL
multipartirde-lo	multipartir+V.ele.ACC.3.M.SG+INF+2+PL
multipartirde-lo	multipartir+V.ele.ACC.3.M.SG+SBJF+2+PL
multipartirde-los	multipartir+V.ele.ACC.3.M.PL+INF+2+PL
multipartirde-los	multipartir+V.ele.ACC.3.M.PL+SBJF+2+PL
multipartirde-nos	multipartir+nós.AD.1.PL+INF+2+PL
multipartirde-nos	multipartir+nós.AD.1.PL+SBJF+2+PL
multipartirdes-lhe	multipartir+V.ele.DAT.3.SG+INF+2+PL
multipartirdes-lhe	multipartir+V.ele.DAT.3.SG+SBJF+2+PL
multipartirdes-lhes	multipartir+V.ele.DAT.3.PL+INF+2+PL
multipartirdes-lhes	multipartir+V.ele.DAT.3.PL+SBJF+2+PL
multipartirdes-me	multipartir+V.eu.AD.1.SG+INF+2+PL
multipartirdes-me	multipartir+V.eu.AD.1.SG+SBJF+2+PL
multipartirdes-te	multipartir+V.tu.AD.2.SG+INF+2+PL
multipartirdes-te	multipartir+V.tu.AD.2.SG+SBJF+2+PL
multipartirdes-vos	multipartir+V.vós.AD.2.PL+INF+2+PL
multipartirdes-vos	multipartir+V.vós.AD.2.PL+SBJF+2+PL
multipartire-la	multipartir+V.ele.ACC.3.F.SG+INF+2+SG
multipartire-la	multipartir+V.ele.ACC.3.F.SG+SBJF+2+SG
multipartire-las	multipartir+V.ele.ACC.3.F.PL+INF+2+SG
multipartire-las	multipartir+V.ele.ACC.3.F.PL+SBJF+2+SG
multipartire-lo	multipartir+V.ele.ACC.3.M.SG+INF+2+SG
multipartire-lo	multipartir+V.ele.ACC.3.M.SG+SBJF+2+SG
multipartire-los	multipartir+V.ele.ACC.3.M.PL+INF+2+SG
multipartire-los	multipartir+V.ele.ACC.3.M.PL+SBJF+2+SG
multipartirem-lhe	multipartir+V.ele.DAT.3.SG+INF+3+PL
multipartirem-lhe	multipartir+V.ele.DAT.3.SG+SBJF+3+PL
multipartirem-lhes	multipartir+V.ele.DAT.3.PL+INF+3+PL
multipartirem-lhes	multipartir+V.ele.DAT.3.PL+SBJF+3+PL
multipartirem-me	multipartir+V.eu.AD.1.SG+INF+3+PL
multipartirem-me	multipartir+V.eu.AD.1.SG+SBJF+3+PL
multipartirem-na	multipartir+V.ele.ACC.3.F.SG+INF+3+PL
multipartirem-na	multipartir+V.ele.ACC.3.F.SG+SBJF+3+PL
multipartirem-nas	multipartir+V.ele.ACC.3.F.PL+INF+3+PL
multipartirem-nas	multipartir+V.ele.ACC.3.F.PL+SBJF+3+PL
multipartirem-no	multipartir+V.ele.ACC.3.M.SG+INF+3+PL
multipartirem-no	multipartir+V.ele.ACC.3.M.SG+SBJF+3+PL
multipartirem-nos	multipartir+V.ele.ACC.3.M.PL+INF+3+PL
multipartirem-nos	multipartir+V.ele.ACC.3.M.PL+SBJF+3+PL
multipartirem-nos	multipartir+V.nós.AD.1.PL+INF+3+PL
multipartirem-nos	multipartir+V.nós.AD.1.PL+SBJF+3+PL
multipartirem-se	multipartir+V.ele.REFL+INF+3+PL
multipartirem-se	multipartir+V.ele.REFL+SBJF+3+PL
multipartirem-te	multipartir+V.tu.AD.2.SG+INF+3+PL
multipartirem-te	multipartir+V.tu.AD.2.SG+SBJF+3+PL
multipartirem-vos	multipartir+V.vós.AD.2.PL+INF+3+PL
multipartirem-vos	multipartir+V.vós.AD.2.PL+SBJF+3+PL
multipartire-nos	multipartir+nós.AD.1.PL+INF+2+SG
multipartire-nos	multipartir+nós.AD.1.PL+SBJF+2+SG
multipartires-lhe	multipartir+V.ele.DAT.3.SG+INF+2+SG
multipartires-lhe	multipartir+V.ele.DAT.3.SG+SBJF+2+SG
multipartires-lhes	multipartir+V.ele.DAT.3.PL+INF+2+SG
multipartires-lhes	multipartir+V.ele.DAT.3.PL+SBJF+2+SG
multipartires-me	multipartir+V.eu.AD.1.SG+INF+2+SG
multipartires-me	multipartir+V.eu.AD.1.SG+SBJF+2+SG
multipartires-te	multipartir+V.tu.AD.2.SG+INF+2+SG
multipartires-te	multipartir+V.tu.AD.2.SG+SBJF+2+SG
multipartires-vos	multipartir+V.vós.AD.2.PL+INF+2+SG
multipartires-vos	multipartir+V.vós.AD.2.PL+SBJF+2+SG
multipartir-lhe-á	multipartir+V.ele.DAT.3.SG+FUT+3+SG
multipartir-lhe-ão	multipartir+V.ele.DAT.3.SG+FUT+3+PL
multipartir-lhe-ás	multipartir+V.ele.DAT.3.SG+FUT+2+SG
multipartir-lhe-ei	multipartir+V.ele.DAT.3.SG+FUT+1+SG
multipartir-lhe-eis	multipartir+V.ele.DAT.3.SG+FUT+2+PL
multipartir-lhe-emos	multipartir+V.ele.DAT.3.SG+FUT+1+PL
multipartir-lhe-iam	multipartir+V.ele.DAT.3.SG+COND+3+PL
multipartir-lhe-íamos	multipartir+V.ele.DAT.3.SG+COND+1+PL
multipartir-lhe-ia	multipartir+V.ele.DAT.3.SG+COND+1+SG
multipartir-lhe-ia	multipartir+V.ele.DAT.3.SG+COND+3+SG
multipartir-lhe-ias	multipartir+V.ele.DAT.3.SG+COND+2+SG
multipartir-lhe-íeis	multipartir+V.ele.DAT.3.SG+COND+2+PL
multipartir-lhe	multipartir+V.ele.DAT.3.SG+INF
multipartir-lhe	multipartir+V.ele.DAT.3.SG+INF+1+SG
multipartir-lhe	multipartir+V.ele.DAT.3.SG+INF+3+SG
multipartir-lhe	multipartir+V.ele.DAT.3.SG+SBJF+1+SG
multipartir-lhe	multipartir+V.ele.DAT.3.SG+SBJF+3+SG
multipartir-lhes-á	multipartir+V.ele.DAT.3.PL+FUT+3+SG
multipartir-lhes-ão	multipartir+V.ele.DAT.3.PL+FUT+3+PL
multipartir-lhes-ás	multipartir+V.ele.DAT.3.PL+FUT+2+SG
multipartir-lhes-ei	multipartir+V.ele.DAT.3.PL+FUT+1+SG
multipartir-lhes-eis	multipartir+V.ele.DAT.3.PL+FUT+2+PL
multipartir-lhes-emos	multipartir+V.ele.DAT.3.PL+FUT+1+PL
multipartir-lhes-iam	multipartir+V.ele.DAT.3.PL+COND+3+PL
multipartir-lhes-íamos	multipartir+V.ele.DAT.3.PL+COND+1+PL
multipartir-lhes-ia	multipartir+V.ele.DAT.3.PL+COND+1+SG
multipartir-lhes-ia	multipartir+V.ele.DAT.3.PL+COND+3+SG
multipartir-lhes-ias	multipartir+V.ele.DAT.3.PL+COND+2+SG
multipartir-lhes-íeis	multipartir+V.ele.DAT.3.PL+COND+2+PL
multipartir-lhes	multipartir+V.ele.DAT.3.PL+INF
multipartir-lhes	multipartir+V.ele.DAT.3.PL+INF+1+SG
multipartir-lhes	multipartir+V.ele.DAT.3.PL+INF+3+SG
multipartir-lhes	multipartir+V.ele.DAT.3.PL+SBJF+1+SG
multipartir-lhes	multipartir+V.ele.DAT.3.PL+SBJF+3+SG
multipartir-me-á	multipartir+V.eu.AD.1.SG+FUT+3+SG
multipartir-me-ão	multipartir+V.eu.AD.1.SG+FUT+3+PL
multipartir-me-ás	multipartir+V.eu.AD.1.SG+FUT+2+SG
multipartir-me-ei	multipartir+V.eu.AD.1.SG+FUT+1+SG
multipartir-me-eis	multipartir+V.eu.AD.1.SG+FUT+2+PL
multipartir-me-emos	multipartir+V.eu.AD.1.SG+FUT+1+PL
multipartir-me-iam	multipartir+V.eu.AD.1.SG+COND+3+PL
multipartir-me-íamos	multipartir+V.eu.AD.1.SG+COND+1+PL
multipartir-me-ia	multipartir+V.eu.AD.1.SG+COND+1+SG
multipartir-me-ia	multipartir+V.eu.AD.1.SG+COND+3+SG
multipartir-me-ias	multipartir+V.eu.AD.1.SG+COND+2+SG
multipartir-me-íeis	multipartir+V.eu.AD.1.SG+COND+2+PL
multipartir-me	multipartir+V.eu.AD.1.SG+INF
multipartir-me	multipartir+V.eu.AD.1.SG+INF+1+SG
multipartir-me	multipartir+V.eu.AD.1.SG+INF+3+SG
multipartir-me	multipartir+V.eu.AD.1.SG+SBJF+1+SG
multipartir-me	multipartir+V.eu.AD.1.SG+SBJF+3+SG
multipartirmo-la	multipartir+V.ele.ACC.3.F.SG+INF+1+PL
multipartirmo-la	multipartir+V.ele.ACC.3.F.SG+SBJF+1+PL
multipartirmo-las	multipartir+V.ele.ACC.3.F.PL+INF+1+PL
multipartirmo-las	multipartir+V.ele.ACC.3.F.PL+SBJF+1+PL
multipartirmo-lo	multipartir+V.ele.ACC.3.M.SG+INF+1+PL
multipartirmo-lo	multipartir+V.ele.ACC.3.M.SG+SBJF+1+PL
multipartirmo-los	multipartir+V.ele.ACC.3.M.PL+INF+1+PL
multipartirmo-los	multipartir+V.ele.ACC.3.M.PL+SBJF+1+PL
multipartirmo-nos	multipartir+nós.AD.1.PL+INF+1+PL
multipartirmo-nos	multipartir+nós.AD.1.PL+SBJF+1+PL
multipartirmos-lhe	multipartir+V.ele.DAT.3.SG+INF+1+PL
multipartirmos-lhe	multipartir+V.ele.DAT.3.SG+SBJF+1+PL
multipartirmos-lhes	multipartir+V.ele.DAT.3.PL+INF+1+PL
multipartirmos-lhes	multipartir+V.ele.DAT.3.PL+SBJF+1+PL
multipartirmos-me	multipartir+V.eu.AD.1.SG+INF+1+PL
multipartirmos-me	multipartir+V.eu.AD.1.SG+SBJF+1+PL
multipartirmos-te	multipartir+V.tu.AD.2.SG+INF+1+PL
multipartirmos-te	multipartir+V.tu.AD.2.SG+SBJF+1+PL
multipartirmos-vos	multipartir+V.vós.AD.2.PL+INF+1+PL
multipartirmos-vos	multipartir+V.vós.AD.2.PL+SBJF+1+PL
multipartir-nos-á	multipartir+nós.AD.1.PL+FUT+3+SG
multipartir-nos-ão	multipartir+nós.AD.1.PL+FUT+3+PL
multipartir-nos-ás	multipartir+nós.AD.1.PL+FUT+2+SG
multipartir-nos-ei	multipartir+nós.AD.1.PL+FUT+1+SG
multipartir-nos-eis	multipartir+nós.AD.1.PL+FUT+2+PL
multipartir-nos-emos	multipartir+nós.AD.1.PL+FUT+1+PL
multipartir-nos-iam	multipartir+nós.AD.1.PL+COND+3+PL
multipartir-nos-íamos	multipartir+nós.AD.1.PL+COND+1+PL
multipartir-nos-ia	multipartir+nós.AD.1.PL+COND+1+SG
multipartir-nos-ia	multipartir+nós.AD.1.PL+COND+3+SG
multipartir-nos-ias	multipartir+nós.AD.1.PL+COND+2+SG
multipartir-nos-íeis	multipartir+nós.AD.1.PL+COND+2+PL
multipartir-nos	multipartir+nós.AD.1.PL+INF
multipartir-nos	multipartir+nós.AD.1.PL+INF+1+SG
multipartir-nos	multipartir+nós.AD.1.PL+INF+3+SG
multipartir-nos	multipartir+nós.AD.1.PL+SBJF+1+SG
multipartir-nos	multipartir+nós.AD.1.PL+SBJF+3+SG
multipartir-se-á	multipartir+V.ele.REFL+FUT+3+SG
multipartir-se-ão	multipartir+V.ele.REFL+FUT+3+PL
multipartir-se-iam	multipartir+V.ele.REFL+COND+3+PL
multipartir-se-ia	multipartir+V.ele.REFL+COND+3+SG
multipartir-se	multipartir+V.ele.REFL+INF
multipartir-se	multipartir+V.ele.REFL+INF+3+SG
multipartir-se	multipartir+V.ele.REFL+SBJF+3+SG
multipartir-te-á	multipartir+V.tu.AD.2.SG+FUT+3+SG
multipartir-te-ão	multipartir+V.tu.AD.2.SG+FUT+3+PL
multipartir-te-ás	multipartir+V.tu.AD.2.SG+FUT+2+SG
multipartir-te-ei	multipartir+V.tu.AD.2.SG+FUT+1+SG
multipartir-te-eis	multipartir+V.tu.AD.2.SG+FUT+2+PL
multipartir-te-emos	multipartir+V.tu.AD.2.SG+FUT+1+PL
multipartir-te-iam	multipartir+V.tu.AD.2.SG+COND+3+PL
multipartir-te-íamos	multipartir+V.tu.AD.2.SG+COND+1+PL
multipartir-te-ia	multipartir+V.tu.AD.2.SG+COND+1+SG
multipartir-te-ia	multipartir+V.tu.AD.2.SG+COND+3+SG
multipartir-te-ias	multipartir+V.tu.AD.2.SG+COND+2+SG
multipartir-te-íeis	multipartir+V.tu.AD.2.SG+COND+2+PL
multipartir-te	multipartir+V.tu.AD.2.SG+INF
multipartir-te	multipartir+V.tu.AD.2.SG+INF+1+SG
multipartir-te	multipartir+V.tu.AD.2.SG+INF+3+SG
multipartir-te	multipartir+V.tu.AD.2.SG+SBJF+1+SG
multipartir-te	multipartir+V.tu.AD.2.SG+SBJF+3+SG
multipartir-vos-á	multipartir+V.vós.AD.2.PL+FUT+3+SG
multipartir-vos-ão	multipartir+V.vós.AD.2.PL+FUT+3+PL
multipartir-vos-ás	multipartir+V.vós.AD.2.PL+FUT+2+SG
multipartir-vos-ei	multipartir+V.vós.AD.2.PL+FUT+1+SG
multipartir-vos-eis	multipartir+V.vós.AD.2.PL+FUT+2+PL
multipartir-vos-emos	multipartir+V.vós.AD.2.PL+FUT+1+PL
multipartir-vos-iam	multipartir+V.vós.AD.2.PL+COND+3+PL
multipartir-vos-íamos	multipartir+V.vós.AD.2.PL+COND+1+PL
multipartir-vos-ia	multipartir+V.vós.AD.2.PL+COND+1+SG
multipartir-vos-ia	multipartir+V.vós.AD.2.PL+COND+3+SG
multipartir-vos-ias	multipartir+V.vós.AD.2.PL+COND+2+SG
multipartir-vos-íeis	multipartir+V.vós.AD.2.PL+COND+2+PL
multipartir-vos	multipartir+V.vós.AD.2.PL+INF
multipartir-vos	multipartir+V.vós.AD.2.PL+INF+1+SG
multipartir-vos	multipartir+V.vós.AD.2.PL+INF+3+SG
multipartir-vos	multipartir+V.vós.AD.2.PL+SBJF+1+SG
multipartir-vos	multipartir+V.vós.AD.2.PL+SBJF+3+SG
multipartiste-a	multipartir+V.ele.ACC.3.F.SG+PRF+2+SG
multipartiste-as	multipartir+V.ele.ACC.3.F.PL+PRF+2+SG
multipartiste-la	multipartir+V.ele.ACC.3.F.SG+PRF+2+PL
multipartiste-las	multipartir+V.ele.ACC.3.F.PL+PRF+2+PL
multipartiste-lhe	multipartir+V.ele.DAT.3.SG+PRF+2+SG
multipartiste-lhes	multipartir+V.ele.DAT.3.PL+PRF+2+SG
multipartiste-lo	multipartir+V.ele.ACC.3.M.SG+PRF+2+PL
multipartiste-los	multipartir+V.ele.ACC.3.M.PL+PRF+2+PL
multipartiste-me	multipartir+V.eu.AD.1.SG+PRF+2+SG
multipartiste-nos	multipartir+nós.AD.1.PL+PRF+2+PL
multipartiste-nos	multipartir+nós.AD.1.PL+PRF+2+SG
multipartiste-o	multipartir+V.ele.ACC.3.M.SG+PRF+2+SG
multipartiste-os	multipartir+V.ele.ACC.3.M.PL+PRF+2+SG
multipartistes-lhe	multipartir+V.ele.DAT.3.SG+PRF+2+PL
multipartistes-lhes	multipartir+V.ele.DAT.3.PL+PRF+2+PL
multipartistes-me	multipartir+V.eu.AD.1.SG+PRF+2+PL
multipartistes-te	multipartir+V.tu.AD.2.SG+PRF+2+PL
multipartistes-vos	multipartir+V.vós.AD.2.PL+PRF+2+PL
multipartiste-te	multipartir+V.tu.AD.2.SG+PRF+2+SG
multipartiste-vos	multipartir+V.vós.AD.2.PL+PRF+2+SG
multiparti-te	multipartir+V.tu.AD.2.SG+PRF+1+SG
multipartiu-a	multipartir+V.ele.ACC.3.F.SG+PRF+3+SG
multipartiu-as	multipartir+V.ele.ACC.3.F.PL+PRF+3+SG
multipartiu-lhe	multipartir+V.ele.DAT.3.SG+PRF+3+SG
multipartiu-lhes	multipartir+V.ele.DAT.3.PL+PRF+3+SG
multipartiu-me	multipartir+V.eu.AD.1.SG+PRF+3+SG
multipartiu-nos	multipartir+nós.AD.1.PL+PRF+3+SG
multipartiu-o	multipartir+V.ele.ACC.3.M.SG+PRF+3+SG
multipartiu-os	multipartir+V.ele.ACC.3.M.PL+PRF+3+SG
multipartiu-se	multipartir+V.ele.REFL+PRF+3+SG
multipartiu-te	multipartir+V.tu.AD.2.SG+PRF+3+SG
multipartiu-vos	multipartir+V.vós.AD.2.PL+PRF+3+SG
multiparti-vos	multipartir+V.vós.AD.2.PL+PRF+1+SG
multiplica-a	multiplicar+V.ele.ACC.3.F.SG+PRS+3+SG
multiplica-as	multiplicar+V.ele.ACC.3.F.PL+PRS+3+SG
multiplicai-la	multiplicar+V.ele.ACC.3.F.SG+PRS+2+PL
multiplicai-las	multiplicar+V.ele.ACC.3.F.PL+PRS+2+PL
multiplicai-lo	multiplicar+V.ele.ACC.3.M.SG+PRS+2+PL
multiplicai-los	multiplicar+V.ele.ACC.3.M.PL+PRS+2+PL
multiplicai-nos	multiplicar+nós.AD.1.PL+PRS+2+PL
multiplicais-lhe	multiplicar+V.ele.DAT.3.SG+PRS+2+PL
multiplicais-lhes	multiplicar+V.ele.DAT.3.PL+PRS+2+PL
multiplicais-me	multiplicar+V.eu.AD.1.SG+PRS+2+PL
multiplicais-te	multiplicar+V.tu.AD.2.SG+PRS+2+PL
multiplicais-vos	multiplicar+V.vós.AD.2.PL+PRS+2+PL
multiplicá-la-á	multiplicar+V.ele.ACC.3.F.SG+FUT+3+SG
multiplicá-la-ão	multiplicar+V.ele.ACC.3.F.SG+FUT+3+PL
multiplicá-la-ás	multiplicar+V.ele.ACC.3.F.SG+FUT+2+SG
multiplicá-la-ei	multiplicar+V.ele.ACC.3.F.SG+FUT+1+SG
multiplicá-la-eis	multiplicar+V.ele.ACC.3.F.SG+FUT+2+PL
multiplicá-la-emos	multiplicar+V.ele.ACC.3.F.SG+FUT+1+PL
multiplicá-la-iam	multiplicar+V.ele.ACC.3.F.SG+COND+3+PL
multiplicá-la-íamos	multiplicar+V.ele.ACC.3.F.SG+COND+1+PL
multiplicá-la-ia	multiplicar+V.ele.ACC.3.F.SG+COND+1+SG
multiplicá-la-ia	multiplicar+V.ele.ACC.3.F.SG+COND+3+SG
multiplicá-la-ias	multiplicar+V.ele.ACC.3.F.SG+COND+2+SG
multiplicá-la-íeis	multiplicar+V.ele.ACC.3.F.SG+COND+2+PL
multiplicá-la	multiplicar+V.ele.ACC.3.F.SG+INF+1+SG
multiplicá-la	multiplicar+V.ele.ACC.3.F.SG+INF+3+SG
multiplica-la	multiplicar+V.ele.ACC.3.F.SG+PRS+2+SG
multiplicá-la	multiplicar+V.ele.ACC.3.F.SG+SBJF+1+SG
multiplicá-la	multiplicar+V.ele.ACC.3.F.SG+SBJF+3+SG
multiplicá-las-á	multiplicar+V.ele.ACC.3.F.PL+FUT+3+SG
multiplicá-las-ão	multiplicar+V.ele.ACC.3.F.PL+FUT+3+PL
multiplicá-las-ás	multiplicar+V.ele.ACC.3.F.PL+FUT+2+SG
multiplicá-las-ei	multiplicar+V.ele.ACC.3.F.PL+FUT+1+SG
multiplicá-las-eis	multiplicar+V.ele.ACC.3.F.PL+FUT+2+PL
multiplicá-las-emos	multiplicar+V.ele.ACC.3.F.PL+FUT+1+PL
multiplicá-las-iam	multiplicar+V.ele.ACC.3.F.PL+COND+3+PL
multiplicá-las-íamos	multiplicar+V.ele.ACC.3.F.PL+COND+1+PL
multiplicá-las-ia	multiplicar+V.ele.ACC.3.F.PL+COND+1+SG
multiplicá-las-ia	multiplicar+V.ele.ACC.3.F.PL+COND+3+SG
multiplicá-las-ias	multiplicar+V.ele.ACC.3.F.PL+COND+2+SG
multiplicá-las-íeis	multiplicar+V.ele.ACC.3.F.PL+COND+2+PL
multiplicá-las	multiplicar+V.ele.ACC.3.F.PL+INF+1+SG
multiplicá-las	multiplicar+V.ele.ACC.3.F.PL+INF+3+SG
multiplica-las	multiplicar+V.ele.ACC.3.F.PL+PRS+2+SG
multiplicá-las	multiplicar+V.ele.ACC.3.F.PL+SBJF+1+SG
multiplicá-las	multiplicar+V.ele.ACC.3.F.PL+SBJF+3+SG
multiplica-lhe	multiplicar+V.ele.DAT.3.SG+PRS+3+SG
multiplica-lhes	multiplicar+V.ele.DAT.3.PL+PRS+3+SG
multiplicá-lo-á	multiplicar+V.ele.ACC.3.M.SG+FUT+3+SG
multiplicá-lo-ão	multiplicar+V.ele.ACC.3.M.SG+FUT+3+PL
multiplicá-lo-ás	multiplicar+V.ele.ACC.3.M.SG+FUT+2+SG
multiplicá-lo-ei	multiplicar+V.ele.ACC.3.M.SG+FUT+1+SG
multiplicá-lo-eis	multiplicar+V.ele.ACC.3.M.SG+FUT+2+PL
multiplicá-lo-emos	multiplicar+V.ele.ACC.3.M.SG+FUT+1+PL
multiplicá-lo-iam	multiplicar+V.ele.ACC.3.M.SG+COND+3+PL
multiplicá-lo-íamos	multiplicar+V.ele.ACC.3.M.SG+COND+1+PL
multiplicá-lo-ia	multiplicar+V.ele.ACC.3.M.SG+COND+1+SG
multiplicá-lo-ia	multiplicar+V.ele.ACC.3.M.SG+COND+3+SG
multiplicá-lo-ias	multiplicar+V.ele.ACC.3.M.SG+COND+2+SG
multiplicá-lo-íeis	multiplicar+V.ele.ACC.3.M.SG+COND+2+PL
multiplicá-lo	multiplicar+V.ele.ACC.3.M.SG+INF+1+SG
multiplicá-lo	multiplicar+V.ele.ACC.3.M.SG+INF+3+SG
multiplica-lo	multiplicar+V.ele.ACC.3.M.SG+PRS+2+SG
multiplicá-lo	multiplicar+V.ele.ACC.3.M.SG+SBJF+1+SG
multiplicá-lo	multiplicar+V.ele.ACC.3.M.SG+SBJF+3+SG
multiplicá-los-á	multiplicar+V.ele.ACC.3.M.PL+FUT+3+SG
multiplicá-los-ão	multiplicar+V.ele.ACC.3.M.PL+FUT+3+PL
multiplicá-los-ás	multiplicar+V.ele.ACC.3.M.PL+FUT+2+SG
multiplicá-los-ei	multiplicar+V.ele.ACC.3.M.PL+FUT+1+SG
multiplicá-los-eis	multiplicar+V.ele.ACC.3.M.PL+FUT+2+PL
multiplicá-los-emos	multiplicar+V.ele.ACC.3.M.PL+FUT+1+PL
multiplicá-los-iam	multiplicar+V.ele.ACC.3.M.PL+COND+3+PL
multiplicá-los-íamos	multiplicar+V.ele.ACC.3.M.PL+COND+1+PL
multiplicá-los-ia	multiplicar+V.ele.ACC.3.M.PL+COND+1+SG
multiplicá-los-ia	multiplicar+V.ele.ACC.3.M.PL+COND+3+SG
multiplicá-los-ias	multiplicar+V.ele.ACC.3.M.PL+COND+2+SG
multiplicá-los-íeis	multiplicar+V.ele.ACC.3.M.PL+COND+2+PL
multiplicá-los	multiplicar+V.ele.ACC.3.M.PL+INF+1+SG
multiplicá-los	multiplicar+V.ele.ACC.3.M.PL+INF+3+SG
multiplica-los	multiplicar+V.ele.ACC.3.M.PL+PRS+2+SG
multiplicá-los	multiplicar+V.ele.ACC.3.M.PL+SBJF+1+SG
multiplicá-los	multiplicar+V.ele.ACC.3.M.PL+SBJF+3+SG
multiplica-me	multiplicar+V.eu.AD.1.SG+PRS+3+SG
multiplicam-lhe	multiplicar+V.ele.DAT.3.SG+PRS+3+PL
multiplicam-lhes	multiplicar+V.ele.DAT.3.PL+PRS+3+PL
multiplicam-me	multiplicar+V.eu.AD.1.SG+PRS+3+PL
multiplicam-na	multiplicar+V.ele.ACC.3.F.SG+PRS+3+PL
multiplicam-nas	multiplicar+V.ele.ACC.3.F.PL+PRS+3+PL
multiplicam-no	multiplicar+V.ele.ACC.3.M.SG+PRS+3+PL
multiplicam-nos	multiplicar+V.ele.ACC.3.M.PL+PRS+3+PL
multiplicam-nos	multiplicar+V.nós.AD.1.PL+PRS+3+PL
multiplicamo-la	multiplicar+V.ele.ACC.3.F.SG+PRF+1+PL
multiplicamo-la	multiplicar+V.ele.ACC.3.F.SG+PRS+1+PL
multiplicamo-las	multiplicar+V.ele.ACC.3.F.PL+PRF+1+PL
multiplicamo-las	multiplicar+V.ele.ACC.3.F.PL+PRS+1+PL
multiplicamo-lo	multiplicar+V.ele.ACC.3.M.SG+PRF+1+PL
multiplicamo-lo	multiplicar+V.ele.ACC.3.M.SG+PRS+1+PL
multiplicamo-los	multiplicar+V.ele.ACC.3.M.PL+PRF+1+PL
multiplicamo-los	multiplicar+V.ele.ACC.3.M.PL+PRS+1+PL
multiplicamo-nos	multiplicar+nós.AD.1.PL+PRF+1+PL
multiplicamo-nos	multiplicar+nós.AD.1.PL+PRS+1+PL
multiplicamos-lhe	multiplicar+V.ele.DAT.3.SG+PRF+1+PL
multiplicamos-lhe	multiplicar+V.ele.DAT.3.SG+PRS+1+PL
multiplicamos-lhes	multiplicar+V.ele.DAT.3.PL+PRF+1+PL
multiplicamos-lhes	multiplicar+V.ele.DAT.3.PL+PRS+1+PL
multiplicamos-me	multiplicar+V.eu.AD.1.SG+PRF+1+PL
multiplicamos-me	multiplicar+V.eu.AD.1.SG+PRS+1+PL
multiplicamos-te	multiplicar+V.tu.AD.2.SG+PRF+1+PL
multiplicamos-te	multiplicar+V.tu.AD.2.SG+PRS+1+PL
multiplicamos-vos	multiplicar+V.vós.AD.2.PL+PRF+1+PL
multiplicamos-vos	multiplicar+V.vós.AD.2.PL+PRS+1+PL
multiplicam-se	multiplicar+V.ele.REFL+PRS+3+PL
multiplicam-te	multiplicar+V.tu.AD.2.SG+PRS+3+PL
multiplicam-vos	multiplicar+V.vós.AD.2.PL+PRS+3+PL
multiplicando-a	multiplicar+V.ele.ACC.3.F.SG+GRD
multiplicando-as	multiplicar+V.ele.ACC.3.F.PL+GRD
multiplicando-lhe	multiplicar+V.ele.DAT.3.SG+GRD
multiplicando-lhes	multiplicar+V.ele.DAT.3.PL+GRD
multiplicando-me	multiplicar+V.eu.AD.1.SG+GRD
multiplicando-nos	multiplicar+nós.AD.1.PL+GRD
multiplicando-o	multiplicar+V.ele.ACC.3.M.SG+GRD
multiplicando-os	multiplicar+V.ele.ACC.3.M.PL+GRD
multiplicando-se	multiplicar+V.ele.REFL+GRD
multiplicando-te	multiplicar+V.tu.AD.2.SG+GRD
multiplicando-vos	multiplicar+V.vós.AD.2.PL+GRD
multiplica-nos	multiplicar+nós.AD.1.PL+PRS+2+SG
multiplica-nos	multiplicar+nós.AD.1.PL+PRS+3+SG
multiplica-o	multiplicar+V.ele.ACC.3.M.SG+PRS+3+SG
multiplica-os	multiplicar+V.ele.ACC.3.M.PL+PRS+3+SG
multiplicara-a	multiplicar+V.ele.ACC.3.F.SG+PQP+1+SG
multiplicara-a	multiplicar+V.ele.ACC.3.F.SG+PQP+3+SG
multiplicara-as	multiplicar+V.ele.ACC.3.F.PL+PQP+1+SG
multiplicara-as	multiplicar+V.ele.ACC.3.F.PL+PQP+3+SG
multiplicara-la	multiplicar+V.ele.ACC.3.F.SG+PQP+2+SG
multiplicara-las	multiplicar+V.ele.ACC.3.F.PL+PQP+2+SG
multiplicara-lhe	multiplicar+V.ele.DAT.3.SG+PQP+1+SG
multiplicara-lhe	multiplicar+V.ele.DAT.3.SG+PQP+3+SG
multiplicara-lhes	multiplicar+V.ele.DAT.3.PL+PQP+1+SG
multiplicara-lhes	multiplicar+V.ele.DAT.3.PL+PQP+3+SG
multiplicara-lo	multiplicar+V.ele.ACC.3.M.SG+PQP+2+SG
multiplicara-los	multiplicar+V.ele.ACC.3.M.PL+PQP+2+SG
multiplicara-me	multiplicar+V.eu.AD.1.SG+PQP+1+SG
multiplicara-me	multiplicar+V.eu.AD.1.SG+PQP+3+SG
multiplicaram-lhe	multiplicar+V.ele.DAT.3.SG+PQP+3+PL
multiplicaram-lhe	multiplicar+V.ele.DAT.3.SG+PRF+3+PL
multiplicaram-lhes	multiplicar+V.ele.DAT.3.PL+PQP+3+PL
multiplicaram-lhes	multiplicar+V.ele.DAT.3.PL+PRF+3+PL
multiplicaram-me	multiplicar+V.eu.AD.1.SG+PQP+3+PL
multiplicaram-me	multiplicar+V.eu.AD.1.SG+PRF+3+PL
multiplicaram-na	multiplicar+V.ele.ACC.3.F.SG+PQP+3+PL
multiplicaram-na	multiplicar+V.ele.ACC.3.F.SG+PRF+3+PL
multiplicaram-nas	multiplicar+V.ele.ACC.3.F.PL+PQP+3+PL
multiplicaram-nas	multiplicar+V.ele.ACC.3.F.PL+PRF+3+PL
multiplicaram-no	multiplicar+V.ele.ACC.3.M.SG+PQP+3+PL
multiplicaram-no	multiplicar+V.ele.ACC.3.M.SG+PRF+3+PL
multiplicaram-nos	multiplicar+V.ele.ACC.3.M.PL+PQP+3+PL
multiplicaram-nos	multiplicar+V.ele.ACC.3.M.PL+PRF+3+PL
multiplicaram-nos	multiplicar+V.nós.AD.1.PL+PQP+3+PL
multiplicaram-nos	multiplicar+V.nós.AD.1.PL+PRF+3+PL
multiplicáramo-la	multiplicar+V.ele.ACC.3.F.SG+PQP+1+PL
multiplicáramo-las	multiplicar+V.ele.ACC.3.F.PL+PQP+1+PL
multiplicáramo-lo	multiplicar+V.ele.ACC.3.M.SG+PQP+1+PL
multiplicáramo-los	multiplicar+V.ele.ACC.3.M.PL+PQP+1+PL
multiplicáramo-nos	multiplicar+nós.AD.1.PL+PQP+1+PL
multiplicáramos-lhe	multiplicar+V.ele.DAT.3.SG+PQP+1+PL
multiplicáramos-lhes	multiplicar+V.ele.DAT.3.PL+PQP+1+PL
multiplicáramos-me	multiplicar+V.eu.AD.1.SG+PQP+1+PL
multiplicáramos-te	multiplicar+V.tu.AD.2.SG+PQP+1+PL
multiplicáramos-vos	multiplicar+V.vós.AD.2.PL+PQP+1+PL
multiplicaram-se	multiplicar+V.ele.REFL+PQP+3+PL
multiplicaram-se	multiplicar+V.ele.REFL+PRF+3+PL
multiplicaram-te	multiplicar+V.tu.AD.2.SG+PQP+3+PL
multiplicaram-te	multiplicar+V.tu.AD.2.SG+PRF+3+PL
multiplicaram-vos	multiplicar+V.vós.AD.2.PL+PQP+3+PL
multiplicaram-vos	multiplicar+V.vós.AD.2.PL+PRF+3+PL
multiplicara-nos	multiplicar+nós.AD.1.PL+PQP+1+SG
multiplicara-nos	multiplicar+nós.AD.1.PL+PQP+2+SG
multiplicara-nos	multiplicar+nós.AD.1.PL+PQP+3+SG
multiplicara-o	multiplicar+V.ele.ACC.3.M.SG+PQP+1+SG
multiplicara-o	multiplicar+V.ele.ACC.3.M.SG+PQP+3+SG
multiplicara-os	multiplicar+V.ele.ACC.3.M.PL+PQP+1+SG
multiplicara-os	multiplicar+V.ele.ACC.3.M.PL+PQP+3+SG
multiplicara-se	multiplicar+V.ele.REFL+PQP+1+SG
multiplicara-se	multiplicar+V.ele.REFL+PQP+3+SG
multiplicaras-lhe	multiplicar+V.ele.DAT.3.SG+PQP+2+SG
multiplicaras-lhes	multiplicar+V.ele.DAT.3.PL+PQP+2+SG
multiplicaras-me	multiplicar+V.eu.AD.1.SG+PQP+2+SG
multiplicaras-te	multiplicar+V.tu.AD.2.SG+PQP+2+SG
multiplicaras-vos	multiplicar+V.vós.AD.2.PL+PQP+2+SG
multiplicara-te	multiplicar+V.tu.AD.2.SG+PQP+1+SG
multiplicara-te	multiplicar+V.tu.AD.2.SG+PQP+3+SG
multiplicara-vos	multiplicar+V.vós.AD.2.PL+PQP+1+SG
multiplicara-vos	multiplicar+V.vós.AD.2.PL+PQP+3+SG
multiplicarde-la	multiplicar+V.ele.ACC.3.F.SG+INF+2+PL
multiplicarde-la	multiplicar+V.ele.ACC.3.F.SG+SBJF+2+PL
multiplicarde-las	multiplicar+V.ele.ACC.3.F.PL+INF+2+PL
multiplicarde-las	multiplicar+V.ele.ACC.3.F.PL+SBJF+2+PL
multiplicarde-lo	multiplicar+V.ele.ACC.3.M.SG+INF+2+PL
multiplicarde-lo	multiplicar+V.ele.ACC.3.M.SG+SBJF+2+PL
multiplicarde-los	multiplicar+V.ele.ACC.3.M.PL+INF+2+PL
multiplicarde-los	multiplicar+V.ele.ACC.3.M.PL+SBJF+2+PL
multiplicarde-nos	multiplicar+nós.AD.1.PL+INF+2+PL
multiplicarde-nos	multiplicar+nós.AD.1.PL+SBJF+2+PL
multiplicardes-lhe	multiplicar+V.ele.DAT.3.SG+INF+2+PL
multiplicardes-lhe	multiplicar+V.ele.DAT.3.SG+SBJF+2+PL
multiplicardes-lhes	multiplicar+V.ele.DAT.3.PL+INF+2+PL
multiplicardes-lhes	multiplicar+V.ele.DAT.3.PL+SBJF+2+PL
multiplicardes-me	multiplicar+V.eu.AD.1.SG+INF+2+PL
multiplicardes-me	multiplicar+V.eu.AD.1.SG+SBJF+2+PL
multiplicardes-te	multiplicar+V.tu.AD.2.SG+INF+2+PL
multiplicardes-te	multiplicar+V.tu.AD.2.SG+SBJF+2+PL
multiplicardes-vos	multiplicar+V.vós.AD.2.PL+INF+2+PL
multiplicardes-vos	multiplicar+V.vós.AD.2.PL+SBJF+2+PL
multiplicárei-la	multiplicar+V.ele.ACC.3.F.SG+PQP+2+PL
multiplicárei-las	multiplicar+V.ele.ACC.3.F.PL+PQP+2+PL
multiplicárei-lo	multiplicar+V.ele.ACC.3.M.SG+PQP+2+PL
multiplicárei-los	multiplicar+V.ele.ACC.3.M.PL+PQP+2+PL
multiplicárei-nos	multiplicar+nós.AD.1.PL+PQP+2+PL
multiplicáreis-lhe	multiplicar+V.ele.DAT.3.SG+PQP+2+PL
multiplicáreis-lhes	multiplicar+V.ele.DAT.3.PL+PQP+2+PL
multiplicáreis-me	multiplicar+V.eu.AD.1.SG+PQP+2+PL
multiplicáreis-te	multiplicar+V.tu.AD.2.SG+PQP+2+PL
multiplicáreis-vos	multiplicar+V.vós.AD.2.PL+PQP+2+PL
multiplicare-la	multiplicar+V.ele.ACC.3.F.SG+INF+2+SG
multiplicare-la	multiplicar+V.ele.ACC.3.F.SG+SBJF+2+SG
multiplicare-las	multiplicar+V.ele.ACC.3.F.PL+INF+2+SG
multiplicare-las	multiplicar+V.ele.ACC.3.F.PL+SBJF+2+SG
multiplicare-lo	multiplicar+V.ele.ACC.3.M.SG+INF+2+SG
multiplicare-lo	multiplicar+V.ele.ACC.3.M.SG+SBJF+2+SG
multiplicare-los	multiplicar+V.ele.ACC.3.M.PL+INF+2+SG
multiplicare-los	multiplicar+V.ele.ACC.3.M.PL+SBJF+2+SG
multiplicarem-lhe	multiplicar+V.ele.DAT.3.SG+INF+3+PL
multiplicarem-lhe	multiplicar+V.ele.DAT.3.SG+SBJF+3+PL
multiplicarem-lhes	multiplicar+V.ele.DAT.3.PL+INF+3+PL
multiplicarem-lhes	multiplicar+V.ele.DAT.3.PL+SBJF+3+PL
multiplicarem-me	multiplicar+V.eu.AD.1.SG+INF+3+PL
multiplicarem-me	multiplicar+V.eu.AD.1.SG+SBJF+3+PL
multiplicarem-na	multiplicar+V.ele.ACC.3.F.SG+INF+3+PL
multiplicarem-na	multiplicar+V.ele.ACC.3.F.SG+SBJF+3+PL
multiplicarem-nas	multiplicar+V.ele.ACC.3.F.PL+INF+3+PL
multiplicarem-nas	multiplicar+V.ele.ACC.3.F.PL+SBJF+3+PL
multiplicarem-no	multiplicar+V.ele.ACC.3.M.SG+INF+3+PL
multiplicarem-no	multiplicar+V.ele.ACC.3.M.SG+SBJF+3+PL
multiplicarem-nos	multiplicar+V.ele.ACC.3.M.PL+INF+3+PL
multiplicarem-nos	multiplicar+V.ele.ACC.3.M.PL+SBJF+3+PL
multiplicarem-nos	multiplicar+V.nós.AD.1.PL+INF+3+PL
multiplicarem-nos	multiplicar+V.nós.AD.1.PL+SBJF+3+PL
multiplicarem-se	multiplicar+V.ele.REFL+INF+3+PL
multiplicarem-se	multiplicar+V.ele.REFL+SBJF+3+PL
multiplicarem-te	multiplicar+V.tu.AD.2.SG+INF+3+PL
multiplicarem-te	multiplicar+V.tu.AD.2.SG+SBJF+3+PL
multiplicarem-vos	multiplicar+V.vós.AD.2.PL+INF+3+PL
multiplicarem-vos	multiplicar+V.vós.AD.2.PL+SBJF+3+PL
multiplicare-nos	multiplicar+nós.AD.1.PL+INF+2+SG
multiplicare-nos	multiplicar+nós.AD.1.PL+SBJF+2+SG
multiplicares-lhe	multiplicar+V.ele.DAT.3.SG+INF+2+SG
multiplicares-lhe	multiplicar+V.ele.DAT.3.SG+SBJF+2+SG
multiplicares-lhes	multiplicar+V.ele.DAT.3.PL+INF+2+SG
multiplicares-lhes	multiplicar+V.ele.DAT.3.PL+SBJF+2+SG
multiplicares-me	multiplicar+V.eu.AD.1.SG+INF+2+SG
multiplicares-me	multiplicar+V.eu.AD.1.SG+SBJF+2+SG
multiplicares-te	multiplicar+V.tu.AD.2.SG+INF+2+SG
multiplicares-te	multiplicar+V.tu.AD.2.SG+SBJF+2+SG
multiplicares-vos	multiplicar+V.vós.AD.2.PL+INF+2+SG
multiplicares-vos	multiplicar+V.vós.AD.2.PL+SBJF+2+SG
multiplicar-lhe-á	multiplicar+V.ele.DAT.3.SG+FUT+3+SG
multiplicar-lhe-ão	multiplicar+V.ele.DAT.3.SG+FUT+3+PL
multiplicar-lhe-ás	multiplicar+V.ele.DAT.3.SG+FUT+2+SG
multiplicar-lhe-ei	multiplicar+V.ele.DAT.3.SG+FUT+1+SG
multiplicar-lhe-eis	multiplicar+V.ele.DAT.3.SG+FUT+2+PL
multiplicar-lhe-emos	multiplicar+V.ele.DAT.3.SG+FUT+1+PL
multiplicar-lhe-iam	multiplicar+V.ele.DAT.3.SG+COND+3+PL
multiplicar-lhe-íamos	multiplicar+V.ele.DAT.3.SG+COND+1+PL
multiplicar-lhe-ia	multiplicar+V.ele.DAT.3.SG+COND+1+SG
multiplicar-lhe-ia	multiplicar+V.ele.DAT.3.SG+COND+3+SG
multiplicar-lhe-ias	multiplicar+V.ele.DAT.3.SG+COND+2+SG
multiplicar-lhe-íeis	multiplicar+V.ele.DAT.3.SG+COND+2+PL
multiplicar-lhe	multiplicar+V.ele.DAT.3.SG+INF
multiplicar-lhe	multiplicar+V.ele.DAT.3.SG+INF+1+SG
multiplicar-lhe	multiplicar+V.ele.DAT.3.SG+INF+3+SG
multiplicar-lhe	multiplicar+V.ele.DAT.3.SG+SBJF+1+SG
multiplicar-lhe	multiplicar+V.ele.DAT.3.SG+SBJF+3+SG
multiplicar-lhes-á	multiplicar+V.ele.DAT.3.PL+FUT+3+SG
multiplicar-lhes-ão	multiplicar+V.ele.DAT.3.PL+FUT+3+PL
multiplicar-lhes-ás	multiplicar+V.ele.DAT.3.PL+FUT+2+SG
multiplicar-lhes-ei	multiplicar+V.ele.DAT.3.PL+FUT+1+SG
multiplicar-lhes-eis	multiplicar+V.ele.DAT.3.PL+FUT+2+PL
multiplicar-lhes-emos	multiplicar+V.ele.DAT.3.PL+FUT+1+PL
multiplicar-lhes-iam	multiplicar+V.ele.DAT.3.PL+COND+3+PL
multiplicar-lhes-íamos	multiplicar+V.ele.DAT.3.PL+COND+1+PL
multiplicar-lhes-ia	multiplicar+V.ele.DAT.3.PL+COND+1+SG
multiplicar-lhes-ia	multiplicar+V.ele.DAT.3.PL+COND+3+SG
multiplicar-lhes-ias	multiplicar+V.ele.DAT.3.PL+COND+2+SG
multiplicar-lhes-íeis	multiplicar+V.ele.DAT.3.PL+COND+2+PL
multiplicar-lhes	multiplicar+V.ele.DAT.3.PL+INF
