ofertar-vos-ia	ofertar+V.vós.AD.2.PL+COND+3+SG
ofertar-vos-ias	ofertar+V.vós.AD.2.PL+COND+2+SG
ofertar-vos-íeis	ofertar+V.vós.AD.2.PL+COND+2+PL
ofertar-vos	ofertar+V.vós.AD.2.PL+INF
ofertar-vos	ofertar+V.vós.AD.2.PL+INF+1+SG
ofertar-vos	ofertar+V.vós.AD.2.PL+INF+3+SG
ofertar-vos	ofertar+V.vós.AD.2.PL+SBJF+1+SG
ofertar-vos	ofertar+V.vós.AD.2.PL+SBJF+3+SG
oferta-se	ofertar+V.ele.REFL+PRS+3+SG
ofertas-lhe	ofertar+V.ele.DAT.3.SG+PRS+2+SG
ofertas-lhes	ofertar+V.ele.DAT.3.PL+PRS+2+SG
ofertas-me	ofertar+V.eu.AD.1.SG+PRS+2+SG
ofertaste-a	ofertar+V.ele.ACC.3.F.SG+PRF+2+SG
ofertaste-as	ofertar+V.ele.ACC.3.F.PL+PRF+2+SG
ofertaste-la	ofertar+V.ele.ACC.3.F.SG+PRF+2+PL
ofertaste-las	ofertar+V.ele.ACC.3.F.PL+PRF+2+PL
ofertaste-lhe	ofertar+V.ele.DAT.3.SG+PRF+2+SG
ofertaste-lhes	ofertar+V.ele.DAT.3.PL+PRF+2+SG
ofertaste-lo	ofertar+V.ele.ACC.3.M.SG+PRF+2+PL
ofertaste-los	ofertar+V.ele.ACC.3.M.PL+PRF+2+PL
ofertaste-me	ofertar+V.eu.AD.1.SG+PRF+2+SG
ofertaste-nos	ofertar+nós.AD.1.PL+PRF+2+PL
ofertaste-nos	ofertar+nós.AD.1.PL+PRF+2+SG
ofertas-te	ofertar+V.tu.AD.2.SG+PRS+2+SG
ofertaste-o	ofertar+V.ele.ACC.3.M.SG+PRF+2+SG
ofertaste-os	ofertar+V.ele.ACC.3.M.PL+PRF+2+SG
ofertastes-lhe	ofertar+V.ele.DAT.3.SG+PRF+2+PL
ofertastes-lhes	ofertar+V.ele.DAT.3.PL+PRF+2+PL
ofertastes-me	ofertar+V.eu.AD.1.SG+PRF+2+PL
ofertastes-te	ofertar+V.tu.AD.2.SG+PRF+2+PL
ofertastes-vos	ofertar+V.vós.AD.2.PL+PRF+2+PL
ofertaste-te	ofertar+V.tu.AD.2.SG+PRF+2+SG
ofertaste-vos	ofertar+V.vós.AD.2.PL+PRF+2+SG
ofertas-vos	ofertar+V.vós.AD.2.PL+PRS+2+SG
oferta-te	ofertar+V.tu.AD.2.SG+PRS+3+SG
ofertava-a	ofertar+V.ele.ACC.3.F.SG+IMPF+1+SG
ofertava-a	ofertar+V.ele.ACC.3.F.SG+IMPF+3+SG
ofertava-as	ofertar+V.ele.ACC.3.F.PL+IMPF+1+SG
ofertava-as	ofertar+V.ele.ACC.3.F.PL+IMPF+3+SG
ofertava-la	ofertar+V.ele.ACC.3.F.SG+IMPF+2+SG
ofertava-las	ofertar+V.ele.ACC.3.F.PL+IMPF+2+SG
ofertava-lhe	ofertar+V.ele.DAT.3.SG+IMPF+1+SG
ofertava-lhe	ofertar+V.ele.DAT.3.SG+IMPF+3+SG
ofertava-lhes	ofertar+V.ele.DAT.3.PL+IMPF+1+SG
ofertava-lhes	ofertar+V.ele.DAT.3.PL+IMPF+3+SG
ofertava-lo	ofertar+V.ele.ACC.3.M.SG+IMPF+2+SG
ofertava-los	ofertar+V.ele.ACC.3.M.PL+IMPF+2+SG
ofertava-me	ofertar+V.eu.AD.1.SG+IMPF+1+SG
ofertava-me	ofertar+V.eu.AD.1.SG+IMPF+3+SG
ofertavam-lhe	ofertar+V.ele.DAT.3.SG+IMPF+3+PL
ofertavam-lhes	ofertar+V.ele.DAT.3.PL+IMPF+3+PL
ofertavam-me	ofertar+V.eu.AD.1.SG+IMPF+3+PL
ofertavam-na	ofertar+V.ele.ACC.3.F.SG+IMPF+3+PL
ofertavam-nas	ofertar+V.ele.ACC.3.F.PL+IMPF+3+PL
ofertavam-no	ofertar+V.ele.ACC.3.M.SG+IMPF+3+PL
ofertavam-nos	ofertar+V.ele.ACC.3.M.PL+IMPF+3+PL
ofertavam-nos	ofertar+V.nós.AD.1.PL+IMPF+3+PL
ofertávamo-la	ofertar+V.ele.ACC.3.F.SG+IMPF+1+PL
ofertávamo-las	ofertar+V.ele.ACC.3.F.PL+IMPF+1+PL
ofertávamo-lo	ofertar+V.ele.ACC.3.M.SG+IMPF+1+PL
ofertávamo-los	ofertar+V.ele.ACC.3.M.PL+IMPF+1+PL
ofertávamo-nos	ofertar+nós.AD.1.PL+IMPF+1+PL
ofertávamos-lhe	ofertar+V.ele.DAT.3.SG+IMPF+1+PL
ofertávamos-lhes	ofertar+V.ele.DAT.3.PL+IMPF+1+PL
ofertávamos-me	ofertar+V.eu.AD.1.SG+IMPF+1+PL
ofertávamos-te	ofertar+V.tu.AD.2.SG+IMPF+1+PL
ofertávamos-vos	ofertar+V.vós.AD.2.PL+IMPF+1+PL
ofertavam-se	ofertar+V.ele.REFL+IMPF+3+PL
ofertavam-te	ofertar+V.tu.AD.2.SG+IMPF+3+PL
ofertavam-vos	ofertar+V.vós.AD.2.PL+IMPF+3+PL
ofertava-nos	ofertar+nós.AD.1.PL+IMPF+1+SG
ofertava-nos	ofertar+nós.AD.1.PL+IMPF+2+SG
ofertava-nos	ofertar+nós.AD.1.PL+IMPF+3+SG
ofertava-o	ofertar+V.ele.ACC.3.M.SG+IMPF+1+SG
ofertava-o	ofertar+V.ele.ACC.3.M.SG+IMPF+3+SG
ofertava-os	ofertar+V.ele.ACC.3.M.PL+IMPF+1+SG
ofertava-os	ofertar+V.ele.ACC.3.M.PL+IMPF+3+SG
ofertava-se	ofertar+V.ele.REFL+IMPF+1+SG
ofertava-se	ofertar+V.ele.REFL+IMPF+3+SG
ofertavas-lhe	ofertar+V.ele.DAT.3.SG+IMPF+2+SG
ofertavas-lhes	ofertar+V.ele.DAT.3.PL+IMPF+2+SG
ofertavas-me	ofertar+V.eu.AD.1.SG+IMPF+2+SG
ofertavas-te	ofertar+V.tu.AD.2.SG+IMPF+2+SG
ofertavas-vos	ofertar+V.vós.AD.2.PL+IMPF+2+SG
ofertava-te	ofertar+V.tu.AD.2.SG+IMPF+1+SG
ofertava-te	ofertar+V.tu.AD.2.SG+IMPF+3+SG
ofertava-vos	ofertar+V.vós.AD.2.PL+IMPF+1+SG
ofertava-vos	ofertar+V.vós.AD.2.PL+IMPF+3+SG
ofertávei-la	ofertar+V.ele.ACC.3.F.SG+IMPF+2+PL
ofertávei-las	ofertar+V.ele.ACC.3.F.PL+IMPF+2+PL
ofertávei-lo	ofertar+V.ele.ACC.3.M.SG+IMPF+2+PL
ofertávei-los	ofertar+V.ele.ACC.3.M.PL+IMPF+2+PL
ofertávei-nos	ofertar+nós.AD.1.PL+IMPF+2+PL
ofertáveis-lhe	ofertar+V.ele.DAT.3.SG+IMPF+2+PL
ofertáveis-lhes	ofertar+V.ele.DAT.3.PL+IMPF+2+PL
ofertáveis-me	ofertar+V.eu.AD.1.SG+IMPF+2+PL
ofertáveis-te	ofertar+V.tu.AD.2.SG+IMPF+2+PL
ofertáveis-vos	ofertar+V.vós.AD.2.PL+IMPF+2+PL
oferta-vos	ofertar+V.vós.AD.2.PL+PRS+3+SG
oferte-a	ofertar+V.ele.ACC.3.F.SG+IMP+3+SG
oferte-as	ofertar+V.ele.ACC.3.F.PL+IMP+3+SG
ofertei-a	ofertar+V.ele.ACC.3.F.SG+PRF+1+SG
ofertei-as	ofertar+V.ele.ACC.3.F.PL+PRF+1+SG
ofertei-lhe	ofertar+V.ele.DAT.3.SG+PRF+1+SG
ofertei-lhes	ofertar+V.ele.DAT.3.PL+PRF+1+SG
ofertei-me	ofertar+V.eu.AD.1.SG+PRF+1+SG
ofertei-nos	ofertar+nós.AD.1.PL+PRF+1+SG
ofertei-o	ofertar+V.ele.ACC.3.M.SG+PRF+1+SG
ofertei-os	ofertar+V.ele.ACC.3.M.PL+PRF+1+SG
ofertei-te	ofertar+V.tu.AD.2.SG+PRF+1+SG
ofertei-vos	ofertar+V.vós.AD.2.PL+PRF+1+SG
oferte-lhe	ofertar+V.ele.DAT.3.SG+IMP+3+SG
oferte-lhes	ofertar+V.ele.DAT.3.PL+IMP+3+SG
oferte-me	ofertar+V.eu.AD.1.SG+IMP+3+SG
ofertem-lhe	ofertar+V.ele.DAT.3.SG+IMP+3+PL
ofertem-lhes	ofertar+V.ele.DAT.3.PL+IMP+3+PL
ofertem-me	ofertar+V.eu.AD.1.SG+IMP+3+PL
ofertem-na	ofertar+V.ele.ACC.3.F.SG+IMP+3+PL
ofertem-nas	ofertar+V.ele.ACC.3.F.PL+IMP+3+PL
ofertem-no	ofertar+V.ele.ACC.3.M.SG+IMP+3+PL
ofertem-nos	ofertar+V.ele.ACC.3.M.PL+IMP+3+PL
ofertem-nos	ofertar+V.nós.AD.1.PL+IMP+3+PL
ofertemo-la	ofertar+V.ele.ACC.3.F.SG+IMP+1+PL
ofertemo-las	ofertar+V.ele.ACC.3.F.PL+IMP+1+PL
ofertemo-lo	ofertar+V.ele.ACC.3.M.SG+IMP+1+PL
ofertemo-los	ofertar+V.ele.ACC.3.M.PL+IMP+1+PL
ofertemo-nos	ofertar+nós.AD.1.PL+IMP+1+PL
ofertemos-lhe	ofertar+V.ele.DAT.3.SG+IMP+1+PL
ofertemos-lhes	ofertar+V.ele.DAT.3.PL+IMP+1+PL
ofertemos-me	ofertar+V.eu.AD.1.SG+IMP+1+PL
ofertemos-te	ofertar+V.tu.AD.2.SG+IMP+1+PL
ofertemos-vos	ofertar+V.vós.AD.2.PL+IMP+1+PL
ofertem-se	ofertar+V.ele.REFL+IMP+3+PL
ofertem-te	ofertar+V.tu.AD.2.SG+IMP+3+PL
ofertem-vos	ofertar+V.vós.AD.2.PL+IMP+3+PL
oferte-nos	ofertar+nós.AD.1.PL+IMP+3+SG
oferte-o	ofertar+V.ele.ACC.3.M.SG+IMP+3+SG
oferte-os	ofertar+V.ele.ACC.3.M.PL+IMP+3+SG
oferte-se	ofertar+V.ele.REFL+IMP+3+SG
oferte-te	ofertar+V.tu.AD.2.SG+IMP+3+SG
oferte-vos	ofertar+V.vós.AD.2.PL+IMP+3+SG
oferto-a	ofertar+V.ele.ACC.3.F.SG+PRS+1+SG
oferto-as	ofertar+V.ele.ACC.3.F.PL+PRS+1+SG
oferto-lhe	ofertar+V.ele.DAT.3.SG+PRS+1+SG
oferto-lhes	ofertar+V.ele.DAT.3.PL+PRS+1+SG
oferto-me	ofertar+V.eu.AD.1.SG+PRS+1+SG
oferto-nos	ofertar+nós.AD.1.PL+PRS+1+SG
oferto-o	ofertar+V.ele.ACC.3.M.SG+PRS+1+SG
oferto-os	ofertar+V.ele.ACC.3.M.PL+PRS+1+SG
oferto-te	ofertar+V.tu.AD.2.SG+PRS+1+SG
ofertou-a	ofertar+V.ele.ACC.3.F.SG+PRF+3+SG
ofertou-as	ofertar+V.ele.ACC.3.F.PL+PRF+3+SG
ofertou-lhe	ofertar+V.ele.DAT.3.SG+PRF+3+SG
ofertou-lhes	ofertar+V.ele.DAT.3.PL+PRF+3+SG
ofertou-me	ofertar+V.eu.AD.1.SG+PRF+3+SG
ofertou-nos	ofertar+nós.AD.1.PL+PRF+3+SG
ofertou-o	ofertar+V.ele.ACC.3.M.SG+PRF+3+SG
ofertou-os	ofertar+V.ele.ACC.3.M.PL+PRF+3+SG
ofertou-se	ofertar+V.ele.REFL+PRF+3+SG
ofertou-te	ofertar+V.tu.AD.2.SG+PRF+3+SG
ofertou-vos	ofertar+V.vós.AD.2.PL+PRF+3+SG
oferto-vos	ofertar+V.vós.AD.2.PL+PRS+1+SG
oficia-a	oficiar+V.ele.ACC.3.F.SG+PRS+3+SG
oficia-as	oficiar+V.ele.ACC.3.F.PL+PRS+3+SG
oficiai-la	oficiar+V.ele.ACC.3.F.SG+PRS+2+PL
oficiai-las	oficiar+V.ele.ACC.3.F.PL+PRS+2+PL
oficiai-lo	oficiar+V.ele.ACC.3.M.SG+PRS+2+PL
oficiai-los	oficiar+V.ele.ACC.3.M.PL+PRS+2+PL
oficiai-nos	oficiar+nós.AD.1.PL+PRS+2+PL
oficiais-lhe	oficiar+V.ele.DAT.3.SG+PRS+2+PL
oficiais-lhes	oficiar+V.ele.DAT.3.PL+PRS+2+PL
oficiais-me	oficiar+V.eu.AD.1.SG+PRS+2+PL
oficiais-te	oficiar+V.tu.AD.2.SG+PRS+2+PL
oficiais-vos	oficiar+V.vós.AD.2.PL+PRS+2+PL
oficiá-la-á	oficiar+V.ele.ACC.3.F.SG+FUT+3+SG
oficiá-la-ão	oficiar+V.ele.ACC.3.F.SG+FUT+3+PL
oficiá-la-ás	oficiar+V.ele.ACC.3.F.SG+FUT+2+SG
oficiá-la-ei	oficiar+V.ele.ACC.3.F.SG+FUT+1+SG
oficiá-la-eis	oficiar+V.ele.ACC.3.F.SG+FUT+2+PL
oficiá-la-emos	oficiar+V.ele.ACC.3.F.SG+FUT+1+PL
oficiá-la-iam	oficiar+V.ele.ACC.3.F.SG+COND+3+PL
oficiá-la-íamos	oficiar+V.ele.ACC.3.F.SG+COND+1+PL
oficiá-la-ia	oficiar+V.ele.ACC.3.F.SG+COND+1+SG
oficiá-la-ia	oficiar+V.ele.ACC.3.F.SG+COND+3+SG
oficiá-la-ias	oficiar+V.ele.ACC.3.F.SG+COND+2+SG
oficiá-la-íeis	oficiar+V.ele.ACC.3.F.SG+COND+2+PL
oficiá-la	oficiar+V.ele.ACC.3.F.SG+INF+1+SG
oficiá-la	oficiar+V.ele.ACC.3.F.SG+INF+3+SG
oficia-la	oficiar+V.ele.ACC.3.F.SG+PRS+2+SG
oficiá-la	oficiar+V.ele.ACC.3.F.SG+SBJF+1+SG
oficiá-la	oficiar+V.ele.ACC.3.F.SG+SBJF+3+SG
oficiá-las-á	oficiar+V.ele.ACC.3.F.PL+FUT+3+SG
oficiá-las-ão	oficiar+V.ele.ACC.3.F.PL+FUT+3+PL
oficiá-las-ás	oficiar+V.ele.ACC.3.F.PL+FUT+2+SG
oficiá-las-ei	oficiar+V.ele.ACC.3.F.PL+FUT+1+SG
oficiá-las-eis	oficiar+V.ele.ACC.3.F.PL+FUT+2+PL
oficiá-las-emos	oficiar+V.ele.ACC.3.F.PL+FUT+1+PL
oficiá-las-iam	oficiar+V.ele.ACC.3.F.PL+COND+3+PL
oficiá-las-íamos	oficiar+V.ele.ACC.3.F.PL+COND+1+PL
oficiá-las-ia	oficiar+V.ele.ACC.3.F.PL+COND+1+SG
oficiá-las-ia	oficiar+V.ele.ACC.3.F.PL+COND+3+SG
oficiá-las-ias	oficiar+V.ele.ACC.3.F.PL+COND+2+SG
oficiá-las-íeis	oficiar+V.ele.ACC.3.F.PL+COND+2+PL
oficiá-las	oficiar+V.ele.ACC.3.F.PL+INF+1+SG
oficiá-las	oficiar+V.ele.ACC.3.F.PL+INF+3+SG
oficia-las	oficiar+V.ele.ACC.3.F.PL+PRS+2+SG
oficiá-las	oficiar+V.ele.ACC.3.F.PL+SBJF+1+SG
oficiá-las	oficiar+V.ele.ACC.3.F.PL+SBJF+3+SG
oficia-lhe	oficiar+V.ele.DAT.3.SG+PRS+3+SG
oficia-lhes	oficiar+V.ele.DAT.3.PL+PRS+3+SG
oficializa-a	oficializar+V.ele.ACC.3.F.SG+PRS+3+SG
oficializa-as	oficializar+V.ele.ACC.3.F.PL+PRS+3+SG
oficializai-la	oficializar+V.ele.ACC.3.F.SG+PRS+2+PL
oficializai-las	oficializar+V.ele.ACC.3.F.PL+PRS+2+PL
oficializai-lo	oficializar+V.ele.ACC.3.M.SG+PRS+2+PL
oficializai-los	oficializar+V.ele.ACC.3.M.PL+PRS+2+PL
oficializai-nos	oficializar+nós.AD.1.PL+PRS+2+PL
oficializais-lhe	oficializar+V.ele.DAT.3.SG+PRS+2+PL
oficializais-lhes	oficializar+V.ele.DAT.3.PL+PRS+2+PL
oficializais-me	oficializar+V.eu.AD.1.SG+PRS+2+PL
oficializais-te	oficializar+V.tu.AD.2.SG+PRS+2+PL
oficializais-vos	oficializar+V.vós.AD.2.PL+PRS+2+PL
oficializá-la-á	oficializar+V.ele.ACC.3.F.SG+FUT+3+SG
oficializá-la-ão	oficializar+V.ele.ACC.3.F.SG+FUT+3+PL
oficializá-la-ás	oficializar+V.ele.ACC.3.F.SG+FUT+2+SG
oficializá-la-ei	oficializar+V.ele.ACC.3.F.SG+FUT+1+SG
oficializá-la-eis	oficializar+V.ele.ACC.3.F.SG+FUT+2+PL
oficializá-la-emos	oficializar+V.ele.ACC.3.F.SG+FUT+1+PL
oficializá-la-iam	oficializar+V.ele.ACC.3.F.SG+COND+3+PL
oficializá-la-íamos	oficializar+V.ele.ACC.3.F.SG+COND+1+PL
oficializá-la-ia	oficializar+V.ele.ACC.3.F.SG+COND+1+SG
oficializá-la-ia	oficializar+V.ele.ACC.3.F.SG+COND+3+SG
oficializá-la-ias	oficializar+V.ele.ACC.3.F.SG+COND+2+SG
oficializá-la-íeis	oficializar+V.ele.ACC.3.F.SG+COND+2+PL
oficializá-la	oficializar+V.ele.ACC.3.F.SG+INF+1+SG
oficializá-la	oficializar+V.ele.ACC.3.F.SG+INF+3+SG
oficializa-la	oficializar+V.ele.ACC.3.F.SG+PRS+2+SG
oficializá-la	oficializar+V.ele.ACC.3.F.SG+SBJF+1+SG
oficializá-la	oficializar+V.ele.ACC.3.F.SG+SBJF+3+SG
oficializá-las-á	oficializar+V.ele.ACC.3.F.PL+FUT+3+SG
oficializá-las-ão	oficializar+V.ele.ACC.3.F.PL+FUT+3+PL
oficializá-las-ás	oficializar+V.ele.ACC.3.F.PL+FUT+2+SG
oficializá-las-ei	oficializar+V.ele.ACC.3.F.PL+FUT+1+SG
oficializá-las-eis	oficializar+V.ele.ACC.3.F.PL+FUT+2+PL
oficializá-las-emos	oficializar+V.ele.ACC.3.F.PL+FUT+1+PL
oficializá-las-iam	oficializar+V.ele.ACC.3.F.PL+COND+3+PL
oficializá-las-íamos	oficializar+V.ele.ACC.3.F.PL+COND+1+PL
oficializá-las-ia	oficializar+V.ele.ACC.3.F.PL+COND+1+SG
oficializá-las-ia	oficializar+V.ele.ACC.3.F.PL+COND+3+SG
oficializá-las-ias	oficializar+V.ele.ACC.3.F.PL+COND+2+SG
oficializá-las-íeis	oficializar+V.ele.ACC.3.F.PL+COND+2+PL
oficializá-las	oficializar+V.ele.ACC.3.F.PL+INF+1+SG
oficializá-las	oficializar+V.ele.ACC.3.F.PL+INF+3+SG
oficializa-las	oficializar+V.ele.ACC.3.F.PL+PRS+2+SG
oficializá-las	oficializar+V.ele.ACC.3.F.PL+SBJF+1+SG
oficializá-las	oficializar+V.ele.ACC.3.F.PL+SBJF+3+SG
oficializa-lhe	oficializar+V.ele.DAT.3.SG+PRS+3+SG
oficializa-lhes	oficializar+V.ele.DAT.3.PL+PRS+3+SG
oficializá-lo-á	oficializar+V.ele.ACC.3.M.SG+FUT+3+SG
oficializá-lo-ão	oficializar+V.ele.ACC.3.M.SG+FUT+3+PL
oficializá-lo-ás	oficializar+V.ele.ACC.3.M.SG+FUT+2+SG
oficializá-lo-ei	oficializar+V.ele.ACC.3.M.SG+FUT+1+SG
oficializá-lo-eis	oficializar+V.ele.ACC.3.M.SG+FUT+2+PL
oficializá-lo-emos	oficializar+V.ele.ACC.3.M.SG+FUT+1+PL
oficializá-lo-iam	oficializar+V.ele.ACC.3.M.SG+COND+3+PL
oficializá-lo-íamos	oficializar+V.ele.ACC.3.M.SG+COND+1+PL
oficializá-lo-ia	oficializar+V.ele.ACC.3.M.SG+COND+1+SG
oficializá-lo-ia	oficializar+V.ele.ACC.3.M.SG+COND+3+SG
oficializá-lo-ias	oficializar+V.ele.ACC.3.M.SG+COND+2+SG
oficializá-lo-íeis	oficializar+V.ele.ACC.3.M.SG+COND+2+PL
oficializá-lo	oficializar+V.ele.ACC.3.M.SG+INF+1+SG
oficializá-lo	oficializar+V.ele.ACC.3.M.SG+INF+3+SG
oficializa-lo	oficializar+V.ele.ACC.3.M.SG+PRS+2+SG
oficializá-lo	oficializar+V.ele.ACC.3.M.SG+SBJF+1+SG
oficializá-lo	oficializar+V.ele.ACC.3.M.SG+SBJF+3+SG
oficializá-los-á	oficializar+V.ele.ACC.3.M.PL+FUT+3+SG
oficializá-los-ão	oficializar+V.ele.ACC.3.M.PL+FUT+3+PL
oficializá-los-ás	oficializar+V.ele.ACC.3.M.PL+FUT+2+SG
oficializá-los-ei	oficializar+V.ele.ACC.3.M.PL+FUT+1+SG
oficializá-los-eis	oficializar+V.ele.ACC.3.M.PL+FUT+2+PL
oficializá-los-emos	oficializar+V.ele.ACC.3.M.PL+FUT+1+PL
oficializá-los-iam	oficializar+V.ele.ACC.3.M.PL+COND+3+PL
oficializá-los-íamos	oficializar+V.ele.ACC.3.M.PL+COND+1+PL
oficializá-los-ia	oficializar+V.ele.ACC.3.M.PL+COND+1+SG
oficializá-los-ia	oficializar+V.ele.ACC.3.M.PL+COND+3+SG
oficializá-los-ias	oficializar+V.ele.ACC.3.M.PL+COND+2+SG
oficializá-los-íeis	oficializar+V.ele.ACC.3.M.PL+COND+2+PL
oficializá-los	oficializar+V.ele.ACC.3.M.PL+INF+1+SG
oficializá-los	oficializar+V.ele.ACC.3.M.PL+INF+3+SG
oficializa-los	oficializar+V.ele.ACC.3.M.PL+PRS+2+SG
oficializá-los	oficializar+V.ele.ACC.3.M.PL+SBJF+1+SG
oficializá-los	oficializar+V.ele.ACC.3.M.PL+SBJF+3+SG
oficializa-me	oficializar+V.eu.AD.1.SG+PRS+3+SG
oficializam-lhe	oficializar+V.ele.DAT.3.SG+PRS+3+PL
oficializam-lhes	oficializar+V.ele.DAT.3.PL+PRS+3+PL
oficializam-me	oficializar+V.eu.AD.1.SG+PRS+3+PL
oficializam-na	oficializar+V.ele.ACC.3.F.SG+PRS+3+PL
oficializam-nas	oficializar+V.ele.ACC.3.F.PL+PRS+3+PL
oficializam-no	oficializar+V.ele.ACC.3.M.SG+PRS+3+PL
oficializam-nos	oficializar+V.ele.ACC.3.M.PL+PRS+3+PL
oficializam-nos	oficializar+V.nós.AD.1.PL+PRS+3+PL
oficializamo-la	oficializar+V.ele.ACC.3.F.SG+PRF+1+PL
oficializamo-la	oficializar+V.ele.ACC.3.F.SG+PRS+1+PL
oficializamo-las	oficializar+V.ele.ACC.3.F.PL+PRF+1+PL
oficializamo-las	oficializar+V.ele.ACC.3.F.PL+PRS+1+PL
oficializamo-lo	oficializar+V.ele.ACC.3.M.SG+PRF+1+PL
oficializamo-lo	oficializar+V.ele.ACC.3.M.SG+PRS+1+PL
oficializamo-los	oficializar+V.ele.ACC.3.M.PL+PRF+1+PL
oficializamo-los	oficializar+V.ele.ACC.3.M.PL+PRS+1+PL
oficializamo-nos	oficializar+nós.AD.1.PL+PRF+1+PL
oficializamo-nos	oficializar+nós.AD.1.PL+PRS+1+PL
oficializamos-lhe	oficializar+V.ele.DAT.3.SG+PRF+1+PL
oficializamos-lhe	oficializar+V.ele.DAT.3.SG+PRS+1+PL
oficializamos-lhes	oficializar+V.ele.DAT.3.PL+PRF+1+PL
oficializamos-lhes	oficializar+V.ele.DAT.3.PL+PRS+1+PL
oficializamos-me	oficializar+V.eu.AD.1.SG+PRF+1+PL
oficializamos-me	oficializar+V.eu.AD.1.SG+PRS+1+PL
oficializamos-te	oficializar+V.tu.AD.2.SG+PRF+1+PL
oficializamos-te	oficializar+V.tu.AD.2.SG+PRS+1+PL
oficializamos-vos	oficializar+V.vós.AD.2.PL+PRF+1+PL
oficializamos-vos	oficializar+V.vós.AD.2.PL+PRS+1+PL
oficializam-se	oficializar+V.ele.REFL+PRS+3+PL
oficializam-te	oficializar+V.tu.AD.2.SG+PRS+3+PL
oficializam-vos	oficializar+V.vós.AD.2.PL+PRS+3+PL
oficializando-a	oficializar+V.ele.ACC.3.F.SG+GRD
oficializando-as	oficializar+V.ele.ACC.3.F.PL+GRD
oficializando-lhe	oficializar+V.ele.DAT.3.SG+GRD
oficializando-lhes	oficializar+V.ele.DAT.3.PL+GRD
oficializando-me	oficializar+V.eu.AD.1.SG+GRD
oficializando-nos	oficializar+nós.AD.1.PL+GRD
oficializando-o	oficializar+V.ele.ACC.3.M.SG+GRD
oficializando-os	oficializar+V.ele.ACC.3.M.PL+GRD
oficializando-se	oficializar+V.ele.REFL+GRD
oficializando-te	oficializar+V.tu.AD.2.SG+GRD
oficializando-vos	oficializar+V.vós.AD.2.PL+GRD
oficializa-nos	oficializar+nós.AD.1.PL+PRS+2+SG
oficializa-nos	oficializar+nós.AD.1.PL+PRS+3+SG
oficializa-o	oficializar+V.ele.ACC.3.M.SG+PRS+3+SG
oficializa-os	oficializar+V.ele.ACC.3.M.PL+PRS+3+SG
oficializara-a	oficializar+V.ele.ACC.3.F.SG+PQP+1+SG
oficializara-a	oficializar+V.ele.ACC.3.F.SG+PQP+3+SG
oficializara-as	oficializar+V.ele.ACC.3.F.PL+PQP+1+SG
oficializara-as	oficializar+V.ele.ACC.3.F.PL+PQP+3+SG
oficializara-la	oficializar+V.ele.ACC.3.F.SG+PQP+2+SG
oficializara-las	oficializar+V.ele.ACC.3.F.PL+PQP+2+SG
oficializara-lhe	oficializar+V.ele.DAT.3.SG+PQP+1+SG
oficializara-lhe	oficializar+V.ele.DAT.3.SG+PQP+3+SG
oficializara-lhes	oficializar+V.ele.DAT.3.PL+PQP+1+SG
oficializara-lhes	oficializar+V.ele.DAT.3.PL+PQP+3+SG
oficializara-lo	oficializar+V.ele.ACC.3.M.SG+PQP+2+SG
oficializara-los	oficializar+V.ele.ACC.3.M.PL+PQP+2+SG
oficializara-me	oficializar+V.eu.AD.1.SG+PQP+1+SG
oficializara-me	oficializar+V.eu.AD.1.SG+PQP+3+SG
oficializaram-lhe	oficializar+V.ele.DAT.3.SG+PQP+3+PL
oficializaram-lhe	oficializar+V.ele.DAT.3.SG+PRF+3+PL
oficializaram-lhes	oficializar+V.ele.DAT.3.PL+PQP+3+PL
oficializaram-lhes	oficializar+V.ele.DAT.3.PL+PRF+3+PL
oficializaram-me	oficializar+V.eu.AD.1.SG+PQP+3+PL
oficializaram-me	oficializar+V.eu.AD.1.SG+PRF+3+PL
oficializaram-na	oficializar+V.ele.ACC.3.F.SG+PQP+3+PL
oficializaram-na	oficializar+V.ele.ACC.3.F.SG+PRF+3+PL
oficializaram-nas	oficializar+V.ele.ACC.3.F.PL+PQP+3+PL
oficializaram-nas	oficializar+V.ele.ACC.3.F.PL+PRF+3+PL
oficializaram-no	oficializar+V.ele.ACC.3.M.SG+PQP+3+PL
oficializaram-no	oficializar+V.ele.ACC.3.M.SG+PRF+3+PL
oficializaram-nos	oficializar+V.ele.ACC.3.M.PL+PQP+3+PL
oficializaram-nos	oficializar+V.ele.ACC.3.M.PL+PRF+3+PL
oficializaram-nos	oficializar+V.nós.AD.1.PL+PQP+3+PL
oficializaram-nos	oficializar+V.nós.AD.1.PL+PRF+3+PL
oficializáramo-la	oficializar+V.ele.ACC.3.F.SG+PQP+1+PL
oficializáramo-las	oficializar+V.ele.ACC.3.F.PL+PQP+1+PL
oficializáramo-lo	oficializar+V.ele.ACC.3.M.SG+PQP+1+PL
oficializáramo-los	oficializar+V.ele.ACC.3.M.PL+PQP+1+PL
oficializáramo-nos	oficializar+nós.AD.1.PL+PQP+1+PL
oficializáramos-lhe	oficializar+V.ele.DAT.3.SG+PQP+1+PL
oficializáramos-lhes	oficializar+V.ele.DAT.3.PL+PQP+1+PL
oficializáramos-me	oficializar+V.eu.AD.1.SG+PQP+1+PL
oficializáramos-te	oficializar+V.tu.AD.2.SG+PQP+1+PL
oficializáramos-vos	oficializar+V.vós.AD.2.PL+PQP+1+PL
oficializaram-se	oficializar+V.ele.REFL+PQP+3+PL
oficializaram-se	oficializar+V.ele.REFL+PRF+3+PL
oficializaram-te	oficializar+V.tu.AD.2.SG+PQP+3+PL
oficializaram-te	oficializar+V.tu.AD.2.SG+PRF+3+PL
oficializaram-vos	oficializar+V.vós.AD.2.PL+PQP+3+PL
oficializaram-vos	oficializar+V.vós.AD.2.PL+PRF+3+PL
oficializara-nos	oficializar+nós.AD.1.PL+PQP+1+SG
oficializara-nos	oficializar+nós.AD.1.PL+PQP+2+SG
oficializara-nos	oficializar+nós.AD.1.PL+PQP+3+SG
oficializara-o	oficializar+V.ele.ACC.3.M.SG+PQP+1+SG
oficializara-o	oficializar+V.ele.ACC.3.M.SG+PQP+3+SG
oficializara-os	oficializar+V.ele.ACC.3.M.PL+PQP+1+SG
oficializara-os	oficializar+V.ele.ACC.3.M.PL+PQP+3+SG
oficializara-se	oficializar+V.ele.REFL+PQP+1+SG
oficializara-se	oficializar+V.ele.REFL+PQP+3+SG
oficializaras-lhe	oficializar+V.ele.DAT.3.SG+PQP+2+SG
oficializaras-lhes	oficializar+V.ele.DAT.3.PL+PQP+2+SG
oficializaras-me	oficializar+V.eu.AD.1.SG+PQP+2+SG
oficializaras-te	oficializar+V.tu.AD.2.SG+PQP+2+SG
oficializaras-vos	oficializar+V.vós.AD.2.PL+PQP+2+SG
oficializara-te	oficializar+V.tu.AD.2.SG+PQP+1+SG
oficializara-te	oficializar+V.tu.AD.2.SG+PQP+3+SG
oficializara-vos	oficializar+V.vós.AD.2.PL+PQP+1+SG
oficializara-vos	oficializar+V.vós.AD.2.PL+PQP+3+SG
oficializarde-la	oficializar+V.ele.ACC.3.F.SG+INF+2+PL
oficializarde-la	oficializar+V.ele.ACC.3.F.SG+SBJF+2+PL
oficializarde-las	oficializar+V.ele.ACC.3.F.PL+INF+2+PL
oficializarde-las	oficializar+V.ele.ACC.3.F.PL+SBJF+2+PL
oficializarde-lo	oficializar+V.ele.ACC.3.M.SG+INF+2+PL
oficializarde-lo	oficializar+V.ele.ACC.3.M.SG+SBJF+2+PL
oficializarde-los	oficializar+V.ele.ACC.3.M.PL+INF+2+PL
oficializarde-los	oficializar+V.ele.ACC.3.M.PL+SBJF+2+PL
oficializarde-nos	oficializar+nós.AD.1.PL+INF+2+PL
oficializarde-nos	oficializar+nós.AD.1.PL+SBJF+2+PL
oficializardes-lhe	oficializar+V.ele.DAT.3.SG+INF+2+PL
oficializardes-lhe	oficializar+V.ele.DAT.3.SG+SBJF+2+PL
oficializardes-lhes	oficializar+V.ele.DAT.3.PL+INF+2+PL
oficializardes-lhes	oficializar+V.ele.DAT.3.PL+SBJF+2+PL
oficializardes-me	oficializar+V.eu.AD.1.SG+INF+2+PL
oficializardes-me	oficializar+V.eu.AD.1.SG+SBJF+2+PL
oficializardes-te	oficializar+V.tu.AD.2.SG+INF+2+PL
oficializardes-te	oficializar+V.tu.AD.2.SG+SBJF+2+PL
oficializardes-vos	oficializar+V.vós.AD.2.PL+INF+2+PL
oficializardes-vos	oficializar+V.vós.AD.2.PL+SBJF+2+PL
oficializárei-la	oficializar+V.ele.ACC.3.F.SG+PQP+2+PL
oficializárei-las	oficializar+V.ele.ACC.3.F.PL+PQP+2+PL
oficializárei-lo	oficializar+V.ele.ACC.3.M.SG+PQP+2+PL
oficializárei-los	oficializar+V.ele.ACC.3.M.PL+PQP+2+PL
oficializárei-nos	oficializar+nós.AD.1.PL+PQP+2+PL
oficializáreis-lhe	oficializar+V.ele.DAT.3.SG+PQP+2+PL
oficializáreis-lhes	oficializar+V.ele.DAT.3.PL+PQP+2+PL
oficializáreis-me	oficializar+V.eu.AD.1.SG+PQP+2+PL
oficializáreis-te	oficializar+V.tu.AD.2.SG+PQP+2+PL
oficializáreis-vos	oficializar+V.vós.AD.2.PL+PQP+2+PL
oficializare-la	oficializar+V.ele.ACC.3.F.SG+INF+2+SG
oficializare-la	oficializar+V.ele.ACC.3.F.SG+SBJF+2+SG
oficializare-las	oficializar+V.ele.ACC.3.F.PL+INF+2+SG
oficializare-las	oficializar+V.ele.ACC.3.F.PL+SBJF+2+SG
oficializare-lo	oficializar+V.ele.ACC.3.M.SG+INF+2+SG
oficializare-lo	oficializar+V.ele.ACC.3.M.SG+SBJF+2+SG
oficializare-los	oficializar+V.ele.ACC.3.M.PL+INF+2+SG
oficializare-los	oficializar+V.ele.ACC.3.M.PL+SBJF+2+SG
oficializarem-lhe	oficializar+V.ele.DAT.3.SG+INF+3+PL
oficializarem-lhe	oficializar+V.ele.DAT.3.SG+SBJF+3+PL
oficializarem-lhes	oficializar+V.ele.DAT.3.PL+INF+3+PL
oficializarem-lhes	oficializar+V.ele.DAT.3.PL+SBJF+3+PL
oficializarem-me	oficializar+V.eu.AD.1.SG+INF+3+PL
oficializarem-me	oficializar+V.eu.AD.1.SG+SBJF+3+PL
oficializarem-na	oficializar+V.ele.ACC.3.F.SG+INF+3+PL
oficializarem-na	oficializar+V.ele.ACC.3.F.SG+SBJF+3+PL
oficializarem-nas	oficializar+V.ele.ACC.3.F.PL+INF+3+PL
oficializarem-nas	oficializar+V.ele.ACC.3.F.PL+SBJF+3+PL
oficializarem-no	oficializar+V.ele.ACC.3.M.SG+INF+3+PL
oficializarem-no	oficializar+V.ele.ACC.3.M.SG+SBJF+3+PL
oficializarem-nos	oficializar+V.ele.ACC.3.M.PL+INF+3+PL
oficializarem-nos	oficializar+V.ele.ACC.3.M.PL+SBJF+3+PL
oficializarem-nos	oficializar+V.nós.AD.1.PL+INF+3+PL
oficializarem-nos	oficializar+V.nós.AD.1.PL+SBJF+3+PL
oficializarem-se	oficializar+V.ele.REFL+INF+3+PL
oficializarem-se	oficializar+V.ele.REFL+SBJF+3+PL
oficializarem-te	oficializar+V.tu.AD.2.SG+INF+3+PL
oficializarem-te	oficializar+V.tu.AD.2.SG+SBJF+3+PL
oficializarem-vos	oficializar+V.vós.AD.2.PL+INF+3+PL
oficializarem-vos	oficializar+V.vós.AD.2.PL+SBJF+3+PL
oficializare-nos	oficializar+nós.AD.1.PL+INF+2+SG
oficializare-nos	oficializar+nós.AD.1.PL+SBJF+2+SG
oficializares-lhe	oficializar+V.ele.DAT.3.SG+INF+2+SG
oficializares-lhe	oficializar+V.ele.DAT.3.SG+SBJF+2+SG
oficializares-lhes	oficializar+V.ele.DAT.3.PL+INF+2+SG
oficializares-lhes	oficializar+V.ele.DAT.3.PL+SBJF+2+SG
oficializares-me	oficializar+V.eu.AD.1.SG+INF+2+SG
oficializares-me	oficializar+V.eu.AD.1.SG+SBJF+2+SG
oficializares-te	oficializar+V.tu.AD.2.SG+INF+2+SG
oficializares-te	oficializar+V.tu.AD.2.SG+SBJF+2+SG
oficializares-vos	oficializar+V.vós.AD.2.PL+INF+2+SG
oficializares-vos	oficializar+V.vós.AD.2.PL+SBJF+2+SG
oficializar-lhe-á	oficializar+V.ele.DAT.3.SG+FUT+3+SG
oficializar-lhe-ão	oficializar+V.ele.DAT.3.SG+FUT+3+PL
oficializar-lhe-ás	oficializar+V.ele.DAT.3.SG+FUT+2+SG
oficializar-lhe-ei	oficializar+V.ele.DAT.3.SG+FUT+1+SG
oficializar-lhe-eis	oficializar+V.ele.DAT.3.SG+FUT+2+PL
oficializar-lhe-emos	oficializar+V.ele.DAT.3.SG+FUT+1+PL
oficializar-lhe-iam	oficializar+V.ele.DAT.3.SG+COND+3+PL
oficializar-lhe-íamos	oficializar+V.ele.DAT.3.SG+COND+1+PL
oficializar-lhe-ia	oficializar+V.ele.DAT.3.SG+COND+1+SG
oficializar-lhe-ia	oficializar+V.ele.DAT.3.SG+COND+3+SG
oficializar-lhe-ias	oficializar+V.ele.DAT.3.SG+COND+2+SG
oficializar-lhe-íeis	oficializar+V.ele.DAT.3.SG+COND+2+PL
oficializar-lhe	oficializar+V.ele.DAT.3.SG+INF
oficializar-lhe	oficializar+V.ele.DAT.3.SG+INF+1+SG
oficializar-lhe	oficializar+V.ele.DAT.3.SG+INF+3+SG
oficializar-lhe	oficializar+V.ele.DAT.3.SG+SBJF+1+SG
oficializar-lhe	oficializar+V.ele.DAT.3.SG+SBJF+3+SG
oficializar-lhes-á	oficializar+V.ele.DAT.3.PL+FUT+3+SG
oficializar-lhes-ão	oficializar+V.ele.DAT.3.PL+FUT+3+PL
oficializar-lhes-ás	oficializar+V.ele.DAT.3.PL+FUT+2+SG
oficializar-lhes-ei	oficializar+V.ele.DAT.3.PL+FUT+1+SG
oficializar-lhes-eis	oficializar+V.ele.DAT.3.PL+FUT+2+PL
oficializar-lhes-emos	oficializar+V.ele.DAT.3.PL+FUT+1+PL
oficializar-lhes-iam	oficializar+V.ele.DAT.3.PL+COND+3+PL
oficializar-lhes-íamos	oficializar+V.ele.DAT.3.PL+COND+1+PL
oficializar-lhes-ia	oficializar+V.ele.DAT.3.PL+COND+1+SG
oficializar-lhes-ia	oficializar+V.ele.DAT.3.PL+COND+3+SG
oficializar-lhes-ias	oficializar+V.ele.DAT.3.PL+COND+2+SG
oficializar-lhes-íeis	oficializar+V.ele.DAT.3.PL+COND+2+PL
oficializar-lhes	oficializar+V.ele.DAT.3.PL+INF
oficializar-lhes	oficializar+V.ele.DAT.3.PL+INF+1+SG
oficializar-lhes	oficializar+V.ele.DAT.3.PL+INF+3+SG
oficializar-lhes	oficializar+V.ele.DAT.3.PL+SBJF+1+SG
oficializar-lhes	oficializar+V.ele.DAT.3.PL+SBJF+3+SG
oficializar-me-á	oficializar+V.eu.AD.1.SG+FUT+3+SG
oficializar-me-ão	oficializar+V.eu.AD.1.SG+FUT+3+PL
oficializar-me-ás	oficializar+V.eu.AD.1.SG+FUT+2+SG
oficializar-me-ei	oficializar+V.eu.AD.1.SG+FUT+1+SG
oficializar-me-eis	oficializar+V.eu.AD.1.SG+FUT+2+PL
oficializar-me-emos	oficializar+V.eu.AD.1.SG+FUT+1+PL
oficializar-me-iam	oficializar+V.eu.AD.1.SG+COND+3+PL
oficializar-me-íamos	oficializar+V.eu.AD.1.SG+COND+1+PL
oficializar-me-ia	oficializar+V.eu.AD.1.SG+COND+1+SG
oficializar-me-ia	oficializar+V.eu.AD.1.SG+COND+3+SG
oficializar-me-ias	oficializar+V.eu.AD.1.SG+COND+2+SG
oficializar-me-íeis	oficializar+V.eu.AD.1.SG+COND+2+PL
oficializar-me	oficializar+V.eu.AD.1.SG+INF
oficializar-me	oficializar+V.eu.AD.1.SG+INF+1+SG
oficializar-me	oficializar+V.eu.AD.1.SG+INF+3+SG
oficializar-me	oficializar+V.eu.AD.1.SG+SBJF+1+SG
oficializar-me	oficializar+V.eu.AD.1.SG+SBJF+3+SG
oficializarmo-la	oficializar+V.ele.ACC.3.F.SG+INF+1+PL
oficializarmo-la	oficializar+V.ele.ACC.3.F.SG+SBJF+1+PL
oficializarmo-las	oficializar+V.ele.ACC.3.F.PL+INF+1+PL
oficializarmo-las	oficializar+V.ele.ACC.3.F.PL+SBJF+1+PL
oficializarmo-lo	oficializar+V.ele.ACC.3.M.SG+INF+1+PL
oficializarmo-lo	oficializar+V.ele.ACC.3.M.SG+SBJF+1+PL
oficializarmo-los	oficializar+V.ele.ACC.3.M.PL+INF+1+PL
oficializarmo-los	oficializar+V.ele.ACC.3.M.PL+SBJF+1+PL
oficializarmo-nos	oficializar+nós.AD.1.PL+INF+1+PL
oficializarmo-nos	oficializar+nós.AD.1.PL+SBJF+1+PL
oficializarmos-lhe	oficializar+V.ele.DAT.3.SG+INF+1+PL
oficializarmos-lhe	oficializar+V.ele.DAT.3.SG+SBJF+1+PL
oficializarmos-lhes	oficializar+V.ele.DAT.3.PL+INF+1+PL
oficializarmos-lhes	oficializar+V.ele.DAT.3.PL+SBJF+1+PL
oficializarmos-me	oficializar+V.eu.AD.1.SG+INF+1+PL
oficializarmos-me	oficializar+V.eu.AD.1.SG+SBJF+1+PL
oficializarmos-te	oficializar+V.tu.AD.2.SG+INF+1+PL
oficializarmos-te	oficializar+V.tu.AD.2.SG+SBJF+1+PL
oficializarmos-vos	oficializar+V.vós.AD.2.PL+INF+1+PL
oficializarmos-vos	oficializar+V.vós.AD.2.PL+SBJF+1+PL
oficializar-nos-á	oficializar+nós.AD.1.PL+FUT+3+SG
oficializar-nos-ão	oficializar+nós.AD.1.PL+FUT+3+PL
oficializar-nos-ás	oficializar+nós.AD.1.PL+FUT+2+SG
oficializar-nos-ei	oficializar+nós.AD.1.PL+FUT+1+SG
oficializar-nos-eis	oficializar+nós.AD.1.PL+FUT+2+PL
oficializar-nos-emos	oficializar+nós.AD.1.PL+FUT+1+PL
oficializar-nos-iam	oficializar+nós.AD.1.PL+COND+3+PL
oficializar-nos-íamos	oficializar+nós.AD.1.PL+COND+1+PL
oficializar-nos-ia	oficializar+nós.AD.1.PL+COND+1+SG
oficializar-nos-ia	oficializar+nós.AD.1.PL+COND+3+SG
oficializar-nos-ias	oficializar+nós.AD.1.PL+COND+2+SG
oficializar-nos-íeis	oficializar+nós.AD.1.PL+COND+2+PL
oficializar-nos	oficializar+nós.AD.1.PL+INF
oficializar-nos	oficializar+nós.AD.1.PL+INF+1+SG
oficializar-nos	oficializar+nós.AD.1.PL+INF+3+SG
oficializar-nos	oficializar+nós.AD.1.PL+SBJF+1+SG
oficializar-nos	oficializar+nós.AD.1.PL+SBJF+3+SG
oficializar-se-á	oficializar+V.ele.REFL+FUT+3+SG
oficializar-se-ão	oficializar+V.ele.REFL+FUT+3+PL
oficializar-se-iam	oficializar+V.ele.REFL+COND+3+PL
oficializar-se-ia	oficializar+V.ele.REFL+COND+3+SG
oficializar-se	oficializar+V.ele.REFL+INF
oficializar-se	oficializar+V.ele.REFL+INF+3+SG
oficializar-se	oficializar+V.ele.REFL+SBJF+3+SG
oficializar-te-á	oficializar+V.tu.AD.2.SG+FUT+3+SG
oficializar-te-ão	oficializar+V.tu.AD.2.SG+FUT+3+PL
oficializar-te-ás	oficializar+V.tu.AD.2.SG+FUT+2+SG
oficializar-te-ei	oficializar+V.tu.AD.2.SG+FUT+1+SG
oficializar-te-eis	oficializar+V.tu.AD.2.SG+FUT+2+PL
oficializar-te-emos	oficializar+V.tu.AD.2.SG+FUT+1+PL
oficializar-te-iam	oficializar+V.tu.AD.2.SG+COND+3+PL
oficializar-te-íamos	oficializar+V.tu.AD.2.SG+COND+1+PL
oficializar-te-ia	oficializar+V.tu.AD.2.SG+COND+1+SG
oficializar-te-ia	oficializar+V.tu.AD.2.SG+COND+3+SG
oficializar-te-ias	oficializar+V.tu.AD.2.SG+COND+2+SG
oficializar-te-íeis	oficializar+V.tu.AD.2.SG+COND+2+PL
oficializar-te	oficializar+V.tu.AD.2.SG+INF
oficializar-te	oficializar+V.tu.AD.2.SG+INF+1+SG
oficializar-te	oficializar+V.tu.AD.2.SG+INF+3+SG
oficializar-te	oficializar+V.tu.AD.2.SG+SBJF+1+SG
oficializar-te	oficializar+V.tu.AD.2.SG+SBJF+3+SG
oficializar-vos-á	oficializar+V.vós.AD.2.PL+FUT+3+SG
oficializar-vos-ão	oficializar+V.vós.AD.2.PL+FUT+3+PL
oficializar-vos-ás	oficializar+V.vós.AD.2.PL+FUT+2+SG
oficializar-vos-ei	oficializar+V.vós.AD.2.PL+FUT+1+SG
oficializar-vos-eis	oficializar+V.vós.AD.2.PL+FUT+2+PL
oficializar-vos-emos	oficializar+V.vós.AD.2.PL+FUT+1+PL
oficializar-vos-iam	oficializar+V.vós.AD.2.PL+COND+3+PL
oficializar-vos-íamos	oficializar+V.vós.AD.2.PL+COND+1+PL
oficializar-vos-ia	oficializar+V.vós.AD.2.PL+COND+1+SG
oficializar-vos-ia	oficializar+V.vós.AD.2.PL+COND+3+SG
oficializar-vos-ias	oficializar+V.vós.AD.2.PL+COND+2+SG
oficializar-vos-íeis	oficializar+V.vós.AD.2.PL+COND+2+PL
oficializar-vos	oficializar+V.vós.AD.2.PL+INF
oficializar-vos	oficializar+V.vós.AD.2.PL+INF+1+SG
oficializar-vos	oficializar+V.vós.AD.2.PL+INF+3+SG
oficializar-vos	oficializar+V.vós.AD.2.PL+SBJF+1+SG
oficializar-vos	oficializar+V.vós.AD.2.PL+SBJF+3+SG
oficializa-se	oficializar+V.ele.REFL+PRS+3+SG
oficializas-lhe	oficializar+V.ele.DAT.3.SG+PRS+2+SG
oficializas-lhes	oficializar+V.ele.DAT.3.PL+PRS+2+SG
oficializas-me	oficializar+V.eu.AD.1.SG+PRS+2+SG
oficializaste-a	oficializar+V.ele.ACC.3.F.SG+PRF+2+SG
oficializaste-as	oficializar+V.ele.ACC.3.F.PL+PRF+2+SG
oficializaste-la	oficializar+V.ele.ACC.3.F.SG+PRF+2+PL
oficializaste-las	oficializar+V.ele.ACC.3.F.PL+PRF+2+PL
oficializaste-lhe	oficializar+V.ele.DAT.3.SG+PRF+2+SG
oficializaste-lhes	oficializar+V.ele.DAT.3.PL+PRF+2+SG
oficializaste-lo	oficializar+V.ele.ACC.3.M.SG+PRF+2+PL
oficializaste-los	oficializar+V.ele.ACC.3.M.PL+PRF+2+PL
oficializaste-me	oficializar+V.eu.AD.1.SG+PRF+2+SG
oficializaste-nos	oficializar+nós.AD.1.PL+PRF+2+PL
oficializaste-nos	oficializar+nós.AD.1.PL+PRF+2+SG
oficializas-te	oficializar+V.tu.AD.2.SG+PRS+2+SG
oficializaste-o	oficializar+V.ele.ACC.3.M.SG+PRF+2+SG
oficializaste-os	oficializar+V.ele.ACC.3.M.PL+PRF+2+SG
oficializastes-lhe	oficializar+V.ele.DAT.3.SG+PRF+2+PL
oficializastes-lhes	oficializar+V.ele.DAT.3.PL+PRF+2+PL
oficializastes-me	oficializar+V.eu.AD.1.SG+PRF+2+PL
oficializastes-te	oficializar+V.tu.AD.2.SG+PRF+2+PL
oficializastes-vos	oficializar+V.vós.AD.2.PL+PRF+2+PL
oficializaste-te	oficializar+V.tu.AD.2.SG+PRF+2+SG
oficializaste-vos	oficializar+V.vós.AD.2.PL+PRF+2+SG
oficializas-vos	oficializar+V.vós.AD.2.PL+PRS+2+SG
oficializa-te	oficializar+V.tu.AD.2.SG+PRS+3+SG
oficializava-a	oficializar+V.ele.ACC.3.F.SG+IMPF+1+SG
oficializava-a	oficializar+V.ele.ACC.3.F.SG+IMPF+3+SG
oficializava-as	oficializar+V.ele.ACC.3.F.PL+IMPF+1+SG
oficializava-as	oficializar+V.ele.ACC.3.F.PL+IMPF+3+SG
oficializava-la	oficializar+V.ele.ACC.3.F.SG+IMPF+2+SG
oficializava-las	oficializar+V.ele.ACC.3.F.PL+IMPF+2+SG
oficializava-lhe	oficializar+V.ele.DAT.3.SG+IMPF+1+SG
oficializava-lhe	oficializar+V.ele.DAT.3.SG+IMPF+3+SG
oficializava-lhes	oficializar+V.ele.DAT.3.PL+IMPF+1+SG
oficializava-lhes	oficializar+V.ele.DAT.3.PL+IMPF+3+SG
oficializava-lo	oficializar+V.ele.ACC.3.M.SG+IMPF+2+SG
oficializava-los	oficializar+V.ele.ACC.3.M.PL+IMPF+2+SG
oficializava-me	oficializar+V.eu.AD.1.SG+IMPF+1+SG
oficializava-me	oficializar+V.eu.AD.1.SG+IMPF+3+SG
oficializavam-lhe	oficializar+V.ele.DAT.3.SG+IMPF+3+PL
oficializavam-lhes	oficializar+V.ele.DAT.3.PL+IMPF+3+PL
oficializavam-me	oficializar+V.eu.AD.1.SG+IMPF+3+PL
oficializavam-na	oficializar+V.ele.ACC.3.F.SG+IMPF+3+PL
oficializavam-nas	oficializar+V.ele.ACC.3.F.PL+IMPF+3+PL
oficializavam-no	oficializar+V.ele.ACC.3.M.SG+IMPF+3+PL
oficializavam-nos	oficializar+V.ele.ACC.3.M.PL+IMPF+3+PL
oficializavam-nos	oficializar+V.nós.AD.1.PL+IMPF+3+PL
oficializávamo-la	oficializar+V.ele.ACC.3.F.SG+IMPF+1+PL
oficializávamo-las	oficializar+V.ele.ACC.3.F.PL+IMPF+1+PL
oficializávamo-lo	oficializar+V.ele.ACC.3.M.SG+IMPF+1+PL
oficializávamo-los	oficializar+V.ele.ACC.3.M.PL+IMPF+1+PL
oficializávamo-nos	oficializar+nós.AD.1.PL+IMPF+1+PL
oficializávamos-lhe	oficializar+V.ele.DAT.3.SG+IMPF+1+PL
oficializávamos-lhes	oficializar+V.ele.DAT.3.PL+IMPF+1+PL
oficializávamos-me	oficializar+V.eu.AD.1.SG+IMPF+1+PL
oficializávamos-te	oficializar+V.tu.AD.2.SG+IMPF+1+PL
oficializávamos-vos	oficializar+V.vós.AD.2.PL+IMPF+1+PL
oficializavam-se	oficializar+V.ele.REFL+IMPF+3+PL
oficializavam-te	oficializar+V.tu.AD.2.SG+IMPF+3+PL
oficializavam-vos	oficializar+V.vós.AD.2.PL+IMPF+3+PL
oficializava-nos	oficializar+nós.AD.1.PL+IMPF+1+SG
oficializava-nos	oficializar+nós.AD.1.PL+IMPF+2+SG
oficializava-nos	oficializar+nós.AD.1.PL+IMPF+3+SG
oficializava-o	oficializar+V.ele.ACC.3.M.SG+IMPF+1+SG
oficializava-o	oficializar+V.ele.ACC.3.M.SG+IMPF+3+SG
oficializava-os	oficializar+V.ele.ACC.3.M.PL+IMPF+1+SG
oficializava-os	oficializar+V.ele.ACC.3.M.PL+IMPF+3+SG
oficializava-se	oficializar+V.ele.REFL+IMPF+1+SG
oficializava-se	oficializar+V.ele.REFL+IMPF+3+SG
oficializavas-lhe	oficializar+V.ele.DAT.3.SG+IMPF+2+SG
oficializavas-lhes	oficializar+V.ele.DAT.3.PL+IMPF+2+SG
oficializavas-me	oficializar+V.eu.AD.1.SG+IMPF+2+SG
oficializavas-te	oficializar+V.tu.AD.2.SG+IMPF+2+SG
oficializavas-vos	oficializar+V.vós.AD.2.PL+IMPF+2+SG
oficializava-te	oficializar+V.tu.AD.2.SG+IMPF+1+SG
oficializava-te	oficializar+V.tu.AD.2.SG+IMPF+3+SG
oficializava-vos	oficializar+V.vós.AD.2.PL+IMPF+1+SG
oficializava-vos	oficializar+V.vós.AD.2.PL+IMPF+3+SG
oficializávei-la	oficializar+V.ele.ACC.3.F.SG+IMPF+2+PL
oficializávei-las	oficializar+V.ele.ACC.3.F.PL+IMPF+2+PL
oficializávei-lo	oficializar+V.ele.ACC.3.M.SG+IMPF+2+PL
oficializávei-los	oficializar+V.ele.ACC.3.M.PL+IMPF+2+PL
oficializávei-nos	oficializar+nós.AD.1.PL+IMPF+2+PL
oficializáveis-lhe	oficializar+V.ele.DAT.3.SG+IMPF+2+PL
oficializáveis-lhes	oficializar+V.ele.DAT.3.PL+IMPF+2+PL
oficializáveis-me	oficializar+V.eu.AD.1.SG+IMPF+2+PL
oficializáveis-te	oficializar+V.tu.AD.2.SG+IMPF+2+PL
oficializáveis-vos	oficializar+V.vós.AD.2.PL+IMPF+2+PL
oficializa-vos	oficializar+V.vós.AD.2.PL+PRS+3+SG
oficialize-a	oficializar+V.ele.ACC.3.F.SG+IMP+3+SG
oficialize-as	oficializar+V.ele.ACC.3.F.PL+IMP+3+SG
oficializei-a	oficializar+V.ele.ACC.3.F.SG+PRF+1+SG
oficializei-as	oficializar+V.ele.ACC.3.F.PL+PRF+1+SG
oficializei-lhe	oficializar+V.ele.DAT.3.SG+PRF+1+SG
oficializei-lhes	oficializar+V.ele.DAT.3.PL+PRF+1+SG
oficializei-me	oficializar+V.eu.AD.1.SG+PRF+1+SG
oficializei-nos	oficializar+nós.AD.1.PL+PRF+1+SG
oficializei-o	oficializar+V.ele.ACC.3.M.SG+PRF+1+SG
oficializei-os	oficializar+V.ele.ACC.3.M.PL+PRF+1+SG
oficializei-te	oficializar+V.tu.AD.2.SG+PRF+1+SG
oficializei-vos	oficializar+V.vós.AD.2.PL+PRF+1+SG
oficialize-lhe	oficializar+V.ele.DAT.3.SG+IMP+3+SG
oficialize-lhes	oficializar+V.ele.DAT.3.PL+IMP+3+SG
oficialize-me	oficializar+V.eu.AD.1.SG+IMP+3+SG
oficializem-lhe	oficializar+V.ele.DAT.3.SG+IMP+3+PL
oficializem-lhes	oficializar+V.ele.DAT.3.PL+IMP+3+PL
oficializem-me	oficializar+V.eu.AD.1.SG+IMP+3+PL
oficializem-na	oficializar+V.ele.ACC.3.F.SG+IMP+3+PL
oficializem-nas	oficializar+V.ele.ACC.3.F.PL+IMP+3+PL
oficializem-no	oficializar+V.ele.ACC.3.M.SG+IMP+3+PL
oficializem-nos	oficializar+V.ele.ACC.3.M.PL+IMP+3+PL
oficializem-nos	oficializar+V.nós.AD.1.PL+IMP+3+PL
oficializemo-la	oficializar+V.ele.ACC.3.F.SG+IMP+1+PL
oficializemo-las	oficializar+V.ele.ACC.3.F.PL+IMP+1+PL
oficializemo-lo	oficializar+V.ele.ACC.3.M.SG+IMP+1+PL
oficializemo-los	oficializar+V.ele.ACC.3.M.PL+IMP+1+PL
oficializemo-nos	oficializar+nós.AD.1.PL+IMP+1+PL
oficializemos-lhe	oficializar+V.ele.DAT.3.SG+IMP+1+PL
oficializemos-lhes	oficializar+V.ele.DAT.3.PL+IMP+1+PL
oficializemos-me	oficializar+V.eu.AD.1.SG+IMP+1+PL
oficializemos-te	oficializar+V.tu.AD.2.SG+IMP+1+PL
oficializemos-vos	oficializar+V.vós.AD.2.PL+IMP+1+PL
oficializem-se	oficializar+V.ele.REFL+IMP+3+PL
oficializem-te	oficializar+V.tu.AD.2.SG+IMP+3+PL
oficializem-vos	oficializar+V.vós.AD.2.PL+IMP+3+PL
oficialize-nos	oficializar+nós.AD.1.PL+IMP+3+SG
oficialize-o	oficializar+V.ele.ACC.3.M.SG+IMP+3+SG
oficialize-os	oficializar+V.ele.ACC.3.M.PL+IMP+3+SG
oficialize-se	oficializar+V.ele.REFL+IMP+3+SG
oficialize-te	oficializar+V.tu.AD.2.SG+IMP+3+SG
oficialize-vos	oficializar+V.vós.AD.2.PL+IMP+3+SG
oficializo-a	oficializar+V.ele.ACC.3.F.SG+PRS+1+SG
oficializo-as	oficializar+V.ele.ACC.3.F.PL+PRS+1+SG
oficializo-lhe	oficializar+V.ele.DAT.3.SG+PRS+1+SG
oficializo-lhes	oficializar+V.ele.DAT.3.PL+PRS+1+SG
oficializo-me	oficializar+V.eu.AD.1.SG+PRS+1+SG
oficializo-nos	oficializar+nós.AD.1.PL+PRS+1+SG
oficializo-o	oficializar+V.ele.ACC.3.M.SG+PRS+1+SG
oficializo-os	oficializar+V.ele.ACC.3.M.PL+PRS+1+SG
oficializo-te	oficializar+V.tu.AD.2.SG+PRS+1+SG
oficializou-a	oficializar+V.ele.ACC.3.F.SG+PRF+3+SG
oficializou-as	oficializar+V.ele.ACC.3.F.PL+PRF+3+SG
oficializou-lhe	oficializar+V.ele.DAT.3.SG+PRF+3+SG
oficializou-lhes	oficializar+V.ele.DAT.3.PL+PRF+3+SG
oficializou-me	oficializar+V.eu.AD.1.SG+PRF+3+SG
oficializou-nos	oficializar+nós.AD.1.PL+PRF+3+SG
oficializou-o	oficializar+V.ele.ACC.3.M.SG+PRF+3+SG
oficializou-os	oficializar+V.ele.ACC.3.M.PL+PRF+3+SG
oficializou-se	oficializar+V.ele.REFL+PRF+3+SG
oficializou-te	oficializar+V.tu.AD.2.SG+PRF+3+SG
oficializou-vos	oficializar+V.vós.AD.2.PL+PRF+3+SG
oficializo-vos	oficializar+V.vós.AD.2.PL+PRS+1+SG
oficiá-lo-á	oficiar+V.ele.ACC.3.M.SG+FUT+3+SG
oficiá-lo-ão	oficiar+V.ele.ACC.3.M.SG+FUT+3+PL
oficiá-lo-ás	oficiar+V.ele.ACC.3.M.SG+FUT+2+SG
oficiá-lo-ei	oficiar+V.ele.ACC.3.M.SG+FUT+1+SG
oficiá-lo-eis	oficiar+V.ele.ACC.3.M.SG+FUT+2+PL
oficiá-lo-emos	oficiar+V.ele.ACC.3.M.SG+FUT+1+PL
oficiá-lo-iam	oficiar+V.ele.ACC.3.M.SG+COND+3+PL
oficiá-lo-íamos	oficiar+V.ele.ACC.3.M.SG+COND+1+PL
oficiá-lo-ia	oficiar+V.ele.ACC.3.M.SG+COND+1+SG
oficiá-lo-ia	oficiar+V.ele.ACC.3.M.SG+COND+3+SG
oficiá-lo-ias	oficiar+V.ele.ACC.3.M.SG+COND+2+SG
oficiá-lo-íeis	oficiar+V.ele.ACC.3.M.SG+COND+2+PL
oficiá-lo	oficiar+V.ele.ACC.3.M.SG+INF+1+SG
oficiá-lo	oficiar+V.ele.ACC.3.M.SG+INF+3+SG
oficia-lo	oficiar+V.ele.ACC.3.M.SG+PRS+2+SG
oficiá-lo	oficiar+V.ele.ACC.3.M.SG+SBJF+1+SG
oficiá-lo	oficiar+V.ele.ACC.3.M.SG+SBJF+3+SG
oficiá-los-á	oficiar+V.ele.ACC.3.M.PL+FUT+3+SG
oficiá-los-ão	oficiar+V.ele.ACC.3.M.PL+FUT+3+PL
oficiá-los-ás	oficiar+V.ele.ACC.3.M.PL+FUT+2+SG
oficiá-los-ei	oficiar+V.ele.ACC.3.M.PL+FUT+1+SG
oficiá-los-eis	oficiar+V.ele.ACC.3.M.PL+FUT+2+PL
oficiá-los-emos	oficiar+V.ele.ACC.3.M.PL+FUT+1+PL
oficiá-los-iam	oficiar+V.ele.ACC.3.M.PL+COND+3+PL
oficiá-los-íamos	oficiar+V.ele.ACC.3.M.PL+COND+1+PL
oficiá-los-ia	oficiar+V.ele.ACC.3.M.PL+COND+1+SG
oficiá-los-ia	oficiar+V.ele.ACC.3.M.PL+COND+3+SG
oficiá-los-ias	oficiar+V.ele.ACC.3.M.PL+COND+2+SG
oficiá-los-íeis	oficiar+V.ele.ACC.3.M.PL+COND+2+PL
oficiá-los	oficiar+V.ele.ACC.3.M.PL+INF+1+SG
oficiá-los	oficiar+V.ele.ACC.3.M.PL+INF+3+SG
oficia-los	oficiar+V.ele.ACC.3.M.PL+PRS+2+SG
oficiá-los	oficiar+V.ele.ACC.3.M.PL+SBJF+1+SG
oficiá-los	oficiar+V.ele.ACC.3.M.PL+SBJF+3+SG
oficia-me	oficiar+V.eu.AD.1.SG+PRS+3+SG
oficiam-lhe	oficiar+V.ele.DAT.3.SG+PRS+3+PL
oficiam-lhes	oficiar+V.ele.DAT.3.PL+PRS+3+PL
oficiam-me	oficiar+V.eu.AD.1.SG+PRS+3+PL
oficiam-na	oficiar+V.ele.ACC.3.F.SG+PRS+3+PL
oficiam-nas	oficiar+V.ele.ACC.3.F.PL+PRS+3+PL
oficiam-no	oficiar+V.ele.ACC.3.M.SG+PRS+3+PL
oficiam-nos	oficiar+V.ele.ACC.3.M.PL+PRS+3+PL
oficiam-nos	oficiar+V.nós.AD.1.PL+PRS+3+PL
oficiamo-la	oficiar+V.ele.ACC.3.F.SG+PRF+1+PL
oficiamo-la	oficiar+V.ele.ACC.3.F.SG+PRS+1+PL
oficiamo-las	oficiar+V.ele.ACC.3.F.PL+PRF+1+PL
oficiamo-las	oficiar+V.ele.ACC.3.F.PL+PRS+1+PL
oficiamo-lo	oficiar+V.ele.ACC.3.M.SG+PRF+1+PL
oficiamo-lo	oficiar+V.ele.ACC.3.M.SG+PRS+1+PL
oficiamo-los	oficiar+V.ele.ACC.3.M.PL+PRF+1+PL
oficiamo-los	oficiar+V.ele.ACC.3.M.PL+PRS+1+PL
oficiamo-nos	oficiar+nós.AD.1.PL+PRF+1+PL
oficiamo-nos	oficiar+nós.AD.1.PL+PRS+1+PL
oficiamos-lhe	oficiar+V.ele.DAT.3.SG+PRF+1+PL
oficiamos-lhe	oficiar+V.ele.DAT.3.SG+PRS+1+PL
oficiamos-lhes	oficiar+V.ele.DAT.3.PL+PRF+1+PL
oficiamos-lhes	oficiar+V.ele.DAT.3.PL+PRS+1+PL
oficiamos-me	oficiar+V.eu.AD.1.SG+PRF+1+PL
oficiamos-me	oficiar+V.eu.AD.1.SG+PRS+1+PL
oficiamos-te	oficiar+V.tu.AD.2.SG+PRF+1+PL
oficiamos-te	oficiar+V.tu.AD.2.SG+PRS+1+PL
oficiamos-vos	oficiar+V.vós.AD.2.PL+PRF+1+PL
oficiamos-vos	oficiar+V.vós.AD.2.PL+PRS+1+PL
oficiam-se	oficiar+V.ele.REFL+PRS+3+PL
oficiam-te	oficiar+V.tu.AD.2.SG+PRS+3+PL
oficiam-vos	oficiar+V.vós.AD.2.PL+PRS+3+PL
oficiando-a	oficiar+V.ele.ACC.3.F.SG+GRD
oficiando-as	oficiar+V.ele.ACC.3.F.PL+GRD
oficiando-lhe	oficiar+V.ele.DAT.3.SG+GRD
oficiando-lhes	oficiar+V.ele.DAT.3.PL+GRD
oficiando-me	oficiar+V.eu.AD.1.SG+GRD
oficiando-nos	oficiar+nós.AD.1.PL+GRD
oficiando-o	oficiar+V.ele.ACC.3.M.SG+GRD
oficiando-os	oficiar+V.ele.ACC.3.M.PL+GRD
oficiando-se	oficiar+V.ele.REFL+GRD
oficiando-te	oficiar+V.tu.AD.2.SG+GRD
oficiando-vos	oficiar+V.vós.AD.2.PL+GRD
oficia-nos	oficiar+nós.AD.1.PL+PRS+2+SG
oficia-nos	oficiar+nós.AD.1.PL+PRS+3+SG
oficia-o	oficiar+V.ele.ACC.3.M.SG+PRS+3+SG
oficia-os	oficiar+V.ele.ACC.3.M.PL+PRS+3+SG
oficiara-a	oficiar+V.ele.ACC.3.F.SG+PQP+1+SG
oficiara-a	oficiar+V.ele.ACC.3.F.SG+PQP+3+SG
oficiara-as	oficiar+V.ele.ACC.3.F.PL+PQP+1+SG
oficiara-as	oficiar+V.ele.ACC.3.F.PL+PQP+3+SG
oficiara-la	oficiar+V.ele.ACC.3.F.SG+PQP+2+SG
oficiara-las	oficiar+V.ele.ACC.3.F.PL+PQP+2+SG
oficiara-lhe	oficiar+V.ele.DAT.3.SG+PQP+1+SG
oficiara-lhe	oficiar+V.ele.DAT.3.SG+PQP+3+SG
oficiara-lhes	oficiar+V.ele.DAT.3.PL+PQP+1+SG
oficiara-lhes	oficiar+V.ele.DAT.3.PL+PQP+3+SG
oficiara-lo	oficiar+V.ele.ACC.3.M.SG+PQP+2+SG
oficiara-los	oficiar+V.ele.ACC.3.M.PL+PQP+2+SG
oficiara-me	oficiar+V.eu.AD.1.SG+PQP+1+SG
oficiara-me	oficiar+V.eu.AD.1.SG+PQP+3+SG
oficiaram-lhe	oficiar+V.ele.DAT.3.SG+PQP+3+PL
oficiaram-lhe	oficiar+V.ele.DAT.3.SG+PRF+3+PL
oficiaram-lhes	oficiar+V.ele.DAT.3.PL+PQP+3+PL
oficiaram-lhes	oficiar+V.ele.DAT.3.PL+PRF+3+PL
oficiaram-me	oficiar+V.eu.AD.1.SG+PQP+3+PL
oficiaram-me	oficiar+V.eu.AD.1.SG+PRF+3+PL
oficiaram-na	oficiar+V.ele.ACC.3.F.SG+PQP+3+PL
oficiaram-na	oficiar+V.ele.ACC.3.F.SG+PRF+3+PL
oficiaram-nas	oficiar+V.ele.ACC.3.F.PL+PQP+3+PL
oficiaram-nas	oficiar+V.ele.ACC.3.F.PL+PRF+3+PL
oficiaram-no	oficiar+V.ele.ACC.3.M.SG+PQP+3+PL
oficiaram-no	oficiar+V.ele.ACC.3.M.SG+PRF+3+PL
oficiaram-nos	oficiar+V.ele.ACC.3.M.PL+PQP+3+PL
oficiaram-nos	oficiar+V.ele.ACC.3.M.PL+PRF+3+PL
oficiaram-nos	oficiar+V.nós.AD.1.PL+PQP+3+PL
oficiaram-nos	oficiar+V.nós.AD.1.PL+PRF+3+PL
oficiáramo-la	oficiar+V.ele.ACC.3.F.SG+PQP+1+PL
oficiáramo-las	oficiar+V.ele.ACC.3.F.PL+PQP+1+PL
oficiáramo-lo	oficiar+V.ele.ACC.3.M.SG+PQP+1+PL
oficiáramo-los	oficiar+V.ele.ACC.3.M.PL+PQP+1+PL
oficiáramo-nos	oficiar+nós.AD.1.PL+PQP+1+PL
oficiáramos-lhe	oficiar+V.ele.DAT.3.SG+PQP+1+PL
oficiáramos-lhes	oficiar+V.ele.DAT.3.PL+PQP+1+PL
oficiáramos-me	oficiar+V.eu.AD.1.SG+PQP+1+PL
oficiáramos-te	oficiar+V.tu.AD.2.SG+PQP+1+PL
oficiáramos-vos	oficiar+V.vós.AD.2.PL+PQP+1+PL
oficiaram-se	oficiar+V.ele.REFL+PQP+3+PL
oficiaram-se	oficiar+V.ele.REFL+PRF+3+PL
oficiaram-te	oficiar+V.tu.AD.2.SG+PQP+3+PL
oficiaram-te	oficiar+V.tu.AD.2.SG+PRF+3+PL
oficiaram-vos	oficiar+V.vós.AD.2.PL+PQP+3+PL
oficiaram-vos	oficiar+V.vós.AD.2.PL+PRF+3+PL
oficiara-nos	oficiar+nós.AD.1.PL+PQP+1+SG
oficiara-nos	oficiar+nós.AD.1.PL+PQP+2+SG
oficiara-nos	oficiar+nós.AD.1.PL+PQP+3+SG
oficiara-o	oficiar+V.ele.ACC.3.M.SG+PQP+1+SG
oficiara-o	oficiar+V.ele.ACC.3.M.SG+PQP+3+SG
oficiara-os	oficiar+V.ele.ACC.3.M.PL+PQP+1+SG
oficiara-os	oficiar+V.ele.ACC.3.M.PL+PQP+3+SG
oficiara-se	oficiar+V.ele.REFL+PQP+1+SG
oficiara-se	oficiar+V.ele.REFL+PQP+3+SG
oficiaras-lhe	oficiar+V.ele.DAT.3.SG+PQP+2+SG
oficiaras-lhes	oficiar+V.ele.DAT.3.PL+PQP+2+SG
oficiaras-me	oficiar+V.eu.AD.1.SG+PQP+2+SG
oficiaras-te	oficiar+V.tu.AD.2.SG+PQP+2+SG
oficiaras-vos	oficiar+V.vós.AD.2.PL+PQP+2+SG
oficiara-te	oficiar+V.tu.AD.2.SG+PQP+1+SG
oficiara-te	oficiar+V.tu.AD.2.SG+PQP+3+SG
oficiara-vos	oficiar+V.vós.AD.2.PL+PQP+1+SG
oficiara-vos	oficiar+V.vós.AD.2.PL+PQP+3+SG
oficiarde-la	oficiar+V.ele.ACC.3.F.SG+INF+2+PL
oficiarde-la	oficiar+V.ele.ACC.3.F.SG+SBJF+2+PL
oficiarde-las	oficiar+V.ele.ACC.3.F.PL+INF+2+PL
oficiarde-las	oficiar+V.ele.ACC.3.F.PL+SBJF+2+PL
oficiarde-lo	oficiar+V.ele.ACC.3.M.SG+INF+2+PL
oficiarde-lo	oficiar+V.ele.ACC.3.M.SG+SBJF+2+PL
oficiarde-los	oficiar+V.ele.ACC.3.M.PL+INF+2+PL
oficiarde-los	oficiar+V.ele.ACC.3.M.PL+SBJF+2+PL
oficiarde-nos	oficiar+nós.AD.1.PL+INF+2+PL
oficiarde-nos	oficiar+nós.AD.1.PL+SBJF+2+PL
oficiardes-lhe	oficiar+V.ele.DAT.3.SG+INF+2+PL
oficiardes-lhe	oficiar+V.ele.DAT.3.SG+SBJF+2+PL
oficiardes-lhes	oficiar+V.ele.DAT.3.PL+INF+2+PL
oficiardes-lhes	oficiar+V.ele.DAT.3.PL+SBJF+2+PL
oficiardes-me	oficiar+V.eu.AD.1.SG+INF+2+PL
oficiardes-me	oficiar+V.eu.AD.1.SG+SBJF+2+PL
oficiardes-te	oficiar+V.tu.AD.2.SG+INF+2+PL
oficiardes-te	oficiar+V.tu.AD.2.SG+SBJF+2+PL
oficiardes-vos	oficiar+V.vós.AD.2.PL+INF+2+PL
oficiardes-vos	oficiar+V.vós.AD.2.PL+SBJF+2+PL
oficiárei-la	oficiar+V.ele.ACC.3.F.SG+PQP+2+PL
oficiárei-las	oficiar+V.ele.ACC.3.F.PL+PQP+2+PL
oficiárei-lo	oficiar+V.ele.ACC.3.M.SG+PQP+2+PL
oficiárei-los	oficiar+V.ele.ACC.3.M.PL+PQP+2+PL
oficiárei-nos	oficiar+nós.AD.1.PL+PQP+2+PL
oficiáreis-lhe	oficiar+V.ele.DAT.3.SG+PQP+2+PL
oficiáreis-lhes	oficiar+V.ele.DAT.3.PL+PQP+2+PL
oficiáreis-me	oficiar+V.eu.AD.1.SG+PQP+2+PL
oficiáreis-te	oficiar+V.tu.AD.2.SG+PQP+2+PL
oficiáreis-vos	oficiar+V.vós.AD.2.PL+PQP+2+PL
oficiare-la	oficiar+V.ele.ACC.3.F.SG+INF+2+SG
oficiare-la	oficiar+V.ele.ACC.3.F.SG+SBJF+2+SG
oficiare-las	oficiar+V.ele.ACC.3.F.PL+INF+2+SG
oficiare-las	oficiar+V.ele.ACC.3.F.PL+SBJF+2+SG
oficiare-lo	oficiar+V.ele.ACC.3.M.SG+INF+2+SG
oficiare-lo	oficiar+V.ele.ACC.3.M.SG+SBJF+2+SG
oficiare-los	oficiar+V.ele.ACC.3.M.PL+INF+2+SG
oficiare-los	oficiar+V.ele.ACC.3.M.PL+SBJF+2+SG
oficiarem-lhe	oficiar+V.ele.DAT.3.SG+INF+3+PL
oficiarem-lhe	oficiar+V.ele.DAT.3.SG+SBJF+3+PL
oficiarem-lhes	oficiar+V.ele.DAT.3.PL+INF+3+PL
oficiarem-lhes	oficiar+V.ele.DAT.3.PL+SBJF+3+PL
oficiarem-me	oficiar+V.eu.AD.1.SG+INF+3+PL
oficiarem-me	oficiar+V.eu.AD.1.SG+SBJF+3+PL
oficiarem-na	oficiar+V.ele.ACC.3.F.SG+INF+3+PL
oficiarem-na	oficiar+V.ele.ACC.3.F.SG+SBJF+3+PL
oficiarem-nas	oficiar+V.ele.ACC.3.F.PL+INF+3+PL
oficiarem-nas	oficiar+V.ele.ACC.3.F.PL+SBJF+3+PL
oficiarem-no	oficiar+V.ele.ACC.3.M.SG+INF+3+PL
oficiarem-no	oficiar+V.ele.ACC.3.M.SG+SBJF+3+PL
oficiarem-nos	oficiar+V.ele.ACC.3.M.PL+INF+3+PL
oficiarem-nos	oficiar+V.ele.ACC.3.M.PL+SBJF+3+PL
oficiarem-nos	oficiar+V.nós.AD.1.PL+INF+3+PL
oficiarem-nos	oficiar+V.nós.AD.1.PL+SBJF+3+PL
oficiarem-se	oficiar+V.ele.REFL+INF+3+PL
oficiarem-se	oficiar+V.ele.REFL+SBJF+3+PL
oficiarem-te	oficiar+V.tu.AD.2.SG+INF+3+PL
oficiarem-te	oficiar+V.tu.AD.2.SG+SBJF+3+PL
oficiarem-vos	oficiar+V.vós.AD.2.PL+INF+3+PL
oficiarem-vos	oficiar+V.vós.AD.2.PL+SBJF+3+PL
oficiare-nos	oficiar+nós.AD.1.PL+INF+2+SG
oficiare-nos	oficiar+nós.AD.1.PL+SBJF+2+SG
oficiares-lhe	oficiar+V.ele.DAT.3.SG+INF+2+SG
oficiares-lhe	oficiar+V.ele.DAT.3.SG+SBJF+2+SG
oficiares-lhes	oficiar+V.ele.DAT.3.PL+INF+2+SG
oficiares-lhes	oficiar+V.ele.DAT.3.PL+SBJF+2+SG
oficiares-me	oficiar+V.eu.AD.1.SG+INF+2+SG
oficiares-me	oficiar+V.eu.AD.1.SG+SBJF+2+SG
oficiares-te	oficiar+V.tu.AD.2.SG+INF+2+SG
oficiares-te	oficiar+V.tu.AD.2.SG+SBJF+2+SG
oficiares-vos	oficiar+V.vós.AD.2.PL+INF+2+SG
oficiares-vos	oficiar+V.vós.AD.2.PL+SBJF+2+SG
oficiar-lhe-á	oficiar+V.ele.DAT.3.SG+FUT+3+SG
oficiar-lhe-ão	oficiar+V.ele.DAT.3.SG+FUT+3+PL
oficiar-lhe-ás	oficiar+V.ele.DAT.3.SG+FUT+2+SG
oficiar-lhe-ei	oficiar+V.ele.DAT.3.SG+FUT+1+SG
oficiar-lhe-eis	oficiar+V.ele.DAT.3.SG+FUT+2+PL
oficiar-lhe-emos	oficiar+V.ele.DAT.3.SG+FUT+1+PL
oficiar-lhe-iam	oficiar+V.ele.DAT.3.SG+COND+3+PL
oficiar-lhe-íamos	oficiar+V.ele.DAT.3.SG+COND+1+PL
oficiar-lhe-ia	oficiar+V.ele.DAT.3.SG+COND+1+SG
oficiar-lhe-ia	oficiar+V.ele.DAT.3.SG+COND+3+SG
oficiar-lhe-ias	oficiar+V.ele.DAT.3.SG+COND+2+SG
oficiar-lhe-íeis	oficiar+V.ele.DAT.3.SG+COND+2+PL
oficiar-lhe	oficiar+V.ele.DAT.3.SG+INF
oficiar-lhe	oficiar+V.ele.DAT.3.SG+INF+1+SG
oficiar-lhe	oficiar+V.ele.DAT.3.SG+INF+3+SG
oficiar-lhe	oficiar+V.ele.DAT.3.SG+SBJF+1+SG
oficiar-lhe	oficiar+V.ele.DAT.3.SG+SBJF+3+SG
oficiar-lhes-á	oficiar+V.ele.DAT.3.PL+FUT+3+SG
oficiar-lhes-ão	oficiar+V.ele.DAT.3.PL+FUT+3+PL
oficiar-lhes-ás	oficiar+V.ele.DAT.3.PL+FUT+2+SG
oficiar-lhes-ei	oficiar+V.ele.DAT.3.PL+FUT+1+SG
oficiar-lhes-eis	oficiar+V.ele.DAT.3.PL+FUT+2+PL
oficiar-lhes-emos	oficiar+V.ele.DAT.3.PL+FUT+1+PL
oficiar-lhes-iam	oficiar+V.ele.DAT.3.PL+COND+3+PL
oficiar-lhes-íamos	oficiar+V.ele.DAT.3.PL+COND+1+PL
