outonear-lhes	outonear+V.ele.DAT.3.PL+INF
outonear-lhes	outonear+V.ele.DAT.3.PL+INF+1+SG
outonear-lhes	outonear+V.ele.DAT.3.PL+INF+3+SG
outonear-lhes	outonear+V.ele.DAT.3.PL+SBJF+1+SG
outonear-lhes	outonear+V.ele.DAT.3.PL+SBJF+3+SG
outonear-me-ão	outonear+V.eu.AD.1.SG+FUT+3+PL
outonear-me-á	outonear+V.eu.AD.1.SG+FUT+3+SG
outonear-me-ás	outonear+V.eu.AD.1.SG+FUT+2+SG
outonear-me-ei	outonear+V.eu.AD.1.SG+FUT+1+SG
outonear-me-eis	outonear+V.eu.AD.1.SG+FUT+2+PL
outonear-me-emos	outonear+V.eu.AD.1.SG+FUT+1+PL
outonear-me-íamos	outonear+V.eu.AD.1.SG+COND+1+PL
outonear-me-iam	outonear+V.eu.AD.1.SG+COND+3+PL
outonear-me-ia	outonear+V.eu.AD.1.SG+COND+1+SG
outonear-me-ia	outonear+V.eu.AD.1.SG+COND+3+SG
outonear-me-ias	outonear+V.eu.AD.1.SG+COND+2+SG
outonear-me-íeis	outonear+V.eu.AD.1.SG+COND+2+PL
outonear-me	outonear+V.eu.AD.1.SG+INF
outonear-me	outonear+V.eu.AD.1.SG+INF+1+SG
outonear-me	outonear+V.eu.AD.1.SG+INF+3+SG
outonear-me	outonear+V.eu.AD.1.SG+SBJF+1+SG
outonear-me	outonear+V.eu.AD.1.SG+SBJF+3+SG
outonearmo-la	outonear+V.ele.ACC.3.F.SG+INF+1+PL
outonearmo-la	outonear+V.ele.ACC.3.F.SG+SBJF+1+PL
outonearmo-las	outonear+V.ele.ACC.3.F.PL+INF+1+PL
outonearmo-las	outonear+V.ele.ACC.3.F.PL+SBJF+1+PL
outonearmo-lo	outonear+V.ele.ACC.3.M.SG+INF+1+PL
outonearmo-lo	outonear+V.ele.ACC.3.M.SG+SBJF+1+PL
outonearmo-los	outonear+V.ele.ACC.3.M.PL+INF+1+PL
outonearmo-los	outonear+V.ele.ACC.3.M.PL+SBJF+1+PL
outonearmo-nos	outonear+nós.AD.1.PL+INF+1+PL
outonearmo-nos	outonear+nós.AD.1.PL+SBJF+1+PL
outonearmos-lhe	outonear+V.ele.DAT.3.SG+INF+1+PL
outonearmos-lhe	outonear+V.ele.DAT.3.SG+SBJF+1+PL
outonearmos-lhes	outonear+V.ele.DAT.3.PL+INF+1+PL
outonearmos-lhes	outonear+V.ele.DAT.3.PL+SBJF+1+PL
outonearmos-me	outonear+V.eu.AD.1.SG+INF+1+PL
outonearmos-me	outonear+V.eu.AD.1.SG+SBJF+1+PL
outonearmos-te	outonear+V.tu.AD.2.SG+INF+1+PL
outonearmos-te	outonear+V.tu.AD.2.SG+SBJF+1+PL
outonearmos-vos	outonear+V.vós.AD.2.PL+INF+1+PL
outonearmos-vos	outonear+V.vós.AD.2.PL+SBJF+1+PL
outonear-nos-ão	outonear+nós.AD.1.PL+FUT+3+PL
outonear-nos-á	outonear+nós.AD.1.PL+FUT+3+SG
outonear-nos-ás	outonear+nós.AD.1.PL+FUT+2+SG
outonear-nos-ei	outonear+nós.AD.1.PL+FUT+1+SG
outonear-nos-eis	outonear+nós.AD.1.PL+FUT+2+PL
outonear-nos-emos	outonear+nós.AD.1.PL+FUT+1+PL
outonear-nos-íamos	outonear+nós.AD.1.PL+COND+1+PL
outonear-nos-iam	outonear+nós.AD.1.PL+COND+3+PL
outonear-nos-ia	outonear+nós.AD.1.PL+COND+1+SG
outonear-nos-ia	outonear+nós.AD.1.PL+COND+3+SG
outonear-nos-ias	outonear+nós.AD.1.PL+COND+2+SG
outonear-nos-íeis	outonear+nós.AD.1.PL+COND+2+PL
outonear-nos	outonear+nós.AD.1.PL+INF
outonear-nos	outonear+nós.AD.1.PL+INF+1+SG
outonear-nos	outonear+nós.AD.1.PL+INF+3+SG
outonear-nos	outonear+nós.AD.1.PL+SBJF+1+SG
outonear-nos	outonear+nós.AD.1.PL+SBJF+3+SG
outonear-se-ão	outonear+V.ele.REFL+FUT+3+PL
outonear-se-á	outonear+V.ele.REFL+FUT+3+SG
outonear-se-iam	outonear+V.ele.REFL+COND+3+PL
outonear-se-ia	outonear+V.ele.REFL+COND+3+SG
outonear-se	outonear+V.ele.REFL+INF
outonear-se	outonear+V.ele.REFL+INF+3+SG
outonear-se	outonear+V.ele.REFL+SBJF+3+SG
outonear-te-ão	outonear+V.tu.AD.2.SG+FUT+3+PL
outonear-te-á	outonear+V.tu.AD.2.SG+FUT+3+SG
outonear-te-ás	outonear+V.tu.AD.2.SG+FUT+2+SG
outonear-te-ei	outonear+V.tu.AD.2.SG+FUT+1+SG
outonear-te-eis	outonear+V.tu.AD.2.SG+FUT+2+PL
outonear-te-emos	outonear+V.tu.AD.2.SG+FUT+1+PL
outonear-te-íamos	outonear+V.tu.AD.2.SG+COND+1+PL
outonear-te-iam	outonear+V.tu.AD.2.SG+COND+3+PL
outonear-te-ia	outonear+V.tu.AD.2.SG+COND+1+SG
outonear-te-ia	outonear+V.tu.AD.2.SG+COND+3+SG
outonear-te-ias	outonear+V.tu.AD.2.SG+COND+2+SG
outonear-te-íeis	outonear+V.tu.AD.2.SG+COND+2+PL
outonear-te	outonear+V.tu.AD.2.SG+INF
outonear-te	outonear+V.tu.AD.2.SG+INF+1+SG
outonear-te	outonear+V.tu.AD.2.SG+INF+3+SG
outonear-te	outonear+V.tu.AD.2.SG+SBJF+1+SG
outonear-te	outonear+V.tu.AD.2.SG+SBJF+3+SG
outonear-vos-ão	outonear+V.vós.AD.2.PL+FUT+3+PL
outonear-vos-á	outonear+V.vós.AD.2.PL+FUT+3+SG
outonear-vos-ás	outonear+V.vós.AD.2.PL+FUT+2+SG
outonear-vos-ei	outonear+V.vós.AD.2.PL+FUT+1+SG
outonear-vos-eis	outonear+V.vós.AD.2.PL+FUT+2+PL
outonear-vos-emos	outonear+V.vós.AD.2.PL+FUT+1+PL
outonear-vos-íamos	outonear+V.vós.AD.2.PL+COND+1+PL
outonear-vos-iam	outonear+V.vós.AD.2.PL+COND+3+PL
outonear-vos-ia	outonear+V.vós.AD.2.PL+COND+1+SG
outonear-vos-ia	outonear+V.vós.AD.2.PL+COND+3+SG
outonear-vos-ias	outonear+V.vós.AD.2.PL+COND+2+SG
outonear-vos-íeis	outonear+V.vós.AD.2.PL+COND+2+PL
outonear-vos	outonear+V.vós.AD.2.PL+INF
outonear-vos	outonear+V.vós.AD.2.PL+INF+1+SG
outonear-vos	outonear+V.vós.AD.2.PL+INF+3+SG
outonear-vos	outonear+V.vós.AD.2.PL+SBJF+1+SG
outonear-vos	outonear+V.vós.AD.2.PL+SBJF+3+SG
outone-as	outonar+V.ele.ACC.3.F.PL+IMP+3+SG
outoneaste-a	outonear+V.ele.ACC.3.F.SG+PRF+2+SG
outoneaste-as	outonear+V.ele.ACC.3.F.PL+PRF+2+SG
outoneaste-la	outonear+V.ele.ACC.3.F.SG+PRF+2+PL
outoneaste-las	outonear+V.ele.ACC.3.F.PL+PRF+2+PL
outoneaste-lhe	outonear+V.ele.DAT.3.SG+PRF+2+SG
outoneaste-lhes	outonear+V.ele.DAT.3.PL+PRF+2+SG
outoneaste-lo	outonear+V.ele.ACC.3.M.SG+PRF+2+PL
outoneaste-los	outonear+V.ele.ACC.3.M.PL+PRF+2+PL
outoneaste-me	outonear+V.eu.AD.1.SG+PRF+2+SG
outoneaste-nos	outonear+nós.AD.1.PL+PRF+2+PL
outoneaste-nos	outonear+nós.AD.1.PL+PRF+2+SG
outoneaste-o	outonear+V.ele.ACC.3.M.SG+PRF+2+SG
outoneaste-os	outonear+V.ele.ACC.3.M.PL+PRF+2+SG
outoneastes-lhe	outonear+V.ele.DAT.3.SG+PRF+2+PL
outoneastes-lhes	outonear+V.ele.DAT.3.PL+PRF+2+PL
outoneastes-me	outonear+V.eu.AD.1.SG+PRF+2+PL
outoneastes-te	outonear+V.tu.AD.2.SG+PRF+2+PL
outoneastes-vos	outonear+V.vós.AD.2.PL+PRF+2+PL
outoneaste-te	outonear+V.tu.AD.2.SG+PRF+2+SG
outoneaste-vos	outonear+V.vós.AD.2.PL+PRF+2+SG
outoneava-a	outonear+V.ele.ACC.3.F.SG+IMPF+1+SG
outoneava-a	outonear+V.ele.ACC.3.F.SG+IMPF+3+SG
outoneava-as	outonear+V.ele.ACC.3.F.PL+IMPF+1+SG
outoneava-as	outonear+V.ele.ACC.3.F.PL+IMPF+3+SG
outoneava-la	outonear+V.ele.ACC.3.F.SG+IMPF+2+SG
outoneava-las	outonear+V.ele.ACC.3.F.PL+IMPF+2+SG
outoneava-lhe	outonear+V.ele.DAT.3.SG+IMPF+1+SG
outoneava-lhe	outonear+V.ele.DAT.3.SG+IMPF+3+SG
outoneava-lhes	outonear+V.ele.DAT.3.PL+IMPF+1+SG
outoneava-lhes	outonear+V.ele.DAT.3.PL+IMPF+3+SG
outoneava-lo	outonear+V.ele.ACC.3.M.SG+IMPF+2+SG
outoneava-los	outonear+V.ele.ACC.3.M.PL+IMPF+2+SG
outoneava-me	outonear+V.eu.AD.1.SG+IMPF+1+SG
outoneava-me	outonear+V.eu.AD.1.SG+IMPF+3+SG
outoneavam-lhe	outonear+V.ele.DAT.3.SG+IMPF+3+PL
outoneavam-lhes	outonear+V.ele.DAT.3.PL+IMPF+3+PL
outoneavam-me	outonear+V.eu.AD.1.SG+IMPF+3+PL
outoneavam-na	outonear+V.ele.ACC.3.F.SG+IMPF+3+PL
outoneavam-nas	outonear+V.ele.ACC.3.F.PL+IMPF+3+PL
outoneavam-no	outonear+V.ele.ACC.3.M.SG+IMPF+3+PL
outoneavam-nos	outonear+V.ele.ACC.3.M.PL+IMPF+3+PL
outoneavam-nos	outonear+V.nós.AD.1.PL+IMPF+3+PL
outoneávamo-la	outonear+V.ele.ACC.3.F.SG+IMPF+1+PL
outoneávamo-las	outonear+V.ele.ACC.3.F.PL+IMPF+1+PL
outoneávamo-lo	outonear+V.ele.ACC.3.M.SG+IMPF+1+PL
outoneávamo-los	outonear+V.ele.ACC.3.M.PL+IMPF+1+PL
outoneávamo-nos	outonear+nós.AD.1.PL+IMPF+1+PL
outoneávamos-lhe	outonear+V.ele.DAT.3.SG+IMPF+1+PL
outoneávamos-lhes	outonear+V.ele.DAT.3.PL+IMPF+1+PL
outoneávamos-me	outonear+V.eu.AD.1.SG+IMPF+1+PL
outoneávamos-te	outonear+V.tu.AD.2.SG+IMPF+1+PL
outoneávamos-vos	outonear+V.vós.AD.2.PL+IMPF+1+PL
outoneavam-se	outonear+V.ele.REFL+IMPF+3+PL
outoneavam-te	outonear+V.tu.AD.2.SG+IMPF+3+PL
outoneavam-vos	outonear+V.vós.AD.2.PL+IMPF+3+PL
outoneava-nos	outonear+nós.AD.1.PL+IMPF+1+SG
outoneava-nos	outonear+nós.AD.1.PL+IMPF+2+SG
outoneava-nos	outonear+nós.AD.1.PL+IMPF+3+SG
outoneava-o	outonear+V.ele.ACC.3.M.SG+IMPF+1+SG
outoneava-o	outonear+V.ele.ACC.3.M.SG+IMPF+3+SG
outoneava-os	outonear+V.ele.ACC.3.M.PL+IMPF+1+SG
outoneava-os	outonear+V.ele.ACC.3.M.PL+IMPF+3+SG
outoneava-se	outonear+V.ele.REFL+IMPF+1+SG
outoneava-se	outonear+V.ele.REFL+IMPF+3+SG
outoneavas-lhe	outonear+V.ele.DAT.3.SG+IMPF+2+SG
outoneavas-lhes	outonear+V.ele.DAT.3.PL+IMPF+2+SG
outoneavas-me	outonear+V.eu.AD.1.SG+IMPF+2+SG
outoneavas-te	outonear+V.tu.AD.2.SG+IMPF+2+SG
outoneavas-vos	outonear+V.vós.AD.2.PL+IMPF+2+SG
outoneava-te	outonear+V.tu.AD.2.SG+IMPF+1+SG
outoneava-te	outonear+V.tu.AD.2.SG+IMPF+3+SG
outoneava-vos	outonear+V.vós.AD.2.PL+IMPF+1+SG
outoneava-vos	outonear+V.vós.AD.2.PL+IMPF+3+SG
outoneávei-la	outonear+V.ele.ACC.3.F.SG+IMPF+2+PL
outoneávei-las	outonear+V.ele.ACC.3.F.PL+IMPF+2+PL
outoneávei-lo	outonear+V.ele.ACC.3.M.SG+IMPF+2+PL
outoneávei-los	outonear+V.ele.ACC.3.M.PL+IMPF+2+PL
outoneávei-nos	outonear+nós.AD.1.PL+IMPF+2+PL
outoneáveis-lhe	outonear+V.ele.DAT.3.SG+IMPF+2+PL
outoneáveis-lhes	outonear+V.ele.DAT.3.PL+IMPF+2+PL
outoneáveis-me	outonear+V.eu.AD.1.SG+IMPF+2+PL
outoneáveis-te	outonear+V.tu.AD.2.SG+IMPF+2+PL
outoneáveis-vos	outonear+V.vós.AD.2.PL+IMPF+2+PL
outoneei-a	outonear+V.ele.ACC.3.F.SG+PRF+1+SG
outoneei-as	outonear+V.ele.ACC.3.F.PL+PRF+1+SG
outoneei-lhe	outonear+V.ele.DAT.3.SG+PRF+1+SG
outoneei-lhes	outonear+V.ele.DAT.3.PL+PRF+1+SG
outoneei-me	outonear+V.eu.AD.1.SG+PRF+1+SG
outoneei-nos	outonear+nós.AD.1.PL+PRF+1+SG
outoneei-o	outonear+V.ele.ACC.3.M.SG+PRF+1+SG
outoneei-os	outonear+V.ele.ACC.3.M.PL+PRF+1+SG
outoneei-te	outonear+V.tu.AD.2.SG+PRF+1+SG
outoneei-vos	outonear+V.vós.AD.2.PL+PRF+1+SG
outoneia-a	outonear+V.ele.ACC.3.F.SG+PRS+3+SG
outoneia-as	outonear+V.ele.ACC.3.F.PL+PRS+3+SG
outoneia-la	outonear+V.ele.ACC.3.F.SG+PRS+2+SG
outoneia-las	outonear+V.ele.ACC.3.F.PL+PRS+2+SG
outoneia-lhe	outonear+V.ele.DAT.3.SG+PRS+3+SG
outoneia-lhes	outonear+V.ele.DAT.3.PL+PRS+3+SG
outoneia-lo	outonear+V.ele.ACC.3.M.SG+PRS+2+SG
outoneia-los	outonear+V.ele.ACC.3.M.PL+PRS+2+SG
outoneia-me	outonear+V.eu.AD.1.SG+PRS+3+SG
outoneiam-lhe	outonear+V.ele.DAT.3.SG+PRS+3+PL
outoneiam-lhes	outonear+V.ele.DAT.3.PL+PRS+3+PL
outoneiam-me	outonear+V.eu.AD.1.SG+PRS+3+PL
outoneiam-na	outonear+V.ele.ACC.3.F.SG+PRS+3+PL
outoneiam-nas	outonear+V.ele.ACC.3.F.PL+PRS+3+PL
outoneiam-no	outonear+V.ele.ACC.3.M.SG+PRS+3+PL
outoneiam-nos	outonear+V.ele.ACC.3.M.PL+PRS+3+PL
outoneiam-nos	outonear+V.nós.AD.1.PL+PRS+3+PL
outoneiam-se	outonear+V.ele.REFL+PRS+3+PL
outoneiam-te	outonear+V.tu.AD.2.SG+PRS+3+PL
outoneiam-vos	outonear+V.vós.AD.2.PL+PRS+3+PL
outoneia-nos	outonear+nós.AD.1.PL+PRS+2+SG
outoneia-nos	outonear+nós.AD.1.PL+PRS+3+SG
outoneia-o	outonear+V.ele.ACC.3.M.SG+PRS+3+SG
outoneia-os	outonear+V.ele.ACC.3.M.PL+PRS+3+SG
outonei-a	outonar+V.ele.ACC.3.F.SG+PRF+1+SG
outoneia-se	outonear+V.ele.REFL+PRS+3+SG
outoneias-lhe	outonear+V.ele.DAT.3.SG+PRS+2+SG
outoneias-lhes	outonear+V.ele.DAT.3.PL+PRS+2+SG
outoneias-me	outonear+V.eu.AD.1.SG+PRS+2+SG
outonei-as	outonar+V.ele.ACC.3.F.PL+PRF+1+SG
outoneias-te	outonear+V.tu.AD.2.SG+PRS+2+SG
outoneias-vos	outonear+V.vós.AD.2.PL+PRS+2+SG
outoneia-te	outonear+V.tu.AD.2.SG+PRS+3+SG
outoneia-vos	outonear+V.vós.AD.2.PL+PRS+3+SG
outonei-lhe	outonar+V.ele.DAT.3.SG+PRF+1+SG
outonei-lhes	outonar+V.ele.DAT.3.PL+PRF+1+SG
outonei-me	outonar+V.eu.AD.1.SG+PRF+1+SG
outonei-nos	outonar+nós.AD.1.PL+PRF+1+SG
outoneio-a	outonear+V.ele.ACC.3.F.SG+PRS+1+SG
outoneio-as	outonear+V.ele.ACC.3.F.PL+PRS+1+SG
outoneio-lhe	outonear+V.ele.DAT.3.SG+PRS+1+SG
outoneio-lhes	outonear+V.ele.DAT.3.PL+PRS+1+SG
outoneio-me	outonear+V.eu.AD.1.SG+PRS+1+SG
outoneio-nos	outonear+nós.AD.1.PL+PRS+1+SG
outoneio-o	outonear+V.ele.ACC.3.M.SG+PRS+1+SG
outoneio-os	outonear+V.ele.ACC.3.M.PL+PRS+1+SG
outonei-o	outonar+V.ele.ACC.3.M.SG+PRF+1+SG
outonei-os	outonar+V.ele.ACC.3.M.PL+PRF+1+SG
outoneio-te	outonear+V.tu.AD.2.SG+PRS+1+SG
outoneio-vos	outonear+V.vós.AD.2.PL+PRS+1+SG
outonei-te	outonar+V.tu.AD.2.SG+PRF+1+SG
outonei-vos	outonar+V.vós.AD.2.PL+PRF+1+SG
outone-lhe	outonar+V.ele.DAT.3.SG+IMP+3+SG
outone-lhes	outonar+V.ele.DAT.3.PL+IMP+3+SG
outone-me	outonar+V.eu.AD.1.SG+IMP+3+SG
outonem-lhe	outonar+V.ele.DAT.3.SG+IMP+3+PL
outonem-lhes	outonar+V.ele.DAT.3.PL+IMP+3+PL
outonem-me	outonar+V.eu.AD.1.SG+IMP+3+PL
outonem-na	outonar+V.ele.ACC.3.F.SG+IMP+3+PL
outonem-nas	outonar+V.ele.ACC.3.F.PL+IMP+3+PL
outonem-no	outonar+V.ele.ACC.3.M.SG+IMP+3+PL
outonem-nos	outonar+V.ele.ACC.3.M.PL+IMP+3+PL
outonem-nos	outonar+V.nós.AD.1.PL+IMP+3+PL
outonemo-la	outonar+V.ele.ACC.3.F.SG+IMP+1+PL
outonemo-las	outonar+V.ele.ACC.3.F.PL+IMP+1+PL
outonemo-lo	outonar+V.ele.ACC.3.M.SG+IMP+1+PL
outonemo-los	outonar+V.ele.ACC.3.M.PL+IMP+1+PL
outonemo-nos	outonar+nós.AD.1.PL+IMP+1+PL
outonemos-lhe	outonar+V.ele.DAT.3.SG+IMP+1+PL
outonemos-lhes	outonar+V.ele.DAT.3.PL+IMP+1+PL
outonemos-me	outonar+V.eu.AD.1.SG+IMP+1+PL
outonemos-te	outonar+V.tu.AD.2.SG+IMP+1+PL
outonemos-vos	outonar+V.vós.AD.2.PL+IMP+1+PL
outonem-se	outonar+V.ele.REFL+IMP+3+PL
outonem-te	outonar+V.tu.AD.2.SG+IMP+3+PL
outonem-vos	outonar+V.vós.AD.2.PL+IMP+3+PL
outone-nos	outonar+nós.AD.1.PL+IMP+3+SG
outone-o	outonar+V.ele.ACC.3.M.SG+IMP+3+SG
outone-os	outonar+V.ele.ACC.3.M.PL+IMP+3+SG
outoneou-a	outonear+V.ele.ACC.3.F.SG+PRF+3+SG
outoneou-as	outonear+V.ele.ACC.3.F.PL+PRF+3+SG
outoneou-lhe	outonear+V.ele.DAT.3.SG+PRF+3+SG
outoneou-lhes	outonear+V.ele.DAT.3.PL+PRF+3+SG
outoneou-me	outonear+V.eu.AD.1.SG+PRF+3+SG
outoneou-nos	outonear+nós.AD.1.PL+PRF+3+SG
outoneou-o	outonear+V.ele.ACC.3.M.SG+PRF+3+SG
outoneou-os	outonear+V.ele.ACC.3.M.PL+PRF+3+SG
outoneou-se	outonear+V.ele.REFL+PRF+3+SG
outoneou-te	outonear+V.tu.AD.2.SG+PRF+3+SG
outoneou-vos	outonear+V.vós.AD.2.PL+PRF+3+SG
outone-se	outonar+V.ele.REFL+IMP+3+SG
outone-te	outonar+V.tu.AD.2.SG+IMP+3+SG
outone-vos	outonar+V.vós.AD.2.PL+IMP+3+SG
outono-a	outonar+V.ele.ACC.3.F.SG+PRS+1+SG
outono-as	outonar+V.ele.ACC.3.F.PL+PRS+1+SG
outono-lhe	outonar+V.ele.DAT.3.SG+PRS+1+SG
outono-lhes	outonar+V.ele.DAT.3.PL+PRS+1+SG
outono-me	outonar+V.eu.AD.1.SG+PRS+1+SG
outono-nos	outonar+nós.AD.1.PL+PRS+1+SG
outono-o	outonar+V.ele.ACC.3.M.SG+PRS+1+SG
outono-os	outonar+V.ele.ACC.3.M.PL+PRS+1+SG
outo-nos	outar+nós.AD.1.PL+PRS+1+SG
outono-te	outonar+V.tu.AD.2.SG+PRS+1+SG
outonou-a	outonar+V.ele.ACC.3.F.SG+PRF+3+SG
outonou-as	outonar+V.ele.ACC.3.F.PL+PRF+3+SG
outonou-lhe	outonar+V.ele.DAT.3.SG+PRF+3+SG
outonou-lhes	outonar+V.ele.DAT.3.PL+PRF+3+SG
outonou-me	outonar+V.eu.AD.1.SG+PRF+3+SG
outonou-nos	outonar+nós.AD.1.PL+PRF+3+SG
outonou-o	outonar+V.ele.ACC.3.M.SG+PRF+3+SG
outonou-os	outonar+V.ele.ACC.3.M.PL+PRF+3+SG
outonou-se	outonar+V.ele.REFL+PRF+3+SG
outonou-te	outonar+V.tu.AD.2.SG+PRF+3+SG
outonou-vos	outonar+V.vós.AD.2.PL+PRF+3+SG
outono-vos	outonar+V.vós.AD.2.PL+PRS+1+SG
outo-o	outar+V.ele.ACC.3.M.SG+PRS+1+SG
outo-os	outar+V.ele.ACC.3.M.PL+PRS+1+SG
outorga-a	outorgar+V.ele.ACC.3.F.SG+PRS+3+SG
outorga-as	outorgar+V.ele.ACC.3.F.PL+PRS+3+SG
outorgai-la	outorgar+V.ele.ACC.3.F.SG+PRS+2+PL
outorgai-las	outorgar+V.ele.ACC.3.F.PL+PRS+2+PL
outorgai-lo	outorgar+V.ele.ACC.3.M.SG+PRS+2+PL
outorgai-los	outorgar+V.ele.ACC.3.M.PL+PRS+2+PL
outorgai-nos	outorgar+nós.AD.1.PL+PRS+2+PL
outorgais-lhe	outorgar+V.ele.DAT.3.SG+PRS+2+PL
outorgais-lhes	outorgar+V.ele.DAT.3.PL+PRS+2+PL
outorgais-me	outorgar+V.eu.AD.1.SG+PRS+2+PL
outorgais-te	outorgar+V.tu.AD.2.SG+PRS+2+PL
outorgais-vos	outorgar+V.vós.AD.2.PL+PRS+2+PL
outorgá-la-ão	outorgar+V.ele.ACC.3.F.SG+FUT+3+PL
outorgá-la-á	outorgar+V.ele.ACC.3.F.SG+FUT+3+SG
outorgá-la-ás	outorgar+V.ele.ACC.3.F.SG+FUT+2+SG
outorgá-la-ei	outorgar+V.ele.ACC.3.F.SG+FUT+1+SG
outorgá-la-eis	outorgar+V.ele.ACC.3.F.SG+FUT+2+PL
outorgá-la-emos	outorgar+V.ele.ACC.3.F.SG+FUT+1+PL
outorgá-la-íamos	outorgar+V.ele.ACC.3.F.SG+COND+1+PL
outorgá-la-iam	outorgar+V.ele.ACC.3.F.SG+COND+3+PL
outorgá-la-ia	outorgar+V.ele.ACC.3.F.SG+COND+1+SG
outorgá-la-ia	outorgar+V.ele.ACC.3.F.SG+COND+3+SG
outorgá-la-ias	outorgar+V.ele.ACC.3.F.SG+COND+2+SG
outorgá-la-íeis	outorgar+V.ele.ACC.3.F.SG+COND+2+PL
outorgá-la	outorgar+V.ele.ACC.3.F.SG+INF+1+SG
outorgá-la	outorgar+V.ele.ACC.3.F.SG+INF+3+SG
outorga-la	outorgar+V.ele.ACC.3.F.SG+PRS+2+SG
outorgá-la	outorgar+V.ele.ACC.3.F.SG+SBJF+1+SG
outorgá-la	outorgar+V.ele.ACC.3.F.SG+SBJF+3+SG
outorgá-las-ão	outorgar+V.ele.ACC.3.F.PL+FUT+3+PL
outorgá-las-á	outorgar+V.ele.ACC.3.F.PL+FUT+3+SG
outorgá-las-ás	outorgar+V.ele.ACC.3.F.PL+FUT+2+SG
outorgá-las-ei	outorgar+V.ele.ACC.3.F.PL+FUT+1+SG
outorgá-las-eis	outorgar+V.ele.ACC.3.F.PL+FUT+2+PL
outorgá-las-emos	outorgar+V.ele.ACC.3.F.PL+FUT+1+PL
outorgá-las-íamos	outorgar+V.ele.ACC.3.F.PL+COND+1+PL
outorgá-las-iam	outorgar+V.ele.ACC.3.F.PL+COND+3+PL
outorgá-las-ia	outorgar+V.ele.ACC.3.F.PL+COND+1+SG
outorgá-las-ia	outorgar+V.ele.ACC.3.F.PL+COND+3+SG
outorgá-las-ias	outorgar+V.ele.ACC.3.F.PL+COND+2+SG
outorgá-las-íeis	outorgar+V.ele.ACC.3.F.PL+COND+2+PL
outorgá-las	outorgar+V.ele.ACC.3.F.PL+INF+1+SG
outorgá-las	outorgar+V.ele.ACC.3.F.PL+INF+3+SG
outorga-las	outorgar+V.ele.ACC.3.F.PL+PRS+2+SG
outorgá-las	outorgar+V.ele.ACC.3.F.PL+SBJF+1+SG
outorgá-las	outorgar+V.ele.ACC.3.F.PL+SBJF+3+SG
outorga-lhe	outorgar+V.ele.DAT.3.SG+PRS+3+SG
outorga-lhes	outorgar+V.ele.DAT.3.PL+PRS+3+SG
outorgá-lo-ão	outorgar+V.ele.ACC.3.M.SG+FUT+3+PL
outorgá-lo-á	outorgar+V.ele.ACC.3.M.SG+FUT+3+SG
outorgá-lo-ás	outorgar+V.ele.ACC.3.M.SG+FUT+2+SG
outorgá-lo-ei	outorgar+V.ele.ACC.3.M.SG+FUT+1+SG
outorgá-lo-eis	outorgar+V.ele.ACC.3.M.SG+FUT+2+PL
outorgá-lo-emos	outorgar+V.ele.ACC.3.M.SG+FUT+1+PL
outorgá-lo-íamos	outorgar+V.ele.ACC.3.M.SG+COND+1+PL
outorgá-lo-iam	outorgar+V.ele.ACC.3.M.SG+COND+3+PL
outorgá-lo-ia	outorgar+V.ele.ACC.3.M.SG+COND+1+SG
outorgá-lo-ia	outorgar+V.ele.ACC.3.M.SG+COND+3+SG
outorgá-lo-ias	outorgar+V.ele.ACC.3.M.SG+COND+2+SG
outorgá-lo-íeis	outorgar+V.ele.ACC.3.M.SG+COND+2+PL
outorgá-lo	outorgar+V.ele.ACC.3.M.SG+INF+1+SG
outorgá-lo	outorgar+V.ele.ACC.3.M.SG+INF+3+SG
outorga-lo	outorgar+V.ele.ACC.3.M.SG+PRS+2+SG
outorgá-lo	outorgar+V.ele.ACC.3.M.SG+SBJF+1+SG
outorgá-lo	outorgar+V.ele.ACC.3.M.SG+SBJF+3+SG
outorgá-los-ão	outorgar+V.ele.ACC.3.M.PL+FUT+3+PL
outorgá-los-á	outorgar+V.ele.ACC.3.M.PL+FUT+3+SG
outorgá-los-ás	outorgar+V.ele.ACC.3.M.PL+FUT+2+SG
outorgá-los-ei	outorgar+V.ele.ACC.3.M.PL+FUT+1+SG
outorgá-los-eis	outorgar+V.ele.ACC.3.M.PL+FUT+2+PL
outorgá-los-emos	outorgar+V.ele.ACC.3.M.PL+FUT+1+PL
outorgá-los-íamos	outorgar+V.ele.ACC.3.M.PL+COND+1+PL
outorgá-los-iam	outorgar+V.ele.ACC.3.M.PL+COND+3+PL
outorgá-los-ia	outorgar+V.ele.ACC.3.M.PL+COND+1+SG
outorgá-los-ia	outorgar+V.ele.ACC.3.M.PL+COND+3+SG
outorgá-los-ias	outorgar+V.ele.ACC.3.M.PL+COND+2+SG
outorgá-los-íeis	outorgar+V.ele.ACC.3.M.PL+COND+2+PL
outorgá-los	outorgar+V.ele.ACC.3.M.PL+INF+1+SG
outorgá-los	outorgar+V.ele.ACC.3.M.PL+INF+3+SG
outorga-los	outorgar+V.ele.ACC.3.M.PL+PRS+2+SG
outorgá-los	outorgar+V.ele.ACC.3.M.PL+SBJF+1+SG
outorgá-los	outorgar+V.ele.ACC.3.M.PL+SBJF+3+SG
outorga-me	outorgar+V.eu.AD.1.SG+PRS+3+SG
outorgam-lhe	outorgar+V.ele.DAT.3.SG+PRS+3+PL
outorgam-lhes	outorgar+V.ele.DAT.3.PL+PRS+3+PL
outorgam-me	outorgar+V.eu.AD.1.SG+PRS+3+PL
outorgam-na	outorgar+V.ele.ACC.3.F.SG+PRS+3+PL
outorgam-nas	outorgar+V.ele.ACC.3.F.PL+PRS+3+PL
outorgam-no	outorgar+V.ele.ACC.3.M.SG+PRS+3+PL
outorgam-nos	outorgar+V.ele.ACC.3.M.PL+PRS+3+PL
outorgam-nos	outorgar+V.nós.AD.1.PL+PRS+3+PL
outorgamo-la	outorgar+V.ele.ACC.3.F.SG+PRF+1+PL
outorgamo-la	outorgar+V.ele.ACC.3.F.SG+PRS+1+PL
outorgamo-las	outorgar+V.ele.ACC.3.F.PL+PRF+1+PL
outorgamo-las	outorgar+V.ele.ACC.3.F.PL+PRS+1+PL
outorgamo-lo	outorgar+V.ele.ACC.3.M.SG+PRF+1+PL
outorgamo-lo	outorgar+V.ele.ACC.3.M.SG+PRS+1+PL
outorgamo-los	outorgar+V.ele.ACC.3.M.PL+PRF+1+PL
outorgamo-los	outorgar+V.ele.ACC.3.M.PL+PRS+1+PL
outorgamo-nos	outorgar+nós.AD.1.PL+PRF+1+PL
outorgamo-nos	outorgar+nós.AD.1.PL+PRS+1+PL
outorgamos-lhe	outorgar+V.ele.DAT.3.SG+PRF+1+PL
outorgamos-lhe	outorgar+V.ele.DAT.3.SG+PRS+1+PL
outorgamos-lhes	outorgar+V.ele.DAT.3.PL+PRF+1+PL
outorgamos-lhes	outorgar+V.ele.DAT.3.PL+PRS+1+PL
outorgamos-me	outorgar+V.eu.AD.1.SG+PRF+1+PL
outorgamos-me	outorgar+V.eu.AD.1.SG+PRS+1+PL
outorgamos-te	outorgar+V.tu.AD.2.SG+PRF+1+PL
outorgamos-te	outorgar+V.tu.AD.2.SG+PRS+1+PL
outorgamos-vos	outorgar+V.vós.AD.2.PL+PRF+1+PL
outorgamos-vos	outorgar+V.vós.AD.2.PL+PRS+1+PL
outorgam-se	outorgar+V.ele.REFL+PRS+3+PL
outorgam-te	outorgar+V.tu.AD.2.SG+PRS+3+PL
outorgam-vos	outorgar+V.vós.AD.2.PL+PRS+3+PL
outorgando-a	outorgar+V.ele.ACC.3.F.SG+GRD
outorgando-as	outorgar+V.ele.ACC.3.F.PL+GRD
outorgando-lhe	outorgar+V.ele.DAT.3.SG+GRD
outorgando-lhes	outorgar+V.ele.DAT.3.PL+GRD
outorgando-me	outorgar+V.eu.AD.1.SG+GRD
outorgando-nos	outorgar+nós.AD.1.PL+GRD
outorgando-o	outorgar+V.ele.ACC.3.M.SG+GRD
outorgando-os	outorgar+V.ele.ACC.3.M.PL+GRD
outorgando-se	outorgar+V.ele.REFL+GRD
outorgando-te	outorgar+V.tu.AD.2.SG+GRD
outorgando-vos	outorgar+V.vós.AD.2.PL+GRD
outorga-nos	outorgar+nós.AD.1.PL+PRS+2+SG
outorga-nos	outorgar+nós.AD.1.PL+PRS+3+SG
outorga-o	outorgar+V.ele.ACC.3.M.SG+PRS+3+SG
outorga-os	outorgar+V.ele.ACC.3.M.PL+PRS+3+SG
outorgara-a	outorgar+V.ele.ACC.3.F.SG+PQP+1+SG
outorgara-a	outorgar+V.ele.ACC.3.F.SG+PQP+3+SG
outorgara-as	outorgar+V.ele.ACC.3.F.PL+PQP+1+SG
outorgara-as	outorgar+V.ele.ACC.3.F.PL+PQP+3+SG
outorgara-la	outorgar+V.ele.ACC.3.F.SG+PQP+2+SG
outorgara-las	outorgar+V.ele.ACC.3.F.PL+PQP+2+SG
outorgara-lhe	outorgar+V.ele.DAT.3.SG+PQP+1+SG
outorgara-lhe	outorgar+V.ele.DAT.3.SG+PQP+3+SG
outorgara-lhes	outorgar+V.ele.DAT.3.PL+PQP+1+SG
outorgara-lhes	outorgar+V.ele.DAT.3.PL+PQP+3+SG
outorgara-lo	outorgar+V.ele.ACC.3.M.SG+PQP+2+SG
outorgara-los	outorgar+V.ele.ACC.3.M.PL+PQP+2+SG
outorgara-me	outorgar+V.eu.AD.1.SG+PQP+1+SG
outorgara-me	outorgar+V.eu.AD.1.SG+PQP+3+SG
outorgaram-lhe	outorgar+V.ele.DAT.3.SG+PQP+3+PL
outorgaram-lhe	outorgar+V.ele.DAT.3.SG+PRF+3+PL
outorgaram-lhes	outorgar+V.ele.DAT.3.PL+PQP+3+PL
outorgaram-lhes	outorgar+V.ele.DAT.3.PL+PRF+3+PL
outorgaram-me	outorgar+V.eu.AD.1.SG+PQP+3+PL
outorgaram-me	outorgar+V.eu.AD.1.SG+PRF+3+PL
outorgaram-na	outorgar+V.ele.ACC.3.F.SG+PQP+3+PL
outorgaram-na	outorgar+V.ele.ACC.3.F.SG+PRF+3+PL
outorgaram-nas	outorgar+V.ele.ACC.3.F.PL+PQP+3+PL
outorgaram-nas	outorgar+V.ele.ACC.3.F.PL+PRF+3+PL
outorgaram-no	outorgar+V.ele.ACC.3.M.SG+PQP+3+PL
outorgaram-no	outorgar+V.ele.ACC.3.M.SG+PRF+3+PL
outorgaram-nos	outorgar+V.ele.ACC.3.M.PL+PQP+3+PL
outorgaram-nos	outorgar+V.ele.ACC.3.M.PL+PRF+3+PL
outorgaram-nos	outorgar+V.nós.AD.1.PL+PQP+3+PL
outorgaram-nos	outorgar+V.nós.AD.1.PL+PRF+3+PL
outorgáramo-la	outorgar+V.ele.ACC.3.F.SG+PQP+1+PL
outorgáramo-las	outorgar+V.ele.ACC.3.F.PL+PQP+1+PL
outorgáramo-lo	outorgar+V.ele.ACC.3.M.SG+PQP+1+PL
outorgáramo-los	outorgar+V.ele.ACC.3.M.PL+PQP+1+PL
outorgáramo-nos	outorgar+nós.AD.1.PL+PQP+1+PL
outorgáramos-lhe	outorgar+V.ele.DAT.3.SG+PQP+1+PL
outorgáramos-lhes	outorgar+V.ele.DAT.3.PL+PQP+1+PL
outorgáramos-me	outorgar+V.eu.AD.1.SG+PQP+1+PL
outorgáramos-te	outorgar+V.tu.AD.2.SG+PQP+1+PL
outorgáramos-vos	outorgar+V.vós.AD.2.PL+PQP+1+PL
outorgaram-se	outorgar+V.ele.REFL+PQP+3+PL
outorgaram-se	outorgar+V.ele.REFL+PRF+3+PL
outorgaram-te	outorgar+V.tu.AD.2.SG+PQP+3+PL
outorgaram-te	outorgar+V.tu.AD.2.SG+PRF+3+PL
outorgaram-vos	outorgar+V.vós.AD.2.PL+PQP+3+PL
outorgaram-vos	outorgar+V.vós.AD.2.PL+PRF+3+PL
outorgara-nos	outorgar+nós.AD.1.PL+PQP+1+SG
outorgara-nos	outorgar+nós.AD.1.PL+PQP+2+SG
outorgara-nos	outorgar+nós.AD.1.PL+PQP+3+SG
outorgara-o	outorgar+V.ele.ACC.3.M.SG+PQP+1+SG
outorgara-o	outorgar+V.ele.ACC.3.M.SG+PQP+3+SG
outorgara-os	outorgar+V.ele.ACC.3.M.PL+PQP+1+SG
outorgara-os	outorgar+V.ele.ACC.3.M.PL+PQP+3+SG
outorgara-se	outorgar+V.ele.REFL+PQP+1+SG
outorgara-se	outorgar+V.ele.REFL+PQP+3+SG
outorgaras-lhe	outorgar+V.ele.DAT.3.SG+PQP+2+SG
outorgaras-lhes	outorgar+V.ele.DAT.3.PL+PQP+2+SG
outorgaras-me	outorgar+V.eu.AD.1.SG+PQP+2+SG
outorgaras-te	outorgar+V.tu.AD.2.SG+PQP+2+SG
outorgaras-vos	outorgar+V.vós.AD.2.PL+PQP+2+SG
outorgara-te	outorgar+V.tu.AD.2.SG+PQP+1+SG
outorgara-te	outorgar+V.tu.AD.2.SG+PQP+3+SG
outorgara-vos	outorgar+V.vós.AD.2.PL+PQP+1+SG
outorgara-vos	outorgar+V.vós.AD.2.PL+PQP+3+SG
outorgarde-la	outorgar+V.ele.ACC.3.F.SG+INF+2+PL
outorgarde-la	outorgar+V.ele.ACC.3.F.SG+SBJF+2+PL
outorgarde-las	outorgar+V.ele.ACC.3.F.PL+INF+2+PL
outorgarde-las	outorgar+V.ele.ACC.3.F.PL+SBJF+2+PL
outorgarde-lo	outorgar+V.ele.ACC.3.M.SG+INF+2+PL
outorgarde-lo	outorgar+V.ele.ACC.3.M.SG+SBJF+2+PL
outorgarde-los	outorgar+V.ele.ACC.3.M.PL+INF+2+PL
outorgarde-los	outorgar+V.ele.ACC.3.M.PL+SBJF+2+PL
outorgarde-nos	outorgar+nós.AD.1.PL+INF+2+PL
outorgarde-nos	outorgar+nós.AD.1.PL+SBJF+2+PL
outorgardes-lhe	outorgar+V.ele.DAT.3.SG+INF+2+PL
outorgardes-lhe	outorgar+V.ele.DAT.3.SG+SBJF+2+PL
outorgardes-lhes	outorgar+V.ele.DAT.3.PL+INF+2+PL
outorgardes-lhes	outorgar+V.ele.DAT.3.PL+SBJF+2+PL
outorgardes-me	outorgar+V.eu.AD.1.SG+INF+2+PL
outorgardes-me	outorgar+V.eu.AD.1.SG+SBJF+2+PL
outorgardes-te	outorgar+V.tu.AD.2.SG+INF+2+PL
outorgardes-te	outorgar+V.tu.AD.2.SG+SBJF+2+PL
outorgardes-vos	outorgar+V.vós.AD.2.PL+INF+2+PL
outorgardes-vos	outorgar+V.vós.AD.2.PL+SBJF+2+PL
outorgárei-la	outorgar+V.ele.ACC.3.F.SG+PQP+2+PL
outorgárei-las	outorgar+V.ele.ACC.3.F.PL+PQP+2+PL
outorgárei-lo	outorgar+V.ele.ACC.3.M.SG+PQP+2+PL
outorgárei-los	outorgar+V.ele.ACC.3.M.PL+PQP+2+PL
outorgárei-nos	outorgar+nós.AD.1.PL+PQP+2+PL
outorgáreis-lhe	outorgar+V.ele.DAT.3.SG+PQP+2+PL
outorgáreis-lhes	outorgar+V.ele.DAT.3.PL+PQP+2+PL
outorgáreis-me	outorgar+V.eu.AD.1.SG+PQP+2+PL
outorgáreis-te	outorgar+V.tu.AD.2.SG+PQP+2+PL
outorgáreis-vos	outorgar+V.vós.AD.2.PL+PQP+2+PL
outorgare-la	outorgar+V.ele.ACC.3.F.SG+INF+2+SG
outorgare-la	outorgar+V.ele.ACC.3.F.SG+SBJF+2+SG
outorgare-las	outorgar+V.ele.ACC.3.F.PL+INF+2+SG
outorgare-las	outorgar+V.ele.ACC.3.F.PL+SBJF+2+SG
outorgare-lo	outorgar+V.ele.ACC.3.M.SG+INF+2+SG
outorgare-lo	outorgar+V.ele.ACC.3.M.SG+SBJF+2+SG
outorgare-los	outorgar+V.ele.ACC.3.M.PL+INF+2+SG
outorgare-los	outorgar+V.ele.ACC.3.M.PL+SBJF+2+SG
outorgarem-lhe	outorgar+V.ele.DAT.3.SG+INF+3+PL
outorgarem-lhe	outorgar+V.ele.DAT.3.SG+SBJF+3+PL
outorgarem-lhes	outorgar+V.ele.DAT.3.PL+INF+3+PL
outorgarem-lhes	outorgar+V.ele.DAT.3.PL+SBJF+3+PL
outorgarem-me	outorgar+V.eu.AD.1.SG+INF+3+PL
outorgarem-me	outorgar+V.eu.AD.1.SG+SBJF+3+PL
outorgarem-na	outorgar+V.ele.ACC.3.F.SG+INF+3+PL
outorgarem-na	outorgar+V.ele.ACC.3.F.SG+SBJF+3+PL
outorgarem-nas	outorgar+V.ele.ACC.3.F.PL+INF+3+PL
outorgarem-nas	outorgar+V.ele.ACC.3.F.PL+SBJF+3+PL
outorgarem-no	outorgar+V.ele.ACC.3.M.SG+INF+3+PL
outorgarem-no	outorgar+V.ele.ACC.3.M.SG+SBJF+3+PL
outorgarem-nos	outorgar+V.ele.ACC.3.M.PL+INF+3+PL
outorgarem-nos	outorgar+V.ele.ACC.3.M.PL+SBJF+3+PL
outorgarem-nos	outorgar+V.nós.AD.1.PL+INF+3+PL
outorgarem-nos	outorgar+V.nós.AD.1.PL+SBJF+3+PL
outorgarem-se	outorgar+V.ele.REFL+INF+3+PL
outorgarem-se	outorgar+V.ele.REFL+SBJF+3+PL
outorgarem-te	outorgar+V.tu.AD.2.SG+INF+3+PL
outorgarem-te	outorgar+V.tu.AD.2.SG+SBJF+3+PL
outorgarem-vos	outorgar+V.vós.AD.2.PL+INF+3+PL
outorgarem-vos	outorgar+V.vós.AD.2.PL+SBJF+3+PL
outorgare-nos	outorgar+nós.AD.1.PL+INF+2+SG
outorgare-nos	outorgar+nós.AD.1.PL+SBJF+2+SG
outorgares-lhe	outorgar+V.ele.DAT.3.SG+INF+2+SG
outorgares-lhe	outorgar+V.ele.DAT.3.SG+SBJF+2+SG
outorgares-lhes	outorgar+V.ele.DAT.3.PL+INF+2+SG
outorgares-lhes	outorgar+V.ele.DAT.3.PL+SBJF+2+SG
outorgares-me	outorgar+V.eu.AD.1.SG+INF+2+SG
outorgares-me	outorgar+V.eu.AD.1.SG+SBJF+2+SG
outorgares-te	outorgar+V.tu.AD.2.SG+INF+2+SG
outorgares-te	outorgar+V.tu.AD.2.SG+SBJF+2+SG
outorgares-vos	outorgar+V.vós.AD.2.PL+INF+2+SG
outorgares-vos	outorgar+V.vós.AD.2.PL+SBJF+2+SG
outorgar-lhe-ão	outorgar+V.ele.DAT.3.SG+FUT+3+PL
outorgar-lhe-á	outorgar+V.ele.DAT.3.SG+FUT+3+SG
outorgar-lhe-ás	outorgar+V.ele.DAT.3.SG+FUT+2+SG
outorgar-lhe-ei	outorgar+V.ele.DAT.3.SG+FUT+1+SG
outorgar-lhe-eis	outorgar+V.ele.DAT.3.SG+FUT+2+PL
outorgar-lhe-emos	outorgar+V.ele.DAT.3.SG+FUT+1+PL
outorgar-lhe-íamos	outorgar+V.ele.DAT.3.SG+COND+1+PL
outorgar-lhe-iam	outorgar+V.ele.DAT.3.SG+COND+3+PL
outorgar-lhe-ia	outorgar+V.ele.DAT.3.SG+COND+1+SG
outorgar-lhe-ia	outorgar+V.ele.DAT.3.SG+COND+3+SG
outorgar-lhe-ias	outorgar+V.ele.DAT.3.SG+COND+2+SG
outorgar-lhe-íeis	outorgar+V.ele.DAT.3.SG+COND+2+PL
outorgar-lhe	outorgar+V.ele.DAT.3.SG+INF
outorgar-lhe	outorgar+V.ele.DAT.3.SG+INF+1+SG
outorgar-lhe	outorgar+V.ele.DAT.3.SG+INF+3+SG
outorgar-lhe	outorgar+V.ele.DAT.3.SG+SBJF+1+SG
outorgar-lhe	outorgar+V.ele.DAT.3.SG+SBJF+3+SG
outorgar-lhes-ão	outorgar+V.ele.DAT.3.PL+FUT+3+PL
outorgar-lhes-á	outorgar+V.ele.DAT.3.PL+FUT+3+SG
outorgar-lhes-ás	outorgar+V.ele.DAT.3.PL+FUT+2+SG
outorgar-lhes-ei	outorgar+V.ele.DAT.3.PL+FUT+1+SG
outorgar-lhes-eis	outorgar+V.ele.DAT.3.PL+FUT+2+PL
outorgar-lhes-emos	outorgar+V.ele.DAT.3.PL+FUT+1+PL
outorgar-lhes-íamos	outorgar+V.ele.DAT.3.PL+COND+1+PL
outorgar-lhes-iam	outorgar+V.ele.DAT.3.PL+COND+3+PL
outorgar-lhes-ia	outorgar+V.ele.DAT.3.PL+COND+1+SG
outorgar-lhes-ia	outorgar+V.ele.DAT.3.PL+COND+3+SG
outorgar-lhes-ias	outorgar+V.ele.DAT.3.PL+COND+2+SG
outorgar-lhes-íeis	outorgar+V.ele.DAT.3.PL+COND+2+PL
outorgar-lhes	outorgar+V.ele.DAT.3.PL+INF
outorgar-lhes	outorgar+V.ele.DAT.3.PL+INF+1+SG
outorgar-lhes	outorgar+V.ele.DAT.3.PL+INF+3+SG
outorgar-lhes	outorgar+V.ele.DAT.3.PL+SBJF+1+SG
outorgar-lhes	outorgar+V.ele.DAT.3.PL+SBJF+3+SG
outorgar-me-ão	outorgar+V.eu.AD.1.SG+FUT+3+PL
outorgar-me-á	outorgar+V.eu.AD.1.SG+FUT+3+SG
outorgar-me-ás	outorgar+V.eu.AD.1.SG+FUT+2+SG
outorgar-me-ei	outorgar+V.eu.AD.1.SG+FUT+1+SG
outorgar-me-eis	outorgar+V.eu.AD.1.SG+FUT+2+PL
outorgar-me-emos	outorgar+V.eu.AD.1.SG+FUT+1+PL
outorgar-me-íamos	outorgar+V.eu.AD.1.SG+COND+1+PL
outorgar-me-iam	outorgar+V.eu.AD.1.SG+COND+3+PL
outorgar-me-ia	outorgar+V.eu.AD.1.SG+COND+1+SG
outorgar-me-ia	outorgar+V.eu.AD.1.SG+COND+3+SG
outorgar-me-ias	outorgar+V.eu.AD.1.SG+COND+2+SG
outorgar-me-íeis	outorgar+V.eu.AD.1.SG+COND+2+PL
outorgar-me	outorgar+V.eu.AD.1.SG+INF
outorgar-me	outorgar+V.eu.AD.1.SG+INF+1+SG
outorgar-me	outorgar+V.eu.AD.1.SG+INF+3+SG
outorgar-me	outorgar+V.eu.AD.1.SG+SBJF+1+SG
outorgar-me	outorgar+V.eu.AD.1.SG+SBJF+3+SG
outorgarmo-la	outorgar+V.ele.ACC.3.F.SG+INF+1+PL
outorgarmo-la	outorgar+V.ele.ACC.3.F.SG+SBJF+1+PL
outorgarmo-las	outorgar+V.ele.ACC.3.F.PL+INF+1+PL
outorgarmo-las	outorgar+V.ele.ACC.3.F.PL+SBJF+1+PL
outorgarmo-lo	outorgar+V.ele.ACC.3.M.SG+INF+1+PL
outorgarmo-lo	outorgar+V.ele.ACC.3.M.SG+SBJF+1+PL
outorgarmo-los	outorgar+V.ele.ACC.3.M.PL+INF+1+PL
outorgarmo-los	outorgar+V.ele.ACC.3.M.PL+SBJF+1+PL
outorgarmo-nos	outorgar+nós.AD.1.PL+INF+1+PL
outorgarmo-nos	outorgar+nós.AD.1.PL+SBJF+1+PL
outorgarmos-lhe	outorgar+V.ele.DAT.3.SG+INF+1+PL
outorgarmos-lhe	outorgar+V.ele.DAT.3.SG+SBJF+1+PL
outorgarmos-lhes	outorgar+V.ele.DAT.3.PL+INF+1+PL
outorgarmos-lhes	outorgar+V.ele.DAT.3.PL+SBJF+1+PL
outorgarmos-me	outorgar+V.eu.AD.1.SG+INF+1+PL
outorgarmos-me	outorgar+V.eu.AD.1.SG+SBJF+1+PL
outorgarmos-te	outorgar+V.tu.AD.2.SG+INF+1+PL
outorgarmos-te	outorgar+V.tu.AD.2.SG+SBJF+1+PL
outorgarmos-vos	outorgar+V.vós.AD.2.PL+INF+1+PL
outorgarmos-vos	outorgar+V.vós.AD.2.PL+SBJF+1+PL
outorgar-nos-ão	outorgar+nós.AD.1.PL+FUT+3+PL
outorgar-nos-á	outorgar+nós.AD.1.PL+FUT+3+SG
outorgar-nos-ás	outorgar+nós.AD.1.PL+FUT+2+SG
outorgar-nos-ei	outorgar+nós.AD.1.PL+FUT+1+SG
outorgar-nos-eis	outorgar+nós.AD.1.PL+FUT+2+PL
outorgar-nos-emos	outorgar+nós.AD.1.PL+FUT+1+PL
outorgar-nos-íamos	outorgar+nós.AD.1.PL+COND+1+PL
outorgar-nos-iam	outorgar+nós.AD.1.PL+COND+3+PL
outorgar-nos-ia	outorgar+nós.AD.1.PL+COND+1+SG
outorgar-nos-ia	outorgar+nós.AD.1.PL+COND+3+SG
outorgar-nos-ias	outorgar+nós.AD.1.PL+COND+2+SG
outorgar-nos-íeis	outorgar+nós.AD.1.PL+COND+2+PL
outorgar-nos	outorgar+nós.AD.1.PL+INF
outorgar-nos	outorgar+nós.AD.1.PL+INF+1+SG
outorgar-nos	outorgar+nós.AD.1.PL+INF+3+SG
outorgar-nos	outorgar+nós.AD.1.PL+SBJF+1+SG
outorgar-nos	outorgar+nós.AD.1.PL+SBJF+3+SG
outorgar-se-ão	outorgar+V.ele.REFL+FUT+3+PL
outorgar-se-á	outorgar+V.ele.REFL+FUT+3+SG
outorgar-se-iam	outorgar+V.ele.REFL+COND+3+PL
outorgar-se-ia	outorgar+V.ele.REFL+COND+3+SG
outorgar-se	outorgar+V.ele.REFL+INF
outorgar-se	outorgar+V.ele.REFL+INF+3+SG
outorgar-se	outorgar+V.ele.REFL+SBJF+3+SG
outorgar-te-ão	outorgar+V.tu.AD.2.SG+FUT+3+PL
outorgar-te-á	outorgar+V.tu.AD.2.SG+FUT+3+SG
outorgar-te-ás	outorgar+V.tu.AD.2.SG+FUT+2+SG
outorgar-te-ei	outorgar+V.tu.AD.2.SG+FUT+1+SG
outorgar-te-eis	outorgar+V.tu.AD.2.SG+FUT+2+PL
outorgar-te-emos	outorgar+V.tu.AD.2.SG+FUT+1+PL
outorgar-te-íamos	outorgar+V.tu.AD.2.SG+COND+1+PL
outorgar-te-iam	outorgar+V.tu.AD.2.SG+COND+3+PL
outorgar-te-ia	outorgar+V.tu.AD.2.SG+COND+1+SG
outorgar-te-ia	outorgar+V.tu.AD.2.SG+COND+3+SG
outorgar-te-ias	outorgar+V.tu.AD.2.SG+COND+2+SG
outorgar-te-íeis	outorgar+V.tu.AD.2.SG+COND+2+PL
outorgar-te	outorgar+V.tu.AD.2.SG+INF
outorgar-te	outorgar+V.tu.AD.2.SG+INF+1+SG
outorgar-te	outorgar+V.tu.AD.2.SG+INF+3+SG
outorgar-te	outorgar+V.tu.AD.2.SG+SBJF+1+SG
outorgar-te	outorgar+V.tu.AD.2.SG+SBJF+3+SG
outorgar-vos-ão	outorgar+V.vós.AD.2.PL+FUT+3+PL
outorgar-vos-á	outorgar+V.vós.AD.2.PL+FUT+3+SG
outorgar-vos-ás	outorgar+V.vós.AD.2.PL+FUT+2+SG
outorgar-vos-ei	outorgar+V.vós.AD.2.PL+FUT+1+SG
outorgar-vos-eis	outorgar+V.vós.AD.2.PL+FUT+2+PL
outorgar-vos-emos	outorgar+V.vós.AD.2.PL+FUT+1+PL
outorgar-vos-íamos	outorgar+V.vós.AD.2.PL+COND+1+PL
outorgar-vos-iam	outorgar+V.vós.AD.2.PL+COND+3+PL
outorgar-vos-ia	outorgar+V.vós.AD.2.PL+COND+1+SG
outorgar-vos-ia	outorgar+V.vós.AD.2.PL+COND+3+SG
outorgar-vos-ias	outorgar+V.vós.AD.2.PL+COND+2+SG
outorgar-vos-íeis	outorgar+V.vós.AD.2.PL+COND+2+PL
outorgar-vos	outorgar+V.vós.AD.2.PL+INF
outorgar-vos	outorgar+V.vós.AD.2.PL+INF+1+SG
outorgar-vos	outorgar+V.vós.AD.2.PL+INF+3+SG
outorgar-vos	outorgar+V.vós.AD.2.PL+SBJF+1+SG
outorgar-vos	outorgar+V.vós.AD.2.PL+SBJF+3+SG
outorga-se	outorgar+V.ele.REFL+PRS+3+SG
outorgas-lhe	outorgar+V.ele.DAT.3.SG+PRS+2+SG
outorgas-lhes	outorgar+V.ele.DAT.3.PL+PRS+2+SG
outorgas-me	outorgar+V.eu.AD.1.SG+PRS+2+SG
outorgaste-a	outorgar+V.ele.ACC.3.F.SG+PRF+2+SG
outorgaste-as	outorgar+V.ele.ACC.3.F.PL+PRF+2+SG
outorgaste-la	outorgar+V.ele.ACC.3.F.SG+PRF+2+PL
outorgaste-las	outorgar+V.ele.ACC.3.F.PL+PRF+2+PL
outorgaste-lhe	outorgar+V.ele.DAT.3.SG+PRF+2+SG
outorgaste-lhes	outorgar+V.ele.DAT.3.PL+PRF+2+SG
outorgaste-lo	outorgar+V.ele.ACC.3.M.SG+PRF+2+PL
outorgaste-los	outorgar+V.ele.ACC.3.M.PL+PRF+2+PL
outorgaste-me	outorgar+V.eu.AD.1.SG+PRF+2+SG
outorgaste-nos	outorgar+nós.AD.1.PL+PRF+2+PL
outorgaste-nos	outorgar+nós.AD.1.PL+PRF+2+SG
outorgaste-o	outorgar+V.ele.ACC.3.M.SG+PRF+2+SG
outorgaste-os	outorgar+V.ele.ACC.3.M.PL+PRF+2+SG
outorgas-te	outorgar+V.tu.AD.2.SG+PRS+2+SG
outorgastes-lhe	outorgar+V.ele.DAT.3.SG+PRF+2+PL
outorgastes-lhes	outorgar+V.ele.DAT.3.PL+PRF+2+PL
outorgastes-me	outorgar+V.eu.AD.1.SG+PRF+2+PL
outorgastes-te	outorgar+V.tu.AD.2.SG+PRF+2+PL
outorgastes-vos	outorgar+V.vós.AD.2.PL+PRF+2+PL
outorgaste-te	outorgar+V.tu.AD.2.SG+PRF+2+SG
outorgaste-vos	outorgar+V.vós.AD.2.PL+PRF+2+SG
outorgas-vos	outorgar+V.vós.AD.2.PL+PRS+2+SG
outorga-te	outorgar+V.tu.AD.2.SG+PRS+3+SG
outorgava-a	outorgar+V.ele.ACC.3.F.SG+IMPF+1+SG
outorgava-a	outorgar+V.ele.ACC.3.F.SG+IMPF+3+SG
outorgava-as	outorgar+V.ele.ACC.3.F.PL+IMPF+1+SG
outorgava-as	outorgar+V.ele.ACC.3.F.PL+IMPF+3+SG
outorgava-la	outorgar+V.ele.ACC.3.F.SG+IMPF+2+SG
outorgava-las	outorgar+V.ele.ACC.3.F.PL+IMPF+2+SG
outorgava-lhe	outorgar+V.ele.DAT.3.SG+IMPF+1+SG
outorgava-lhe	outorgar+V.ele.DAT.3.SG+IMPF+3+SG
outorgava-lhes	outorgar+V.ele.DAT.3.PL+IMPF+1+SG
outorgava-lhes	outorgar+V.ele.DAT.3.PL+IMPF+3+SG
outorgava-lo	outorgar+V.ele.ACC.3.M.SG+IMPF+2+SG
outorgava-los	outorgar+V.ele.ACC.3.M.PL+IMPF+2+SG
outorgava-me	outorgar+V.eu.AD.1.SG+IMPF+1+SG
outorgava-me	outorgar+V.eu.AD.1.SG+IMPF+3+SG
outorgavam-lhe	outorgar+V.ele.DAT.3.SG+IMPF+3+PL
outorgavam-lhes	outorgar+V.ele.DAT.3.PL+IMPF+3+PL
outorgavam-me	outorgar+V.eu.AD.1.SG+IMPF+3+PL
outorgavam-na	outorgar+V.ele.ACC.3.F.SG+IMPF+3+PL
outorgavam-nas	outorgar+V.ele.ACC.3.F.PL+IMPF+3+PL
outorgavam-no	outorgar+V.ele.ACC.3.M.SG+IMPF+3+PL
outorgavam-nos	outorgar+V.ele.ACC.3.M.PL+IMPF+3+PL
outorgavam-nos	outorgar+V.nós.AD.1.PL+IMPF+3+PL
outorgávamo-la	outorgar+V.ele.ACC.3.F.SG+IMPF+1+PL
outorgávamo-las	outorgar+V.ele.ACC.3.F.PL+IMPF+1+PL
outorgávamo-lo	outorgar+V.ele.ACC.3.M.SG+IMPF+1+PL
outorgávamo-los	outorgar+V.ele.ACC.3.M.PL+IMPF+1+PL
outorgávamo-nos	outorgar+nós.AD.1.PL+IMPF+1+PL
outorgávamos-lhe	outorgar+V.ele.DAT.3.SG+IMPF+1+PL
outorgávamos-lhes	outorgar+V.ele.DAT.3.PL+IMPF+1+PL
outorgávamos-me	outorgar+V.eu.AD.1.SG+IMPF+1+PL
outorgávamos-te	outorgar+V.tu.AD.2.SG+IMPF+1+PL
outorgávamos-vos	outorgar+V.vós.AD.2.PL+IMPF+1+PL
outorgavam-se	outorgar+V.ele.REFL+IMPF+3+PL
outorgavam-te	outorgar+V.tu.AD.2.SG+IMPF+3+PL
outorgavam-vos	outorgar+V.vós.AD.2.PL+IMPF+3+PL
outorgava-nos	outorgar+nós.AD.1.PL+IMPF+1+SG
outorgava-nos	outorgar+nós.AD.1.PL+IMPF+2+SG
outorgava-nos	outorgar+nós.AD.1.PL+IMPF+3+SG
outorgava-o	outorgar+V.ele.ACC.3.M.SG+IMPF+1+SG
outorgava-o	outorgar+V.ele.ACC.3.M.SG+IMPF+3+SG
outorgava-os	outorgar+V.ele.ACC.3.M.PL+IMPF+1+SG
outorgava-os	outorgar+V.ele.ACC.3.M.PL+IMPF+3+SG
outorgava-se	outorgar+V.ele.REFL+IMPF+1+SG
outorgava-se	outorgar+V.ele.REFL+IMPF+3+SG
outorgavas-lhe	outorgar+V.ele.DAT.3.SG+IMPF+2+SG
outorgavas-lhes	outorgar+V.ele.DAT.3.PL+IMPF+2+SG
outorgavas-me	outorgar+V.eu.AD.1.SG+IMPF+2+SG
outorgavas-te	outorgar+V.tu.AD.2.SG+IMPF+2+SG
outorgavas-vos	outorgar+V.vós.AD.2.PL+IMPF+2+SG
outorgava-te	outorgar+V.tu.AD.2.SG+IMPF+1+SG
outorgava-te	outorgar+V.tu.AD.2.SG+IMPF+3+SG
outorgava-vos	outorgar+V.vós.AD.2.PL+IMPF+1+SG
outorgava-vos	outorgar+V.vós.AD.2.PL+IMPF+3+SG
outorgávei-la	outorgar+V.ele.ACC.3.F.SG+IMPF+2+PL
outorgávei-las	outorgar+V.ele.ACC.3.F.PL+IMPF+2+PL
outorgávei-lo	outorgar+V.ele.ACC.3.M.SG+IMPF+2+PL
outorgávei-los	outorgar+V.ele.ACC.3.M.PL+IMPF+2+PL
outorgávei-nos	outorgar+nós.AD.1.PL+IMPF+2+PL
outorgáveis-lhe	outorgar+V.ele.DAT.3.SG+IMPF+2+PL
outorgáveis-lhes	outorgar+V.ele.DAT.3.PL+IMPF+2+PL
outorgáveis-me	outorgar+V.eu.AD.1.SG+IMPF+2+PL
outorgáveis-te	outorgar+V.tu.AD.2.SG+IMPF+2+PL
outorgáveis-vos	outorgar+V.vós.AD.2.PL+IMPF+2+PL
outorga-vos	outorgar+V.vós.AD.2.PL+PRS+3+SG
outorgo-a	outorgar+V.ele.ACC.3.F.SG+PRS+1+SG
outorgo-as	outorgar+V.ele.ACC.3.F.PL+PRS+1+SG
outorgo-lhe	outorgar+V.ele.DAT.3.SG+PRS+1+SG
outorgo-lhes	outorgar+V.ele.DAT.3.PL+PRS+1+SG
outorgo-me	outorgar+V.eu.AD.1.SG+PRS+1+SG
outorgo-nos	outorgar+nós.AD.1.PL+PRS+1+SG
outorgo-o	outorgar+V.ele.ACC.3.M.SG+PRS+1+SG
outorgo-os	outorgar+V.ele.ACC.3.M.PL+PRS+1+SG
outorgo-te	outorgar+V.tu.AD.2.SG+PRS+1+SG
outorgou-a	outorgar+V.ele.ACC.3.F.SG+PRF+3+SG
outorgou-as	outorgar+V.ele.ACC.3.F.PL+PRF+3+SG
outorgou-lhe	outorgar+V.ele.DAT.3.SG+PRF+3+SG
outorgou-lhes	outorgar+V.ele.DAT.3.PL+PRF+3+SG
outorgou-me	outorgar+V.eu.AD.1.SG+PRF+3+SG
outorgou-nos	outorgar+nós.AD.1.PL+PRF+3+SG
outorgou-o	outorgar+V.ele.ACC.3.M.SG+PRF+3+SG
outorgou-os	outorgar+V.ele.ACC.3.M.PL+PRF+3+SG
outorgou-se	outorgar+V.ele.REFL+PRF+3+SG
outorgou-te	outorgar+V.tu.AD.2.SG+PRF+3+SG
outorgou-vos	outorgar+V.vós.AD.2.PL+PRF+3+SG
outorgo-vos	outorgar+V.vós.AD.2.PL+PRS+1+SG
outorgue-a	outorgar+V.ele.ACC.3.F.SG+IMP+3+SG
outorgue-as	outorgar+V.ele.ACC.3.F.PL+IMP+3+SG
outorguei-a	outorgar+V.ele.ACC.3.F.SG+PRF+1+SG
outorguei-as	outorgar+V.ele.ACC.3.F.PL+PRF+1+SG
outorguei-lhe	outorgar+V.ele.DAT.3.SG+PRF+1+SG
outorguei-lhes	outorgar+V.ele.DAT.3.PL+PRF+1+SG
outorguei-me	outorgar+V.eu.AD.1.SG+PRF+1+SG
outorguei-nos	outorgar+nós.AD.1.PL+PRF+1+SG
outorguei-o	outorgar+V.ele.ACC.3.M.SG+PRF+1+SG
outorguei-os	outorgar+V.ele.ACC.3.M.PL+PRF+1+SG
outorguei-te	outorgar+V.tu.AD.2.SG+PRF+1+SG
outorguei-vos	outorgar+V.vós.AD.2.PL+PRF+1+SG
outorgue-lhe	outorgar+V.ele.DAT.3.SG+IMP+3+SG
outorgue-lhes	outorgar+V.ele.DAT.3.PL+IMP+3+SG
outorgue-me	outorgar+V.eu.AD.1.SG+IMP+3+SG
outorguem-lhe	outorgar+V.ele.DAT.3.SG+IMP+3+PL
outorguem-lhes	outorgar+V.ele.DAT.3.PL+IMP+3+PL
outorguem-me	outorgar+V.eu.AD.1.SG+IMP+3+PL
outorguem-na	outorgar+V.ele.ACC.3.F.SG+IMP+3+PL
outorguem-nas	outorgar+V.ele.ACC.3.F.PL+IMP+3+PL
outorguem-no	outorgar+V.ele.ACC.3.M.SG+IMP+3+PL
outorguem-nos	outorgar+V.ele.ACC.3.M.PL+IMP+3+PL
outorguem-nos	outorgar+V.nós.AD.1.PL+IMP+3+PL
outorguemo-la	outorgar+V.ele.ACC.3.F.SG+IMP+1+PL
outorguemo-las	outorgar+V.ele.ACC.3.F.PL+IMP+1+PL
outorguemo-lo	outorgar+V.ele.ACC.3.M.SG+IMP+1+PL
outorguemo-los	outorgar+V.ele.ACC.3.M.PL+IMP+1+PL
outorguemo-nos	outorgar+nós.AD.1.PL+IMP+1+PL
outorguemos-lhe	outorgar+V.ele.DAT.3.SG+IMP+1+PL
outorguemos-lhes	outorgar+V.ele.DAT.3.PL+IMP+1+PL
outorguemos-me	outorgar+V.eu.AD.1.SG+IMP+1+PL
outorguemos-te	outorgar+V.tu.AD.2.SG+IMP+1+PL
outorguemos-vos	outorgar+V.vós.AD.2.PL+IMP+1+PL
outorguem-se	outorgar+V.ele.REFL+IMP+3+PL
outorguem-te	outorgar+V.tu.AD.2.SG+IMP+3+PL
outorguem-vos	outorgar+V.vós.AD.2.PL+IMP+3+PL
outorgue-nos	outorgar+nós.AD.1.PL+IMP+3+SG
outorgue-o	outorgar+V.ele.ACC.3.M.SG+IMP+3+SG
outorgue-os	outorgar+V.ele.ACC.3.M.PL+IMP+3+SG
outorgue-se	outorgar+V.ele.REFL+IMP+3+SG
outorgue-te	outorgar+V.tu.AD.2.SG+IMP+3+SG
outorgue-vos	outorgar+V.vós.AD.2.PL+IMP+3+SG
outo-te	outar+V.tu.AD.2.SG+PRS+1+SG
outou-a	outar+V.ele.ACC.3.F.SG+PRF+3+SG
outou-as	outar+V.ele.ACC.3.F.PL+PRF+3+SG
outou-lhe	outar+V.ele.DAT.3.SG+PRF+3+SG
outou-lhes	outar+V.ele.DAT.3.PL+PRF+3+SG
outou-me	outar+V.eu.AD.1.SG+PRF+3+SG
outou-nos	outar+nós.AD.1.PL+PRF+3+SG
outou-o	outar+V.ele.ACC.3.M.SG+PRF+3+SG
outou-os	outar+V.ele.ACC.3.M.PL+PRF+3+SG
outou-se	outar+V.ele.REFL+PRF+3+SG
outou-te	outar+V.tu.AD.2.SG+PRF+3+SG
outou-vos	outar+V.vós.AD.2.PL+PRF+3+SG
outo-vos	outar+V.vós.AD.2.PL+PRS+1+SG
ouve-a	ouvir+V.ele.ACC.3.F.SG+PRS+3+SG
ouve-as	ouvir+V.ele.ACC.3.F.PL+PRS+3+SG
ouve-la	ouvir+V.ele.ACC.3.F.SG+PRS+2+SG
ouve-las	ouvir+V.ele.ACC.3.F.PL+PRS+2+SG
ouve-lhe	ouvir+V.ele.DAT.3.SG+PRS+3+SG
ouve-lhes	ouvir+V.ele.DAT.3.PL+PRS+3+SG
ouve-lo	ouvir+V.ele.ACC.3.M.SG+PRS+2+SG
ouve-los	ouvir+V.ele.ACC.3.M.PL+PRS+2+SG
ouve-me	ouvir+V.eu.AD.1.SG+PRS+3+SG
ouvem-lhe	ouvir+V.ele.DAT.3.SG+PRS+3+PL
ouvem-lhes	ouvir+V.ele.DAT.3.PL+PRS+3+PL
ouvem-me	ouvir+V.eu.AD.1.SG+PRS+3+PL
ouvem-na	ouvir+V.ele.ACC.3.F.SG+PRS+3+PL
ouvem-nas	ouvir+V.ele.ACC.3.F.PL+PRS+3+PL
ouvem-no	ouvir+V.ele.ACC.3.M.SG+PRS+3+PL
ouvem-nos	ouvir+V.ele.ACC.3.M.PL+PRS+3+PL
ouvem-nos	ouvir+V.nós.AD.1.PL+PRS+3+PL
ouvem-se	ouvir+V.ele.REFL+PRS+3+PL
ouvem-te	ouvir+V.tu.AD.2.SG+PRS+3+PL
ouvem-vos	ouvir+V.vós.AD.2.PL+PRS+3+PL
ouve-nos	ouvir+nós.AD.1.PL+PRS+2+SG
ouve-nos	ouvir+nós.AD.1.PL+PRS+3+SG
ouve-o	ouvir+V.ele.ACC.3.M.SG+PRS+3+SG
ouve-os	ouvir+V.ele.ACC.3.M.PL+PRS+3+SG
ouve-se	ouvir+V.ele.REFL+PRS+3+SG
ouves-lhe	ouvir+V.ele.DAT.3.SG+PRS+2+SG
ouves-lhes	ouvir+V.ele.DAT.3.PL+PRS+2+SG
ouves-me	ouvir+V.eu.AD.1.SG+PRS+2+SG
ouves-te	ouvir+V.tu.AD.2.SG+PRS+2+SG
ouves-vos	ouvir+V.vós.AD.2.PL+PRS+2+SG
ouve-te	ouvir+V.tu.AD.2.SG+PRS+3+SG
ouve-vos	ouvir+V.vós.AD.2.PL+PRS+3+SG
ouvia-a	ouvir+V.ele.ACC.3.F.SG+IMPF+1+SG
ouvia-a	ouvir+V.ele.ACC.3.F.SG+IMPF+3+SG
ouvia-as	ouvir+V.ele.ACC.3.F.PL+IMPF+1+SG
ouvia-as	ouvir+V.ele.ACC.3.F.PL+IMPF+3+SG
ouvia-la	ouvir+V.ele.ACC.3.F.SG+IMPF+2+SG
ouvia-las	ouvir+V.ele.ACC.3.F.PL+IMPF+2+SG
ouvia-lhe	ouvir+V.ele.DAT.3.SG+IMPF+1+SG
ouvia-lhe	ouvir+V.ele.DAT.3.SG+IMPF+3+SG
ouvia-lhes	ouvir+V.ele.DAT.3.PL+IMPF+1+SG
ouvia-lhes	ouvir+V.ele.DAT.3.PL+IMPF+3+SG
ouvia-lo	ouvir+V.ele.ACC.3.M.SG+IMPF+2+SG
ouvia-los	ouvir+V.ele.ACC.3.M.PL+IMPF+2+SG
ouvia-me	ouvir+V.eu.AD.1.SG+IMPF+1+SG
ouvia-me	ouvir+V.eu.AD.1.SG+IMPF+3+SG
ouviam-lhe	ouvir+V.ele.DAT.3.SG+IMPF+3+PL
ouviam-lhes	ouvir+V.ele.DAT.3.PL+IMPF+3+PL
ouviam-me	ouvir+V.eu.AD.1.SG+IMPF+3+PL
ouviam-na	ouvir+V.ele.ACC.3.F.SG+IMPF+3+PL
ouviam-nas	ouvir+V.ele.ACC.3.F.PL+IMPF+3+PL
ouviam-no	ouvir+V.ele.ACC.3.M.SG+IMPF+3+PL
ouviam-nos	ouvir+V.ele.ACC.3.M.PL+IMPF+3+PL
ouviam-nos	ouvir+V.nós.AD.1.PL+IMPF+3+PL
ouvíamo-la	ouvir+V.ele.ACC.3.F.SG+IMPF+1+PL
ouvíamo-las	ouvir+V.ele.ACC.3.F.PL+IMPF+1+PL
ouvíamo-lo	ouvir+V.ele.ACC.3.M.SG+IMPF+1+PL
ouvíamo-los	ouvir+V.ele.ACC.3.M.PL+IMPF+1+PL
ouvíamo-nos	ouvir+nós.AD.1.PL+IMPF+1+PL
ouvíamos-lhe	ouvir+V.ele.DAT.3.SG+IMPF+1+PL
ouvíamos-lhes	ouvir+V.ele.DAT.3.PL+IMPF+1+PL
ouvíamos-me	ouvir+V.eu.AD.1.SG+IMPF+1+PL
ouvíamos-te	ouvir+V.tu.AD.2.SG+IMPF+1+PL
ouvíamos-vos	ouvir+V.vós.AD.2.PL+IMPF+1+PL
ouviam-se	ouvir+V.ele.REFL+IMPF+3+PL
ouviam-te	ouvir+V.tu.AD.2.SG+IMPF+3+PL
ouviam-vos	ouvir+V.vós.AD.2.PL+IMPF+3+PL
ouvia-nos	ouvir+nós.AD.1.PL+IMPF+1+SG
ouvia-nos	ouvir+nós.AD.1.PL+IMPF+2+SG
ouvia-nos	ouvir+nós.AD.1.PL+IMPF+3+SG
ouvia-o	ouvir+V.ele.ACC.3.M.SG+IMPF+1+SG
ouvia-o	ouvir+V.ele.ACC.3.M.SG+IMPF+3+SG
ouvia-os	ouvir+V.ele.ACC.3.M.PL+IMPF+1+SG
ouvia-os	ouvir+V.ele.ACC.3.M.PL+IMPF+3+SG
ouvi-a	ouvir+V.ele.ACC.3.F.SG+PRF+1+SG
ouvia-se	ouvir+V.ele.REFL+IMPF+3+SG
ouvias-lhe	ouvir+V.ele.DAT.3.SG+IMPF+2+SG
ouvias-lhes	ouvir+V.ele.DAT.3.PL+IMPF+2+SG
ouvias-me	ouvir+V.eu.AD.1.SG+IMPF+2+SG
ouvi-as	ouvir+V.ele.ACC.3.F.PL+PRF+1+SG
ouvias-te	ouvir+V.tu.AD.2.SG+IMPF+2+SG
ouvias-vos	ouvir+V.vós.AD.2.PL+IMPF+2+SG
ouvia-te	ouvir+V.tu.AD.2.SG+IMPF+1+SG
ouvia-te	ouvir+V.tu.AD.2.SG+IMPF+3+SG
ouvia-vos	ouvir+V.vós.AD.2.PL+IMPF+1+SG
ouvia-vos	ouvir+V.vós.AD.2.PL+IMPF+3+SG
ouvíei-la	ouvir+V.ele.ACC.3.F.SG+IMPF+2+PL
ouvíei-las	ouvir+V.ele.ACC.3.F.PL+IMPF+2+PL
ouvíei-lo	ouvir+V.ele.ACC.3.M.SG+IMPF+2+PL
ouvíei-los	ouvir+V.ele.ACC.3.M.PL+IMPF+2+PL
ouvíei-nos	ouvir+nós.AD.1.PL+IMPF+2+PL
ouvíeis-lhe	ouvir+V.ele.DAT.3.SG+IMPF+2+PL
ouvíeis-lhes	ouvir+V.ele.DAT.3.PL+IMPF+2+PL
ouvíeis-me	ouvir+V.eu.AD.1.SG+IMPF+2+PL
ouvíeis-te	ouvir+V.tu.AD.2.SG+IMPF+2+PL
ouvíeis-vos	ouvir+V.vós.AD.2.PL+IMPF+2+PL
ouvi-la-ão	ouvir+V.ele.ACC.3.F.SG+FUT+3+PL
ouvi-la-á	ouvir+V.ele.ACC.3.F.SG+FUT+3+SG
ouvi-la-ás	ouvir+V.ele.ACC.3.F.SG+FUT+2+SG
ouvi-la-ei	ouvir+V.ele.ACC.3.F.SG+FUT+1+SG
ouvi-la-eis	ouvir+V.ele.ACC.3.F.SG+FUT+2+PL
ouvi-la-emos	ouvir+V.ele.ACC.3.F.SG+FUT+1+PL
ouvi-la-íamos	ouvir+V.ele.ACC.3.F.SG+COND+1+PL
ouvi-la-iam	ouvir+V.ele.ACC.3.F.SG+COND+3+PL
ouvi-la-ia	ouvir+V.ele.ACC.3.F.SG+COND+1+SG
ouvi-la-ia	ouvir+V.ele.ACC.3.F.SG+COND+3+SG
ouvi-la-ias	ouvir+V.ele.ACC.3.F.SG+COND+2+SG
ouvi-la-íeis	ouvir+V.ele.ACC.3.F.SG+COND+2+PL
ouvi-la	ouvir+V.ele.ACC.3.F.SG+INF+1+SG
ouvi-la	ouvir+V.ele.ACC.3.F.SG+INF+3+SG
ouvi-la	ouvir+V.ele.ACC.3.F.SG+PRS+2+PL
ouvi-la	ouvir+V.ele.ACC.3.F.SG+SBJF+1+SG
ouvi-la	ouvir+V.ele.ACC.3.F.SG+SBJF+3+SG
ouvi-las-ão	ouvir+V.ele.ACC.3.F.PL+FUT+3+PL
ouvi-las-á	ouvir+V.ele.ACC.3.F.PL+FUT+3+SG
ouvi-las-ás	ouvir+V.ele.ACC.3.F.PL+FUT+2+SG
ouvi-las-ei	ouvir+V.ele.ACC.3.F.PL+FUT+1+SG
ouvi-las-eis	ouvir+V.ele.ACC.3.F.PL+FUT+2+PL
ouvi-las-emos	ouvir+V.ele.ACC.3.F.PL+FUT+1+PL
ouvi-las-íamos	ouvir+V.ele.ACC.3.F.PL+COND+1+PL
ouvi-las-iam	ouvir+V.ele.ACC.3.F.PL+COND+3+PL
ouvi-las-ia	ouvir+V.ele.ACC.3.F.PL+COND+1+SG
ouvi-las-ia	ouvir+V.ele.ACC.3.F.PL+COND+3+SG
ouvi-las-ias	ouvir+V.ele.ACC.3.F.PL+COND+2+SG
ouvi-las-íeis	ouvir+V.ele.ACC.3.F.PL+COND+2+PL
ouvi-las	ouvir+V.ele.ACC.3.F.PL+INF+1+SG
ouvi-las	ouvir+V.ele.ACC.3.F.PL+INF+3+SG
ouvi-las	ouvir+V.ele.ACC.3.F.PL+PRS+2+PL
