parolear-te-íamos	parolear+V.tu.AD.2.SG+COND+1+PL
parolear-te-iam	parolear+V.tu.AD.2.SG+COND+3+PL
parolear-te-ia	parolear+V.tu.AD.2.SG+COND+1+SG
parolear-te-ia	parolear+V.tu.AD.2.SG+COND+3+SG
parolear-te-ias	parolear+V.tu.AD.2.SG+COND+2+SG
parolear-te-íeis	parolear+V.tu.AD.2.SG+COND+2+PL
parolear-te	parolear+V.tu.AD.2.SG+INF
parolear-te	parolear+V.tu.AD.2.SG+INF+1+SG
parolear-te	parolear+V.tu.AD.2.SG+INF+3+SG
parolear-te	parolear+V.tu.AD.2.SG+SBJF+1+SG
parolear-te	parolear+V.tu.AD.2.SG+SBJF+3+SG
parolear-vos-ão	parolear+V.vós.AD.2.PL+FUT+3+PL
parolear-vos-á	parolear+V.vós.AD.2.PL+FUT+3+SG
parolear-vos-ás	parolear+V.vós.AD.2.PL+FUT+2+SG
parolear-vos-ei	parolear+V.vós.AD.2.PL+FUT+1+SG
parolear-vos-eis	parolear+V.vós.AD.2.PL+FUT+2+PL
parolear-vos-emos	parolear+V.vós.AD.2.PL+FUT+1+PL
parolear-vos-íamos	parolear+V.vós.AD.2.PL+COND+1+PL
parolear-vos-iam	parolear+V.vós.AD.2.PL+COND+3+PL
parolear-vos-ia	parolear+V.vós.AD.2.PL+COND+1+SG
parolear-vos-ia	parolear+V.vós.AD.2.PL+COND+3+SG
parolear-vos-ias	parolear+V.vós.AD.2.PL+COND+2+SG
parolear-vos-íeis	parolear+V.vós.AD.2.PL+COND+2+PL
parolear-vos	parolear+V.vós.AD.2.PL+INF
parolear-vos	parolear+V.vós.AD.2.PL+INF+1+SG
parolear-vos	parolear+V.vós.AD.2.PL+INF+3+SG
parolear-vos	parolear+V.vós.AD.2.PL+SBJF+1+SG
parolear-vos	parolear+V.vós.AD.2.PL+SBJF+3+SG
parole-as	parolar+V.ele.ACC.3.F.PL+IMP+3+SG
paroleaste-a	parolear+V.ele.ACC.3.F.SG+PRF+2+SG
paroleaste-as	parolear+V.ele.ACC.3.F.PL+PRF+2+SG
paroleaste-la	parolear+V.ele.ACC.3.F.SG+PRF+2+PL
paroleaste-las	parolear+V.ele.ACC.3.F.PL+PRF+2+PL
paroleaste-lhe	parolear+V.ele.DAT.3.SG+PRF+2+SG
paroleaste-lhes	parolear+V.ele.DAT.3.PL+PRF+2+SG
paroleaste-lo	parolear+V.ele.ACC.3.M.SG+PRF+2+PL
paroleaste-los	parolear+V.ele.ACC.3.M.PL+PRF+2+PL
paroleaste-me	parolear+V.eu.AD.1.SG+PRF+2+SG
paroleaste-nos	parolear+nós.AD.1.PL+PRF+2+PL
paroleaste-nos	parolear+nós.AD.1.PL+PRF+2+SG
paroleaste-o	parolear+V.ele.ACC.3.M.SG+PRF+2+SG
paroleaste-os	parolear+V.ele.ACC.3.M.PL+PRF+2+SG
paroleastes-lhe	parolear+V.ele.DAT.3.SG+PRF+2+PL
paroleastes-lhes	parolear+V.ele.DAT.3.PL+PRF+2+PL
paroleastes-me	parolear+V.eu.AD.1.SG+PRF+2+PL
paroleastes-te	parolear+V.tu.AD.2.SG+PRF+2+PL
paroleastes-vos	parolear+V.vós.AD.2.PL+PRF+2+PL
paroleaste-te	parolear+V.tu.AD.2.SG+PRF+2+SG
paroleaste-vos	parolear+V.vós.AD.2.PL+PRF+2+SG
paroleava-a	parolear+V.ele.ACC.3.F.SG+IMPF+1+SG
paroleava-a	parolear+V.ele.ACC.3.F.SG+IMPF+3+SG
paroleava-as	parolear+V.ele.ACC.3.F.PL+IMPF+1+SG
paroleava-as	parolear+V.ele.ACC.3.F.PL+IMPF+3+SG
paroleava-la	parolear+V.ele.ACC.3.F.SG+IMPF+2+SG
paroleava-las	parolear+V.ele.ACC.3.F.PL+IMPF+2+SG
paroleava-lhe	parolear+V.ele.DAT.3.SG+IMPF+1+SG
paroleava-lhe	parolear+V.ele.DAT.3.SG+IMPF+3+SG
paroleava-lhes	parolear+V.ele.DAT.3.PL+IMPF+1+SG
paroleava-lhes	parolear+V.ele.DAT.3.PL+IMPF+3+SG
paroleava-lo	parolear+V.ele.ACC.3.M.SG+IMPF+2+SG
paroleava-los	parolear+V.ele.ACC.3.M.PL+IMPF+2+SG
paroleava-me	parolear+V.eu.AD.1.SG+IMPF+1+SG
paroleava-me	parolear+V.eu.AD.1.SG+IMPF+3+SG
paroleavam-lhe	parolear+V.ele.DAT.3.SG+IMPF+3+PL
paroleavam-lhes	parolear+V.ele.DAT.3.PL+IMPF+3+PL
paroleavam-me	parolear+V.eu.AD.1.SG+IMPF+3+PL
paroleavam-na	parolear+V.ele.ACC.3.F.SG+IMPF+3+PL
paroleavam-nas	parolear+V.ele.ACC.3.F.PL+IMPF+3+PL
paroleavam-no	parolear+V.ele.ACC.3.M.SG+IMPF+3+PL
paroleavam-nos	parolear+V.ele.ACC.3.M.PL+IMPF+3+PL
paroleavam-nos	parolear+V.nós.AD.1.PL+IMPF+3+PL
paroleávamo-la	parolear+V.ele.ACC.3.F.SG+IMPF+1+PL
paroleávamo-las	parolear+V.ele.ACC.3.F.PL+IMPF+1+PL
paroleávamo-lo	parolear+V.ele.ACC.3.M.SG+IMPF+1+PL
paroleávamo-los	parolear+V.ele.ACC.3.M.PL+IMPF+1+PL
paroleávamo-nos	parolear+nós.AD.1.PL+IMPF+1+PL
paroleávamos-lhe	parolear+V.ele.DAT.3.SG+IMPF+1+PL
paroleávamos-lhes	parolear+V.ele.DAT.3.PL+IMPF+1+PL
paroleávamos-me	parolear+V.eu.AD.1.SG+IMPF+1+PL
paroleávamos-te	parolear+V.tu.AD.2.SG+IMPF+1+PL
paroleávamos-vos	parolear+V.vós.AD.2.PL+IMPF+1+PL
paroleavam-se	parolear+V.ele.REFL+IMPF+3+PL
paroleavam-te	parolear+V.tu.AD.2.SG+IMPF+3+PL
paroleavam-vos	parolear+V.vós.AD.2.PL+IMPF+3+PL
paroleava-nos	parolear+nós.AD.1.PL+IMPF+1+SG
paroleava-nos	parolear+nós.AD.1.PL+IMPF+2+SG
paroleava-nos	parolear+nós.AD.1.PL+IMPF+3+SG
paroleava-o	parolear+V.ele.ACC.3.M.SG+IMPF+1+SG
paroleava-o	parolear+V.ele.ACC.3.M.SG+IMPF+3+SG
paroleava-os	parolear+V.ele.ACC.3.M.PL+IMPF+1+SG
paroleava-os	parolear+V.ele.ACC.3.M.PL+IMPF+3+SG
paroleava-se	parolear+V.ele.REFL+IMPF+1+SG
paroleava-se	parolear+V.ele.REFL+IMPF+3+SG
paroleavas-lhe	parolear+V.ele.DAT.3.SG+IMPF+2+SG
paroleavas-lhes	parolear+V.ele.DAT.3.PL+IMPF+2+SG
paroleavas-me	parolear+V.eu.AD.1.SG+IMPF+2+SG
paroleavas-te	parolear+V.tu.AD.2.SG+IMPF+2+SG
paroleavas-vos	parolear+V.vós.AD.2.PL+IMPF+2+SG
paroleava-te	parolear+V.tu.AD.2.SG+IMPF+1+SG
paroleava-te	parolear+V.tu.AD.2.SG+IMPF+3+SG
paroleava-vos	parolear+V.vós.AD.2.PL+IMPF+1+SG
paroleava-vos	parolear+V.vós.AD.2.PL+IMPF+3+SG
paroleávei-la	parolear+V.ele.ACC.3.F.SG+IMPF+2+PL
paroleávei-las	parolear+V.ele.ACC.3.F.PL+IMPF+2+PL
paroleávei-lo	parolear+V.ele.ACC.3.M.SG+IMPF+2+PL
paroleávei-los	parolear+V.ele.ACC.3.M.PL+IMPF+2+PL
paroleávei-nos	parolear+nós.AD.1.PL+IMPF+2+PL
paroleáveis-lhe	parolear+V.ele.DAT.3.SG+IMPF+2+PL
paroleáveis-lhes	parolear+V.ele.DAT.3.PL+IMPF+2+PL
paroleáveis-me	parolear+V.eu.AD.1.SG+IMPF+2+PL
paroleáveis-te	parolear+V.tu.AD.2.SG+IMPF+2+PL
paroleáveis-vos	parolear+V.vós.AD.2.PL+IMPF+2+PL
paroleei-a	parolear+V.ele.ACC.3.F.SG+PRF+1+SG
paroleei-as	parolear+V.ele.ACC.3.F.PL+PRF+1+SG
paroleei-lhe	parolear+V.ele.DAT.3.SG+PRF+1+SG
paroleei-lhes	parolear+V.ele.DAT.3.PL+PRF+1+SG
paroleei-me	parolear+V.eu.AD.1.SG+PRF+1+SG
paroleei-nos	parolear+nós.AD.1.PL+PRF+1+SG
paroleei-o	parolear+V.ele.ACC.3.M.SG+PRF+1+SG
paroleei-os	parolear+V.ele.ACC.3.M.PL+PRF+1+SG
paroleei-te	parolear+V.tu.AD.2.SG+PRF+1+SG
paroleei-vos	parolear+V.vós.AD.2.PL+PRF+1+SG
paroleia-a	parolear+V.ele.ACC.3.F.SG+PRS+3+SG
paroleia-as	parolear+V.ele.ACC.3.F.PL+PRS+3+SG
paroleia-la	parolear+V.ele.ACC.3.F.SG+PRS+2+SG
paroleia-las	parolear+V.ele.ACC.3.F.PL+PRS+2+SG
paroleia-lhe	parolear+V.ele.DAT.3.SG+PRS+3+SG
paroleia-lhes	parolear+V.ele.DAT.3.PL+PRS+3+SG
paroleia-lo	parolear+V.ele.ACC.3.M.SG+PRS+2+SG
paroleia-los	parolear+V.ele.ACC.3.M.PL+PRS+2+SG
paroleia-me	parolear+V.eu.AD.1.SG+PRS+3+SG
paroleiam-lhe	parolear+V.ele.DAT.3.SG+PRS+3+PL
paroleiam-lhes	parolear+V.ele.DAT.3.PL+PRS+3+PL
paroleiam-me	parolear+V.eu.AD.1.SG+PRS+3+PL
paroleiam-na	parolear+V.ele.ACC.3.F.SG+PRS+3+PL
paroleiam-nas	parolear+V.ele.ACC.3.F.PL+PRS+3+PL
paroleiam-no	parolear+V.ele.ACC.3.M.SG+PRS+3+PL
paroleiam-nos	parolear+V.ele.ACC.3.M.PL+PRS+3+PL
paroleiam-nos	parolear+V.nós.AD.1.PL+PRS+3+PL
paroleiam-se	parolear+V.ele.REFL+PRS+3+PL
paroleiam-te	parolear+V.tu.AD.2.SG+PRS+3+PL
paroleiam-vos	parolear+V.vós.AD.2.PL+PRS+3+PL
paroleia-nos	parolear+nós.AD.1.PL+PRS+2+SG
paroleia-nos	parolear+nós.AD.1.PL+PRS+3+SG
paroleia-o	parolear+V.ele.ACC.3.M.SG+PRS+3+SG
paroleia-os	parolear+V.ele.ACC.3.M.PL+PRS+3+SG
parolei-a	parolar+V.ele.ACC.3.F.SG+PRF+1+SG
paroleia-se	parolear+V.ele.REFL+PRS+3+SG
paroleias-lhe	parolear+V.ele.DAT.3.SG+PRS+2+SG
paroleias-lhes	parolear+V.ele.DAT.3.PL+PRS+2+SG
paroleias-me	parolear+V.eu.AD.1.SG+PRS+2+SG
parolei-as	parolar+V.ele.ACC.3.F.PL+PRF+1+SG
paroleias-te	parolear+V.tu.AD.2.SG+PRS+2+SG
paroleias-vos	parolear+V.vós.AD.2.PL+PRS+2+SG
paroleia-te	parolear+V.tu.AD.2.SG+PRS+3+SG
paroleia-vos	parolear+V.vós.AD.2.PL+PRS+3+SG
parolei-lhe	parolar+V.ele.DAT.3.SG+PRF+1+SG
parolei-lhes	parolar+V.ele.DAT.3.PL+PRF+1+SG
parolei-me	parolar+V.eu.AD.1.SG+PRF+1+SG
parolei-nos	parolar+nós.AD.1.PL+PRF+1+SG
paroleio-a	parolear+V.ele.ACC.3.F.SG+PRS+1+SG
paroleio-as	parolear+V.ele.ACC.3.F.PL+PRS+1+SG
paroleio-lhe	parolear+V.ele.DAT.3.SG+PRS+1+SG
paroleio-lhes	parolear+V.ele.DAT.3.PL+PRS+1+SG
paroleio-me	parolear+V.eu.AD.1.SG+PRS+1+SG
paroleio-nos	parolear+nós.AD.1.PL+PRS+1+SG
paroleio-o	parolear+V.ele.ACC.3.M.SG+PRS+1+SG
paroleio-os	parolear+V.ele.ACC.3.M.PL+PRS+1+SG
parolei-o	parolar+V.ele.ACC.3.M.SG+PRF+1+SG
parolei-os	parolar+V.ele.ACC.3.M.PL+PRF+1+SG
paroleio-te	parolear+V.tu.AD.2.SG+PRS+1+SG
paroleio-vos	parolear+V.vós.AD.2.PL+PRS+1+SG
parolei-te	parolar+V.tu.AD.2.SG+PRF+1+SG
parolei-vos	parolar+V.vós.AD.2.PL+PRF+1+SG
parole-lhe	parolar+V.ele.DAT.3.SG+IMP+3+SG
parole-lhes	parolar+V.ele.DAT.3.PL+IMP+3+SG
parole-me	parolar+V.eu.AD.1.SG+IMP+3+SG
parolem-lhe	parolar+V.ele.DAT.3.SG+IMP+3+PL
parolem-lhes	parolar+V.ele.DAT.3.PL+IMP+3+PL
parolem-me	parolar+V.eu.AD.1.SG+IMP+3+PL
parolem-na	parolar+V.ele.ACC.3.F.SG+IMP+3+PL
parolem-nas	parolar+V.ele.ACC.3.F.PL+IMP+3+PL
parolem-no	parolar+V.ele.ACC.3.M.SG+IMP+3+PL
parolem-nos	parolar+V.ele.ACC.3.M.PL+IMP+3+PL
parolem-nos	parolar+V.nós.AD.1.PL+IMP+3+PL
parolemo-la	parolar+V.ele.ACC.3.F.SG+IMP+1+PL
parolemo-las	parolar+V.ele.ACC.3.F.PL+IMP+1+PL
parolemo-lo	parolar+V.ele.ACC.3.M.SG+IMP+1+PL
parolemo-los	parolar+V.ele.ACC.3.M.PL+IMP+1+PL
parolemo-nos	parolar+nós.AD.1.PL+IMP+1+PL
parolemos-lhe	parolar+V.ele.DAT.3.SG+IMP+1+PL
parolemos-lhes	parolar+V.ele.DAT.3.PL+IMP+1+PL
parolemos-me	parolar+V.eu.AD.1.SG+IMP+1+PL
parolemos-te	parolar+V.tu.AD.2.SG+IMP+1+PL
parolemos-vos	parolar+V.vós.AD.2.PL+IMP+1+PL
parolem-se	parolar+V.ele.REFL+IMP+3+PL
parolem-te	parolar+V.tu.AD.2.SG+IMP+3+PL
parolem-vos	parolar+V.vós.AD.2.PL+IMP+3+PL
parole-nos	parolar+nós.AD.1.PL+IMP+3+SG
parole-o	parolar+V.ele.ACC.3.M.SG+IMP+3+SG
parole-os	parolar+V.ele.ACC.3.M.PL+IMP+3+SG
paroleou-a	parolear+V.ele.ACC.3.F.SG+PRF+3+SG
paroleou-as	parolear+V.ele.ACC.3.F.PL+PRF+3+SG
paroleou-lhe	parolear+V.ele.DAT.3.SG+PRF+3+SG
paroleou-lhes	parolear+V.ele.DAT.3.PL+PRF+3+SG
paroleou-me	parolear+V.eu.AD.1.SG+PRF+3+SG
paroleou-nos	parolear+nós.AD.1.PL+PRF+3+SG
paroleou-o	parolear+V.ele.ACC.3.M.SG+PRF+3+SG
paroleou-os	parolear+V.ele.ACC.3.M.PL+PRF+3+SG
paroleou-se	parolear+V.ele.REFL+PRF+3+SG
paroleou-te	parolear+V.tu.AD.2.SG+PRF+3+SG
paroleou-vos	parolear+V.vós.AD.2.PL+PRF+3+SG
parole-se	parolar+V.ele.REFL+IMP+3+SG
parole-te	parolar+V.tu.AD.2.SG+IMP+3+SG
parole-vos	parolar+V.vós.AD.2.PL+IMP+3+SG
paro-lhe	parar+V.ele.DAT.3.SG+PRS+1+SG
paro-lhes	parar+V.ele.DAT.3.PL+PRS+1+SG
parolo-a	parolar+V.ele.ACC.3.F.SG+PRS+1+SG
parolo-as	parolar+V.ele.ACC.3.F.PL+PRS+1+SG
parolo-lhe	parolar+V.ele.DAT.3.SG+PRS+1+SG
parolo-lhes	parolar+V.ele.DAT.3.PL+PRS+1+SG
parolo-me	parolar+V.eu.AD.1.SG+PRS+1+SG
parolo-nos	parolar+nós.AD.1.PL+PRS+1+SG
parolo-o	parolar+V.ele.ACC.3.M.SG+PRS+1+SG
parolo-os	parolar+V.ele.ACC.3.M.PL+PRS+1+SG
parolo-te	parolar+V.tu.AD.2.SG+PRS+1+SG
parolou-a	parolar+V.ele.ACC.3.F.SG+PRF+3+SG
parolou-as	parolar+V.ele.ACC.3.F.PL+PRF+3+SG
parolou-lhe	parolar+V.ele.DAT.3.SG+PRF+3+SG
parolou-lhes	parolar+V.ele.DAT.3.PL+PRF+3+SG
parolou-me	parolar+V.eu.AD.1.SG+PRF+3+SG
parolou-nos	parolar+nós.AD.1.PL+PRF+3+SG
parolou-o	parolar+V.ele.ACC.3.M.SG+PRF+3+SG
parolou-os	parolar+V.ele.ACC.3.M.PL+PRF+3+SG
parolou-se	parolar+V.ele.REFL+PRF+3+SG
parolou-te	parolar+V.tu.AD.2.SG+PRF+3+SG
parolou-vos	parolar+V.vós.AD.2.PL+PRF+3+SG
parolo-vos	parolar+V.vós.AD.2.PL+PRS+1+SG
paro-me	parar+V.eu.AD.1.SG+PRS+1+SG
paro-nos	parar+nós.AD.1.PL+PRS+1+SG
paro-o	parar+V.ele.ACC.3.M.SG+PRS+1+SG
paro-os	parar+V.ele.ACC.3.M.PL+PRS+1+SG
paroquia-a	paroquiar+V.ele.ACC.3.F.SG+PRS+3+SG
paroquia-as	paroquiar+V.ele.ACC.3.F.PL+PRS+3+SG
paroquiai-la	paroquiar+V.ele.ACC.3.F.SG+PRS+2+PL
paroquiai-las	paroquiar+V.ele.ACC.3.F.PL+PRS+2+PL
paroquiai-lo	paroquiar+V.ele.ACC.3.M.SG+PRS+2+PL
paroquiai-los	paroquiar+V.ele.ACC.3.M.PL+PRS+2+PL
paroquiai-nos	paroquiar+nós.AD.1.PL+PRS+2+PL
paroquiais-lhe	paroquiar+V.ele.DAT.3.SG+PRS+2+PL
paroquiais-lhes	paroquiar+V.ele.DAT.3.PL+PRS+2+PL
paroquiais-me	paroquiar+V.eu.AD.1.SG+PRS+2+PL
paroquiais-te	paroquiar+V.tu.AD.2.SG+PRS+2+PL
paroquiais-vos	paroquiar+V.vós.AD.2.PL+PRS+2+PL
paroquiá-la-ão	paroquiar+V.ele.ACC.3.F.SG+FUT+3+PL
paroquiá-la-á	paroquiar+V.ele.ACC.3.F.SG+FUT+3+SG
paroquiá-la-ás	paroquiar+V.ele.ACC.3.F.SG+FUT+2+SG
paroquiá-la-ei	paroquiar+V.ele.ACC.3.F.SG+FUT+1+SG
paroquiá-la-eis	paroquiar+V.ele.ACC.3.F.SG+FUT+2+PL
paroquiá-la-emos	paroquiar+V.ele.ACC.3.F.SG+FUT+1+PL
paroquiá-la-íamos	paroquiar+V.ele.ACC.3.F.SG+COND+1+PL
paroquiá-la-iam	paroquiar+V.ele.ACC.3.F.SG+COND+3+PL
paroquiá-la-ia	paroquiar+V.ele.ACC.3.F.SG+COND+1+SG
paroquiá-la-ia	paroquiar+V.ele.ACC.3.F.SG+COND+3+SG
paroquiá-la-ias	paroquiar+V.ele.ACC.3.F.SG+COND+2+SG
paroquiá-la-íeis	paroquiar+V.ele.ACC.3.F.SG+COND+2+PL
paroquiá-la	paroquiar+V.ele.ACC.3.F.SG+INF+1+SG
paroquiá-la	paroquiar+V.ele.ACC.3.F.SG+INF+3+SG
paroquia-la	paroquiar+V.ele.ACC.3.F.SG+PRS+2+SG
paroquiá-la	paroquiar+V.ele.ACC.3.F.SG+SBJF+1+SG
paroquiá-la	paroquiar+V.ele.ACC.3.F.SG+SBJF+3+SG
paroquiá-las-ão	paroquiar+V.ele.ACC.3.F.PL+FUT+3+PL
paroquiá-las-á	paroquiar+V.ele.ACC.3.F.PL+FUT+3+SG
paroquiá-las-ás	paroquiar+V.ele.ACC.3.F.PL+FUT+2+SG
paroquiá-las-ei	paroquiar+V.ele.ACC.3.F.PL+FUT+1+SG
paroquiá-las-eis	paroquiar+V.ele.ACC.3.F.PL+FUT+2+PL
paroquiá-las-emos	paroquiar+V.ele.ACC.3.F.PL+FUT+1+PL
paroquiá-las-íamos	paroquiar+V.ele.ACC.3.F.PL+COND+1+PL
paroquiá-las-iam	paroquiar+V.ele.ACC.3.F.PL+COND+3+PL
paroquiá-las-ia	paroquiar+V.ele.ACC.3.F.PL+COND+1+SG
paroquiá-las-ia	paroquiar+V.ele.ACC.3.F.PL+COND+3+SG
paroquiá-las-ias	paroquiar+V.ele.ACC.3.F.PL+COND+2+SG
paroquiá-las-íeis	paroquiar+V.ele.ACC.3.F.PL+COND+2+PL
paroquiá-las	paroquiar+V.ele.ACC.3.F.PL+INF+1+SG
paroquiá-las	paroquiar+V.ele.ACC.3.F.PL+INF+3+SG
paroquia-las	paroquiar+V.ele.ACC.3.F.PL+PRS+2+SG
paroquiá-las	paroquiar+V.ele.ACC.3.F.PL+SBJF+1+SG
paroquiá-las	paroquiar+V.ele.ACC.3.F.PL+SBJF+3+SG
paroquia-lhe	paroquiar+V.ele.DAT.3.SG+PRS+3+SG
paroquia-lhes	paroquiar+V.ele.DAT.3.PL+PRS+3+SG
paroquiá-lo-ão	paroquiar+V.ele.ACC.3.M.SG+FUT+3+PL
paroquiá-lo-á	paroquiar+V.ele.ACC.3.M.SG+FUT+3+SG
paroquiá-lo-ás	paroquiar+V.ele.ACC.3.M.SG+FUT+2+SG
paroquiá-lo-ei	paroquiar+V.ele.ACC.3.M.SG+FUT+1+SG
paroquiá-lo-eis	paroquiar+V.ele.ACC.3.M.SG+FUT+2+PL
paroquiá-lo-emos	paroquiar+V.ele.ACC.3.M.SG+FUT+1+PL
paroquiá-lo-íamos	paroquiar+V.ele.ACC.3.M.SG+COND+1+PL
paroquiá-lo-iam	paroquiar+V.ele.ACC.3.M.SG+COND+3+PL
paroquiá-lo-ia	paroquiar+V.ele.ACC.3.M.SG+COND+1+SG
paroquiá-lo-ia	paroquiar+V.ele.ACC.3.M.SG+COND+3+SG
paroquiá-lo-ias	paroquiar+V.ele.ACC.3.M.SG+COND+2+SG
paroquiá-lo-íeis	paroquiar+V.ele.ACC.3.M.SG+COND+2+PL
paroquiá-lo	paroquiar+V.ele.ACC.3.M.SG+INF+1+SG
paroquiá-lo	paroquiar+V.ele.ACC.3.M.SG+INF+3+SG
paroquia-lo	paroquiar+V.ele.ACC.3.M.SG+PRS+2+SG
paroquiá-lo	paroquiar+V.ele.ACC.3.M.SG+SBJF+1+SG
paroquiá-lo	paroquiar+V.ele.ACC.3.M.SG+SBJF+3+SG
paroquiá-los-ão	paroquiar+V.ele.ACC.3.M.PL+FUT+3+PL
paroquiá-los-á	paroquiar+V.ele.ACC.3.M.PL+FUT+3+SG
paroquiá-los-ás	paroquiar+V.ele.ACC.3.M.PL+FUT+2+SG
paroquiá-los-ei	paroquiar+V.ele.ACC.3.M.PL+FUT+1+SG
paroquiá-los-eis	paroquiar+V.ele.ACC.3.M.PL+FUT+2+PL
paroquiá-los-emos	paroquiar+V.ele.ACC.3.M.PL+FUT+1+PL
paroquiá-los-íamos	paroquiar+V.ele.ACC.3.M.PL+COND+1+PL
paroquiá-los-iam	paroquiar+V.ele.ACC.3.M.PL+COND+3+PL
paroquiá-los-ia	paroquiar+V.ele.ACC.3.M.PL+COND+1+SG
paroquiá-los-ia	paroquiar+V.ele.ACC.3.M.PL+COND+3+SG
paroquiá-los-ias	paroquiar+V.ele.ACC.3.M.PL+COND+2+SG
paroquiá-los-íeis	paroquiar+V.ele.ACC.3.M.PL+COND+2+PL
paroquiá-los	paroquiar+V.ele.ACC.3.M.PL+INF+1+SG
paroquiá-los	paroquiar+V.ele.ACC.3.M.PL+INF+3+SG
paroquia-los	paroquiar+V.ele.ACC.3.M.PL+PRS+2+SG
paroquiá-los	paroquiar+V.ele.ACC.3.M.PL+SBJF+1+SG
paroquiá-los	paroquiar+V.ele.ACC.3.M.PL+SBJF+3+SG
paroquia-me	paroquiar+V.eu.AD.1.SG+PRS+3+SG
paroquiam-lhe	paroquiar+V.ele.DAT.3.SG+PRS+3+PL
paroquiam-lhes	paroquiar+V.ele.DAT.3.PL+PRS+3+PL
paroquiam-me	paroquiar+V.eu.AD.1.SG+PRS+3+PL
paroquiam-na	paroquiar+V.ele.ACC.3.F.SG+PRS+3+PL
paroquiam-nas	paroquiar+V.ele.ACC.3.F.PL+PRS+3+PL
paroquiam-no	paroquiar+V.ele.ACC.3.M.SG+PRS+3+PL
paroquiam-nos	paroquiar+V.ele.ACC.3.M.PL+PRS+3+PL
paroquiam-nos	paroquiar+V.nós.AD.1.PL+PRS+3+PL
paroquiamo-la	paroquiar+V.ele.ACC.3.F.SG+PRF+1+PL
paroquiamo-la	paroquiar+V.ele.ACC.3.F.SG+PRS+1+PL
paroquiamo-las	paroquiar+V.ele.ACC.3.F.PL+PRF+1+PL
paroquiamo-las	paroquiar+V.ele.ACC.3.F.PL+PRS+1+PL
paroquiamo-lo	paroquiar+V.ele.ACC.3.M.SG+PRF+1+PL
paroquiamo-lo	paroquiar+V.ele.ACC.3.M.SG+PRS+1+PL
paroquiamo-los	paroquiar+V.ele.ACC.3.M.PL+PRF+1+PL
paroquiamo-los	paroquiar+V.ele.ACC.3.M.PL+PRS+1+PL
paroquiamo-nos	paroquiar+nós.AD.1.PL+PRF+1+PL
paroquiamo-nos	paroquiar+nós.AD.1.PL+PRS+1+PL
paroquiamos-lhe	paroquiar+V.ele.DAT.3.SG+PRF+1+PL
paroquiamos-lhe	paroquiar+V.ele.DAT.3.SG+PRS+1+PL
paroquiamos-lhes	paroquiar+V.ele.DAT.3.PL+PRF+1+PL
paroquiamos-lhes	paroquiar+V.ele.DAT.3.PL+PRS+1+PL
paroquiamos-me	paroquiar+V.eu.AD.1.SG+PRF+1+PL
paroquiamos-me	paroquiar+V.eu.AD.1.SG+PRS+1+PL
paroquiamos-te	paroquiar+V.tu.AD.2.SG+PRF+1+PL
paroquiamos-te	paroquiar+V.tu.AD.2.SG+PRS+1+PL
paroquiamos-vos	paroquiar+V.vós.AD.2.PL+PRF+1+PL
paroquiamos-vos	paroquiar+V.vós.AD.2.PL+PRS+1+PL
paroquiam-se	paroquiar+V.ele.REFL+PRS+3+PL
paroquiam-te	paroquiar+V.tu.AD.2.SG+PRS+3+PL
paroquiam-vos	paroquiar+V.vós.AD.2.PL+PRS+3+PL
paroquiando-a	paroquiar+V.ele.ACC.3.F.SG+GRD
paroquiando-as	paroquiar+V.ele.ACC.3.F.PL+GRD
paroquiando-lhe	paroquiar+V.ele.DAT.3.SG+GRD
paroquiando-lhes	paroquiar+V.ele.DAT.3.PL+GRD
paroquiando-me	paroquiar+V.eu.AD.1.SG+GRD
paroquiando-nos	paroquiar+nós.AD.1.PL+GRD
paroquiando-o	paroquiar+V.ele.ACC.3.M.SG+GRD
paroquiando-os	paroquiar+V.ele.ACC.3.M.PL+GRD
paroquiando-se	paroquiar+V.ele.REFL+GRD
paroquiando-te	paroquiar+V.tu.AD.2.SG+GRD
paroquiando-vos	paroquiar+V.vós.AD.2.PL+GRD
paroquia-nos	paroquiar+nós.AD.1.PL+PRS+2+SG
paroquia-nos	paroquiar+nós.AD.1.PL+PRS+3+SG
paroquia-o	paroquiar+V.ele.ACC.3.M.SG+PRS+3+SG
paroquia-os	paroquiar+V.ele.ACC.3.M.PL+PRS+3+SG
paroquiara-a	paroquiar+V.ele.ACC.3.F.SG+PQP+1+SG
paroquiara-a	paroquiar+V.ele.ACC.3.F.SG+PQP+3+SG
paroquiara-as	paroquiar+V.ele.ACC.3.F.PL+PQP+1+SG
paroquiara-as	paroquiar+V.ele.ACC.3.F.PL+PQP+3+SG
paroquiara-la	paroquiar+V.ele.ACC.3.F.SG+PQP+2+SG
paroquiara-las	paroquiar+V.ele.ACC.3.F.PL+PQP+2+SG
paroquiara-lhe	paroquiar+V.ele.DAT.3.SG+PQP+1+SG
paroquiara-lhe	paroquiar+V.ele.DAT.3.SG+PQP+3+SG
paroquiara-lhes	paroquiar+V.ele.DAT.3.PL+PQP+1+SG
paroquiara-lhes	paroquiar+V.ele.DAT.3.PL+PQP+3+SG
paroquiara-lo	paroquiar+V.ele.ACC.3.M.SG+PQP+2+SG
paroquiara-los	paroquiar+V.ele.ACC.3.M.PL+PQP+2+SG
paroquiara-me	paroquiar+V.eu.AD.1.SG+PQP+1+SG
paroquiara-me	paroquiar+V.eu.AD.1.SG+PQP+3+SG
paroquiaram-lhe	paroquiar+V.ele.DAT.3.SG+PQP+3+PL
paroquiaram-lhe	paroquiar+V.ele.DAT.3.SG+PRF+3+PL
paroquiaram-lhes	paroquiar+V.ele.DAT.3.PL+PQP+3+PL
paroquiaram-lhes	paroquiar+V.ele.DAT.3.PL+PRF+3+PL
paroquiaram-me	paroquiar+V.eu.AD.1.SG+PQP+3+PL
paroquiaram-me	paroquiar+V.eu.AD.1.SG+PRF+3+PL
paroquiaram-na	paroquiar+V.ele.ACC.3.F.SG+PQP+3+PL
paroquiaram-na	paroquiar+V.ele.ACC.3.F.SG+PRF+3+PL
paroquiaram-nas	paroquiar+V.ele.ACC.3.F.PL+PQP+3+PL
paroquiaram-nas	paroquiar+V.ele.ACC.3.F.PL+PRF+3+PL
paroquiaram-no	paroquiar+V.ele.ACC.3.M.SG+PQP+3+PL
paroquiaram-no	paroquiar+V.ele.ACC.3.M.SG+PRF+3+PL
paroquiaram-nos	paroquiar+V.ele.ACC.3.M.PL+PQP+3+PL
paroquiaram-nos	paroquiar+V.ele.ACC.3.M.PL+PRF+3+PL
paroquiaram-nos	paroquiar+V.nós.AD.1.PL+PQP+3+PL
paroquiaram-nos	paroquiar+V.nós.AD.1.PL+PRF+3+PL
paroquiáramo-la	paroquiar+V.ele.ACC.3.F.SG+PQP+1+PL
paroquiáramo-las	paroquiar+V.ele.ACC.3.F.PL+PQP+1+PL
paroquiáramo-lo	paroquiar+V.ele.ACC.3.M.SG+PQP+1+PL
paroquiáramo-los	paroquiar+V.ele.ACC.3.M.PL+PQP+1+PL
paroquiáramo-nos	paroquiar+nós.AD.1.PL+PQP+1+PL
paroquiáramos-lhe	paroquiar+V.ele.DAT.3.SG+PQP+1+PL
paroquiáramos-lhes	paroquiar+V.ele.DAT.3.PL+PQP+1+PL
paroquiáramos-me	paroquiar+V.eu.AD.1.SG+PQP+1+PL
paroquiáramos-te	paroquiar+V.tu.AD.2.SG+PQP+1+PL
paroquiáramos-vos	paroquiar+V.vós.AD.2.PL+PQP+1+PL
paroquiaram-se	paroquiar+V.ele.REFL+PQP+3+PL
paroquiaram-se	paroquiar+V.ele.REFL+PRF+3+PL
paroquiaram-te	paroquiar+V.tu.AD.2.SG+PQP+3+PL
paroquiaram-te	paroquiar+V.tu.AD.2.SG+PRF+3+PL
paroquiaram-vos	paroquiar+V.vós.AD.2.PL+PQP+3+PL
paroquiaram-vos	paroquiar+V.vós.AD.2.PL+PRF+3+PL
paroquiara-nos	paroquiar+nós.AD.1.PL+PQP+1+SG
paroquiara-nos	paroquiar+nós.AD.1.PL+PQP+2+SG
paroquiara-nos	paroquiar+nós.AD.1.PL+PQP+3+SG
paroquiara-o	paroquiar+V.ele.ACC.3.M.SG+PQP+1+SG
paroquiara-o	paroquiar+V.ele.ACC.3.M.SG+PQP+3+SG
paroquiara-os	paroquiar+V.ele.ACC.3.M.PL+PQP+1+SG
paroquiara-os	paroquiar+V.ele.ACC.3.M.PL+PQP+3+SG
paroquiara-se	paroquiar+V.ele.REFL+PQP+1+SG
paroquiara-se	paroquiar+V.ele.REFL+PQP+3+SG
paroquiaras-lhe	paroquiar+V.ele.DAT.3.SG+PQP+2+SG
paroquiaras-lhes	paroquiar+V.ele.DAT.3.PL+PQP+2+SG
paroquiaras-me	paroquiar+V.eu.AD.1.SG+PQP+2+SG
paroquiaras-te	paroquiar+V.tu.AD.2.SG+PQP+2+SG
paroquiaras-vos	paroquiar+V.vós.AD.2.PL+PQP+2+SG
paroquiara-te	paroquiar+V.tu.AD.2.SG+PQP+1+SG
paroquiara-te	paroquiar+V.tu.AD.2.SG+PQP+3+SG
paroquiara-vos	paroquiar+V.vós.AD.2.PL+PQP+1+SG
paroquiara-vos	paroquiar+V.vós.AD.2.PL+PQP+3+SG
paroquiarde-la	paroquiar+V.ele.ACC.3.F.SG+INF+2+PL
paroquiarde-la	paroquiar+V.ele.ACC.3.F.SG+SBJF+2+PL
paroquiarde-las	paroquiar+V.ele.ACC.3.F.PL+INF+2+PL
paroquiarde-las	paroquiar+V.ele.ACC.3.F.PL+SBJF+2+PL
paroquiarde-lo	paroquiar+V.ele.ACC.3.M.SG+INF+2+PL
paroquiarde-lo	paroquiar+V.ele.ACC.3.M.SG+SBJF+2+PL
paroquiarde-los	paroquiar+V.ele.ACC.3.M.PL+INF+2+PL
paroquiarde-los	paroquiar+V.ele.ACC.3.M.PL+SBJF+2+PL
paroquiarde-nos	paroquiar+nós.AD.1.PL+INF+2+PL
paroquiarde-nos	paroquiar+nós.AD.1.PL+SBJF+2+PL
paroquiardes-lhe	paroquiar+V.ele.DAT.3.SG+INF+2+PL
paroquiardes-lhe	paroquiar+V.ele.DAT.3.SG+SBJF+2+PL
paroquiardes-lhes	paroquiar+V.ele.DAT.3.PL+INF+2+PL
paroquiardes-lhes	paroquiar+V.ele.DAT.3.PL+SBJF+2+PL
paroquiardes-me	paroquiar+V.eu.AD.1.SG+INF+2+PL
paroquiardes-me	paroquiar+V.eu.AD.1.SG+SBJF+2+PL
paroquiardes-te	paroquiar+V.tu.AD.2.SG+INF+2+PL
paroquiardes-te	paroquiar+V.tu.AD.2.SG+SBJF+2+PL
paroquiardes-vos	paroquiar+V.vós.AD.2.PL+INF+2+PL
paroquiardes-vos	paroquiar+V.vós.AD.2.PL+SBJF+2+PL
paroquiárei-la	paroquiar+V.ele.ACC.3.F.SG+PQP+2+PL
paroquiárei-las	paroquiar+V.ele.ACC.3.F.PL+PQP+2+PL
paroquiárei-lo	paroquiar+V.ele.ACC.3.M.SG+PQP+2+PL
paroquiárei-los	paroquiar+V.ele.ACC.3.M.PL+PQP+2+PL
paroquiárei-nos	paroquiar+nós.AD.1.PL+PQP+2+PL
paroquiáreis-lhe	paroquiar+V.ele.DAT.3.SG+PQP+2+PL
paroquiáreis-lhes	paroquiar+V.ele.DAT.3.PL+PQP+2+PL
paroquiáreis-me	paroquiar+V.eu.AD.1.SG+PQP+2+PL
paroquiáreis-te	paroquiar+V.tu.AD.2.SG+PQP+2+PL
paroquiáreis-vos	paroquiar+V.vós.AD.2.PL+PQP+2+PL
paroquiare-la	paroquiar+V.ele.ACC.3.F.SG+INF+2+SG
paroquiare-la	paroquiar+V.ele.ACC.3.F.SG+SBJF+2+SG
paroquiare-las	paroquiar+V.ele.ACC.3.F.PL+INF+2+SG
paroquiare-las	paroquiar+V.ele.ACC.3.F.PL+SBJF+2+SG
paroquiare-lo	paroquiar+V.ele.ACC.3.M.SG+INF+2+SG
paroquiare-lo	paroquiar+V.ele.ACC.3.M.SG+SBJF+2+SG
paroquiare-los	paroquiar+V.ele.ACC.3.M.PL+INF+2+SG
paroquiare-los	paroquiar+V.ele.ACC.3.M.PL+SBJF+2+SG
paroquiarem-lhe	paroquiar+V.ele.DAT.3.SG+INF+3+PL
paroquiarem-lhe	paroquiar+V.ele.DAT.3.SG+SBJF+3+PL
paroquiarem-lhes	paroquiar+V.ele.DAT.3.PL+INF+3+PL
paroquiarem-lhes	paroquiar+V.ele.DAT.3.PL+SBJF+3+PL
paroquiarem-me	paroquiar+V.eu.AD.1.SG+INF+3+PL
paroquiarem-me	paroquiar+V.eu.AD.1.SG+SBJF+3+PL
paroquiarem-na	paroquiar+V.ele.ACC.3.F.SG+INF+3+PL
paroquiarem-na	paroquiar+V.ele.ACC.3.F.SG+SBJF+3+PL
paroquiarem-nas	paroquiar+V.ele.ACC.3.F.PL+INF+3+PL
paroquiarem-nas	paroquiar+V.ele.ACC.3.F.PL+SBJF+3+PL
paroquiarem-no	paroquiar+V.ele.ACC.3.M.SG+INF+3+PL
paroquiarem-no	paroquiar+V.ele.ACC.3.M.SG+SBJF+3+PL
paroquiarem-nos	paroquiar+V.ele.ACC.3.M.PL+INF+3+PL
paroquiarem-nos	paroquiar+V.ele.ACC.3.M.PL+SBJF+3+PL
paroquiarem-nos	paroquiar+V.nós.AD.1.PL+INF+3+PL
paroquiarem-nos	paroquiar+V.nós.AD.1.PL+SBJF+3+PL
paroquiarem-se	paroquiar+V.ele.REFL+INF+3+PL
paroquiarem-se	paroquiar+V.ele.REFL+SBJF+3+PL
paroquiarem-te	paroquiar+V.tu.AD.2.SG+INF+3+PL
paroquiarem-te	paroquiar+V.tu.AD.2.SG+SBJF+3+PL
paroquiarem-vos	paroquiar+V.vós.AD.2.PL+INF+3+PL
paroquiarem-vos	paroquiar+V.vós.AD.2.PL+SBJF+3+PL
paroquiare-nos	paroquiar+nós.AD.1.PL+INF+2+SG
paroquiare-nos	paroquiar+nós.AD.1.PL+SBJF+2+SG
paroquiares-lhe	paroquiar+V.ele.DAT.3.SG+INF+2+SG
paroquiares-lhe	paroquiar+V.ele.DAT.3.SG+SBJF+2+SG
paroquiares-lhes	paroquiar+V.ele.DAT.3.PL+INF+2+SG
paroquiares-lhes	paroquiar+V.ele.DAT.3.PL+SBJF+2+SG
paroquiares-me	paroquiar+V.eu.AD.1.SG+INF+2+SG
paroquiares-me	paroquiar+V.eu.AD.1.SG+SBJF+2+SG
paroquiares-te	paroquiar+V.tu.AD.2.SG+INF+2+SG
paroquiares-te	paroquiar+V.tu.AD.2.SG+SBJF+2+SG
paroquiares-vos	paroquiar+V.vós.AD.2.PL+INF+2+SG
paroquiares-vos	paroquiar+V.vós.AD.2.PL+SBJF+2+SG
paroquiar-lhe-ão	paroquiar+V.ele.DAT.3.SG+FUT+3+PL
paroquiar-lhe-á	paroquiar+V.ele.DAT.3.SG+FUT+3+SG
paroquiar-lhe-ás	paroquiar+V.ele.DAT.3.SG+FUT+2+SG
paroquiar-lhe-ei	paroquiar+V.ele.DAT.3.SG+FUT+1+SG
paroquiar-lhe-eis	paroquiar+V.ele.DAT.3.SG+FUT+2+PL
paroquiar-lhe-emos	paroquiar+V.ele.DAT.3.SG+FUT+1+PL
paroquiar-lhe-íamos	paroquiar+V.ele.DAT.3.SG+COND+1+PL
paroquiar-lhe-iam	paroquiar+V.ele.DAT.3.SG+COND+3+PL
paroquiar-lhe-ia	paroquiar+V.ele.DAT.3.SG+COND+1+SG
paroquiar-lhe-ia	paroquiar+V.ele.DAT.3.SG+COND+3+SG
paroquiar-lhe-ias	paroquiar+V.ele.DAT.3.SG+COND+2+SG
paroquiar-lhe-íeis	paroquiar+V.ele.DAT.3.SG+COND+2+PL
paroquiar-lhe	paroquiar+V.ele.DAT.3.SG+INF
paroquiar-lhe	paroquiar+V.ele.DAT.3.SG+INF+1+SG
paroquiar-lhe	paroquiar+V.ele.DAT.3.SG+INF+3+SG
paroquiar-lhe	paroquiar+V.ele.DAT.3.SG+SBJF+1+SG
paroquiar-lhe	paroquiar+V.ele.DAT.3.SG+SBJF+3+SG
paroquiar-lhes-ão	paroquiar+V.ele.DAT.3.PL+FUT+3+PL
paroquiar-lhes-á	paroquiar+V.ele.DAT.3.PL+FUT+3+SG
paroquiar-lhes-ás	paroquiar+V.ele.DAT.3.PL+FUT+2+SG
paroquiar-lhes-ei	paroquiar+V.ele.DAT.3.PL+FUT+1+SG
paroquiar-lhes-eis	paroquiar+V.ele.DAT.3.PL+FUT+2+PL
paroquiar-lhes-emos	paroquiar+V.ele.DAT.3.PL+FUT+1+PL
paroquiar-lhes-íamos	paroquiar+V.ele.DAT.3.PL+COND+1+PL
paroquiar-lhes-iam	paroquiar+V.ele.DAT.3.PL+COND+3+PL
paroquiar-lhes-ia	paroquiar+V.ele.DAT.3.PL+COND+1+SG
paroquiar-lhes-ia	paroquiar+V.ele.DAT.3.PL+COND+3+SG
paroquiar-lhes-ias	paroquiar+V.ele.DAT.3.PL+COND+2+SG
paroquiar-lhes-íeis	paroquiar+V.ele.DAT.3.PL+COND+2+PL
paroquiar-lhes	paroquiar+V.ele.DAT.3.PL+INF
paroquiar-lhes	paroquiar+V.ele.DAT.3.PL+INF+1+SG
paroquiar-lhes	paroquiar+V.ele.DAT.3.PL+INF+3+SG
paroquiar-lhes	paroquiar+V.ele.DAT.3.PL+SBJF+1+SG
paroquiar-lhes	paroquiar+V.ele.DAT.3.PL+SBJF+3+SG
paroquiar-me-ão	paroquiar+V.eu.AD.1.SG+FUT+3+PL
paroquiar-me-á	paroquiar+V.eu.AD.1.SG+FUT+3+SG
paroquiar-me-ás	paroquiar+V.eu.AD.1.SG+FUT+2+SG
paroquiar-me-ei	paroquiar+V.eu.AD.1.SG+FUT+1+SG
paroquiar-me-eis	paroquiar+V.eu.AD.1.SG+FUT+2+PL
paroquiar-me-emos	paroquiar+V.eu.AD.1.SG+FUT+1+PL
paroquiar-me-íamos	paroquiar+V.eu.AD.1.SG+COND+1+PL
paroquiar-me-iam	paroquiar+V.eu.AD.1.SG+COND+3+PL
paroquiar-me-ia	paroquiar+V.eu.AD.1.SG+COND+1+SG
paroquiar-me-ia	paroquiar+V.eu.AD.1.SG+COND+3+SG
paroquiar-me-ias	paroquiar+V.eu.AD.1.SG+COND+2+SG
paroquiar-me-íeis	paroquiar+V.eu.AD.1.SG+COND+2+PL
paroquiar-me	paroquiar+V.eu.AD.1.SG+INF
paroquiar-me	paroquiar+V.eu.AD.1.SG+INF+1+SG
paroquiar-me	paroquiar+V.eu.AD.1.SG+INF+3+SG
paroquiar-me	paroquiar+V.eu.AD.1.SG+SBJF+1+SG
paroquiar-me	paroquiar+V.eu.AD.1.SG+SBJF+3+SG
paroquiarmo-la	paroquiar+V.ele.ACC.3.F.SG+INF+1+PL
paroquiarmo-la	paroquiar+V.ele.ACC.3.F.SG+SBJF+1+PL
paroquiarmo-las	paroquiar+V.ele.ACC.3.F.PL+INF+1+PL
paroquiarmo-las	paroquiar+V.ele.ACC.3.F.PL+SBJF+1+PL
paroquiarmo-lo	paroquiar+V.ele.ACC.3.M.SG+INF+1+PL
paroquiarmo-lo	paroquiar+V.ele.ACC.3.M.SG+SBJF+1+PL
paroquiarmo-los	paroquiar+V.ele.ACC.3.M.PL+INF+1+PL
paroquiarmo-los	paroquiar+V.ele.ACC.3.M.PL+SBJF+1+PL
paroquiarmo-nos	paroquiar+nós.AD.1.PL+INF+1+PL
paroquiarmo-nos	paroquiar+nós.AD.1.PL+SBJF+1+PL
paroquiarmos-lhe	paroquiar+V.ele.DAT.3.SG+INF+1+PL
paroquiarmos-lhe	paroquiar+V.ele.DAT.3.SG+SBJF+1+PL
paroquiarmos-lhes	paroquiar+V.ele.DAT.3.PL+INF+1+PL
paroquiarmos-lhes	paroquiar+V.ele.DAT.3.PL+SBJF+1+PL
paroquiarmos-me	paroquiar+V.eu.AD.1.SG+INF+1+PL
paroquiarmos-me	paroquiar+V.eu.AD.1.SG+SBJF+1+PL
paroquiarmos-te	paroquiar+V.tu.AD.2.SG+INF+1+PL
paroquiarmos-te	paroquiar+V.tu.AD.2.SG+SBJF+1+PL
paroquiarmos-vos	paroquiar+V.vós.AD.2.PL+INF+1+PL
paroquiarmos-vos	paroquiar+V.vós.AD.2.PL+SBJF+1+PL
paroquiar-nos-ão	paroquiar+nós.AD.1.PL+FUT+3+PL
paroquiar-nos-á	paroquiar+nós.AD.1.PL+FUT+3+SG
paroquiar-nos-ás	paroquiar+nós.AD.1.PL+FUT+2+SG
paroquiar-nos-ei	paroquiar+nós.AD.1.PL+FUT+1+SG
paroquiar-nos-eis	paroquiar+nós.AD.1.PL+FUT+2+PL
paroquiar-nos-emos	paroquiar+nós.AD.1.PL+FUT+1+PL
paroquiar-nos-íamos	paroquiar+nós.AD.1.PL+COND+1+PL
paroquiar-nos-iam	paroquiar+nós.AD.1.PL+COND+3+PL
paroquiar-nos-ia	paroquiar+nós.AD.1.PL+COND+1+SG
paroquiar-nos-ia	paroquiar+nós.AD.1.PL+COND+3+SG
paroquiar-nos-ias	paroquiar+nós.AD.1.PL+COND+2+SG
paroquiar-nos-íeis	paroquiar+nós.AD.1.PL+COND+2+PL
paroquiar-nos	paroquiar+nós.AD.1.PL+INF
paroquiar-nos	paroquiar+nós.AD.1.PL+INF+1+SG
paroquiar-nos	paroquiar+nós.AD.1.PL+INF+3+SG
paroquiar-nos	paroquiar+nós.AD.1.PL+SBJF+1+SG
paroquiar-nos	paroquiar+nós.AD.1.PL+SBJF+3+SG
paroquiar-se-ão	paroquiar+V.ele.REFL+FUT+3+PL
paroquiar-se-á	paroquiar+V.ele.REFL+FUT+3+SG
paroquiar-se-iam	paroquiar+V.ele.REFL+COND+3+PL
paroquiar-se-ia	paroquiar+V.ele.REFL+COND+3+SG
paroquiar-se	paroquiar+V.ele.REFL+INF
paroquiar-se	paroquiar+V.ele.REFL+INF+3+SG
paroquiar-se	paroquiar+V.ele.REFL+SBJF+3+SG
paroquiar-te-ão	paroquiar+V.tu.AD.2.SG+FUT+3+PL
paroquiar-te-á	paroquiar+V.tu.AD.2.SG+FUT+3+SG
paroquiar-te-ás	paroquiar+V.tu.AD.2.SG+FUT+2+SG
paroquiar-te-ei	paroquiar+V.tu.AD.2.SG+FUT+1+SG
paroquiar-te-eis	paroquiar+V.tu.AD.2.SG+FUT+2+PL
paroquiar-te-emos	paroquiar+V.tu.AD.2.SG+FUT+1+PL
paroquiar-te-íamos	paroquiar+V.tu.AD.2.SG+COND+1+PL
paroquiar-te-iam	paroquiar+V.tu.AD.2.SG+COND+3+PL
paroquiar-te-ia	paroquiar+V.tu.AD.2.SG+COND+1+SG
paroquiar-te-ia	paroquiar+V.tu.AD.2.SG+COND+3+SG
paroquiar-te-ias	paroquiar+V.tu.AD.2.SG+COND+2+SG
paroquiar-te-íeis	paroquiar+V.tu.AD.2.SG+COND+2+PL
paroquiar-te	paroquiar+V.tu.AD.2.SG+INF
paroquiar-te	paroquiar+V.tu.AD.2.SG+INF+1+SG
paroquiar-te	paroquiar+V.tu.AD.2.SG+INF+3+SG
paroquiar-te	paroquiar+V.tu.AD.2.SG+SBJF+1+SG
paroquiar-te	paroquiar+V.tu.AD.2.SG+SBJF+3+SG
paroquiar-vos-ão	paroquiar+V.vós.AD.2.PL+FUT+3+PL
paroquiar-vos-á	paroquiar+V.vós.AD.2.PL+FUT+3+SG
paroquiar-vos-ás	paroquiar+V.vós.AD.2.PL+FUT+2+SG
paroquiar-vos-ei	paroquiar+V.vós.AD.2.PL+FUT+1+SG
paroquiar-vos-eis	paroquiar+V.vós.AD.2.PL+FUT+2+PL
paroquiar-vos-emos	paroquiar+V.vós.AD.2.PL+FUT+1+PL
paroquiar-vos-íamos	paroquiar+V.vós.AD.2.PL+COND+1+PL
paroquiar-vos-iam	paroquiar+V.vós.AD.2.PL+COND+3+PL
paroquiar-vos-ia	paroquiar+V.vós.AD.2.PL+COND+1+SG
paroquiar-vos-ia	paroquiar+V.vós.AD.2.PL+COND+3+SG
paroquiar-vos-ias	paroquiar+V.vós.AD.2.PL+COND+2+SG
paroquiar-vos-íeis	paroquiar+V.vós.AD.2.PL+COND+2+PL
paroquiar-vos	paroquiar+V.vós.AD.2.PL+INF
paroquiar-vos	paroquiar+V.vós.AD.2.PL+INF+1+SG
paroquiar-vos	paroquiar+V.vós.AD.2.PL+INF+3+SG
paroquiar-vos	paroquiar+V.vós.AD.2.PL+SBJF+1+SG
paroquiar-vos	paroquiar+V.vós.AD.2.PL+SBJF+3+SG
paroquia-se	paroquiar+V.ele.REFL+PRS+3+SG
paroquias-lhe	paroquiar+V.ele.DAT.3.SG+PRS+2+SG
paroquias-lhes	paroquiar+V.ele.DAT.3.PL+PRS+2+SG
paroquias-me	paroquiar+V.eu.AD.1.SG+PRS+2+SG
paroquiaste-a	paroquiar+V.ele.ACC.3.F.SG+PRF+2+SG
paroquiaste-as	paroquiar+V.ele.ACC.3.F.PL+PRF+2+SG
paroquiaste-la	paroquiar+V.ele.ACC.3.F.SG+PRF+2+PL
paroquiaste-las	paroquiar+V.ele.ACC.3.F.PL+PRF+2+PL
paroquiaste-lhe	paroquiar+V.ele.DAT.3.SG+PRF+2+SG
paroquiaste-lhes	paroquiar+V.ele.DAT.3.PL+PRF+2+SG
paroquiaste-lo	paroquiar+V.ele.ACC.3.M.SG+PRF+2+PL
paroquiaste-los	paroquiar+V.ele.ACC.3.M.PL+PRF+2+PL
paroquiaste-me	paroquiar+V.eu.AD.1.SG+PRF+2+SG
paroquiaste-nos	paroquiar+nós.AD.1.PL+PRF+2+PL
paroquiaste-nos	paroquiar+nós.AD.1.PL+PRF+2+SG
paroquiaste-o	paroquiar+V.ele.ACC.3.M.SG+PRF+2+SG
paroquiaste-os	paroquiar+V.ele.ACC.3.M.PL+PRF+2+SG
paroquias-te	paroquiar+V.tu.AD.2.SG+PRS+2+SG
paroquiastes-lhe	paroquiar+V.ele.DAT.3.SG+PRF+2+PL
paroquiastes-lhes	paroquiar+V.ele.DAT.3.PL+PRF+2+PL
paroquiastes-me	paroquiar+V.eu.AD.1.SG+PRF+2+PL
paroquiastes-te	paroquiar+V.tu.AD.2.SG+PRF+2+PL
paroquiastes-vos	paroquiar+V.vós.AD.2.PL+PRF+2+PL
paroquiaste-te	paroquiar+V.tu.AD.2.SG+PRF+2+SG
paroquiaste-vos	paroquiar+V.vós.AD.2.PL+PRF+2+SG
paroquias-vos	paroquiar+V.vós.AD.2.PL+PRS+2+SG
paroquia-te	paroquiar+V.tu.AD.2.SG+PRS+3+SG
paroquiava-a	paroquiar+V.ele.ACC.3.F.SG+IMPF+1+SG
paroquiava-a	paroquiar+V.ele.ACC.3.F.SG+IMPF+3+SG
paroquiava-as	paroquiar+V.ele.ACC.3.F.PL+IMPF+1+SG
paroquiava-as	paroquiar+V.ele.ACC.3.F.PL+IMPF+3+SG
paroquiava-la	paroquiar+V.ele.ACC.3.F.SG+IMPF+2+SG
paroquiava-las	paroquiar+V.ele.ACC.3.F.PL+IMPF+2+SG
paroquiava-lhe	paroquiar+V.ele.DAT.3.SG+IMPF+1+SG
paroquiava-lhe	paroquiar+V.ele.DAT.3.SG+IMPF+3+SG
paroquiava-lhes	paroquiar+V.ele.DAT.3.PL+IMPF+1+SG
paroquiava-lhes	paroquiar+V.ele.DAT.3.PL+IMPF+3+SG
paroquiava-lo	paroquiar+V.ele.ACC.3.M.SG+IMPF+2+SG
paroquiava-los	paroquiar+V.ele.ACC.3.M.PL+IMPF+2+SG
paroquiava-me	paroquiar+V.eu.AD.1.SG+IMPF+1+SG
paroquiava-me	paroquiar+V.eu.AD.1.SG+IMPF+3+SG
paroquiavam-lhe	paroquiar+V.ele.DAT.3.SG+IMPF+3+PL
paroquiavam-lhes	paroquiar+V.ele.DAT.3.PL+IMPF+3+PL
paroquiavam-me	paroquiar+V.eu.AD.1.SG+IMPF+3+PL
paroquiavam-na	paroquiar+V.ele.ACC.3.F.SG+IMPF+3+PL
paroquiavam-nas	paroquiar+V.ele.ACC.3.F.PL+IMPF+3+PL
paroquiavam-no	paroquiar+V.ele.ACC.3.M.SG+IMPF+3+PL
paroquiavam-nos	paroquiar+V.ele.ACC.3.M.PL+IMPF+3+PL
paroquiavam-nos	paroquiar+V.nós.AD.1.PL+IMPF+3+PL
paroquiávamo-la	paroquiar+V.ele.ACC.3.F.SG+IMPF+1+PL
paroquiávamo-las	paroquiar+V.ele.ACC.3.F.PL+IMPF+1+PL
paroquiávamo-lo	paroquiar+V.ele.ACC.3.M.SG+IMPF+1+PL
paroquiávamo-los	paroquiar+V.ele.ACC.3.M.PL+IMPF+1+PL
paroquiávamo-nos	paroquiar+nós.AD.1.PL+IMPF+1+PL
paroquiávamos-lhe	paroquiar+V.ele.DAT.3.SG+IMPF+1+PL
paroquiávamos-lhes	paroquiar+V.ele.DAT.3.PL+IMPF+1+PL
paroquiávamos-me	paroquiar+V.eu.AD.1.SG+IMPF+1+PL
paroquiávamos-te	paroquiar+V.tu.AD.2.SG+IMPF+1+PL
paroquiávamos-vos	paroquiar+V.vós.AD.2.PL+IMPF+1+PL
paroquiavam-se	paroquiar+V.ele.REFL+IMPF+3+PL
paroquiavam-te	paroquiar+V.tu.AD.2.SG+IMPF+3+PL
paroquiavam-vos	paroquiar+V.vós.AD.2.PL+IMPF+3+PL
paroquiava-nos	paroquiar+nós.AD.1.PL+IMPF+1+SG
paroquiava-nos	paroquiar+nós.AD.1.PL+IMPF+2+SG
paroquiava-nos	paroquiar+nós.AD.1.PL+IMPF+3+SG
paroquiava-o	paroquiar+V.ele.ACC.3.M.SG+IMPF+1+SG
paroquiava-o	paroquiar+V.ele.ACC.3.M.SG+IMPF+3+SG
paroquiava-os	paroquiar+V.ele.ACC.3.M.PL+IMPF+1+SG
paroquiava-os	paroquiar+V.ele.ACC.3.M.PL+IMPF+3+SG
paroquiava-se	paroquiar+V.ele.REFL+IMPF+1+SG
paroquiava-se	paroquiar+V.ele.REFL+IMPF+3+SG
paroquiavas-lhe	paroquiar+V.ele.DAT.3.SG+IMPF+2+SG
paroquiavas-lhes	paroquiar+V.ele.DAT.3.PL+IMPF+2+SG
paroquiavas-me	paroquiar+V.eu.AD.1.SG+IMPF+2+SG
paroquiavas-te	paroquiar+V.tu.AD.2.SG+IMPF+2+SG
paroquiavas-vos	paroquiar+V.vós.AD.2.PL+IMPF+2+SG
paroquiava-te	paroquiar+V.tu.AD.2.SG+IMPF+1+SG
paroquiava-te	paroquiar+V.tu.AD.2.SG+IMPF+3+SG
paroquiava-vos	paroquiar+V.vós.AD.2.PL+IMPF+1+SG
paroquiava-vos	paroquiar+V.vós.AD.2.PL+IMPF+3+SG
paroquiávei-la	paroquiar+V.ele.ACC.3.F.SG+IMPF+2+PL
paroquiávei-las	paroquiar+V.ele.ACC.3.F.PL+IMPF+2+PL
paroquiávei-lo	paroquiar+V.ele.ACC.3.M.SG+IMPF+2+PL
paroquiávei-los	paroquiar+V.ele.ACC.3.M.PL+IMPF+2+PL
paroquiávei-nos	paroquiar+nós.AD.1.PL+IMPF+2+PL
paroquiáveis-lhe	paroquiar+V.ele.DAT.3.SG+IMPF+2+PL
paroquiáveis-lhes	paroquiar+V.ele.DAT.3.PL+IMPF+2+PL
paroquiáveis-me	paroquiar+V.eu.AD.1.SG+IMPF+2+PL
paroquiáveis-te	paroquiar+V.tu.AD.2.SG+IMPF+2+PL
paroquiáveis-vos	paroquiar+V.vós.AD.2.PL+IMPF+2+PL
paroquia-vos	paroquiar+V.vós.AD.2.PL+PRS+3+SG
paroquie-a	paroquiar+V.ele.ACC.3.F.SG+IMP+3+SG
paroquie-as	paroquiar+V.ele.ACC.3.F.PL+IMP+3+SG
paroquiei-a	paroquiar+V.ele.ACC.3.F.SG+PRF+1+SG
paroquiei-as	paroquiar+V.ele.ACC.3.F.PL+PRF+1+SG
paroquiei-lhe	paroquiar+V.ele.DAT.3.SG+PRF+1+SG
paroquiei-lhes	paroquiar+V.ele.DAT.3.PL+PRF+1+SG
paroquiei-me	paroquiar+V.eu.AD.1.SG+PRF+1+SG
paroquiei-nos	paroquiar+nós.AD.1.PL+PRF+1+SG
paroquiei-o	paroquiar+V.ele.ACC.3.M.SG+PRF+1+SG
paroquiei-os	paroquiar+V.ele.ACC.3.M.PL+PRF+1+SG
paroquiei-te	paroquiar+V.tu.AD.2.SG+PRF+1+SG
paroquiei-vos	paroquiar+V.vós.AD.2.PL+PRF+1+SG
paroquie-lhe	paroquiar+V.ele.DAT.3.SG+IMP+3+SG
paroquie-lhes	paroquiar+V.ele.DAT.3.PL+IMP+3+SG
paroquie-me	paroquiar+V.eu.AD.1.SG+IMP+3+SG
paroquiem-lhe	paroquiar+V.ele.DAT.3.SG+IMP+3+PL
paroquiem-lhes	paroquiar+V.ele.DAT.3.PL+IMP+3+PL
paroquiem-me	paroquiar+V.eu.AD.1.SG+IMP+3+PL
paroquiem-na	paroquiar+V.ele.ACC.3.F.SG+IMP+3+PL
paroquiem-nas	paroquiar+V.ele.ACC.3.F.PL+IMP+3+PL
paroquiem-no	paroquiar+V.ele.ACC.3.M.SG+IMP+3+PL
paroquiem-nos	paroquiar+V.ele.ACC.3.M.PL+IMP+3+PL
paroquiem-nos	paroquiar+V.nós.AD.1.PL+IMP+3+PL
paroquiemo-la	paroquiar+V.ele.ACC.3.F.SG+IMP+1+PL
paroquiemo-las	paroquiar+V.ele.ACC.3.F.PL+IMP+1+PL
paroquiemo-lo	paroquiar+V.ele.ACC.3.M.SG+IMP+1+PL
paroquiemo-los	paroquiar+V.ele.ACC.3.M.PL+IMP+1+PL
paroquiemo-nos	paroquiar+nós.AD.1.PL+IMP+1+PL
paroquiemos-lhe	paroquiar+V.ele.DAT.3.SG+IMP+1+PL
paroquiemos-lhes	paroquiar+V.ele.DAT.3.PL+IMP+1+PL
paroquiemos-me	paroquiar+V.eu.AD.1.SG+IMP+1+PL
paroquiemos-te	paroquiar+V.tu.AD.2.SG+IMP+1+PL
paroquiemos-vos	paroquiar+V.vós.AD.2.PL+IMP+1+PL
paroquiem-se	paroquiar+V.ele.REFL+IMP+3+PL
paroquiem-te	paroquiar+V.tu.AD.2.SG+IMP+3+PL
paroquiem-vos	paroquiar+V.vós.AD.2.PL+IMP+3+PL
paroquie-nos	paroquiar+nós.AD.1.PL+IMP+3+SG
paroquie-o	paroquiar+V.ele.ACC.3.M.SG+IMP+3+SG
paroquie-os	paroquiar+V.ele.ACC.3.M.PL+IMP+3+SG
paroquie-se	paroquiar+V.ele.REFL+IMP+3+SG
paroquie-te	paroquiar+V.tu.AD.2.SG+IMP+3+SG
paroquie-vos	paroquiar+V.vós.AD.2.PL+IMP+3+SG
paroquio-a	paroquiar+V.ele.ACC.3.F.SG+PRS+1+SG
paroquio-as	paroquiar+V.ele.ACC.3.F.PL+PRS+1+SG
paroquio-lhe	paroquiar+V.ele.DAT.3.SG+PRS+1+SG
paroquio-lhes	paroquiar+V.ele.DAT.3.PL+PRS+1+SG
paroquio-me	paroquiar+V.eu.AD.1.SG+PRS+1+SG
paroquio-nos	paroquiar+nós.AD.1.PL+PRS+1+SG
paroquio-o	paroquiar+V.ele.ACC.3.M.SG+PRS+1+SG
paroquio-os	paroquiar+V.ele.ACC.3.M.PL+PRS+1+SG
paroquio-te	paroquiar+V.tu.AD.2.SG+PRS+1+SG
paroquiou-a	paroquiar+V.ele.ACC.3.F.SG+PRF+3+SG
paroquiou-as	paroquiar+V.ele.ACC.3.F.PL+PRF+3+SG
paroquiou-lhe	paroquiar+V.ele.DAT.3.SG+PRF+3+SG
paroquiou-lhes	paroquiar+V.ele.DAT.3.PL+PRF+3+SG
paroquiou-me	paroquiar+V.eu.AD.1.SG+PRF+3+SG
paroquiou-nos	paroquiar+nós.AD.1.PL+PRF+3+SG
paroquiou-o	paroquiar+V.ele.ACC.3.M.SG+PRF+3+SG
paroquiou-os	paroquiar+V.ele.ACC.3.M.PL+PRF+3+SG
paroquiou-se	paroquiar+V.ele.REFL+PRF+3+SG
paroquiou-te	paroquiar+V.tu.AD.2.SG+PRF+3+SG
paroquiou-vos	paroquiar+V.vós.AD.2.PL+PRF+3+SG
paroquio-vos	paroquiar+V.vós.AD.2.PL+PRS+1+SG
paro-te	parar+V.tu.AD.2.SG+PRS+1+SG
parou-a	parar+V.ele.ACC.3.F.SG+PRF+3+SG
parou-as	parar+V.ele.ACC.3.F.PL+PRF+3+SG
parou-lhe	parar+V.ele.DAT.3.SG+PRF+3+SG
parou-lhes	parar+V.ele.DAT.3.PL+PRF+3+SG
parou-me	parar+V.eu.AD.1.SG+PRF+3+SG
parou-nos	parar+nós.AD.1.PL+PRF+3+SG
parou-o	parar+V.ele.ACC.3.M.SG+PRF+3+SG
parou-os	parar+V.ele.ACC.3.M.PL+PRF+3+SG
parou-se	parar+V.ele.REFL+PRF+3+SG
parou-te	parar+V.tu.AD.2.SG+PRF+3+SG
parou-vos	parar+V.vós.AD.2.PL+PRF+3+SG
paro-vos	parar+V.vós.AD.2.PL+PRS+1+SG
parqueai-la	parquear+V.ele.ACC.3.F.SG+PRS+2+PL
parqueai-las	parquear+V.ele.ACC.3.F.PL+PRS+2+PL
parqueai-lo	parquear+V.ele.ACC.3.M.SG+PRS+2+PL
parqueai-los	parquear+V.ele.ACC.3.M.PL+PRS+2+PL
parqueai-nos	parquear+nós.AD.1.PL+PRS+2+PL
parqueais-lhe	parquear+V.ele.DAT.3.SG+PRS+2+PL
parqueais-lhes	parquear+V.ele.DAT.3.PL+PRS+2+PL
parqueais-me	parquear+V.eu.AD.1.SG+PRS+2+PL
parqueais-te	parquear+V.tu.AD.2.SG+PRS+2+PL
parqueais-vos	parquear+V.vós.AD.2.PL+PRS+2+PL
parqueá-la-ão	parquear+V.ele.ACC.3.F.SG+FUT+3+PL
parqueá-la-á	parquear+V.ele.ACC.3.F.SG+FUT+3+SG
parqueá-la-ás	parquear+V.ele.ACC.3.F.SG+FUT+2+SG
parqueá-la-ei	parquear+V.ele.ACC.3.F.SG+FUT+1+SG
parqueá-la-eis	parquear+V.ele.ACC.3.F.SG+FUT+2+PL
parqueá-la-emos	parquear+V.ele.ACC.3.F.SG+FUT+1+PL
parqueá-la-íamos	parquear+V.ele.ACC.3.F.SG+COND+1+PL
parqueá-la-iam	parquear+V.ele.ACC.3.F.SG+COND+3+PL
parqueá-la-ia	parquear+V.ele.ACC.3.F.SG+COND+1+SG
parqueá-la-ia	parquear+V.ele.ACC.3.F.SG+COND+3+SG
parqueá-la-ias	parquear+V.ele.ACC.3.F.SG+COND+2+SG
parqueá-la-íeis	parquear+V.ele.ACC.3.F.SG+COND+2+PL
parqueá-la	parquear+V.ele.ACC.3.F.SG+INF+1+SG
parqueá-la	parquear+V.ele.ACC.3.F.SG+INF+3+SG
parqueá-la	parquear+V.ele.ACC.3.F.SG+SBJF+1+SG
parqueá-la	parquear+V.ele.ACC.3.F.SG+SBJF+3+SG
parqueá-las-ão	parquear+V.ele.ACC.3.F.PL+FUT+3+PL
parqueá-las-á	parquear+V.ele.ACC.3.F.PL+FUT+3+SG
parqueá-las-ás	parquear+V.ele.ACC.3.F.PL+FUT+2+SG
parqueá-las-ei	parquear+V.ele.ACC.3.F.PL+FUT+1+SG
parqueá-las-eis	parquear+V.ele.ACC.3.F.PL+FUT+2+PL
parqueá-las-emos	parquear+V.ele.ACC.3.F.PL+FUT+1+PL
parqueá-las-íamos	parquear+V.ele.ACC.3.F.PL+COND+1+PL
parqueá-las-iam	parquear+V.ele.ACC.3.F.PL+COND+3+PL
parqueá-las-ia	parquear+V.ele.ACC.3.F.PL+COND+1+SG
parqueá-las-ia	parquear+V.ele.ACC.3.F.PL+COND+3+SG
parqueá-las-ias	parquear+V.ele.ACC.3.F.PL+COND+2+SG
parqueá-las-íeis	parquear+V.ele.ACC.3.F.PL+COND+2+PL
parqueá-las	parquear+V.ele.ACC.3.F.PL+INF+1+SG
parqueá-las	parquear+V.ele.ACC.3.F.PL+INF+3+SG
parqueá-las	parquear+V.ele.ACC.3.F.PL+SBJF+1+SG
parqueá-las	parquear+V.ele.ACC.3.F.PL+SBJF+3+SG
parqueá-lo-ão	parquear+V.ele.ACC.3.M.SG+FUT+3+PL
parqueá-lo-á	parquear+V.ele.ACC.3.M.SG+FUT+3+SG
parqueá-lo-ás	parquear+V.ele.ACC.3.M.SG+FUT+2+SG
parqueá-lo-ei	parquear+V.ele.ACC.3.M.SG+FUT+1+SG
parqueá-lo-eis	parquear+V.ele.ACC.3.M.SG+FUT+2+PL
parqueá-lo-emos	parquear+V.ele.ACC.3.M.SG+FUT+1+PL
parqueá-lo-íamos	parquear+V.ele.ACC.3.M.SG+COND+1+PL
parqueá-lo-iam	parquear+V.ele.ACC.3.M.SG+COND+3+PL
parqueá-lo-ia	parquear+V.ele.ACC.3.M.SG+COND+1+SG
parqueá-lo-ia	parquear+V.ele.ACC.3.M.SG+COND+3+SG
parqueá-lo-ias	parquear+V.ele.ACC.3.M.SG+COND+2+SG
parqueá-lo-íeis	parquear+V.ele.ACC.3.M.SG+COND+2+PL
parqueá-lo	parquear+V.ele.ACC.3.M.SG+INF+1+SG
parqueá-lo	parquear+V.ele.ACC.3.M.SG+INF+3+SG
parqueá-lo	parquear+V.ele.ACC.3.M.SG+SBJF+1+SG
parqueá-lo	parquear+V.ele.ACC.3.M.SG+SBJF+3+SG
parqueá-los-ão	parquear+V.ele.ACC.3.M.PL+FUT+3+PL
parqueá-los-á	parquear+V.ele.ACC.3.M.PL+FUT+3+SG
parqueá-los-ás	parquear+V.ele.ACC.3.M.PL+FUT+2+SG
parqueá-los-ei	parquear+V.ele.ACC.3.M.PL+FUT+1+SG
parqueá-los-eis	parquear+V.ele.ACC.3.M.PL+FUT+2+PL
parqueá-los-emos	parquear+V.ele.ACC.3.M.PL+FUT+1+PL
parqueá-los-íamos	parquear+V.ele.ACC.3.M.PL+COND+1+PL
parqueá-los-iam	parquear+V.ele.ACC.3.M.PL+COND+3+PL
parqueá-los-ia	parquear+V.ele.ACC.3.M.PL+COND+1+SG
parqueá-los-ia	parquear+V.ele.ACC.3.M.PL+COND+3+SG
parqueá-los-ias	parquear+V.ele.ACC.3.M.PL+COND+2+SG
parqueá-los-íeis	parquear+V.ele.ACC.3.M.PL+COND+2+PL
parqueá-los	parquear+V.ele.ACC.3.M.PL+INF+1+SG
parqueá-los	parquear+V.ele.ACC.3.M.PL+INF+3+SG
parqueá-los	parquear+V.ele.ACC.3.M.PL+SBJF+1+SG
parqueá-los	parquear+V.ele.ACC.3.M.PL+SBJF+3+SG
parqueamo-la	parquear+V.ele.ACC.3.F.SG+PRF+1+PL
parqueamo-la	parquear+V.ele.ACC.3.F.SG+PRS+1+PL
parqueamo-las	parquear+V.ele.ACC.3.F.PL+PRF+1+PL
parqueamo-las	parquear+V.ele.ACC.3.F.PL+PRS+1+PL
parqueamo-lo	parquear+V.ele.ACC.3.M.SG+PRF+1+PL
parqueamo-lo	parquear+V.ele.ACC.3.M.SG+PRS+1+PL
parqueamo-los	parquear+V.ele.ACC.3.M.PL+PRF+1+PL
parqueamo-los	parquear+V.ele.ACC.3.M.PL+PRS+1+PL
parqueamo-nos	parquear+nós.AD.1.PL+PRF+1+PL
parqueamo-nos	parquear+nós.AD.1.PL+PRS+1+PL
parqueamos-lhe	parquear+V.ele.DAT.3.SG+PRF+1+PL
parqueamos-lhe	parquear+V.ele.DAT.3.SG+PRS+1+PL
parqueamos-lhes	parquear+V.ele.DAT.3.PL+PRF+1+PL
parqueamos-lhes	parquear+V.ele.DAT.3.PL+PRS+1+PL
parqueamos-me	parquear+V.eu.AD.1.SG+PRF+1+PL
parqueamos-me	parquear+V.eu.AD.1.SG+PRS+1+PL
parqueamos-te	parquear+V.tu.AD.2.SG+PRF+1+PL
parqueamos-te	parquear+V.tu.AD.2.SG+PRS+1+PL
parqueamos-vos	parquear+V.vós.AD.2.PL+PRF+1+PL
parqueamos-vos	parquear+V.vós.AD.2.PL+PRS+1+PL
parqueando-a	parquear+V.ele.ACC.3.F.SG+GRD
parqueando-as	parquear+V.ele.ACC.3.F.PL+GRD
parqueando-lhe	parquear+V.ele.DAT.3.SG+GRD
parqueando-lhes	parquear+V.ele.DAT.3.PL+GRD
parqueando-me	parquear+V.eu.AD.1.SG+GRD
parqueando-nos	parquear+nós.AD.1.PL+GRD
parqueando-o	parquear+V.ele.ACC.3.M.SG+GRD
parqueando-os	parquear+V.ele.ACC.3.M.PL+GRD
parqueando-se	parquear+V.ele.REFL+GRD
parqueando-te	parquear+V.tu.AD.2.SG+GRD
parqueando-vos	parquear+V.vós.AD.2.PL+GRD
parqueara-a	parquear+V.ele.ACC.3.F.SG+PQP+1+SG
parqueara-a	parquear+V.ele.ACC.3.F.SG+PQP+3+SG
parqueara-as	parquear+V.ele.ACC.3.F.PL+PQP+1+SG
parqueara-as	parquear+V.ele.ACC.3.F.PL+PQP+3+SG
parqueara-la	parquear+V.ele.ACC.3.F.SG+PQP+2+SG
parqueara-las	parquear+V.ele.ACC.3.F.PL+PQP+2+SG
parqueara-lhe	parquear+V.ele.DAT.3.SG+PQP+1+SG
parqueara-lhe	parquear+V.ele.DAT.3.SG+PQP+3+SG
parqueara-lhes	parquear+V.ele.DAT.3.PL+PQP+1+SG
parqueara-lhes	parquear+V.ele.DAT.3.PL+PQP+3+SG
parqueara-lo	parquear+V.ele.ACC.3.M.SG+PQP+2+SG
parqueara-los	parquear+V.ele.ACC.3.M.PL+PQP+2+SG
parqueara-me	parquear+V.eu.AD.1.SG+PQP+1+SG
parqueara-me	parquear+V.eu.AD.1.SG+PQP+3+SG
parquearam-lhe	parquear+V.ele.DAT.3.SG+PQP+3+PL
parquearam-lhe	parquear+V.ele.DAT.3.SG+PRF+3+PL
parquearam-lhes	parquear+V.ele.DAT.3.PL+PQP+3+PL
parquearam-lhes	parquear+V.ele.DAT.3.PL+PRF+3+PL
parquearam-me	parquear+V.eu.AD.1.SG+PQP+3+PL
parquearam-me	parquear+V.eu.AD.1.SG+PRF+3+PL
parquearam-na	parquear+V.ele.ACC.3.F.SG+PQP+3+PL
parquearam-na	parquear+V.ele.ACC.3.F.SG+PRF+3+PL
parquearam-nas	parquear+V.ele.ACC.3.F.PL+PQP+3+PL
parquearam-nas	parquear+V.ele.ACC.3.F.PL+PRF+3+PL
parquearam-no	parquear+V.ele.ACC.3.M.SG+PQP+3+PL
parquearam-no	parquear+V.ele.ACC.3.M.SG+PRF+3+PL
parquearam-nos	parquear+V.ele.ACC.3.M.PL+PQP+3+PL
parquearam-nos	parquear+V.ele.ACC.3.M.PL+PRF+3+PL
parquearam-nos	parquear+V.nós.AD.1.PL+PQP+3+PL
parquearam-nos	parquear+V.nós.AD.1.PL+PRF+3+PL
parqueáramo-la	parquear+V.ele.ACC.3.F.SG+PQP+1+PL
parqueáramo-las	parquear+V.ele.ACC.3.F.PL+PQP+1+PL
parqueáramo-lo	parquear+V.ele.ACC.3.M.SG+PQP+1+PL
parqueáramo-los	parquear+V.ele.ACC.3.M.PL+PQP+1+PL
parqueáramo-nos	parquear+nós.AD.1.PL+PQP+1+PL
parqueáramos-lhe	parquear+V.ele.DAT.3.SG+PQP+1+PL
parqueáramos-lhes	parquear+V.ele.DAT.3.PL+PQP+1+PL
parqueáramos-me	parquear+V.eu.AD.1.SG+PQP+1+PL
parqueáramos-te	parquear+V.tu.AD.2.SG+PQP+1+PL
parqueáramos-vos	parquear+V.vós.AD.2.PL+PQP+1+PL
parquearam-se	parquear+V.ele.REFL+PQP+3+PL
parquearam-se	parquear+V.ele.REFL+PRF+3+PL
parquearam-te	parquear+V.tu.AD.2.SG+PQP+3+PL
parquearam-te	parquear+V.tu.AD.2.SG+PRF+3+PL
parquearam-vos	parquear+V.vós.AD.2.PL+PQP+3+PL
parquearam-vos	parquear+V.vós.AD.2.PL+PRF+3+PL
parqueara-nos	parquear+nós.AD.1.PL+PQP+1+SG
parqueara-nos	parquear+nós.AD.1.PL+PQP+2+SG
parqueara-nos	parquear+nós.AD.1.PL+PQP+3+SG
parqueara-o	parquear+V.ele.ACC.3.M.SG+PQP+1+SG
parqueara-o	parquear+V.ele.ACC.3.M.SG+PQP+3+SG
parqueara-os	parquear+V.ele.ACC.3.M.PL+PQP+1+SG
parqueara-os	parquear+V.ele.ACC.3.M.PL+PQP+3+SG
parqueara-se	parquear+V.ele.REFL+PQP+1+SG
parqueara-se	parquear+V.ele.REFL+PQP+3+SG
parquearas-lhe	parquear+V.ele.DAT.3.SG+PQP+2+SG
parquearas-lhes	parquear+V.ele.DAT.3.PL+PQP+2+SG
parquearas-me	parquear+V.eu.AD.1.SG+PQP+2+SG
parquearas-te	parquear+V.tu.AD.2.SG+PQP+2+SG
parquearas-vos	parquear+V.vós.AD.2.PL+PQP+2+SG
parqueara-te	parquear+V.tu.AD.2.SG+PQP+1+SG
parqueara-te	parquear+V.tu.AD.2.SG+PQP+3+SG
parqueara-vos	parquear+V.vós.AD.2.PL+PQP+1+SG
parqueara-vos	parquear+V.vós.AD.2.PL+PQP+3+SG
parquearde-la	parquear+V.ele.ACC.3.F.SG+INF+2+PL
parquearde-la	parquear+V.ele.ACC.3.F.SG+SBJF+2+PL
parquearde-las	parquear+V.ele.ACC.3.F.PL+INF+2+PL
parquearde-las	parquear+V.ele.ACC.3.F.PL+SBJF+2+PL
parquearde-lo	parquear+V.ele.ACC.3.M.SG+INF+2+PL
parquearde-lo	parquear+V.ele.ACC.3.M.SG+SBJF+2+PL
parquearde-los	parquear+V.ele.ACC.3.M.PL+INF+2+PL
parquearde-los	parquear+V.ele.ACC.3.M.PL+SBJF+2+PL
parquearde-nos	parquear+nós.AD.1.PL+INF+2+PL
parquearde-nos	parquear+nós.AD.1.PL+SBJF+2+PL
parqueardes-lhe	parquear+V.ele.DAT.3.SG+INF+2+PL
parqueardes-lhe	parquear+V.ele.DAT.3.SG+SBJF+2+PL
parqueardes-lhes	parquear+V.ele.DAT.3.PL+INF+2+PL
parqueardes-lhes	parquear+V.ele.DAT.3.PL+SBJF+2+PL
parqueardes-me	parquear+V.eu.AD.1.SG+INF+2+PL
parqueardes-me	parquear+V.eu.AD.1.SG+SBJF+2+PL
parqueardes-te	parquear+V.tu.AD.2.SG+INF+2+PL
parqueardes-te	parquear+V.tu.AD.2.SG+SBJF+2+PL
parqueardes-vos	parquear+V.vós.AD.2.PL+INF+2+PL
parqueardes-vos	parquear+V.vós.AD.2.PL+SBJF+2+PL
parqueárei-la	parquear+V.ele.ACC.3.F.SG+PQP+2+PL
parqueárei-las	parquear+V.ele.ACC.3.F.PL+PQP+2+PL
parqueárei-lo	parquear+V.ele.ACC.3.M.SG+PQP+2+PL
parqueárei-los	parquear+V.ele.ACC.3.M.PL+PQP+2+PL
parqueárei-nos	parquear+nós.AD.1.PL+PQP+2+PL
parqueáreis-lhe	parquear+V.ele.DAT.3.SG+PQP+2+PL
parqueáreis-lhes	parquear+V.ele.DAT.3.PL+PQP+2+PL
parqueáreis-me	parquear+V.eu.AD.1.SG+PQP+2+PL
