pastorizares-te	pastorizar+V.tu.AD.2.SG+INF+2+SG
pastorizares-te	pastorizar+V.tu.AD.2.SG+SBJF+2+SG
pastorizares-vos	pastorizar+V.vós.AD.2.PL+INF+2+SG
pastorizares-vos	pastorizar+V.vós.AD.2.PL+SBJF+2+SG
pastorizar-lhe-ão	pastorizar+V.ele.DAT.3.SG+FUT+3+PL
pastorizar-lhe-á	pastorizar+V.ele.DAT.3.SG+FUT+3+SG
pastorizar-lhe-ás	pastorizar+V.ele.DAT.3.SG+FUT+2+SG
pastorizar-lhe-ei	pastorizar+V.ele.DAT.3.SG+FUT+1+SG
pastorizar-lhe-eis	pastorizar+V.ele.DAT.3.SG+FUT+2+PL
pastorizar-lhe-emos	pastorizar+V.ele.DAT.3.SG+FUT+1+PL
pastorizar-lhe-íamos	pastorizar+V.ele.DAT.3.SG+COND+1+PL
pastorizar-lhe-iam	pastorizar+V.ele.DAT.3.SG+COND+3+PL
pastorizar-lhe-ia	pastorizar+V.ele.DAT.3.SG+COND+1+SG
pastorizar-lhe-ia	pastorizar+V.ele.DAT.3.SG+COND+3+SG
pastorizar-lhe-ias	pastorizar+V.ele.DAT.3.SG+COND+2+SG
pastorizar-lhe-íeis	pastorizar+V.ele.DAT.3.SG+COND+2+PL
pastorizar-lhe	pastorizar+V.ele.DAT.3.SG+INF
pastorizar-lhe	pastorizar+V.ele.DAT.3.SG+INF+1+SG
pastorizar-lhe	pastorizar+V.ele.DAT.3.SG+INF+3+SG
pastorizar-lhe	pastorizar+V.ele.DAT.3.SG+SBJF+1+SG
pastorizar-lhe	pastorizar+V.ele.DAT.3.SG+SBJF+3+SG
pastorizar-lhes-ão	pastorizar+V.ele.DAT.3.PL+FUT+3+PL
pastorizar-lhes-á	pastorizar+V.ele.DAT.3.PL+FUT+3+SG
pastorizar-lhes-ás	pastorizar+V.ele.DAT.3.PL+FUT+2+SG
pastorizar-lhes-ei	pastorizar+V.ele.DAT.3.PL+FUT+1+SG
pastorizar-lhes-eis	pastorizar+V.ele.DAT.3.PL+FUT+2+PL
pastorizar-lhes-emos	pastorizar+V.ele.DAT.3.PL+FUT+1+PL
pastorizar-lhes-íamos	pastorizar+V.ele.DAT.3.PL+COND+1+PL
pastorizar-lhes-iam	pastorizar+V.ele.DAT.3.PL+COND+3+PL
pastorizar-lhes-ia	pastorizar+V.ele.DAT.3.PL+COND+1+SG
pastorizar-lhes-ia	pastorizar+V.ele.DAT.3.PL+COND+3+SG
pastorizar-lhes-ias	pastorizar+V.ele.DAT.3.PL+COND+2+SG
pastorizar-lhes-íeis	pastorizar+V.ele.DAT.3.PL+COND+2+PL
pastorizar-lhes	pastorizar+V.ele.DAT.3.PL+INF
pastorizar-lhes	pastorizar+V.ele.DAT.3.PL+INF+1+SG
pastorizar-lhes	pastorizar+V.ele.DAT.3.PL+INF+3+SG
pastorizar-lhes	pastorizar+V.ele.DAT.3.PL+SBJF+1+SG
pastorizar-lhes	pastorizar+V.ele.DAT.3.PL+SBJF+3+SG
pastorizar-me-ão	pastorizar+V.eu.AD.1.SG+FUT+3+PL
pastorizar-me-á	pastorizar+V.eu.AD.1.SG+FUT+3+SG
pastorizar-me-ás	pastorizar+V.eu.AD.1.SG+FUT+2+SG
pastorizar-me-ei	pastorizar+V.eu.AD.1.SG+FUT+1+SG
pastorizar-me-eis	pastorizar+V.eu.AD.1.SG+FUT+2+PL
pastorizar-me-emos	pastorizar+V.eu.AD.1.SG+FUT+1+PL
pastorizar-me-íamos	pastorizar+V.eu.AD.1.SG+COND+1+PL
pastorizar-me-iam	pastorizar+V.eu.AD.1.SG+COND+3+PL
pastorizar-me-ia	pastorizar+V.eu.AD.1.SG+COND+1+SG
pastorizar-me-ia	pastorizar+V.eu.AD.1.SG+COND+3+SG
pastorizar-me-ias	pastorizar+V.eu.AD.1.SG+COND+2+SG
pastorizar-me-íeis	pastorizar+V.eu.AD.1.SG+COND+2+PL
pastorizar-me	pastorizar+V.eu.AD.1.SG+INF
pastorizar-me	pastorizar+V.eu.AD.1.SG+INF+1+SG
pastorizar-me	pastorizar+V.eu.AD.1.SG+INF+3+SG
pastorizar-me	pastorizar+V.eu.AD.1.SG+SBJF+1+SG
pastorizar-me	pastorizar+V.eu.AD.1.SG+SBJF+3+SG
pastorizarmo-la	pastorizar+V.ele.ACC.3.F.SG+INF+1+PL
pastorizarmo-la	pastorizar+V.ele.ACC.3.F.SG+SBJF+1+PL
pastorizarmo-las	pastorizar+V.ele.ACC.3.F.PL+INF+1+PL
pastorizarmo-las	pastorizar+V.ele.ACC.3.F.PL+SBJF+1+PL
pastorizarmo-lo	pastorizar+V.ele.ACC.3.M.SG+INF+1+PL
pastorizarmo-lo	pastorizar+V.ele.ACC.3.M.SG+SBJF+1+PL
pastorizarmo-los	pastorizar+V.ele.ACC.3.M.PL+INF+1+PL
pastorizarmo-los	pastorizar+V.ele.ACC.3.M.PL+SBJF+1+PL
pastorizarmo-nos	pastorizar+nós.AD.1.PL+INF+1+PL
pastorizarmo-nos	pastorizar+nós.AD.1.PL+SBJF+1+PL
pastorizarmos-lhe	pastorizar+V.ele.DAT.3.SG+INF+1+PL
pastorizarmos-lhe	pastorizar+V.ele.DAT.3.SG+SBJF+1+PL
pastorizarmos-lhes	pastorizar+V.ele.DAT.3.PL+INF+1+PL
pastorizarmos-lhes	pastorizar+V.ele.DAT.3.PL+SBJF+1+PL
pastorizarmos-me	pastorizar+V.eu.AD.1.SG+INF+1+PL
pastorizarmos-me	pastorizar+V.eu.AD.1.SG+SBJF+1+PL
pastorizarmos-te	pastorizar+V.tu.AD.2.SG+INF+1+PL
pastorizarmos-te	pastorizar+V.tu.AD.2.SG+SBJF+1+PL
pastorizarmos-vos	pastorizar+V.vós.AD.2.PL+INF+1+PL
pastorizarmos-vos	pastorizar+V.vós.AD.2.PL+SBJF+1+PL
pastorizar-nos-ão	pastorizar+nós.AD.1.PL+FUT+3+PL
pastorizar-nos-á	pastorizar+nós.AD.1.PL+FUT+3+SG
pastorizar-nos-ás	pastorizar+nós.AD.1.PL+FUT+2+SG
pastorizar-nos-ei	pastorizar+nós.AD.1.PL+FUT+1+SG
pastorizar-nos-eis	pastorizar+nós.AD.1.PL+FUT+2+PL
pastorizar-nos-emos	pastorizar+nós.AD.1.PL+FUT+1+PL
pastorizar-nos-íamos	pastorizar+nós.AD.1.PL+COND+1+PL
pastorizar-nos-iam	pastorizar+nós.AD.1.PL+COND+3+PL
pastorizar-nos-ia	pastorizar+nós.AD.1.PL+COND+1+SG
pastorizar-nos-ia	pastorizar+nós.AD.1.PL+COND+3+SG
pastorizar-nos-ias	pastorizar+nós.AD.1.PL+COND+2+SG
pastorizar-nos-íeis	pastorizar+nós.AD.1.PL+COND+2+PL
pastorizar-nos	pastorizar+nós.AD.1.PL+INF
pastorizar-nos	pastorizar+nós.AD.1.PL+INF+1+SG
pastorizar-nos	pastorizar+nós.AD.1.PL+INF+3+SG
pastorizar-nos	pastorizar+nós.AD.1.PL+SBJF+1+SG
pastorizar-nos	pastorizar+nós.AD.1.PL+SBJF+3+SG
pastorizar-se-ão	pastorizar+V.ele.REFL+FUT+3+PL
pastorizar-se-á	pastorizar+V.ele.REFL+FUT+3+SG
pastorizar-se-iam	pastorizar+V.ele.REFL+COND+3+PL
pastorizar-se-ia	pastorizar+V.ele.REFL+COND+3+SG
pastorizar-se	pastorizar+V.ele.REFL+INF
pastorizar-se	pastorizar+V.ele.REFL+INF+3+SG
pastorizar-se	pastorizar+V.ele.REFL+SBJF+3+SG
pastorizar-te-ão	pastorizar+V.tu.AD.2.SG+FUT+3+PL
pastorizar-te-á	pastorizar+V.tu.AD.2.SG+FUT+3+SG
pastorizar-te-ás	pastorizar+V.tu.AD.2.SG+FUT+2+SG
pastorizar-te-ei	pastorizar+V.tu.AD.2.SG+FUT+1+SG
pastorizar-te-eis	pastorizar+V.tu.AD.2.SG+FUT+2+PL
pastorizar-te-emos	pastorizar+V.tu.AD.2.SG+FUT+1+PL
pastorizar-te-íamos	pastorizar+V.tu.AD.2.SG+COND+1+PL
pastorizar-te-iam	pastorizar+V.tu.AD.2.SG+COND+3+PL
pastorizar-te-ia	pastorizar+V.tu.AD.2.SG+COND+1+SG
pastorizar-te-ia	pastorizar+V.tu.AD.2.SG+COND+3+SG
pastorizar-te-ias	pastorizar+V.tu.AD.2.SG+COND+2+SG
pastorizar-te-íeis	pastorizar+V.tu.AD.2.SG+COND+2+PL
pastorizar-te	pastorizar+V.tu.AD.2.SG+INF
pastorizar-te	pastorizar+V.tu.AD.2.SG+INF+1+SG
pastorizar-te	pastorizar+V.tu.AD.2.SG+INF+3+SG
pastorizar-te	pastorizar+V.tu.AD.2.SG+SBJF+1+SG
pastorizar-te	pastorizar+V.tu.AD.2.SG+SBJF+3+SG
pastorizar-vos-ão	pastorizar+V.vós.AD.2.PL+FUT+3+PL
pastorizar-vos-á	pastorizar+V.vós.AD.2.PL+FUT+3+SG
pastorizar-vos-ás	pastorizar+V.vós.AD.2.PL+FUT+2+SG
pastorizar-vos-ei	pastorizar+V.vós.AD.2.PL+FUT+1+SG
pastorizar-vos-eis	pastorizar+V.vós.AD.2.PL+FUT+2+PL
pastorizar-vos-emos	pastorizar+V.vós.AD.2.PL+FUT+1+PL
pastorizar-vos-íamos	pastorizar+V.vós.AD.2.PL+COND+1+PL
pastorizar-vos-iam	pastorizar+V.vós.AD.2.PL+COND+3+PL
pastorizar-vos-ia	pastorizar+V.vós.AD.2.PL+COND+1+SG
pastorizar-vos-ia	pastorizar+V.vós.AD.2.PL+COND+3+SG
pastorizar-vos-ias	pastorizar+V.vós.AD.2.PL+COND+2+SG
pastorizar-vos-íeis	pastorizar+V.vós.AD.2.PL+COND+2+PL
pastorizar-vos	pastorizar+V.vós.AD.2.PL+INF
pastorizar-vos	pastorizar+V.vós.AD.2.PL+INF+1+SG
pastorizar-vos	pastorizar+V.vós.AD.2.PL+INF+3+SG
pastorizar-vos	pastorizar+V.vós.AD.2.PL+SBJF+1+SG
pastorizar-vos	pastorizar+V.vós.AD.2.PL+SBJF+3+SG
pastoriza-se	pastorizar+V.ele.REFL+PRS+3+SG
pastorizas-lhe	pastorizar+V.ele.DAT.3.SG+PRS+2+SG
pastorizas-lhes	pastorizar+V.ele.DAT.3.PL+PRS+2+SG
pastorizas-me	pastorizar+V.eu.AD.1.SG+PRS+2+SG
pastorizaste-a	pastorizar+V.ele.ACC.3.F.SG+PRF+2+SG
pastorizaste-as	pastorizar+V.ele.ACC.3.F.PL+PRF+2+SG
pastorizaste-la	pastorizar+V.ele.ACC.3.F.SG+PRF+2+PL
pastorizaste-las	pastorizar+V.ele.ACC.3.F.PL+PRF+2+PL
pastorizaste-lhe	pastorizar+V.ele.DAT.3.SG+PRF+2+SG
pastorizaste-lhes	pastorizar+V.ele.DAT.3.PL+PRF+2+SG
pastorizaste-lo	pastorizar+V.ele.ACC.3.M.SG+PRF+2+PL
pastorizaste-los	pastorizar+V.ele.ACC.3.M.PL+PRF+2+PL
pastorizaste-me	pastorizar+V.eu.AD.1.SG+PRF+2+SG
pastorizaste-nos	pastorizar+nós.AD.1.PL+PRF+2+PL
pastorizaste-nos	pastorizar+nós.AD.1.PL+PRF+2+SG
pastorizaste-o	pastorizar+V.ele.ACC.3.M.SG+PRF+2+SG
pastorizaste-os	pastorizar+V.ele.ACC.3.M.PL+PRF+2+SG
pastorizas-te	pastorizar+V.tu.AD.2.SG+PRS+2+SG
pastorizastes-lhe	pastorizar+V.ele.DAT.3.SG+PRF+2+PL
pastorizastes-lhes	pastorizar+V.ele.DAT.3.PL+PRF+2+PL
pastorizastes-me	pastorizar+V.eu.AD.1.SG+PRF+2+PL
pastorizastes-te	pastorizar+V.tu.AD.2.SG+PRF+2+PL
pastorizastes-vos	pastorizar+V.vós.AD.2.PL+PRF+2+PL
pastorizaste-te	pastorizar+V.tu.AD.2.SG+PRF+2+SG
pastorizaste-vos	pastorizar+V.vós.AD.2.PL+PRF+2+SG
pastorizas-vos	pastorizar+V.vós.AD.2.PL+PRS+2+SG
pastoriza-te	pastorizar+V.tu.AD.2.SG+PRS+3+SG
pastorizava-a	pastorizar+V.ele.ACC.3.F.SG+IMPF+1+SG
pastorizava-a	pastorizar+V.ele.ACC.3.F.SG+IMPF+3+SG
pastorizava-as	pastorizar+V.ele.ACC.3.F.PL+IMPF+1+SG
pastorizava-as	pastorizar+V.ele.ACC.3.F.PL+IMPF+3+SG
pastorizava-la	pastorizar+V.ele.ACC.3.F.SG+IMPF+2+SG
pastorizava-las	pastorizar+V.ele.ACC.3.F.PL+IMPF+2+SG
pastorizava-lhe	pastorizar+V.ele.DAT.3.SG+IMPF+1+SG
pastorizava-lhe	pastorizar+V.ele.DAT.3.SG+IMPF+3+SG
pastorizava-lhes	pastorizar+V.ele.DAT.3.PL+IMPF+1+SG
pastorizava-lhes	pastorizar+V.ele.DAT.3.PL+IMPF+3+SG
pastorizava-lo	pastorizar+V.ele.ACC.3.M.SG+IMPF+2+SG
pastorizava-los	pastorizar+V.ele.ACC.3.M.PL+IMPF+2+SG
pastorizava-me	pastorizar+V.eu.AD.1.SG+IMPF+1+SG
pastorizava-me	pastorizar+V.eu.AD.1.SG+IMPF+3+SG
pastorizavam-lhe	pastorizar+V.ele.DAT.3.SG+IMPF+3+PL
pastorizavam-lhes	pastorizar+V.ele.DAT.3.PL+IMPF+3+PL
pastorizavam-me	pastorizar+V.eu.AD.1.SG+IMPF+3+PL
pastorizavam-na	pastorizar+V.ele.ACC.3.F.SG+IMPF+3+PL
pastorizavam-nas	pastorizar+V.ele.ACC.3.F.PL+IMPF+3+PL
pastorizavam-no	pastorizar+V.ele.ACC.3.M.SG+IMPF+3+PL
pastorizavam-nos	pastorizar+V.ele.ACC.3.M.PL+IMPF+3+PL
pastorizavam-nos	pastorizar+V.nós.AD.1.PL+IMPF+3+PL
pastorizávamo-la	pastorizar+V.ele.ACC.3.F.SG+IMPF+1+PL
pastorizávamo-las	pastorizar+V.ele.ACC.3.F.PL+IMPF+1+PL
pastorizávamo-lo	pastorizar+V.ele.ACC.3.M.SG+IMPF+1+PL
pastorizávamo-los	pastorizar+V.ele.ACC.3.M.PL+IMPF+1+PL
pastorizávamo-nos	pastorizar+nós.AD.1.PL+IMPF+1+PL
pastorizávamos-lhe	pastorizar+V.ele.DAT.3.SG+IMPF+1+PL
pastorizávamos-lhes	pastorizar+V.ele.DAT.3.PL+IMPF+1+PL
pastorizávamos-me	pastorizar+V.eu.AD.1.SG+IMPF+1+PL
pastorizávamos-te	pastorizar+V.tu.AD.2.SG+IMPF+1+PL
pastorizávamos-vos	pastorizar+V.vós.AD.2.PL+IMPF+1+PL
pastorizavam-se	pastorizar+V.ele.REFL+IMPF+3+PL
pastorizavam-te	pastorizar+V.tu.AD.2.SG+IMPF+3+PL
pastorizavam-vos	pastorizar+V.vós.AD.2.PL+IMPF+3+PL
pastorizava-nos	pastorizar+nós.AD.1.PL+IMPF+1+SG
pastorizava-nos	pastorizar+nós.AD.1.PL+IMPF+2+SG
pastorizava-nos	pastorizar+nós.AD.1.PL+IMPF+3+SG
pastorizava-o	pastorizar+V.ele.ACC.3.M.SG+IMPF+1+SG
pastorizava-o	pastorizar+V.ele.ACC.3.M.SG+IMPF+3+SG
pastorizava-os	pastorizar+V.ele.ACC.3.M.PL+IMPF+1+SG
pastorizava-os	pastorizar+V.ele.ACC.3.M.PL+IMPF+3+SG
pastorizava-se	pastorizar+V.ele.REFL+IMPF+1+SG
pastorizava-se	pastorizar+V.ele.REFL+IMPF+3+SG
pastorizavas-lhe	pastorizar+V.ele.DAT.3.SG+IMPF+2+SG
pastorizavas-lhes	pastorizar+V.ele.DAT.3.PL+IMPF+2+SG
pastorizavas-me	pastorizar+V.eu.AD.1.SG+IMPF+2+SG
pastorizavas-te	pastorizar+V.tu.AD.2.SG+IMPF+2+SG
pastorizavas-vos	pastorizar+V.vós.AD.2.PL+IMPF+2+SG
pastorizava-te	pastorizar+V.tu.AD.2.SG+IMPF+1+SG
pastorizava-te	pastorizar+V.tu.AD.2.SG+IMPF+3+SG
pastorizava-vos	pastorizar+V.vós.AD.2.PL+IMPF+1+SG
pastorizava-vos	pastorizar+V.vós.AD.2.PL+IMPF+3+SG
pastorizávei-la	pastorizar+V.ele.ACC.3.F.SG+IMPF+2+PL
pastorizávei-las	pastorizar+V.ele.ACC.3.F.PL+IMPF+2+PL
pastorizávei-lo	pastorizar+V.ele.ACC.3.M.SG+IMPF+2+PL
pastorizávei-los	pastorizar+V.ele.ACC.3.M.PL+IMPF+2+PL
pastorizávei-nos	pastorizar+nós.AD.1.PL+IMPF+2+PL
pastorizáveis-lhe	pastorizar+V.ele.DAT.3.SG+IMPF+2+PL
pastorizáveis-lhes	pastorizar+V.ele.DAT.3.PL+IMPF+2+PL
pastorizáveis-me	pastorizar+V.eu.AD.1.SG+IMPF+2+PL
pastorizáveis-te	pastorizar+V.tu.AD.2.SG+IMPF+2+PL
pastorizáveis-vos	pastorizar+V.vós.AD.2.PL+IMPF+2+PL
pastoriza-vos	pastorizar+V.vós.AD.2.PL+PRS+3+SG
pastorize-a	pastorizar+V.ele.ACC.3.F.SG+IMP+3+SG
pastorize-as	pastorizar+V.ele.ACC.3.F.PL+IMP+3+SG
pastorizei-a	pastorizar+V.ele.ACC.3.F.SG+PRF+1+SG
pastorizei-as	pastorizar+V.ele.ACC.3.F.PL+PRF+1+SG
pastorizei-lhe	pastorizar+V.ele.DAT.3.SG+PRF+1+SG
pastorizei-lhes	pastorizar+V.ele.DAT.3.PL+PRF+1+SG
pastorizei-me	pastorizar+V.eu.AD.1.SG+PRF+1+SG
pastorizei-nos	pastorizar+nós.AD.1.PL+PRF+1+SG
pastorizei-o	pastorizar+V.ele.ACC.3.M.SG+PRF+1+SG
pastorizei-os	pastorizar+V.ele.ACC.3.M.PL+PRF+1+SG
pastorizei-te	pastorizar+V.tu.AD.2.SG+PRF+1+SG
pastorizei-vos	pastorizar+V.vós.AD.2.PL+PRF+1+SG
pastorize-lhe	pastorizar+V.ele.DAT.3.SG+IMP+3+SG
pastorize-lhes	pastorizar+V.ele.DAT.3.PL+IMP+3+SG
pastorize-me	pastorizar+V.eu.AD.1.SG+IMP+3+SG
pastorizem-lhe	pastorizar+V.ele.DAT.3.SG+IMP+3+PL
pastorizem-lhes	pastorizar+V.ele.DAT.3.PL+IMP+3+PL
pastorizem-me	pastorizar+V.eu.AD.1.SG+IMP+3+PL
pastorizem-na	pastorizar+V.ele.ACC.3.F.SG+IMP+3+PL
pastorizem-nas	pastorizar+V.ele.ACC.3.F.PL+IMP+3+PL
pastorizem-no	pastorizar+V.ele.ACC.3.M.SG+IMP+3+PL
pastorizem-nos	pastorizar+V.ele.ACC.3.M.PL+IMP+3+PL
pastorizem-nos	pastorizar+V.nós.AD.1.PL+IMP+3+PL
pastorizemo-la	pastorizar+V.ele.ACC.3.F.SG+IMP+1+PL
pastorizemo-las	pastorizar+V.ele.ACC.3.F.PL+IMP+1+PL
pastorizemo-lo	pastorizar+V.ele.ACC.3.M.SG+IMP+1+PL
pastorizemo-los	pastorizar+V.ele.ACC.3.M.PL+IMP+1+PL
pastorizemo-nos	pastorizar+nós.AD.1.PL+IMP+1+PL
pastorizemos-lhe	pastorizar+V.ele.DAT.3.SG+IMP+1+PL
pastorizemos-lhes	pastorizar+V.ele.DAT.3.PL+IMP+1+PL
pastorizemos-me	pastorizar+V.eu.AD.1.SG+IMP+1+PL
pastorizemos-te	pastorizar+V.tu.AD.2.SG+IMP+1+PL
pastorizemos-vos	pastorizar+V.vós.AD.2.PL+IMP+1+PL
pastorizem-se	pastorizar+V.ele.REFL+IMP+3+PL
pastorizem-te	pastorizar+V.tu.AD.2.SG+IMP+3+PL
pastorizem-vos	pastorizar+V.vós.AD.2.PL+IMP+3+PL
pastorize-nos	pastorizar+nós.AD.1.PL+IMP+3+SG
pastorize-o	pastorizar+V.ele.ACC.3.M.SG+IMP+3+SG
pastorize-os	pastorizar+V.ele.ACC.3.M.PL+IMP+3+SG
pastorize-se	pastorizar+V.ele.REFL+IMP+3+SG
pastorize-te	pastorizar+V.tu.AD.2.SG+IMP+3+SG
pastorize-vos	pastorizar+V.vós.AD.2.PL+IMP+3+SG
pastorizo-a	pastorizar+V.ele.ACC.3.F.SG+PRS+1+SG
pastorizo-as	pastorizar+V.ele.ACC.3.F.PL+PRS+1+SG
pastorizo-lhe	pastorizar+V.ele.DAT.3.SG+PRS+1+SG
pastorizo-lhes	pastorizar+V.ele.DAT.3.PL+PRS+1+SG
pastorizo-me	pastorizar+V.eu.AD.1.SG+PRS+1+SG
pastorizo-nos	pastorizar+nós.AD.1.PL+PRS+1+SG
pastorizo-o	pastorizar+V.ele.ACC.3.M.SG+PRS+1+SG
pastorizo-os	pastorizar+V.ele.ACC.3.M.PL+PRS+1+SG
pastorizo-te	pastorizar+V.tu.AD.2.SG+PRS+1+SG
pastorizou-a	pastorizar+V.ele.ACC.3.F.SG+PRF+3+SG
pastorizou-as	pastorizar+V.ele.ACC.3.F.PL+PRF+3+SG
pastorizou-lhe	pastorizar+V.ele.DAT.3.SG+PRF+3+SG
pastorizou-lhes	pastorizar+V.ele.DAT.3.PL+PRF+3+SG
pastorizou-me	pastorizar+V.eu.AD.1.SG+PRF+3+SG
pastorizou-nos	pastorizar+nós.AD.1.PL+PRF+3+SG
pastorizou-o	pastorizar+V.ele.ACC.3.M.SG+PRF+3+SG
pastorizou-os	pastorizar+V.ele.ACC.3.M.PL+PRF+3+SG
pastorizou-se	pastorizar+V.ele.REFL+PRF+3+SG
pastorizou-te	pastorizar+V.tu.AD.2.SG+PRF+3+SG
pastorizou-vos	pastorizar+V.vós.AD.2.PL+PRF+3+SG
pastorizo-vos	pastorizar+V.vós.AD.2.PL+PRS+1+SG
pastoro-a	pastorar+V.ele.ACC.3.F.SG+PRS+1+SG
pastoro-as	pastorar+V.ele.ACC.3.F.PL+PRS+1+SG
pastoro-lhe	pastorar+V.ele.DAT.3.SG+PRS+1+SG
pastoro-lhes	pastorar+V.ele.DAT.3.PL+PRS+1+SG
pastoro-me	pastorar+V.eu.AD.1.SG+PRS+1+SG
pastoro-nos	pastorar+nós.AD.1.PL+PRS+1+SG
pastoro-o	pastorar+V.ele.ACC.3.M.SG+PRS+1+SG
pastoro-os	pastorar+V.ele.ACC.3.M.PL+PRS+1+SG
pastoro-te	pastorar+V.tu.AD.2.SG+PRS+1+SG
pastorou-a	pastorar+V.ele.ACC.3.F.SG+PRF+3+SG
pastorou-as	pastorar+V.ele.ACC.3.F.PL+PRF+3+SG
pastorou-lhe	pastorar+V.ele.DAT.3.SG+PRF+3+SG
pastorou-lhes	pastorar+V.ele.DAT.3.PL+PRF+3+SG
pastorou-me	pastorar+V.eu.AD.1.SG+PRF+3+SG
pastorou-nos	pastorar+nós.AD.1.PL+PRF+3+SG
pastorou-o	pastorar+V.ele.ACC.3.M.SG+PRF+3+SG
pastorou-os	pastorar+V.ele.ACC.3.M.PL+PRF+3+SG
pastorou-se	pastorar+V.ele.REFL+PRF+3+SG
pastorou-te	pastorar+V.tu.AD.2.SG+PRF+3+SG
pastorou-vos	pastorar+V.vós.AD.2.PL+PRF+3+SG
pastoro-vos	pastorar+V.vós.AD.2.PL+PRS+1+SG
pasto-te	pastar+V.tu.AD.2.SG+PRS+1+SG
pastou-a	pastar+V.ele.ACC.3.F.SG+PRF+3+SG
pastou-as	pastar+V.ele.ACC.3.F.PL+PRF+3+SG
pastou-lhe	pastar+V.ele.DAT.3.SG+PRF+3+SG
pastou-lhes	pastar+V.ele.DAT.3.PL+PRF+3+SG
pastou-me	pastar+V.eu.AD.1.SG+PRF+3+SG
pastou-nos	pastar+nós.AD.1.PL+PRF+3+SG
pastou-o	pastar+V.ele.ACC.3.M.SG+PRF+3+SG
pastou-os	pastar+V.ele.ACC.3.M.PL+PRF+3+SG
pastou-se	pastar+V.ele.REFL+PRF+3+SG
pastou-te	pastar+V.tu.AD.2.SG+PRF+3+SG
pastou-vos	pastar+V.vós.AD.2.PL+PRF+3+SG
pasto-vos	pastar+V.vós.AD.2.PL+PRS+1+SG
pataleai-la	patalear+V.ele.ACC.3.F.SG+PRS+2+PL
pataleai-las	patalear+V.ele.ACC.3.F.PL+PRS+2+PL
pataleai-lo	patalear+V.ele.ACC.3.M.SG+PRS+2+PL
pataleai-los	patalear+V.ele.ACC.3.M.PL+PRS+2+PL
pataleai-nos	patalear+nós.AD.1.PL+PRS+2+PL
pataleais-lhe	patalear+V.ele.DAT.3.SG+PRS+2+PL
pataleais-lhes	patalear+V.ele.DAT.3.PL+PRS+2+PL
pataleais-me	patalear+V.eu.AD.1.SG+PRS+2+PL
pataleais-te	patalear+V.tu.AD.2.SG+PRS+2+PL
pataleais-vos	patalear+V.vós.AD.2.PL+PRS+2+PL
pataleá-la-ão	patalear+V.ele.ACC.3.F.SG+FUT+3+PL
pataleá-la-á	patalear+V.ele.ACC.3.F.SG+FUT+3+SG
pataleá-la-ás	patalear+V.ele.ACC.3.F.SG+FUT+2+SG
pataleá-la-ei	patalear+V.ele.ACC.3.F.SG+FUT+1+SG
pataleá-la-eis	patalear+V.ele.ACC.3.F.SG+FUT+2+PL
pataleá-la-emos	patalear+V.ele.ACC.3.F.SG+FUT+1+PL
pataleá-la-íamos	patalear+V.ele.ACC.3.F.SG+COND+1+PL
pataleá-la-iam	patalear+V.ele.ACC.3.F.SG+COND+3+PL
pataleá-la-ia	patalear+V.ele.ACC.3.F.SG+COND+1+SG
pataleá-la-ia	patalear+V.ele.ACC.3.F.SG+COND+3+SG
pataleá-la-ias	patalear+V.ele.ACC.3.F.SG+COND+2+SG
pataleá-la-íeis	patalear+V.ele.ACC.3.F.SG+COND+2+PL
pataleá-la	patalear+V.ele.ACC.3.F.SG+INF+1+SG
pataleá-la	patalear+V.ele.ACC.3.F.SG+INF+3+SG
pataleá-la	patalear+V.ele.ACC.3.F.SG+SBJF+1+SG
pataleá-la	patalear+V.ele.ACC.3.F.SG+SBJF+3+SG
pataleá-las-ão	patalear+V.ele.ACC.3.F.PL+FUT+3+PL
pataleá-las-á	patalear+V.ele.ACC.3.F.PL+FUT+3+SG
pataleá-las-ás	patalear+V.ele.ACC.3.F.PL+FUT+2+SG
pataleá-las-ei	patalear+V.ele.ACC.3.F.PL+FUT+1+SG
pataleá-las-eis	patalear+V.ele.ACC.3.F.PL+FUT+2+PL
pataleá-las-emos	patalear+V.ele.ACC.3.F.PL+FUT+1+PL
pataleá-las-íamos	patalear+V.ele.ACC.3.F.PL+COND+1+PL
pataleá-las-iam	patalear+V.ele.ACC.3.F.PL+COND+3+PL
pataleá-las-ia	patalear+V.ele.ACC.3.F.PL+COND+1+SG
pataleá-las-ia	patalear+V.ele.ACC.3.F.PL+COND+3+SG
pataleá-las-ias	patalear+V.ele.ACC.3.F.PL+COND+2+SG
pataleá-las-íeis	patalear+V.ele.ACC.3.F.PL+COND+2+PL
pataleá-las	patalear+V.ele.ACC.3.F.PL+INF+1+SG
pataleá-las	patalear+V.ele.ACC.3.F.PL+INF+3+SG
pataleá-las	patalear+V.ele.ACC.3.F.PL+SBJF+1+SG
pataleá-las	patalear+V.ele.ACC.3.F.PL+SBJF+3+SG
pataleá-lo-ão	patalear+V.ele.ACC.3.M.SG+FUT+3+PL
pataleá-lo-á	patalear+V.ele.ACC.3.M.SG+FUT+3+SG
pataleá-lo-ás	patalear+V.ele.ACC.3.M.SG+FUT+2+SG
pataleá-lo-ei	patalear+V.ele.ACC.3.M.SG+FUT+1+SG
pataleá-lo-eis	patalear+V.ele.ACC.3.M.SG+FUT+2+PL
pataleá-lo-emos	patalear+V.ele.ACC.3.M.SG+FUT+1+PL
pataleá-lo-íamos	patalear+V.ele.ACC.3.M.SG+COND+1+PL
pataleá-lo-iam	patalear+V.ele.ACC.3.M.SG+COND+3+PL
pataleá-lo-ia	patalear+V.ele.ACC.3.M.SG+COND+1+SG
pataleá-lo-ia	patalear+V.ele.ACC.3.M.SG+COND+3+SG
pataleá-lo-ias	patalear+V.ele.ACC.3.M.SG+COND+2+SG
pataleá-lo-íeis	patalear+V.ele.ACC.3.M.SG+COND+2+PL
pataleá-lo	patalear+V.ele.ACC.3.M.SG+INF+1+SG
pataleá-lo	patalear+V.ele.ACC.3.M.SG+INF+3+SG
pataleá-lo	patalear+V.ele.ACC.3.M.SG+SBJF+1+SG
pataleá-lo	patalear+V.ele.ACC.3.M.SG+SBJF+3+SG
pataleá-los-ão	patalear+V.ele.ACC.3.M.PL+FUT+3+PL
pataleá-los-á	patalear+V.ele.ACC.3.M.PL+FUT+3+SG
pataleá-los-ás	patalear+V.ele.ACC.3.M.PL+FUT+2+SG
pataleá-los-ei	patalear+V.ele.ACC.3.M.PL+FUT+1+SG
pataleá-los-eis	patalear+V.ele.ACC.3.M.PL+FUT+2+PL
pataleá-los-emos	patalear+V.ele.ACC.3.M.PL+FUT+1+PL
pataleá-los-íamos	patalear+V.ele.ACC.3.M.PL+COND+1+PL
pataleá-los-iam	patalear+V.ele.ACC.3.M.PL+COND+3+PL
pataleá-los-ia	patalear+V.ele.ACC.3.M.PL+COND+1+SG
pataleá-los-ia	patalear+V.ele.ACC.3.M.PL+COND+3+SG
pataleá-los-ias	patalear+V.ele.ACC.3.M.PL+COND+2+SG
pataleá-los-íeis	patalear+V.ele.ACC.3.M.PL+COND+2+PL
pataleá-los	patalear+V.ele.ACC.3.M.PL+INF+1+SG
pataleá-los	patalear+V.ele.ACC.3.M.PL+INF+3+SG
pataleá-los	patalear+V.ele.ACC.3.M.PL+SBJF+1+SG
pataleá-los	patalear+V.ele.ACC.3.M.PL+SBJF+3+SG
pataleamo-la	patalear+V.ele.ACC.3.F.SG+PRF+1+PL
pataleamo-la	patalear+V.ele.ACC.3.F.SG+PRS+1+PL
pataleamo-las	patalear+V.ele.ACC.3.F.PL+PRF+1+PL
pataleamo-las	patalear+V.ele.ACC.3.F.PL+PRS+1+PL
pataleamo-lo	patalear+V.ele.ACC.3.M.SG+PRF+1+PL
pataleamo-lo	patalear+V.ele.ACC.3.M.SG+PRS+1+PL
pataleamo-los	patalear+V.ele.ACC.3.M.PL+PRF+1+PL
pataleamo-los	patalear+V.ele.ACC.3.M.PL+PRS+1+PL
pataleamo-nos	patalear+nós.AD.1.PL+PRF+1+PL
pataleamo-nos	patalear+nós.AD.1.PL+PRS+1+PL
pataleamos-lhe	patalear+V.ele.DAT.3.SG+PRF+1+PL
pataleamos-lhe	patalear+V.ele.DAT.3.SG+PRS+1+PL
pataleamos-lhes	patalear+V.ele.DAT.3.PL+PRF+1+PL
pataleamos-lhes	patalear+V.ele.DAT.3.PL+PRS+1+PL
pataleamos-me	patalear+V.eu.AD.1.SG+PRF+1+PL
pataleamos-me	patalear+V.eu.AD.1.SG+PRS+1+PL
pataleamos-te	patalear+V.tu.AD.2.SG+PRF+1+PL
pataleamos-te	patalear+V.tu.AD.2.SG+PRS+1+PL
pataleamos-vos	patalear+V.vós.AD.2.PL+PRF+1+PL
pataleamos-vos	patalear+V.vós.AD.2.PL+PRS+1+PL
pataleando-a	patalear+V.ele.ACC.3.F.SG+GRD
pataleando-as	patalear+V.ele.ACC.3.F.PL+GRD
pataleando-lhe	patalear+V.ele.DAT.3.SG+GRD
pataleando-lhes	patalear+V.ele.DAT.3.PL+GRD
pataleando-me	patalear+V.eu.AD.1.SG+GRD
pataleando-nos	patalear+nós.AD.1.PL+GRD
pataleando-o	patalear+V.ele.ACC.3.M.SG+GRD
pataleando-os	patalear+V.ele.ACC.3.M.PL+GRD
pataleando-se	patalear+V.ele.REFL+GRD
pataleando-te	patalear+V.tu.AD.2.SG+GRD
pataleando-vos	patalear+V.vós.AD.2.PL+GRD
pataleara-a	patalear+V.ele.ACC.3.F.SG+PQP+1+SG
pataleara-a	patalear+V.ele.ACC.3.F.SG+PQP+3+SG
pataleara-as	patalear+V.ele.ACC.3.F.PL+PQP+1+SG
pataleara-as	patalear+V.ele.ACC.3.F.PL+PQP+3+SG
pataleara-la	patalear+V.ele.ACC.3.F.SG+PQP+2+SG
pataleara-las	patalear+V.ele.ACC.3.F.PL+PQP+2+SG
pataleara-lhe	patalear+V.ele.DAT.3.SG+PQP+1+SG
pataleara-lhe	patalear+V.ele.DAT.3.SG+PQP+3+SG
pataleara-lhes	patalear+V.ele.DAT.3.PL+PQP+1+SG
pataleara-lhes	patalear+V.ele.DAT.3.PL+PQP+3+SG
pataleara-lo	patalear+V.ele.ACC.3.M.SG+PQP+2+SG
pataleara-los	patalear+V.ele.ACC.3.M.PL+PQP+2+SG
pataleara-me	patalear+V.eu.AD.1.SG+PQP+1+SG
pataleara-me	patalear+V.eu.AD.1.SG+PQP+3+SG
patalearam-lhe	patalear+V.ele.DAT.3.SG+PQP+3+PL
patalearam-lhe	patalear+V.ele.DAT.3.SG+PRF+3+PL
patalearam-lhes	patalear+V.ele.DAT.3.PL+PQP+3+PL
patalearam-lhes	patalear+V.ele.DAT.3.PL+PRF+3+PL
patalearam-me	patalear+V.eu.AD.1.SG+PQP+3+PL
patalearam-me	patalear+V.eu.AD.1.SG+PRF+3+PL
patalearam-na	patalear+V.ele.ACC.3.F.SG+PQP+3+PL
patalearam-na	patalear+V.ele.ACC.3.F.SG+PRF+3+PL
patalearam-nas	patalear+V.ele.ACC.3.F.PL+PQP+3+PL
patalearam-nas	patalear+V.ele.ACC.3.F.PL+PRF+3+PL
patalearam-no	patalear+V.ele.ACC.3.M.SG+PQP+3+PL
patalearam-no	patalear+V.ele.ACC.3.M.SG+PRF+3+PL
patalearam-nos	patalear+V.ele.ACC.3.M.PL+PQP+3+PL
patalearam-nos	patalear+V.ele.ACC.3.M.PL+PRF+3+PL
patalearam-nos	patalear+V.nós.AD.1.PL+PQP+3+PL
patalearam-nos	patalear+V.nós.AD.1.PL+PRF+3+PL
pataleáramo-la	patalear+V.ele.ACC.3.F.SG+PQP+1+PL
pataleáramo-las	patalear+V.ele.ACC.3.F.PL+PQP+1+PL
pataleáramo-lo	patalear+V.ele.ACC.3.M.SG+PQP+1+PL
pataleáramo-los	patalear+V.ele.ACC.3.M.PL+PQP+1+PL
pataleáramo-nos	patalear+nós.AD.1.PL+PQP+1+PL
pataleáramos-lhe	patalear+V.ele.DAT.3.SG+PQP+1+PL
pataleáramos-lhes	patalear+V.ele.DAT.3.PL+PQP+1+PL
pataleáramos-me	patalear+V.eu.AD.1.SG+PQP+1+PL
pataleáramos-te	patalear+V.tu.AD.2.SG+PQP+1+PL
pataleáramos-vos	patalear+V.vós.AD.2.PL+PQP+1+PL
patalearam-se	patalear+V.ele.REFL+PQP+3+PL
patalearam-se	patalear+V.ele.REFL+PRF+3+PL
patalearam-te	patalear+V.tu.AD.2.SG+PQP+3+PL
patalearam-te	patalear+V.tu.AD.2.SG+PRF+3+PL
patalearam-vos	patalear+V.vós.AD.2.PL+PQP+3+PL
patalearam-vos	patalear+V.vós.AD.2.PL+PRF+3+PL
pataleara-nos	patalear+nós.AD.1.PL+PQP+1+SG
pataleara-nos	patalear+nós.AD.1.PL+PQP+2+SG
pataleara-nos	patalear+nós.AD.1.PL+PQP+3+SG
pataleara-o	patalear+V.ele.ACC.3.M.SG+PQP+1+SG
pataleara-o	patalear+V.ele.ACC.3.M.SG+PQP+3+SG
pataleara-os	patalear+V.ele.ACC.3.M.PL+PQP+1+SG
pataleara-os	patalear+V.ele.ACC.3.M.PL+PQP+3+SG
pataleara-se	patalear+V.ele.REFL+PQP+1+SG
pataleara-se	patalear+V.ele.REFL+PQP+3+SG
patalearas-lhe	patalear+V.ele.DAT.3.SG+PQP+2+SG
patalearas-lhes	patalear+V.ele.DAT.3.PL+PQP+2+SG
patalearas-me	patalear+V.eu.AD.1.SG+PQP+2+SG
patalearas-te	patalear+V.tu.AD.2.SG+PQP+2+SG
patalearas-vos	patalear+V.vós.AD.2.PL+PQP+2+SG
pataleara-te	patalear+V.tu.AD.2.SG+PQP+1+SG
pataleara-te	patalear+V.tu.AD.2.SG+PQP+3+SG
pataleara-vos	patalear+V.vós.AD.2.PL+PQP+1+SG
pataleara-vos	patalear+V.vós.AD.2.PL+PQP+3+SG
patalearde-la	patalear+V.ele.ACC.3.F.SG+INF+2+PL
patalearde-la	patalear+V.ele.ACC.3.F.SG+SBJF+2+PL
patalearde-las	patalear+V.ele.ACC.3.F.PL+INF+2+PL
patalearde-las	patalear+V.ele.ACC.3.F.PL+SBJF+2+PL
patalearde-lo	patalear+V.ele.ACC.3.M.SG+INF+2+PL
patalearde-lo	patalear+V.ele.ACC.3.M.SG+SBJF+2+PL
patalearde-los	patalear+V.ele.ACC.3.M.PL+INF+2+PL
patalearde-los	patalear+V.ele.ACC.3.M.PL+SBJF+2+PL
patalearde-nos	patalear+nós.AD.1.PL+INF+2+PL
patalearde-nos	patalear+nós.AD.1.PL+SBJF+2+PL
pataleardes-lhe	patalear+V.ele.DAT.3.SG+INF+2+PL
pataleardes-lhe	patalear+V.ele.DAT.3.SG+SBJF+2+PL
pataleardes-lhes	patalear+V.ele.DAT.3.PL+INF+2+PL
pataleardes-lhes	patalear+V.ele.DAT.3.PL+SBJF+2+PL
pataleardes-me	patalear+V.eu.AD.1.SG+INF+2+PL
pataleardes-me	patalear+V.eu.AD.1.SG+SBJF+2+PL
pataleardes-te	patalear+V.tu.AD.2.SG+INF+2+PL
pataleardes-te	patalear+V.tu.AD.2.SG+SBJF+2+PL
pataleardes-vos	patalear+V.vós.AD.2.PL+INF+2+PL
pataleardes-vos	patalear+V.vós.AD.2.PL+SBJF+2+PL
pataleárei-la	patalear+V.ele.ACC.3.F.SG+PQP+2+PL
pataleárei-las	patalear+V.ele.ACC.3.F.PL+PQP+2+PL
pataleárei-lo	patalear+V.ele.ACC.3.M.SG+PQP+2+PL
pataleárei-los	patalear+V.ele.ACC.3.M.PL+PQP+2+PL
pataleárei-nos	patalear+nós.AD.1.PL+PQP+2+PL
pataleáreis-lhe	patalear+V.ele.DAT.3.SG+PQP+2+PL
pataleáreis-lhes	patalear+V.ele.DAT.3.PL+PQP+2+PL
pataleáreis-me	patalear+V.eu.AD.1.SG+PQP+2+PL
pataleáreis-te	patalear+V.tu.AD.2.SG+PQP+2+PL
pataleáreis-vos	patalear+V.vós.AD.2.PL+PQP+2+PL
pataleare-la	patalear+V.ele.ACC.3.F.SG+INF+2+SG
pataleare-la	patalear+V.ele.ACC.3.F.SG+SBJF+2+SG
pataleare-las	patalear+V.ele.ACC.3.F.PL+INF+2+SG
pataleare-las	patalear+V.ele.ACC.3.F.PL+SBJF+2+SG
pataleare-lo	patalear+V.ele.ACC.3.M.SG+INF+2+SG
pataleare-lo	patalear+V.ele.ACC.3.M.SG+SBJF+2+SG
pataleare-los	patalear+V.ele.ACC.3.M.PL+INF+2+SG
pataleare-los	patalear+V.ele.ACC.3.M.PL+SBJF+2+SG
patalearem-lhe	patalear+V.ele.DAT.3.SG+INF+3+PL
patalearem-lhe	patalear+V.ele.DAT.3.SG+SBJF+3+PL
patalearem-lhes	patalear+V.ele.DAT.3.PL+INF+3+PL
patalearem-lhes	patalear+V.ele.DAT.3.PL+SBJF+3+PL
patalearem-me	patalear+V.eu.AD.1.SG+INF+3+PL
patalearem-me	patalear+V.eu.AD.1.SG+SBJF+3+PL
patalearem-na	patalear+V.ele.ACC.3.F.SG+INF+3+PL
patalearem-na	patalear+V.ele.ACC.3.F.SG+SBJF+3+PL
patalearem-nas	patalear+V.ele.ACC.3.F.PL+INF+3+PL
patalearem-nas	patalear+V.ele.ACC.3.F.PL+SBJF+3+PL
patalearem-no	patalear+V.ele.ACC.3.M.SG+INF+3+PL
patalearem-no	patalear+V.ele.ACC.3.M.SG+SBJF+3+PL
patalearem-nos	patalear+V.ele.ACC.3.M.PL+INF+3+PL
patalearem-nos	patalear+V.ele.ACC.3.M.PL+SBJF+3+PL
patalearem-nos	patalear+V.nós.AD.1.PL+INF+3+PL
patalearem-nos	patalear+V.nós.AD.1.PL+SBJF+3+PL
patalearem-se	patalear+V.ele.REFL+INF+3+PL
patalearem-se	patalear+V.ele.REFL+SBJF+3+PL
patalearem-te	patalear+V.tu.AD.2.SG+INF+3+PL
patalearem-te	patalear+V.tu.AD.2.SG+SBJF+3+PL
patalearem-vos	patalear+V.vós.AD.2.PL+INF+3+PL
patalearem-vos	patalear+V.vós.AD.2.PL+SBJF+3+PL
pataleare-nos	patalear+nós.AD.1.PL+INF+2+SG
pataleare-nos	patalear+nós.AD.1.PL+SBJF+2+SG
pataleares-lhe	patalear+V.ele.DAT.3.SG+INF+2+SG
pataleares-lhe	patalear+V.ele.DAT.3.SG+SBJF+2+SG
pataleares-lhes	patalear+V.ele.DAT.3.PL+INF+2+SG
pataleares-lhes	patalear+V.ele.DAT.3.PL+SBJF+2+SG
pataleares-me	patalear+V.eu.AD.1.SG+INF+2+SG
pataleares-me	patalear+V.eu.AD.1.SG+SBJF+2+SG
pataleares-te	patalear+V.tu.AD.2.SG+INF+2+SG
pataleares-te	patalear+V.tu.AD.2.SG+SBJF+2+SG
pataleares-vos	patalear+V.vós.AD.2.PL+INF+2+SG
pataleares-vos	patalear+V.vós.AD.2.PL+SBJF+2+SG
patalear-lhe-ão	patalear+V.ele.DAT.3.SG+FUT+3+PL
patalear-lhe-á	patalear+V.ele.DAT.3.SG+FUT+3+SG
patalear-lhe-ás	patalear+V.ele.DAT.3.SG+FUT+2+SG
patalear-lhe-ei	patalear+V.ele.DAT.3.SG+FUT+1+SG
patalear-lhe-eis	patalear+V.ele.DAT.3.SG+FUT+2+PL
patalear-lhe-emos	patalear+V.ele.DAT.3.SG+FUT+1+PL
patalear-lhe-íamos	patalear+V.ele.DAT.3.SG+COND+1+PL
patalear-lhe-iam	patalear+V.ele.DAT.3.SG+COND+3+PL
patalear-lhe-ia	patalear+V.ele.DAT.3.SG+COND+1+SG
patalear-lhe-ia	patalear+V.ele.DAT.3.SG+COND+3+SG
patalear-lhe-ias	patalear+V.ele.DAT.3.SG+COND+2+SG
patalear-lhe-íeis	patalear+V.ele.DAT.3.SG+COND+2+PL
patalear-lhe	patalear+V.ele.DAT.3.SG+INF
patalear-lhe	patalear+V.ele.DAT.3.SG+INF+1+SG
patalear-lhe	patalear+V.ele.DAT.3.SG+INF+3+SG
patalear-lhe	patalear+V.ele.DAT.3.SG+SBJF+1+SG
patalear-lhe	patalear+V.ele.DAT.3.SG+SBJF+3+SG
patalear-lhes-ão	patalear+V.ele.DAT.3.PL+FUT+3+PL
patalear-lhes-á	patalear+V.ele.DAT.3.PL+FUT+3+SG
patalear-lhes-ás	patalear+V.ele.DAT.3.PL+FUT+2+SG
patalear-lhes-ei	patalear+V.ele.DAT.3.PL+FUT+1+SG
patalear-lhes-eis	patalear+V.ele.DAT.3.PL+FUT+2+PL
patalear-lhes-emos	patalear+V.ele.DAT.3.PL+FUT+1+PL
patalear-lhes-íamos	patalear+V.ele.DAT.3.PL+COND+1+PL
patalear-lhes-iam	patalear+V.ele.DAT.3.PL+COND+3+PL
patalear-lhes-ia	patalear+V.ele.DAT.3.PL+COND+1+SG
patalear-lhes-ia	patalear+V.ele.DAT.3.PL+COND+3+SG
patalear-lhes-ias	patalear+V.ele.DAT.3.PL+COND+2+SG
patalear-lhes-íeis	patalear+V.ele.DAT.3.PL+COND+2+PL
patalear-lhes	patalear+V.ele.DAT.3.PL+INF
patalear-lhes	patalear+V.ele.DAT.3.PL+INF+1+SG
patalear-lhes	patalear+V.ele.DAT.3.PL+INF+3+SG
patalear-lhes	patalear+V.ele.DAT.3.PL+SBJF+1+SG
patalear-lhes	patalear+V.ele.DAT.3.PL+SBJF+3+SG
patalear-me-ão	patalear+V.eu.AD.1.SG+FUT+3+PL
patalear-me-á	patalear+V.eu.AD.1.SG+FUT+3+SG
patalear-me-ás	patalear+V.eu.AD.1.SG+FUT+2+SG
patalear-me-ei	patalear+V.eu.AD.1.SG+FUT+1+SG
patalear-me-eis	patalear+V.eu.AD.1.SG+FUT+2+PL
patalear-me-emos	patalear+V.eu.AD.1.SG+FUT+1+PL
patalear-me-íamos	patalear+V.eu.AD.1.SG+COND+1+PL
patalear-me-iam	patalear+V.eu.AD.1.SG+COND+3+PL
patalear-me-ia	patalear+V.eu.AD.1.SG+COND+1+SG
patalear-me-ia	patalear+V.eu.AD.1.SG+COND+3+SG
patalear-me-ias	patalear+V.eu.AD.1.SG+COND+2+SG
patalear-me-íeis	patalear+V.eu.AD.1.SG+COND+2+PL
patalear-me	patalear+V.eu.AD.1.SG+INF
patalear-me	patalear+V.eu.AD.1.SG+INF+1+SG
patalear-me	patalear+V.eu.AD.1.SG+INF+3+SG
patalear-me	patalear+V.eu.AD.1.SG+SBJF+1+SG
patalear-me	patalear+V.eu.AD.1.SG+SBJF+3+SG
patalearmo-la	patalear+V.ele.ACC.3.F.SG+INF+1+PL
patalearmo-la	patalear+V.ele.ACC.3.F.SG+SBJF+1+PL
patalearmo-las	patalear+V.ele.ACC.3.F.PL+INF+1+PL
patalearmo-las	patalear+V.ele.ACC.3.F.PL+SBJF+1+PL
patalearmo-lo	patalear+V.ele.ACC.3.M.SG+INF+1+PL
patalearmo-lo	patalear+V.ele.ACC.3.M.SG+SBJF+1+PL
patalearmo-los	patalear+V.ele.ACC.3.M.PL+INF+1+PL
patalearmo-los	patalear+V.ele.ACC.3.M.PL+SBJF+1+PL
patalearmo-nos	patalear+nós.AD.1.PL+INF+1+PL
patalearmo-nos	patalear+nós.AD.1.PL+SBJF+1+PL
patalearmos-lhe	patalear+V.ele.DAT.3.SG+INF+1+PL
patalearmos-lhe	patalear+V.ele.DAT.3.SG+SBJF+1+PL
patalearmos-lhes	patalear+V.ele.DAT.3.PL+INF+1+PL
patalearmos-lhes	patalear+V.ele.DAT.3.PL+SBJF+1+PL
patalearmos-me	patalear+V.eu.AD.1.SG+INF+1+PL
patalearmos-me	patalear+V.eu.AD.1.SG+SBJF+1+PL
patalearmos-te	patalear+V.tu.AD.2.SG+INF+1+PL
patalearmos-te	patalear+V.tu.AD.2.SG+SBJF+1+PL
patalearmos-vos	patalear+V.vós.AD.2.PL+INF+1+PL
patalearmos-vos	patalear+V.vós.AD.2.PL+SBJF+1+PL
patalear-nos-ão	patalear+nós.AD.1.PL+FUT+3+PL
patalear-nos-á	patalear+nós.AD.1.PL+FUT+3+SG
patalear-nos-ás	patalear+nós.AD.1.PL+FUT+2+SG
patalear-nos-ei	patalear+nós.AD.1.PL+FUT+1+SG
patalear-nos-eis	patalear+nós.AD.1.PL+FUT+2+PL
patalear-nos-emos	patalear+nós.AD.1.PL+FUT+1+PL
patalear-nos-íamos	patalear+nós.AD.1.PL+COND+1+PL
patalear-nos-iam	patalear+nós.AD.1.PL+COND+3+PL
patalear-nos-ia	patalear+nós.AD.1.PL+COND+1+SG
patalear-nos-ia	patalear+nós.AD.1.PL+COND+3+SG
patalear-nos-ias	patalear+nós.AD.1.PL+COND+2+SG
patalear-nos-íeis	patalear+nós.AD.1.PL+COND+2+PL
patalear-nos	patalear+nós.AD.1.PL+INF
patalear-nos	patalear+nós.AD.1.PL+INF+1+SG
patalear-nos	patalear+nós.AD.1.PL+INF+3+SG
patalear-nos	patalear+nós.AD.1.PL+SBJF+1+SG
patalear-nos	patalear+nós.AD.1.PL+SBJF+3+SG
patalear-se-ão	patalear+V.ele.REFL+FUT+3+PL
patalear-se-á	patalear+V.ele.REFL+FUT+3+SG
patalear-se-iam	patalear+V.ele.REFL+COND+3+PL
patalear-se-ia	patalear+V.ele.REFL+COND+3+SG
patalear-se	patalear+V.ele.REFL+INF
patalear-se	patalear+V.ele.REFL+INF+3+SG
patalear-se	patalear+V.ele.REFL+SBJF+3+SG
patalear-te-ão	patalear+V.tu.AD.2.SG+FUT+3+PL
patalear-te-á	patalear+V.tu.AD.2.SG+FUT+3+SG
patalear-te-ás	patalear+V.tu.AD.2.SG+FUT+2+SG
patalear-te-ei	patalear+V.tu.AD.2.SG+FUT+1+SG
patalear-te-eis	patalear+V.tu.AD.2.SG+FUT+2+PL
patalear-te-emos	patalear+V.tu.AD.2.SG+FUT+1+PL
patalear-te-íamos	patalear+V.tu.AD.2.SG+COND+1+PL
patalear-te-iam	patalear+V.tu.AD.2.SG+COND+3+PL
patalear-te-ia	patalear+V.tu.AD.2.SG+COND+1+SG
patalear-te-ia	patalear+V.tu.AD.2.SG+COND+3+SG
patalear-te-ias	patalear+V.tu.AD.2.SG+COND+2+SG
patalear-te-íeis	patalear+V.tu.AD.2.SG+COND+2+PL
patalear-te	patalear+V.tu.AD.2.SG+INF
patalear-te	patalear+V.tu.AD.2.SG+INF+1+SG
patalear-te	patalear+V.tu.AD.2.SG+INF+3+SG
patalear-te	patalear+V.tu.AD.2.SG+SBJF+1+SG
patalear-te	patalear+V.tu.AD.2.SG+SBJF+3+SG
patalear-vos-ão	patalear+V.vós.AD.2.PL+FUT+3+PL
patalear-vos-á	patalear+V.vós.AD.2.PL+FUT+3+SG
patalear-vos-ás	patalear+V.vós.AD.2.PL+FUT+2+SG
patalear-vos-ei	patalear+V.vós.AD.2.PL+FUT+1+SG
patalear-vos-eis	patalear+V.vós.AD.2.PL+FUT+2+PL
patalear-vos-emos	patalear+V.vós.AD.2.PL+FUT+1+PL
patalear-vos-íamos	patalear+V.vós.AD.2.PL+COND+1+PL
patalear-vos-iam	patalear+V.vós.AD.2.PL+COND+3+PL
patalear-vos-ia	patalear+V.vós.AD.2.PL+COND+1+SG
patalear-vos-ia	patalear+V.vós.AD.2.PL+COND+3+SG
patalear-vos-ias	patalear+V.vós.AD.2.PL+COND+2+SG
patalear-vos-íeis	patalear+V.vós.AD.2.PL+COND+2+PL
patalear-vos	patalear+V.vós.AD.2.PL+INF
patalear-vos	patalear+V.vós.AD.2.PL+INF+1+SG
patalear-vos	patalear+V.vós.AD.2.PL+INF+3+SG
patalear-vos	patalear+V.vós.AD.2.PL+SBJF+1+SG
patalear-vos	patalear+V.vós.AD.2.PL+SBJF+3+SG
pataleaste-a	patalear+V.ele.ACC.3.F.SG+PRF+2+SG
pataleaste-as	patalear+V.ele.ACC.3.F.PL+PRF+2+SG
pataleaste-la	patalear+V.ele.ACC.3.F.SG+PRF+2+PL
pataleaste-las	patalear+V.ele.ACC.3.F.PL+PRF+2+PL
pataleaste-lhe	patalear+V.ele.DAT.3.SG+PRF+2+SG
pataleaste-lhes	patalear+V.ele.DAT.3.PL+PRF+2+SG
pataleaste-lo	patalear+V.ele.ACC.3.M.SG+PRF+2+PL
pataleaste-los	patalear+V.ele.ACC.3.M.PL+PRF+2+PL
pataleaste-me	patalear+V.eu.AD.1.SG+PRF+2+SG
pataleaste-nos	patalear+nós.AD.1.PL+PRF+2+PL
pataleaste-nos	patalear+nós.AD.1.PL+PRF+2+SG
pataleaste-o	patalear+V.ele.ACC.3.M.SG+PRF+2+SG
pataleaste-os	patalear+V.ele.ACC.3.M.PL+PRF+2+SG
pataleastes-lhe	patalear+V.ele.DAT.3.SG+PRF+2+PL
pataleastes-lhes	patalear+V.ele.DAT.3.PL+PRF+2+PL
pataleastes-me	patalear+V.eu.AD.1.SG+PRF+2+PL
pataleastes-te	patalear+V.tu.AD.2.SG+PRF+2+PL
pataleastes-vos	patalear+V.vós.AD.2.PL+PRF+2+PL
pataleaste-te	patalear+V.tu.AD.2.SG+PRF+2+SG
pataleaste-vos	patalear+V.vós.AD.2.PL+PRF+2+SG
pataleava-a	patalear+V.ele.ACC.3.F.SG+IMPF+1+SG
pataleava-a	patalear+V.ele.ACC.3.F.SG+IMPF+3+SG
pataleava-as	patalear+V.ele.ACC.3.F.PL+IMPF+1+SG
pataleava-as	patalear+V.ele.ACC.3.F.PL+IMPF+3+SG
pataleava-la	patalear+V.ele.ACC.3.F.SG+IMPF+2+SG
pataleava-las	patalear+V.ele.ACC.3.F.PL+IMPF+2+SG
pataleava-lhe	patalear+V.ele.DAT.3.SG+IMPF+1+SG
pataleava-lhe	patalear+V.ele.DAT.3.SG+IMPF+3+SG
pataleava-lhes	patalear+V.ele.DAT.3.PL+IMPF+1+SG
pataleava-lhes	patalear+V.ele.DAT.3.PL+IMPF+3+SG
pataleava-lo	patalear+V.ele.ACC.3.M.SG+IMPF+2+SG
pataleava-los	patalear+V.ele.ACC.3.M.PL+IMPF+2+SG
pataleava-me	patalear+V.eu.AD.1.SG+IMPF+1+SG
pataleava-me	patalear+V.eu.AD.1.SG+IMPF+3+SG
pataleavam-lhe	patalear+V.ele.DAT.3.SG+IMPF+3+PL
pataleavam-lhes	patalear+V.ele.DAT.3.PL+IMPF+3+PL
pataleavam-me	patalear+V.eu.AD.1.SG+IMPF+3+PL
pataleavam-na	patalear+V.ele.ACC.3.F.SG+IMPF+3+PL
pataleavam-nas	patalear+V.ele.ACC.3.F.PL+IMPF+3+PL
pataleavam-no	patalear+V.ele.ACC.3.M.SG+IMPF+3+PL
pataleavam-nos	patalear+V.ele.ACC.3.M.PL+IMPF+3+PL
pataleavam-nos	patalear+V.nós.AD.1.PL+IMPF+3+PL
pataleávamo-la	patalear+V.ele.ACC.3.F.SG+IMPF+1+PL
pataleávamo-las	patalear+V.ele.ACC.3.F.PL+IMPF+1+PL
pataleávamo-lo	patalear+V.ele.ACC.3.M.SG+IMPF+1+PL
pataleávamo-los	patalear+V.ele.ACC.3.M.PL+IMPF+1+PL
pataleávamo-nos	patalear+nós.AD.1.PL+IMPF+1+PL
pataleávamos-lhe	patalear+V.ele.DAT.3.SG+IMPF+1+PL
pataleávamos-lhes	patalear+V.ele.DAT.3.PL+IMPF+1+PL
pataleávamos-me	patalear+V.eu.AD.1.SG+IMPF+1+PL
pataleávamos-te	patalear+V.tu.AD.2.SG+IMPF+1+PL
pataleávamos-vos	patalear+V.vós.AD.2.PL+IMPF+1+PL
pataleavam-se	patalear+V.ele.REFL+IMPF+3+PL
pataleavam-te	patalear+V.tu.AD.2.SG+IMPF+3+PL
pataleavam-vos	patalear+V.vós.AD.2.PL+IMPF+3+PL
pataleava-nos	patalear+nós.AD.1.PL+IMPF+1+SG
pataleava-nos	patalear+nós.AD.1.PL+IMPF+2+SG
pataleava-nos	patalear+nós.AD.1.PL+IMPF+3+SG
pataleava-o	patalear+V.ele.ACC.3.M.SG+IMPF+1+SG
pataleava-o	patalear+V.ele.ACC.3.M.SG+IMPF+3+SG
pataleava-os	patalear+V.ele.ACC.3.M.PL+IMPF+1+SG
pataleava-os	patalear+V.ele.ACC.3.M.PL+IMPF+3+SG
pataleava-se	patalear+V.ele.REFL+IMPF+1+SG
pataleava-se	patalear+V.ele.REFL+IMPF+3+SG
pataleavas-lhe	patalear+V.ele.DAT.3.SG+IMPF+2+SG
pataleavas-lhes	patalear+V.ele.DAT.3.PL+IMPF+2+SG
pataleavas-me	patalear+V.eu.AD.1.SG+IMPF+2+SG
pataleavas-te	patalear+V.tu.AD.2.SG+IMPF+2+SG
pataleavas-vos	patalear+V.vós.AD.2.PL+IMPF+2+SG
pataleava-te	patalear+V.tu.AD.2.SG+IMPF+1+SG
pataleava-te	patalear+V.tu.AD.2.SG+IMPF+3+SG
pataleava-vos	patalear+V.vós.AD.2.PL+IMPF+1+SG
pataleava-vos	patalear+V.vós.AD.2.PL+IMPF+3+SG
pataleávei-la	patalear+V.ele.ACC.3.F.SG+IMPF+2+PL
pataleávei-las	patalear+V.ele.ACC.3.F.PL+IMPF+2+PL
pataleávei-lo	patalear+V.ele.ACC.3.M.SG+IMPF+2+PL
pataleávei-los	patalear+V.ele.ACC.3.M.PL+IMPF+2+PL
pataleávei-nos	patalear+nós.AD.1.PL+IMPF+2+PL
pataleáveis-lhe	patalear+V.ele.DAT.3.SG+IMPF+2+PL
pataleáveis-lhes	patalear+V.ele.DAT.3.PL+IMPF+2+PL
pataleáveis-me	patalear+V.eu.AD.1.SG+IMPF+2+PL
pataleáveis-te	patalear+V.tu.AD.2.SG+IMPF+2+PL
pataleáveis-vos	patalear+V.vós.AD.2.PL+IMPF+2+PL
pataleei-a	patalear+V.ele.ACC.3.F.SG+PRF+1+SG
pataleei-as	patalear+V.ele.ACC.3.F.PL+PRF+1+SG
pataleei-lhe	patalear+V.ele.DAT.3.SG+PRF+1+SG
pataleei-lhes	patalear+V.ele.DAT.3.PL+PRF+1+SG
pataleei-me	patalear+V.eu.AD.1.SG+PRF+1+SG
pataleei-nos	patalear+nós.AD.1.PL+PRF+1+SG
pataleei-o	patalear+V.ele.ACC.3.M.SG+PRF+1+SG
pataleei-os	patalear+V.ele.ACC.3.M.PL+PRF+1+SG
pataleei-te	patalear+V.tu.AD.2.SG+PRF+1+SG
pataleei-vos	patalear+V.vós.AD.2.PL+PRF+1+SG
pataleia-a	patalear+V.ele.ACC.3.F.SG+PRS+3+SG
pataleia-as	patalear+V.ele.ACC.3.F.PL+PRS+3+SG
pataleia-la	patalear+V.ele.ACC.3.F.SG+PRS+2+SG
pataleia-las	patalear+V.ele.ACC.3.F.PL+PRS+2+SG
pataleia-lhe	patalear+V.ele.DAT.3.SG+PRS+3+SG
pataleia-lhes	patalear+V.ele.DAT.3.PL+PRS+3+SG
pataleia-lo	patalear+V.ele.ACC.3.M.SG+PRS+2+SG
pataleia-los	patalear+V.ele.ACC.3.M.PL+PRS+2+SG
pataleia-me	patalear+V.eu.AD.1.SG+PRS+3+SG
pataleiam-lhe	patalear+V.ele.DAT.3.SG+PRS+3+PL
pataleiam-lhes	patalear+V.ele.DAT.3.PL+PRS+3+PL
pataleiam-me	patalear+V.eu.AD.1.SG+PRS+3+PL
pataleiam-na	patalear+V.ele.ACC.3.F.SG+PRS+3+PL
pataleiam-nas	patalear+V.ele.ACC.3.F.PL+PRS+3+PL
pataleiam-no	patalear+V.ele.ACC.3.M.SG+PRS+3+PL
pataleiam-nos	patalear+V.ele.ACC.3.M.PL+PRS+3+PL
pataleiam-nos	patalear+V.nós.AD.1.PL+PRS+3+PL
pataleiam-se	patalear+V.ele.REFL+PRS+3+PL
pataleiam-te	patalear+V.tu.AD.2.SG+PRS+3+PL
pataleiam-vos	patalear+V.vós.AD.2.PL+PRS+3+PL
pataleia-nos	patalear+nós.AD.1.PL+PRS+2+SG
pataleia-nos	patalear+nós.AD.1.PL+PRS+3+SG
pataleia-o	patalear+V.ele.ACC.3.M.SG+PRS+3+SG
pataleia-os	patalear+V.ele.ACC.3.M.PL+PRS+3+SG
pataleia-se	patalear+V.ele.REFL+PRS+3+SG
pataleias-lhe	patalear+V.ele.DAT.3.SG+PRS+2+SG
pataleias-lhes	patalear+V.ele.DAT.3.PL+PRS+2+SG
pataleias-me	patalear+V.eu.AD.1.SG+PRS+2+SG
pataleias-te	patalear+V.tu.AD.2.SG+PRS+2+SG
pataleias-vos	patalear+V.vós.AD.2.PL+PRS+2+SG
pataleia-te	patalear+V.tu.AD.2.SG+PRS+3+SG
pataleia-vos	patalear+V.vós.AD.2.PL+PRS+3+SG
pataleio-a	patalear+V.ele.ACC.3.F.SG+PRS+1+SG
pataleio-as	patalear+V.ele.ACC.3.F.PL+PRS+1+SG
pataleio-lhe	patalear+V.ele.DAT.3.SG+PRS+1+SG
pataleio-lhes	patalear+V.ele.DAT.3.PL+PRS+1+SG
pataleio-me	patalear+V.eu.AD.1.SG+PRS+1+SG
pataleio-nos	patalear+nós.AD.1.PL+PRS+1+SG
pataleio-o	patalear+V.ele.ACC.3.M.SG+PRS+1+SG
pataleio-os	patalear+V.ele.ACC.3.M.PL+PRS+1+SG
pataleio-te	patalear+V.tu.AD.2.SG+PRS+1+SG
pataleio-vos	patalear+V.vós.AD.2.PL+PRS+1+SG
pataleou-a	patalear+V.ele.ACC.3.F.SG+PRF+3+SG
pataleou-as	patalear+V.ele.ACC.3.F.PL+PRF+3+SG
pataleou-lhe	patalear+V.ele.DAT.3.SG+PRF+3+SG
pataleou-lhes	patalear+V.ele.DAT.3.PL+PRF+3+SG
pataleou-me	patalear+V.eu.AD.1.SG+PRF+3+SG
pataleou-nos	patalear+nós.AD.1.PL+PRF+3+SG
pataleou-o	patalear+V.ele.ACC.3.M.SG+PRF+3+SG
pataleou-os	patalear+V.ele.ACC.3.M.PL+PRF+3+SG
pataleou-se	patalear+V.ele.REFL+PRF+3+SG
pataleou-te	patalear+V.tu.AD.2.SG+PRF+3+SG
pataleou-vos	patalear+V.vós.AD.2.PL+PRF+3+SG
patarata-a	pataratar+V.ele.ACC.3.F.SG+PRS+3+SG
patarata-as	pataratar+V.ele.ACC.3.F.PL+PRS+3+SG
pataratai-la	pataratar+V.ele.ACC.3.F.SG+PRS+2+PL
pataratai-las	pataratar+V.ele.ACC.3.F.PL+PRS+2+PL
pataratai-lo	pataratar+V.ele.ACC.3.M.SG+PRS+2+PL
pataratai-los	pataratar+V.ele.ACC.3.M.PL+PRS+2+PL
pataratai-nos	pataratar+nós.AD.1.PL+PRS+2+PL
pataratais-lhe	pataratar+V.ele.DAT.3.SG+PRS+2+PL
pataratais-lhes	pataratar+V.ele.DAT.3.PL+PRS+2+PL
pataratais-me	pataratar+V.eu.AD.1.SG+PRS+2+PL
pataratais-te	pataratar+V.tu.AD.2.SG+PRS+2+PL
pataratais-vos	pataratar+V.vós.AD.2.PL+PRS+2+PL
pataratá-la-ão	pataratar+V.ele.ACC.3.F.SG+FUT+3+PL
pataratá-la-á	pataratar+V.ele.ACC.3.F.SG+FUT+3+SG
pataratá-la-ás	pataratar+V.ele.ACC.3.F.SG+FUT+2+SG
pataratá-la-ei	pataratar+V.ele.ACC.3.F.SG+FUT+1+SG
pataratá-la-eis	pataratar+V.ele.ACC.3.F.SG+FUT+2+PL
pataratá-la-emos	pataratar+V.ele.ACC.3.F.SG+FUT+1+PL
pataratá-la-íamos	pataratar+V.ele.ACC.3.F.SG+COND+1+PL
pataratá-la-iam	pataratar+V.ele.ACC.3.F.SG+COND+3+PL
pataratá-la-ia	pataratar+V.ele.ACC.3.F.SG+COND+1+SG
pataratá-la-ia	pataratar+V.ele.ACC.3.F.SG+COND+3+SG
pataratá-la-ias	pataratar+V.ele.ACC.3.F.SG+COND+2+SG
pataratá-la-íeis	pataratar+V.ele.ACC.3.F.SG+COND+2+PL
pataratá-la	pataratar+V.ele.ACC.3.F.SG+INF+1+SG
pataratá-la	pataratar+V.ele.ACC.3.F.SG+INF+3+SG
patarata-la	pataratar+V.ele.ACC.3.F.SG+PRS+2+SG
pataratá-la	pataratar+V.ele.ACC.3.F.SG+SBJF+1+SG
pataratá-la	pataratar+V.ele.ACC.3.F.SG+SBJF+3+SG
pataratá-las-ão	pataratar+V.ele.ACC.3.F.PL+FUT+3+PL
pataratá-las-á	pataratar+V.ele.ACC.3.F.PL+FUT+3+SG
pataratá-las-ás	pataratar+V.ele.ACC.3.F.PL+FUT+2+SG
pataratá-las-ei	pataratar+V.ele.ACC.3.F.PL+FUT+1+SG
pataratá-las-eis	pataratar+V.ele.ACC.3.F.PL+FUT+2+PL
pataratá-las-emos	pataratar+V.ele.ACC.3.F.PL+FUT+1+PL
pataratá-las-íamos	pataratar+V.ele.ACC.3.F.PL+COND+1+PL
pataratá-las-iam	pataratar+V.ele.ACC.3.F.PL+COND+3+PL
pataratá-las-ia	pataratar+V.ele.ACC.3.F.PL+COND+1+SG
pataratá-las-ia	pataratar+V.ele.ACC.3.F.PL+COND+3+SG
pataratá-las-ias	pataratar+V.ele.ACC.3.F.PL+COND+2+SG
pataratá-las-íeis	pataratar+V.ele.ACC.3.F.PL+COND+2+PL
pataratá-las	pataratar+V.ele.ACC.3.F.PL+INF+1+SG
pataratá-las	pataratar+V.ele.ACC.3.F.PL+INF+3+SG
patarata-las	pataratar+V.ele.ACC.3.F.PL+PRS+2+SG
pataratá-las	pataratar+V.ele.ACC.3.F.PL+SBJF+1+SG
pataratá-las	pataratar+V.ele.ACC.3.F.PL+SBJF+3+SG
patarata-lhe	pataratar+V.ele.DAT.3.SG+PRS+3+SG
patarata-lhes	pataratar+V.ele.DAT.3.PL+PRS+3+SG
pataratá-lo-ão	pataratar+V.ele.ACC.3.M.SG+FUT+3+PL
pataratá-lo-á	pataratar+V.ele.ACC.3.M.SG+FUT+3+SG
pataratá-lo-ás	pataratar+V.ele.ACC.3.M.SG+FUT+2+SG
pataratá-lo-ei	pataratar+V.ele.ACC.3.M.SG+FUT+1+SG
pataratá-lo-eis	pataratar+V.ele.ACC.3.M.SG+FUT+2+PL
pataratá-lo-emos	pataratar+V.ele.ACC.3.M.SG+FUT+1+PL
pataratá-lo-íamos	pataratar+V.ele.ACC.3.M.SG+COND+1+PL
pataratá-lo-iam	pataratar+V.ele.ACC.3.M.SG+COND+3+PL
pataratá-lo-ia	pataratar+V.ele.ACC.3.M.SG+COND+1+SG
pataratá-lo-ia	pataratar+V.ele.ACC.3.M.SG+COND+3+SG
pataratá-lo-ias	pataratar+V.ele.ACC.3.M.SG+COND+2+SG
pataratá-lo-íeis	pataratar+V.ele.ACC.3.M.SG+COND+2+PL
pataratá-lo	pataratar+V.ele.ACC.3.M.SG+INF+1+SG
pataratá-lo	pataratar+V.ele.ACC.3.M.SG+INF+3+SG
patarata-lo	pataratar+V.ele.ACC.3.M.SG+PRS+2+SG
pataratá-lo	pataratar+V.ele.ACC.3.M.SG+SBJF+1+SG
pataratá-lo	pataratar+V.ele.ACC.3.M.SG+SBJF+3+SG
pataratá-los-ão	pataratar+V.ele.ACC.3.M.PL+FUT+3+PL
pataratá-los-á	pataratar+V.ele.ACC.3.M.PL+FUT+3+SG
pataratá-los-ás	pataratar+V.ele.ACC.3.M.PL+FUT+2+SG
pataratá-los-ei	pataratar+V.ele.ACC.3.M.PL+FUT+1+SG
pataratá-los-eis	pataratar+V.ele.ACC.3.M.PL+FUT+2+PL
pataratá-los-emos	pataratar+V.ele.ACC.3.M.PL+FUT+1+PL
pataratá-los-íamos	pataratar+V.ele.ACC.3.M.PL+COND+1+PL
pataratá-los-iam	pataratar+V.ele.ACC.3.M.PL+COND+3+PL
pataratá-los-ia	pataratar+V.ele.ACC.3.M.PL+COND+1+SG
pataratá-los-ia	pataratar+V.ele.ACC.3.M.PL+COND+3+SG
pataratá-los-ias	pataratar+V.ele.ACC.3.M.PL+COND+2+SG
pataratá-los-íeis	pataratar+V.ele.ACC.3.M.PL+COND+2+PL
pataratá-los	pataratar+V.ele.ACC.3.M.PL+INF+1+SG
pataratá-los	pataratar+V.ele.ACC.3.M.PL+INF+3+SG
patarata-los	pataratar+V.ele.ACC.3.M.PL+PRS+2+SG
pataratá-los	pataratar+V.ele.ACC.3.M.PL+SBJF+1+SG
pataratá-los	pataratar+V.ele.ACC.3.M.PL+SBJF+3+SG
patarata-me	pataratar+V.eu.AD.1.SG+PRS+3+SG
pataratam-lhe	pataratar+V.ele.DAT.3.SG+PRS+3+PL
pataratam-lhes	pataratar+V.ele.DAT.3.PL+PRS+3+PL
pataratam-me	pataratar+V.eu.AD.1.SG+PRS+3+PL
pataratam-na	pataratar+V.ele.ACC.3.F.SG+PRS+3+PL
pataratam-nas	pataratar+V.ele.ACC.3.F.PL+PRS+3+PL
pataratam-no	pataratar+V.ele.ACC.3.M.SG+PRS+3+PL
pataratam-nos	pataratar+V.ele.ACC.3.M.PL+PRS+3+PL
pataratam-nos	pataratar+V.nós.AD.1.PL+PRS+3+PL
pataratamo-la	pataratar+V.ele.ACC.3.F.SG+PRF+1+PL
pataratamo-la	pataratar+V.ele.ACC.3.F.SG+PRS+1+PL
pataratamo-las	pataratar+V.ele.ACC.3.F.PL+PRF+1+PL
pataratamo-las	pataratar+V.ele.ACC.3.F.PL+PRS+1+PL
pataratamo-lo	pataratar+V.ele.ACC.3.M.SG+PRF+1+PL
pataratamo-lo	pataratar+V.ele.ACC.3.M.SG+PRS+1+PL
pataratamo-los	pataratar+V.ele.ACC.3.M.PL+PRF+1+PL
pataratamo-los	pataratar+V.ele.ACC.3.M.PL+PRS+1+PL
pataratamo-nos	pataratar+nós.AD.1.PL+PRF+1+PL
pataratamo-nos	pataratar+nós.AD.1.PL+PRS+1+PL
pataratamos-lhe	pataratar+V.ele.DAT.3.SG+PRF+1+PL
pataratamos-lhe	pataratar+V.ele.DAT.3.SG+PRS+1+PL
pataratamos-lhes	pataratar+V.ele.DAT.3.PL+PRF+1+PL
pataratamos-lhes	pataratar+V.ele.DAT.3.PL+PRS+1+PL
pataratamos-me	pataratar+V.eu.AD.1.SG+PRF+1+PL
pataratamos-me	pataratar+V.eu.AD.1.SG+PRS+1+PL
pataratamos-te	pataratar+V.tu.AD.2.SG+PRF+1+PL
pataratamos-te	pataratar+V.tu.AD.2.SG+PRS+1+PL
pataratamos-vos	pataratar+V.vós.AD.2.PL+PRF+1+PL
pataratamos-vos	pataratar+V.vós.AD.2.PL+PRS+1+PL
pataratam-se	pataratar+V.ele.REFL+PRS+3+PL
pataratam-te	pataratar+V.tu.AD.2.SG+PRS+3+PL
pataratam-vos	pataratar+V.vós.AD.2.PL+PRS+3+PL
pataratando-a	pataratar+V.ele.ACC.3.F.SG+GRD
pataratando-as	pataratar+V.ele.ACC.3.F.PL+GRD
pataratando-lhe	pataratar+V.ele.DAT.3.SG+GRD
pataratando-lhes	pataratar+V.ele.DAT.3.PL+GRD
pataratando-me	pataratar+V.eu.AD.1.SG+GRD
pataratando-nos	pataratar+nós.AD.1.PL+GRD
pataratando-o	pataratar+V.ele.ACC.3.M.SG+GRD
pataratando-os	pataratar+V.ele.ACC.3.M.PL+GRD
pataratando-se	pataratar+V.ele.REFL+GRD
pataratando-te	pataratar+V.tu.AD.2.SG+GRD
pataratando-vos	pataratar+V.vós.AD.2.PL+GRD
patarata-nos	pataratar+nós.AD.1.PL+PRS+2+SG
patarata-nos	pataratar+nós.AD.1.PL+PRS+3+SG
patarata-o	pataratar+V.ele.ACC.3.M.SG+PRS+3+SG
patarata-os	pataratar+V.ele.ACC.3.M.PL+PRS+3+SG
pataratara-a	pataratar+V.ele.ACC.3.F.SG+PQP+1+SG
pataratara-a	pataratar+V.ele.ACC.3.F.SG+PQP+3+SG
pataratara-as	pataratar+V.ele.ACC.3.F.PL+PQP+1+SG
pataratara-as	pataratar+V.ele.ACC.3.F.PL+PQP+3+SG
pataratara-la	pataratar+V.ele.ACC.3.F.SG+PQP+2+SG
pataratara-las	pataratar+V.ele.ACC.3.F.PL+PQP+2+SG
pataratara-lhe	pataratar+V.ele.DAT.3.SG+PQP+1+SG
pataratara-lhe	pataratar+V.ele.DAT.3.SG+PQP+3+SG
pataratara-lhes	pataratar+V.ele.DAT.3.PL+PQP+1+SG
pataratara-lhes	pataratar+V.ele.DAT.3.PL+PQP+3+SG
pataratara-lo	pataratar+V.ele.ACC.3.M.SG+PQP+2+SG
pataratara-los	pataratar+V.ele.ACC.3.M.PL+PQP+2+SG
pataratara-me	pataratar+V.eu.AD.1.SG+PQP+1+SG
pataratara-me	pataratar+V.eu.AD.1.SG+PQP+3+SG
patarataram-lhe	pataratar+V.ele.DAT.3.SG+PQP+3+PL
patarataram-lhe	pataratar+V.ele.DAT.3.SG+PRF+3+PL
patarataram-lhes	pataratar+V.ele.DAT.3.PL+PQP+3+PL
patarataram-lhes	pataratar+V.ele.DAT.3.PL+PRF+3+PL
patarataram-me	pataratar+V.eu.AD.1.SG+PQP+3+PL
patarataram-me	pataratar+V.eu.AD.1.SG+PRF+3+PL
patarataram-na	pataratar+V.ele.ACC.3.F.SG+PQP+3+PL
patarataram-na	pataratar+V.ele.ACC.3.F.SG+PRF+3+PL
patarataram-nas	pataratar+V.ele.ACC.3.F.PL+PQP+3+PL
patarataram-nas	pataratar+V.ele.ACC.3.F.PL+PRF+3+PL
patarataram-no	pataratar+V.ele.ACC.3.M.SG+PQP+3+PL
patarataram-no	pataratar+V.ele.ACC.3.M.SG+PRF+3+PL
patarataram-nos	pataratar+V.ele.ACC.3.M.PL+PQP+3+PL
patarataram-nos	pataratar+V.ele.ACC.3.M.PL+PRF+3+PL
patarataram-nos	pataratar+V.nós.AD.1.PL+PQP+3+PL
patarataram-nos	pataratar+V.nós.AD.1.PL+PRF+3+PL
pataratáramo-la	pataratar+V.ele.ACC.3.F.SG+PQP+1+PL
pataratáramo-las	pataratar+V.ele.ACC.3.F.PL+PQP+1+PL
pataratáramo-lo	pataratar+V.ele.ACC.3.M.SG+PQP+1+PL
pataratáramo-los	pataratar+V.ele.ACC.3.M.PL+PQP+1+PL
