perfar-lhe-ei	perfazer+V.ele.DAT.3.SG+FUT+1+SG
perfar-lhe-eis	perfazer+V.ele.DAT.3.SG+FUT+2+PL
perfar-lhe-emos	perfazer+V.ele.DAT.3.SG+FUT+1+PL
perfar-lhe-íamos	perfazer+V.ele.DAT.3.SG+COND+1+PL
perfar-lhe-iam	perfazer+V.ele.DAT.3.SG+COND+3+PL
perfar-lhe-ia	perfazer+V.ele.DAT.3.SG+COND+1+SG
perfar-lhe-ia	perfazer+V.ele.DAT.3.SG+COND+3+SG
perfar-lhe-ias	perfazer+V.ele.DAT.3.SG+COND+2+SG
perfar-lhe-íeis	perfazer+V.ele.DAT.3.SG+COND+2+PL
perfar-lhes-ão	perfazer+V.ele.DAT.3.PL+FUT+3+PL
perfar-lhes-á	perfazer+V.ele.DAT.3.PL+FUT+3+SG
perfar-lhes-ás	perfazer+V.ele.DAT.3.PL+FUT+2+SG
perfar-lhes-ei	perfazer+V.ele.DAT.3.PL+FUT+1+SG
perfar-lhes-eis	perfazer+V.ele.DAT.3.PL+FUT+2+PL
perfar-lhes-emos	perfazer+V.ele.DAT.3.PL+FUT+1+PL
perfar-lhes-íamos	perfazer+V.ele.DAT.3.PL+COND+1+PL
perfar-lhes-iam	perfazer+V.ele.DAT.3.PL+COND+3+PL
perfar-lhes-ia	perfazer+V.ele.DAT.3.PL+COND+1+SG
perfar-lhes-ia	perfazer+V.ele.DAT.3.PL+COND+3+SG
perfar-lhes-ias	perfazer+V.ele.DAT.3.PL+COND+2+SG
perfar-lhes-íeis	perfazer+V.ele.DAT.3.PL+COND+2+PL
perfar-me-ão	perfazer+V.eu.AD.1.SG+FUT+3+PL
perfar-me-á	perfazer+V.eu.AD.1.SG+FUT+3+SG
perfar-me-ás	perfazer+V.eu.AD.1.SG+FUT+2+SG
perfar-me-ei	perfazer+V.eu.AD.1.SG+FUT+1+SG
perfar-me-eis	perfazer+V.eu.AD.1.SG+FUT+2+PL
perfar-me-emos	perfazer+V.eu.AD.1.SG+FUT+1+PL
perfar-me-íamos	perfazer+V.eu.AD.1.SG+COND+1+PL
perfar-me-iam	perfazer+V.eu.AD.1.SG+COND+3+PL
perfar-me-ia	perfazer+V.eu.AD.1.SG+COND+1+SG
perfar-me-ia	perfazer+V.eu.AD.1.SG+COND+3+SG
perfar-me-ias	perfazer+V.eu.AD.1.SG+COND+2+SG
perfar-me-íeis	perfazer+V.eu.AD.1.SG+COND+2+PL
perfar-nos-ão	perfazer+nós.AD.1.PL+FUT+3+PL
perfar-nos-á	perfazer+nós.AD.1.PL+FUT+3+SG
perfar-nos-ás	perfazer+nós.AD.1.PL+FUT+2+SG
perfar-nos-ei	perfazer+nós.AD.1.PL+FUT+1+SG
perfar-nos-eis	perfazer+nós.AD.1.PL+FUT+2+PL
perfar-nos-emos	perfazer+nós.AD.1.PL+FUT+1+PL
perfar-nos-íamos	perfazer+nós.AD.1.PL+COND+1+PL
perfar-nos-iam	perfazer+nós.AD.1.PL+COND+3+PL
perfar-nos-ia	perfazer+nós.AD.1.PL+COND+1+SG
perfar-nos-ia	perfazer+nós.AD.1.PL+COND+3+SG
perfar-nos-ias	perfazer+nós.AD.1.PL+COND+2+SG
perfar-nos-íeis	perfazer+nós.AD.1.PL+COND+2+PL
perfar-se-ão	perfazer+V.ele.REFL+FUT+3+PL
perfar-se-á	perfazer+V.ele.REFL+FUT+3+SG
perfar-se-iam	perfazer+V.ele.REFL+COND+3+PL
perfar-se-ia	perfazer+V.ele.REFL+COND+3+SG
perfar-te-ão	perfazer+V.tu.AD.2.SG+FUT+3+PL
perfar-te-á	perfazer+V.tu.AD.2.SG+FUT+3+SG
perfar-te-ás	perfazer+V.tu.AD.2.SG+FUT+2+SG
perfar-te-ei	perfazer+V.tu.AD.2.SG+FUT+1+SG
perfar-te-eis	perfazer+V.tu.AD.2.SG+FUT+2+PL
perfar-te-emos	perfazer+V.tu.AD.2.SG+FUT+1+PL
perfar-te-íamos	perfazer+V.tu.AD.2.SG+COND+1+PL
perfar-te-iam	perfazer+V.tu.AD.2.SG+COND+3+PL
perfar-te-ia	perfazer+V.tu.AD.2.SG+COND+1+SG
perfar-te-ia	perfazer+V.tu.AD.2.SG+COND+3+SG
perfar-te-ias	perfazer+V.tu.AD.2.SG+COND+2+SG
perfar-te-íeis	perfazer+V.tu.AD.2.SG+COND+2+PL
perfar-vos-ão	perfazer+V.vós.AD.2.PL+FUT+3+PL
perfar-vos-á	perfazer+V.vós.AD.2.PL+FUT+3+SG
perfar-vos-ás	perfazer+V.vós.AD.2.PL+FUT+2+SG
perfar-vos-ei	perfazer+V.vós.AD.2.PL+FUT+1+SG
perfar-vos-eis	perfazer+V.vós.AD.2.PL+FUT+2+PL
perfar-vos-emos	perfazer+V.vós.AD.2.PL+FUT+1+PL
perfar-vos-íamos	perfazer+V.vós.AD.2.PL+COND+1+PL
perfar-vos-iam	perfazer+V.vós.AD.2.PL+COND+3+PL
perfar-vos-ia	perfazer+V.vós.AD.2.PL+COND+1+SG
perfar-vos-ia	perfazer+V.vós.AD.2.PL+COND+3+SG
perfar-vos-ias	perfazer+V.vós.AD.2.PL+COND+2+SG
perfar-vos-íeis	perfazer+V.vós.AD.2.PL+COND+2+PL
perfaz-a	perfazer+V.ele.ACC.3.F.SG+PRS+3+SG
perfaz-as	perfazer+V.ele.ACC.3.F.PL+PRS+3+SG
perfazei-la	perfazer+V.ele.ACC.3.F.SG+PRS+2+PL
perfazei-las	perfazer+V.ele.ACC.3.F.PL+PRS+2+PL
perfazei-lo	perfazer+V.ele.ACC.3.M.SG+PRS+2+PL
perfazei-los	perfazer+V.ele.ACC.3.M.PL+PRS+2+PL
perfazei-nos	perfazer+nós.AD.1.PL+PRS+2+PL
perfazeis-lhe	perfazer+V.ele.DAT.3.SG+PRS+2+PL
perfazeis-lhes	perfazer+V.ele.DAT.3.PL+PRS+2+PL
perfazeis-me	perfazer+V.eu.AD.1.SG+PRS+2+PL
perfazeis-te	perfazer+V.tu.AD.2.SG+PRS+2+PL
perfazeis-vos	perfazer+V.vós.AD.2.PL+PRS+2+PL
perfazê-la	perfazer+V.ele.ACC.3.F.SG+INF
perfazê-la	perfazer+V.ele.ACC.3.F.SG+INF+1+SG
perfazê-la	perfazer+V.ele.ACC.3.F.SG+INF+3+SG
perfaze-la	perfazer+V.ele.ACC.3.F.SG+PRS+2+SG
perfazê-las	perfazer+V.ele.ACC.3.F.PL+INF
perfazê-las	perfazer+V.ele.ACC.3.F.PL+INF+1+SG
perfazê-las	perfazer+V.ele.ACC.3.F.PL+INF+3+SG
perfaze-las	perfazer+V.ele.ACC.3.F.PL+PRS+2+SG
perfazê-lo	perfazer+V.ele.ACC.3.M.SG+INF
perfazê-lo	perfazer+V.ele.ACC.3.M.SG+INF+1+SG
perfazê-lo	perfazer+V.ele.ACC.3.M.SG+INF+3+SG
perfaze-lo	perfazer+V.ele.ACC.3.M.SG+PRS+2+SG
perfazê-los	perfazer+V.ele.ACC.3.M.PL+INF
perfazê-los	perfazer+V.ele.ACC.3.M.PL+INF+1+SG
perfazê-los	perfazer+V.ele.ACC.3.M.PL+INF+3+SG
perfaze-los	perfazer+V.ele.ACC.3.M.PL+PRS+2+SG
perfazem-lhe	perfazer+V.ele.DAT.3.SG+PRS+3+PL
perfazem-lhes	perfazer+V.ele.DAT.3.PL+PRS+3+PL
perfazem-me	perfazer+V.eu.AD.1.SG+PRS+3+PL
perfazem-na	perfazer+V.ele.ACC.3.F.SG+PRS+3+PL
perfazem-nas	perfazer+V.ele.ACC.3.F.PL+PRS+3+PL
perfazem-no	perfazer+V.ele.ACC.3.M.SG+PRS+3+PL
perfazem-nos	perfazer+V.ele.ACC.3.M.PL+PRS+3+PL
perfazem-nos	perfazer+V.nós.AD.1.PL+PRS+3+PL
perfazemo-la	perfazer+V.ele.ACC.3.F.SG+PRS+1+PL
perfazemo-las	perfazer+V.ele.ACC.3.F.PL+PRS+1+PL
perfazemo-lo	perfazer+V.ele.ACC.3.M.SG+PRS+1+PL
perfazemo-los	perfazer+V.ele.ACC.3.M.PL+PRS+1+PL
perfazemo-nos	perfazer+nós.AD.1.PL+PRS+1+PL
perfazemos-lhe	perfazer+V.ele.DAT.3.SG+PRS+1+PL
perfazemos-lhes	perfazer+V.ele.DAT.3.PL+PRS+1+PL
perfazemos-me	perfazer+V.eu.AD.1.SG+PRS+1+PL
perfazemos-te	perfazer+V.tu.AD.2.SG+PRS+1+PL
perfazemos-vos	perfazer+V.vós.AD.2.PL+PRS+1+PL
perfazem-se	perfazer+V.ele.REFL+PRS+3+PL
perfazem-te	perfazer+V.tu.AD.2.SG+PRS+3+PL
perfazem-vos	perfazer+V.vós.AD.2.PL+PRS+3+PL
perfazendo-a	perfazer+V.ele.ACC.3.F.SG+GRD
perfazendo-as	perfazer+V.ele.ACC.3.F.PL+GRD
perfazendo-lhe	perfazer+V.ele.DAT.3.SG+GRD
perfazendo-lhes	perfazer+V.ele.DAT.3.PL+GRD
perfazendo-me	perfazer+V.eu.AD.1.SG+GRD
perfazendo-nos	perfazer+nós.AD.1.PL+GRD
perfazendo-o	perfazer+V.ele.ACC.3.M.SG+GRD
perfazendo-os	perfazer+V.ele.ACC.3.M.PL+GRD
perfazendo-se	perfazer+V.ele.REFL+GRD
perfazendo-te	perfazer+V.tu.AD.2.SG+GRD
perfazendo-vos	perfazer+V.vós.AD.2.PL+GRD
perfaze-nos	perfazer+nós.AD.1.PL+PRS+2+SG
perfazerde-la	perfazer+V.ele.ACC.3.F.SG+INF+2+PL
perfazerde-las	perfazer+V.ele.ACC.3.F.PL+INF+2+PL
perfazerde-lo	perfazer+V.ele.ACC.3.M.SG+INF+2+PL
perfazerde-los	perfazer+V.ele.ACC.3.M.PL+INF+2+PL
perfazerde-nos	perfazer+nós.AD.1.PL+INF+2+PL
perfazerdes-lhe	perfazer+V.ele.DAT.3.SG+INF+2+PL
perfazerdes-lhes	perfazer+V.ele.DAT.3.PL+INF+2+PL
perfazerdes-me	perfazer+V.eu.AD.1.SG+INF+2+PL
perfazerdes-te	perfazer+V.tu.AD.2.SG+INF+2+PL
perfazerdes-vos	perfazer+V.vós.AD.2.PL+INF+2+PL
perfazere-la	perfazer+V.ele.ACC.3.F.SG+INF+2+SG
perfazere-las	perfazer+V.ele.ACC.3.F.PL+INF+2+SG
perfazere-lo	perfazer+V.ele.ACC.3.M.SG+INF+2+SG
perfazere-los	perfazer+V.ele.ACC.3.M.PL+INF+2+SG
perfazerem-lhe	perfazer+V.ele.DAT.3.SG+INF+3+PL
perfazerem-lhes	perfazer+V.ele.DAT.3.PL+INF+3+PL
perfazerem-me	perfazer+V.eu.AD.1.SG+INF+3+PL
perfazerem-na	perfazer+V.ele.ACC.3.F.SG+INF+3+PL
perfazerem-nas	perfazer+V.ele.ACC.3.F.PL+INF+3+PL
perfazerem-no	perfazer+V.ele.ACC.3.M.SG+INF+3+PL
perfazerem-nos	perfazer+V.ele.ACC.3.M.PL+INF+3+PL
perfazerem-nos	perfazer+V.nós.AD.1.PL+INF+3+PL
perfazerem-se	perfazer+V.ele.REFL+INF+3+PL
perfazerem-te	perfazer+V.tu.AD.2.SG+INF+3+PL
perfazerem-vos	perfazer+V.vós.AD.2.PL+INF+3+PL
perfazere-nos	perfazer+nós.AD.1.PL+INF+2+SG
perfazeres-lhe	perfazer+V.ele.DAT.3.SG+INF+2+SG
perfazeres-lhes	perfazer+V.ele.DAT.3.PL+INF+2+SG
perfazeres-me	perfazer+V.eu.AD.1.SG+INF+2+SG
perfazeres-te	perfazer+V.tu.AD.2.SG+INF+2+SG
perfazeres-vos	perfazer+V.vós.AD.2.PL+INF+2+SG
perfazer-lhe	perfazer+V.ele.DAT.3.SG+INF
perfazer-lhe	perfazer+V.ele.DAT.3.SG+INF+1+SG
perfazer-lhe	perfazer+V.ele.DAT.3.SG+INF+3+SG
perfazer-lhes	perfazer+V.ele.DAT.3.PL+INF
perfazer-lhes	perfazer+V.ele.DAT.3.PL+INF+1+SG
perfazer-lhes	perfazer+V.ele.DAT.3.PL+INF+3+SG
perfazer-me	perfazer+V.eu.AD.1.SG+INF
perfazer-me	perfazer+V.eu.AD.1.SG+INF+1+SG
perfazer-me	perfazer+V.eu.AD.1.SG+INF+3+SG
perfazermo-la	perfazer+V.ele.ACC.3.F.SG+INF+1+PL
perfazermo-las	perfazer+V.ele.ACC.3.F.PL+INF+1+PL
perfazermo-lo	perfazer+V.ele.ACC.3.M.SG+INF+1+PL
perfazermo-los	perfazer+V.ele.ACC.3.M.PL+INF+1+PL
perfazermo-nos	perfazer+nós.AD.1.PL+INF+1+PL
perfazermos-lhe	perfazer+V.ele.DAT.3.SG+INF+1+PL
perfazermos-lhes	perfazer+V.ele.DAT.3.PL+INF+1+PL
perfazermos-me	perfazer+V.eu.AD.1.SG+INF+1+PL
perfazermos-te	perfazer+V.tu.AD.2.SG+INF+1+PL
perfazermos-vos	perfazer+V.vós.AD.2.PL+INF+1+PL
perfazer-nos	perfazer+nós.AD.1.PL+INF
perfazer-nos	perfazer+nós.AD.1.PL+INF+1+SG
perfazer-nos	perfazer+nós.AD.1.PL+INF+3+SG
perfazer-se	perfazer+V.ele.REFL+INF
perfazer-se	perfazer+V.ele.REFL+INF+3+SG
perfazer-te	perfazer+V.tu.AD.2.SG+INF
perfazer-te	perfazer+V.tu.AD.2.SG+INF+1+SG
perfazer-te	perfazer+V.tu.AD.2.SG+INF+3+SG
perfazer-vos	perfazer+V.vós.AD.2.PL+INF
perfazer-vos	perfazer+V.vós.AD.2.PL+INF+1+SG
perfazer-vos	perfazer+V.vós.AD.2.PL+INF+3+SG
perfazes-lhe	perfazer+V.ele.DAT.3.SG+PRS+2+SG
perfazes-lhes	perfazer+V.ele.DAT.3.PL+PRS+2+SG
perfazes-me	perfazer+V.eu.AD.1.SG+PRS+2+SG
perfazes-te	perfazer+V.tu.AD.2.SG+PRS+2+SG
perfazes-vos	perfazer+V.vós.AD.2.PL+PRS+2+SG
perfazia-a	perfazer+V.ele.ACC.3.F.SG+IMPF+1+SG
perfazia-a	perfazer+V.ele.ACC.3.F.SG+IMPF+3+SG
perfazia-as	perfazer+V.ele.ACC.3.F.PL+IMPF+1+SG
perfazia-as	perfazer+V.ele.ACC.3.F.PL+IMPF+3+SG
perfazia-la	perfazer+V.ele.ACC.3.F.SG+IMPF+2+SG
perfazia-las	perfazer+V.ele.ACC.3.F.PL+IMPF+2+SG
perfazia-lhe	perfazer+V.ele.DAT.3.SG+IMPF+1+SG
perfazia-lhe	perfazer+V.ele.DAT.3.SG+IMPF+3+SG
perfazia-lhes	perfazer+V.ele.DAT.3.PL+IMPF+1+SG
perfazia-lhes	perfazer+V.ele.DAT.3.PL+IMPF+3+SG
perfazia-lo	perfazer+V.ele.ACC.3.M.SG+IMPF+2+SG
perfazia-los	perfazer+V.ele.ACC.3.M.PL+IMPF+2+SG
perfazia-me	perfazer+V.eu.AD.1.SG+IMPF+1+SG
perfazia-me	perfazer+V.eu.AD.1.SG+IMPF+3+SG
perfaziam-lhe	perfazer+V.ele.DAT.3.SG+IMPF+3+PL
perfaziam-lhes	perfazer+V.ele.DAT.3.PL+IMPF+3+PL
perfaziam-me	perfazer+V.eu.AD.1.SG+IMPF+3+PL
perfaziam-na	perfazer+V.ele.ACC.3.F.SG+IMPF+3+PL
perfaziam-nas	perfazer+V.ele.ACC.3.F.PL+IMPF+3+PL
perfaziam-no	perfazer+V.ele.ACC.3.M.SG+IMPF+3+PL
perfaziam-nos	perfazer+V.ele.ACC.3.M.PL+IMPF+3+PL
perfaziam-nos	perfazer+V.nós.AD.1.PL+IMPF+3+PL
perfazíamo-la	perfazer+V.ele.ACC.3.F.SG+IMPF+1+PL
perfazíamo-las	perfazer+V.ele.ACC.3.F.PL+IMPF+1+PL
perfazíamo-lo	perfazer+V.ele.ACC.3.M.SG+IMPF+1+PL
perfazíamo-los	perfazer+V.ele.ACC.3.M.PL+IMPF+1+PL
perfazíamo-nos	perfazer+nós.AD.1.PL+IMPF+1+PL
perfazíamos-lhe	perfazer+V.ele.DAT.3.SG+IMPF+1+PL
perfazíamos-lhes	perfazer+V.ele.DAT.3.PL+IMPF+1+PL
perfazíamos-me	perfazer+V.eu.AD.1.SG+IMPF+1+PL
perfazíamos-te	perfazer+V.tu.AD.2.SG+IMPF+1+PL
perfazíamos-vos	perfazer+V.vós.AD.2.PL+IMPF+1+PL
perfaziam-se	perfazer+V.ele.REFL+IMPF+3+PL
perfaziam-te	perfazer+V.tu.AD.2.SG+IMPF+3+PL
perfaziam-vos	perfazer+V.vós.AD.2.PL+IMPF+3+PL
perfazia-nos	perfazer+nós.AD.1.PL+IMPF+1+SG
perfazia-nos	perfazer+nós.AD.1.PL+IMPF+2+SG
perfazia-nos	perfazer+nós.AD.1.PL+IMPF+3+SG
perfazia-o	perfazer+V.ele.ACC.3.M.SG+IMPF+1+SG
perfazia-o	perfazer+V.ele.ACC.3.M.SG+IMPF+3+SG
perfazia-os	perfazer+V.ele.ACC.3.M.PL+IMPF+1+SG
perfazia-os	perfazer+V.ele.ACC.3.M.PL+IMPF+3+SG
perfazia-se	perfazer+V.ele.REFL+IMPF+3+SG
perfazias-lhe	perfazer+V.ele.DAT.3.SG+IMPF+2+SG
perfazias-lhes	perfazer+V.ele.DAT.3.PL+IMPF+2+SG
perfazias-me	perfazer+V.eu.AD.1.SG+IMPF+2+SG
perfazias-te	perfazer+V.tu.AD.2.SG+IMPF+2+SG
perfazias-vos	perfazer+V.vós.AD.2.PL+IMPF+2+SG
perfazia-te	perfazer+V.tu.AD.2.SG+IMPF+1+SG
perfazia-te	perfazer+V.tu.AD.2.SG+IMPF+3+SG
perfazia-vos	perfazer+V.vós.AD.2.PL+IMPF+1+SG
perfazia-vos	perfazer+V.vós.AD.2.PL+IMPF+3+SG
perfazíei-la	perfazer+V.ele.ACC.3.F.SG+IMPF+2+PL
perfazíei-las	perfazer+V.ele.ACC.3.F.PL+IMPF+2+PL
perfazíei-lo	perfazer+V.ele.ACC.3.M.SG+IMPF+2+PL
perfazíei-los	perfazer+V.ele.ACC.3.M.PL+IMPF+2+PL
perfazíei-nos	perfazer+nós.AD.1.PL+IMPF+2+PL
perfazíeis-lhe	perfazer+V.ele.DAT.3.SG+IMPF+2+PL
perfazíeis-lhes	perfazer+V.ele.DAT.3.PL+IMPF+2+PL
perfazíeis-me	perfazer+V.eu.AD.1.SG+IMPF+2+PL
perfazíeis-te	perfazer+V.tu.AD.2.SG+IMPF+2+PL
perfazíeis-vos	perfazer+V.vós.AD.2.PL+IMPF+2+PL
perfaz-lhe	perfazer+V.ele.DAT.3.SG+PRS+3+SG
perfaz-lhes	perfazer+V.ele.DAT.3.PL+PRS+3+SG
perfaz-me	perfazer+V.eu.AD.1.SG+PRS+3+SG
perfaz-nos	perfazer+nós.AD.1.PL+PRS+3+SG
perfaz-o	perfazer+V.ele.ACC.3.M.SG+PRS+3+SG
perfaz-os	perfazer+V.ele.ACC.3.M.PL+PRS+3+SG
perfaz-se	perfazer+V.ele.REFL+PRS+3+SG
perfaz-te	perfazer+V.tu.AD.2.SG+PRS+3+SG
perfaz-vos	perfazer+V.vós.AD.2.PL+PRS+3+SG
perfectibiliza-a	perfectibilizar+V.ele.ACC.3.F.SG+PRS+3+SG
perfectibiliza-as	perfectibilizar+V.ele.ACC.3.F.PL+PRS+3+SG
perfectibilizai-la	perfectibilizar+V.ele.ACC.3.F.SG+PRS+2+PL
perfectibilizai-las	perfectibilizar+V.ele.ACC.3.F.PL+PRS+2+PL
perfectibilizai-lo	perfectibilizar+V.ele.ACC.3.M.SG+PRS+2+PL
perfectibilizai-los	perfectibilizar+V.ele.ACC.3.M.PL+PRS+2+PL
perfectibilizai-nos	perfectibilizar+nós.AD.1.PL+PRS+2+PL
perfectibilizais-lhe	perfectibilizar+V.ele.DAT.3.SG+PRS+2+PL
perfectibilizais-lhes	perfectibilizar+V.ele.DAT.3.PL+PRS+2+PL
perfectibilizais-me	perfectibilizar+V.eu.AD.1.SG+PRS+2+PL
perfectibilizais-te	perfectibilizar+V.tu.AD.2.SG+PRS+2+PL
perfectibilizais-vos	perfectibilizar+V.vós.AD.2.PL+PRS+2+PL
perfectibilizá-la-ão	perfectibilizar+V.ele.ACC.3.F.SG+FUT+3+PL
perfectibilizá-la-á	perfectibilizar+V.ele.ACC.3.F.SG+FUT+3+SG
perfectibilizá-la-ás	perfectibilizar+V.ele.ACC.3.F.SG+FUT+2+SG
perfectibilizá-la-ei	perfectibilizar+V.ele.ACC.3.F.SG+FUT+1+SG
perfectibilizá-la-eis	perfectibilizar+V.ele.ACC.3.F.SG+FUT+2+PL
perfectibilizá-la-emos	perfectibilizar+V.ele.ACC.3.F.SG+FUT+1+PL
perfectibilizá-la-íamos	perfectibilizar+V.ele.ACC.3.F.SG+COND+1+PL
perfectibilizá-la-iam	perfectibilizar+V.ele.ACC.3.F.SG+COND+3+PL
perfectibilizá-la-ia	perfectibilizar+V.ele.ACC.3.F.SG+COND+1+SG
perfectibilizá-la-ia	perfectibilizar+V.ele.ACC.3.F.SG+COND+3+SG
perfectibilizá-la-ias	perfectibilizar+V.ele.ACC.3.F.SG+COND+2+SG
perfectibilizá-la-íeis	perfectibilizar+V.ele.ACC.3.F.SG+COND+2+PL
perfectibilizá-la	perfectibilizar+V.ele.ACC.3.F.SG+INF+1+SG
perfectibilizá-la	perfectibilizar+V.ele.ACC.3.F.SG+INF+3+SG
perfectibiliza-la	perfectibilizar+V.ele.ACC.3.F.SG+PRS+2+SG
perfectibilizá-la	perfectibilizar+V.ele.ACC.3.F.SG+SBJF+1+SG
perfectibilizá-la	perfectibilizar+V.ele.ACC.3.F.SG+SBJF+3+SG
perfectibilizá-las-ão	perfectibilizar+V.ele.ACC.3.F.PL+FUT+3+PL
perfectibilizá-las-á	perfectibilizar+V.ele.ACC.3.F.PL+FUT+3+SG
perfectibilizá-las-ás	perfectibilizar+V.ele.ACC.3.F.PL+FUT+2+SG
perfectibilizá-las-ei	perfectibilizar+V.ele.ACC.3.F.PL+FUT+1+SG
perfectibilizá-las-eis	perfectibilizar+V.ele.ACC.3.F.PL+FUT+2+PL
perfectibilizá-las-emos	perfectibilizar+V.ele.ACC.3.F.PL+FUT+1+PL
perfectibilizá-las-íamos	perfectibilizar+V.ele.ACC.3.F.PL+COND+1+PL
perfectibilizá-las-iam	perfectibilizar+V.ele.ACC.3.F.PL+COND+3+PL
perfectibilizá-las-ia	perfectibilizar+V.ele.ACC.3.F.PL+COND+1+SG
perfectibilizá-las-ia	perfectibilizar+V.ele.ACC.3.F.PL+COND+3+SG
perfectibilizá-las-ias	perfectibilizar+V.ele.ACC.3.F.PL+COND+2+SG
perfectibilizá-las-íeis	perfectibilizar+V.ele.ACC.3.F.PL+COND+2+PL
perfectibilizá-las	perfectibilizar+V.ele.ACC.3.F.PL+INF+1+SG
perfectibilizá-las	perfectibilizar+V.ele.ACC.3.F.PL+INF+3+SG
perfectibiliza-las	perfectibilizar+V.ele.ACC.3.F.PL+PRS+2+SG
perfectibilizá-las	perfectibilizar+V.ele.ACC.3.F.PL+SBJF+1+SG
perfectibilizá-las	perfectibilizar+V.ele.ACC.3.F.PL+SBJF+3+SG
perfectibiliza-lhe	perfectibilizar+V.ele.DAT.3.SG+PRS+3+SG
perfectibiliza-lhes	perfectibilizar+V.ele.DAT.3.PL+PRS+3+SG
perfectibilizá-lo-ão	perfectibilizar+V.ele.ACC.3.M.SG+FUT+3+PL
perfectibilizá-lo-á	perfectibilizar+V.ele.ACC.3.M.SG+FUT+3+SG
perfectibilizá-lo-ás	perfectibilizar+V.ele.ACC.3.M.SG+FUT+2+SG
perfectibilizá-lo-ei	perfectibilizar+V.ele.ACC.3.M.SG+FUT+1+SG
perfectibilizá-lo-eis	perfectibilizar+V.ele.ACC.3.M.SG+FUT+2+PL
perfectibilizá-lo-emos	perfectibilizar+V.ele.ACC.3.M.SG+FUT+1+PL
perfectibilizá-lo-íamos	perfectibilizar+V.ele.ACC.3.M.SG+COND+1+PL
perfectibilizá-lo-iam	perfectibilizar+V.ele.ACC.3.M.SG+COND+3+PL
perfectibilizá-lo-ia	perfectibilizar+V.ele.ACC.3.M.SG+COND+1+SG
perfectibilizá-lo-ia	perfectibilizar+V.ele.ACC.3.M.SG+COND+3+SG
perfectibilizá-lo-ias	perfectibilizar+V.ele.ACC.3.M.SG+COND+2+SG
perfectibilizá-lo-íeis	perfectibilizar+V.ele.ACC.3.M.SG+COND+2+PL
perfectibilizá-lo	perfectibilizar+V.ele.ACC.3.M.SG+INF+1+SG
perfectibilizá-lo	perfectibilizar+V.ele.ACC.3.M.SG+INF+3+SG
perfectibiliza-lo	perfectibilizar+V.ele.ACC.3.M.SG+PRS+2+SG
perfectibilizá-lo	perfectibilizar+V.ele.ACC.3.M.SG+SBJF+1+SG
perfectibilizá-lo	perfectibilizar+V.ele.ACC.3.M.SG+SBJF+3+SG
perfectibilizá-los-ão	perfectibilizar+V.ele.ACC.3.M.PL+FUT+3+PL
perfectibilizá-los-á	perfectibilizar+V.ele.ACC.3.M.PL+FUT+3+SG
perfectibilizá-los-ás	perfectibilizar+V.ele.ACC.3.M.PL+FUT+2+SG
perfectibilizá-los-ei	perfectibilizar+V.ele.ACC.3.M.PL+FUT+1+SG
perfectibilizá-los-eis	perfectibilizar+V.ele.ACC.3.M.PL+FUT+2+PL
perfectibilizá-los-emos	perfectibilizar+V.ele.ACC.3.M.PL+FUT+1+PL
perfectibilizá-los-íamos	perfectibilizar+V.ele.ACC.3.M.PL+COND+1+PL
perfectibilizá-los-iam	perfectibilizar+V.ele.ACC.3.M.PL+COND+3+PL
perfectibilizá-los-ia	perfectibilizar+V.ele.ACC.3.M.PL+COND+1+SG
perfectibilizá-los-ia	perfectibilizar+V.ele.ACC.3.M.PL+COND+3+SG
perfectibilizá-los-ias	perfectibilizar+V.ele.ACC.3.M.PL+COND+2+SG
perfectibilizá-los-íeis	perfectibilizar+V.ele.ACC.3.M.PL+COND+2+PL
perfectibilizá-los	perfectibilizar+V.ele.ACC.3.M.PL+INF+1+SG
perfectibilizá-los	perfectibilizar+V.ele.ACC.3.M.PL+INF+3+SG
perfectibiliza-los	perfectibilizar+V.ele.ACC.3.M.PL+PRS+2+SG
perfectibilizá-los	perfectibilizar+V.ele.ACC.3.M.PL+SBJF+1+SG
perfectibilizá-los	perfectibilizar+V.ele.ACC.3.M.PL+SBJF+3+SG
perfectibiliza-me	perfectibilizar+V.eu.AD.1.SG+PRS+3+SG
perfectibilizam-lhe	perfectibilizar+V.ele.DAT.3.SG+PRS+3+PL
perfectibilizam-lhes	perfectibilizar+V.ele.DAT.3.PL+PRS+3+PL
perfectibilizam-me	perfectibilizar+V.eu.AD.1.SG+PRS+3+PL
perfectibilizam-na	perfectibilizar+V.ele.ACC.3.F.SG+PRS+3+PL
perfectibilizam-nas	perfectibilizar+V.ele.ACC.3.F.PL+PRS+3+PL
perfectibilizam-no	perfectibilizar+V.ele.ACC.3.M.SG+PRS+3+PL
perfectibilizam-nos	perfectibilizar+V.ele.ACC.3.M.PL+PRS+3+PL
perfectibilizam-nos	perfectibilizar+V.nós.AD.1.PL+PRS+3+PL
perfectibilizamo-la	perfectibilizar+V.ele.ACC.3.F.SG+PRF+1+PL
perfectibilizamo-la	perfectibilizar+V.ele.ACC.3.F.SG+PRS+1+PL
perfectibilizamo-las	perfectibilizar+V.ele.ACC.3.F.PL+PRF+1+PL
perfectibilizamo-las	perfectibilizar+V.ele.ACC.3.F.PL+PRS+1+PL
perfectibilizamo-lo	perfectibilizar+V.ele.ACC.3.M.SG+PRF+1+PL
perfectibilizamo-lo	perfectibilizar+V.ele.ACC.3.M.SG+PRS+1+PL
perfectibilizamo-los	perfectibilizar+V.ele.ACC.3.M.PL+PRF+1+PL
perfectibilizamo-los	perfectibilizar+V.ele.ACC.3.M.PL+PRS+1+PL
perfectibilizamo-nos	perfectibilizar+nós.AD.1.PL+PRF+1+PL
perfectibilizamo-nos	perfectibilizar+nós.AD.1.PL+PRS+1+PL
perfectibilizamos-lhe	perfectibilizar+V.ele.DAT.3.SG+PRF+1+PL
perfectibilizamos-lhe	perfectibilizar+V.ele.DAT.3.SG+PRS+1+PL
perfectibilizamos-lhes	perfectibilizar+V.ele.DAT.3.PL+PRF+1+PL
perfectibilizamos-lhes	perfectibilizar+V.ele.DAT.3.PL+PRS+1+PL
perfectibilizamos-me	perfectibilizar+V.eu.AD.1.SG+PRF+1+PL
perfectibilizamos-me	perfectibilizar+V.eu.AD.1.SG+PRS+1+PL
perfectibilizamos-te	perfectibilizar+V.tu.AD.2.SG+PRF+1+PL
perfectibilizamos-te	perfectibilizar+V.tu.AD.2.SG+PRS+1+PL
perfectibilizamos-vos	perfectibilizar+V.vós.AD.2.PL+PRF+1+PL
perfectibilizamos-vos	perfectibilizar+V.vós.AD.2.PL+PRS+1+PL
perfectibilizam-se	perfectibilizar+V.ele.REFL+PRS+3+PL
perfectibilizam-te	perfectibilizar+V.tu.AD.2.SG+PRS+3+PL
perfectibilizam-vos	perfectibilizar+V.vós.AD.2.PL+PRS+3+PL
perfectibilizando-a	perfectibilizar+V.ele.ACC.3.F.SG+GRD
perfectibilizando-as	perfectibilizar+V.ele.ACC.3.F.PL+GRD
perfectibilizando-lhe	perfectibilizar+V.ele.DAT.3.SG+GRD
perfectibilizando-lhes	perfectibilizar+V.ele.DAT.3.PL+GRD
perfectibilizando-me	perfectibilizar+V.eu.AD.1.SG+GRD
perfectibilizando-nos	perfectibilizar+nós.AD.1.PL+GRD
perfectibilizando-o	perfectibilizar+V.ele.ACC.3.M.SG+GRD
perfectibilizando-os	perfectibilizar+V.ele.ACC.3.M.PL+GRD
perfectibilizando-se	perfectibilizar+V.ele.REFL+GRD
perfectibilizando-te	perfectibilizar+V.tu.AD.2.SG+GRD
perfectibilizando-vos	perfectibilizar+V.vós.AD.2.PL+GRD
perfectibiliza-nos	perfectibilizar+nós.AD.1.PL+PRS+2+SG
perfectibiliza-nos	perfectibilizar+nós.AD.1.PL+PRS+3+SG
perfectibiliza-o	perfectibilizar+V.ele.ACC.3.M.SG+PRS+3+SG
perfectibiliza-os	perfectibilizar+V.ele.ACC.3.M.PL+PRS+3+SG
perfectibilizara-a	perfectibilizar+V.ele.ACC.3.F.SG+PQP+1+SG
perfectibilizara-a	perfectibilizar+V.ele.ACC.3.F.SG+PQP+3+SG
perfectibilizara-as	perfectibilizar+V.ele.ACC.3.F.PL+PQP+1+SG
perfectibilizara-as	perfectibilizar+V.ele.ACC.3.F.PL+PQP+3+SG
perfectibilizara-la	perfectibilizar+V.ele.ACC.3.F.SG+PQP+2+SG
perfectibilizara-las	perfectibilizar+V.ele.ACC.3.F.PL+PQP+2+SG
perfectibilizara-lhe	perfectibilizar+V.ele.DAT.3.SG+PQP+1+SG
perfectibilizara-lhe	perfectibilizar+V.ele.DAT.3.SG+PQP+3+SG
perfectibilizara-lhes	perfectibilizar+V.ele.DAT.3.PL+PQP+1+SG
perfectibilizara-lhes	perfectibilizar+V.ele.DAT.3.PL+PQP+3+SG
perfectibilizara-lo	perfectibilizar+V.ele.ACC.3.M.SG+PQP+2+SG
perfectibilizara-los	perfectibilizar+V.ele.ACC.3.M.PL+PQP+2+SG
perfectibilizara-me	perfectibilizar+V.eu.AD.1.SG+PQP+1+SG
perfectibilizara-me	perfectibilizar+V.eu.AD.1.SG+PQP+3+SG
perfectibilizaram-lhe	perfectibilizar+V.ele.DAT.3.SG+PQP+3+PL
perfectibilizaram-lhe	perfectibilizar+V.ele.DAT.3.SG+PRF+3+PL
perfectibilizaram-lhes	perfectibilizar+V.ele.DAT.3.PL+PQP+3+PL
perfectibilizaram-lhes	perfectibilizar+V.ele.DAT.3.PL+PRF+3+PL
perfectibilizaram-me	perfectibilizar+V.eu.AD.1.SG+PQP+3+PL
perfectibilizaram-me	perfectibilizar+V.eu.AD.1.SG+PRF+3+PL
perfectibilizaram-na	perfectibilizar+V.ele.ACC.3.F.SG+PQP+3+PL
perfectibilizaram-na	perfectibilizar+V.ele.ACC.3.F.SG+PRF+3+PL
perfectibilizaram-nas	perfectibilizar+V.ele.ACC.3.F.PL+PQP+3+PL
perfectibilizaram-nas	perfectibilizar+V.ele.ACC.3.F.PL+PRF+3+PL
perfectibilizaram-no	perfectibilizar+V.ele.ACC.3.M.SG+PQP+3+PL
perfectibilizaram-no	perfectibilizar+V.ele.ACC.3.M.SG+PRF+3+PL
perfectibilizaram-nos	perfectibilizar+V.ele.ACC.3.M.PL+PQP+3+PL
perfectibilizaram-nos	perfectibilizar+V.ele.ACC.3.M.PL+PRF+3+PL
perfectibilizaram-nos	perfectibilizar+V.nós.AD.1.PL+PQP+3+PL
perfectibilizaram-nos	perfectibilizar+V.nós.AD.1.PL+PRF+3+PL
perfectibilizáramo-la	perfectibilizar+V.ele.ACC.3.F.SG+PQP+1+PL
perfectibilizáramo-las	perfectibilizar+V.ele.ACC.3.F.PL+PQP+1+PL
perfectibilizáramo-lo	perfectibilizar+V.ele.ACC.3.M.SG+PQP+1+PL
perfectibilizáramo-los	perfectibilizar+V.ele.ACC.3.M.PL+PQP+1+PL
perfectibilizáramo-nos	perfectibilizar+nós.AD.1.PL+PQP+1+PL
perfectibilizáramos-lhe	perfectibilizar+V.ele.DAT.3.SG+PQP+1+PL
perfectibilizáramos-lhes	perfectibilizar+V.ele.DAT.3.PL+PQP+1+PL
perfectibilizáramos-me	perfectibilizar+V.eu.AD.1.SG+PQP+1+PL
perfectibilizáramos-te	perfectibilizar+V.tu.AD.2.SG+PQP+1+PL
perfectibilizáramos-vos	perfectibilizar+V.vós.AD.2.PL+PQP+1+PL
perfectibilizaram-se	perfectibilizar+V.ele.REFL+PQP+3+PL
perfectibilizaram-se	perfectibilizar+V.ele.REFL+PRF+3+PL
perfectibilizaram-te	perfectibilizar+V.tu.AD.2.SG+PQP+3+PL
perfectibilizaram-te	perfectibilizar+V.tu.AD.2.SG+PRF+3+PL
perfectibilizaram-vos	perfectibilizar+V.vós.AD.2.PL+PQP+3+PL
perfectibilizaram-vos	perfectibilizar+V.vós.AD.2.PL+PRF+3+PL
perfectibilizara-nos	perfectibilizar+nós.AD.1.PL+PQP+1+SG
perfectibilizara-nos	perfectibilizar+nós.AD.1.PL+PQP+2+SG
perfectibilizara-nos	perfectibilizar+nós.AD.1.PL+PQP+3+SG
perfectibilizara-o	perfectibilizar+V.ele.ACC.3.M.SG+PQP+1+SG
perfectibilizara-o	perfectibilizar+V.ele.ACC.3.M.SG+PQP+3+SG
perfectibilizara-os	perfectibilizar+V.ele.ACC.3.M.PL+PQP+1+SG
perfectibilizara-os	perfectibilizar+V.ele.ACC.3.M.PL+PQP+3+SG
perfectibilizara-se	perfectibilizar+V.ele.REFL+PQP+1+SG
perfectibilizara-se	perfectibilizar+V.ele.REFL+PQP+3+SG
perfectibilizaras-lhe	perfectibilizar+V.ele.DAT.3.SG+PQP+2+SG
perfectibilizaras-lhes	perfectibilizar+V.ele.DAT.3.PL+PQP+2+SG
perfectibilizaras-me	perfectibilizar+V.eu.AD.1.SG+PQP+2+SG
perfectibilizaras-te	perfectibilizar+V.tu.AD.2.SG+PQP+2+SG
perfectibilizaras-vos	perfectibilizar+V.vós.AD.2.PL+PQP+2+SG
perfectibilizara-te	perfectibilizar+V.tu.AD.2.SG+PQP+1+SG
perfectibilizara-te	perfectibilizar+V.tu.AD.2.SG+PQP+3+SG
perfectibilizara-vos	perfectibilizar+V.vós.AD.2.PL+PQP+1+SG
perfectibilizara-vos	perfectibilizar+V.vós.AD.2.PL+PQP+3+SG
perfectibilizarde-la	perfectibilizar+V.ele.ACC.3.F.SG+INF+2+PL
perfectibilizarde-la	perfectibilizar+V.ele.ACC.3.F.SG+SBJF+2+PL
perfectibilizarde-las	perfectibilizar+V.ele.ACC.3.F.PL+INF+2+PL
perfectibilizarde-las	perfectibilizar+V.ele.ACC.3.F.PL+SBJF+2+PL
perfectibilizarde-lo	perfectibilizar+V.ele.ACC.3.M.SG+INF+2+PL
perfectibilizarde-lo	perfectibilizar+V.ele.ACC.3.M.SG+SBJF+2+PL
perfectibilizarde-los	perfectibilizar+V.ele.ACC.3.M.PL+INF+2+PL
perfectibilizarde-los	perfectibilizar+V.ele.ACC.3.M.PL+SBJF+2+PL
perfectibilizarde-nos	perfectibilizar+nós.AD.1.PL+INF+2+PL
perfectibilizarde-nos	perfectibilizar+nós.AD.1.PL+SBJF+2+PL
perfectibilizardes-lhe	perfectibilizar+V.ele.DAT.3.SG+INF+2+PL
perfectibilizardes-lhe	perfectibilizar+V.ele.DAT.3.SG+SBJF+2+PL
perfectibilizardes-lhes	perfectibilizar+V.ele.DAT.3.PL+INF+2+PL
perfectibilizardes-lhes	perfectibilizar+V.ele.DAT.3.PL+SBJF+2+PL
perfectibilizardes-me	perfectibilizar+V.eu.AD.1.SG+INF+2+PL
perfectibilizardes-me	perfectibilizar+V.eu.AD.1.SG+SBJF+2+PL
perfectibilizardes-te	perfectibilizar+V.tu.AD.2.SG+INF+2+PL
perfectibilizardes-te	perfectibilizar+V.tu.AD.2.SG+SBJF+2+PL
perfectibilizardes-vos	perfectibilizar+V.vós.AD.2.PL+INF+2+PL
perfectibilizardes-vos	perfectibilizar+V.vós.AD.2.PL+SBJF+2+PL
perfectibilizárei-la	perfectibilizar+V.ele.ACC.3.F.SG+PQP+2+PL
perfectibilizárei-las	perfectibilizar+V.ele.ACC.3.F.PL+PQP+2+PL
perfectibilizárei-lo	perfectibilizar+V.ele.ACC.3.M.SG+PQP+2+PL
perfectibilizárei-los	perfectibilizar+V.ele.ACC.3.M.PL+PQP+2+PL
perfectibilizárei-nos	perfectibilizar+nós.AD.1.PL+PQP+2+PL
perfectibilizáreis-lhe	perfectibilizar+V.ele.DAT.3.SG+PQP+2+PL
perfectibilizáreis-lhes	perfectibilizar+V.ele.DAT.3.PL+PQP+2+PL
perfectibilizáreis-me	perfectibilizar+V.eu.AD.1.SG+PQP+2+PL
perfectibilizáreis-te	perfectibilizar+V.tu.AD.2.SG+PQP+2+PL
perfectibilizáreis-vos	perfectibilizar+V.vós.AD.2.PL+PQP+2+PL
perfectibilizare-la	perfectibilizar+V.ele.ACC.3.F.SG+INF+2+SG
perfectibilizare-la	perfectibilizar+V.ele.ACC.3.F.SG+SBJF+2+SG
perfectibilizare-las	perfectibilizar+V.ele.ACC.3.F.PL+INF+2+SG
perfectibilizare-las	perfectibilizar+V.ele.ACC.3.F.PL+SBJF+2+SG
perfectibilizare-lo	perfectibilizar+V.ele.ACC.3.M.SG+INF+2+SG
perfectibilizare-lo	perfectibilizar+V.ele.ACC.3.M.SG+SBJF+2+SG
perfectibilizare-los	perfectibilizar+V.ele.ACC.3.M.PL+INF+2+SG
perfectibilizare-los	perfectibilizar+V.ele.ACC.3.M.PL+SBJF+2+SG
perfectibilizarem-lhe	perfectibilizar+V.ele.DAT.3.SG+INF+3+PL
perfectibilizarem-lhe	perfectibilizar+V.ele.DAT.3.SG+SBJF+3+PL
perfectibilizarem-lhes	perfectibilizar+V.ele.DAT.3.PL+INF+3+PL
perfectibilizarem-lhes	perfectibilizar+V.ele.DAT.3.PL+SBJF+3+PL
perfectibilizarem-me	perfectibilizar+V.eu.AD.1.SG+INF+3+PL
perfectibilizarem-me	perfectibilizar+V.eu.AD.1.SG+SBJF+3+PL
perfectibilizarem-na	perfectibilizar+V.ele.ACC.3.F.SG+INF+3+PL
perfectibilizarem-na	perfectibilizar+V.ele.ACC.3.F.SG+SBJF+3+PL
perfectibilizarem-nas	perfectibilizar+V.ele.ACC.3.F.PL+INF+3+PL
perfectibilizarem-nas	perfectibilizar+V.ele.ACC.3.F.PL+SBJF+3+PL
perfectibilizarem-no	perfectibilizar+V.ele.ACC.3.M.SG+INF+3+PL
perfectibilizarem-no	perfectibilizar+V.ele.ACC.3.M.SG+SBJF+3+PL
perfectibilizarem-nos	perfectibilizar+V.ele.ACC.3.M.PL+INF+3+PL
perfectibilizarem-nos	perfectibilizar+V.ele.ACC.3.M.PL+SBJF+3+PL
perfectibilizarem-nos	perfectibilizar+V.nós.AD.1.PL+INF+3+PL
perfectibilizarem-nos	perfectibilizar+V.nós.AD.1.PL+SBJF+3+PL
perfectibilizarem-se	perfectibilizar+V.ele.REFL+INF+3+PL
perfectibilizarem-se	perfectibilizar+V.ele.REFL+SBJF+3+PL
perfectibilizarem-te	perfectibilizar+V.tu.AD.2.SG+INF+3+PL
perfectibilizarem-te	perfectibilizar+V.tu.AD.2.SG+SBJF+3+PL
perfectibilizarem-vos	perfectibilizar+V.vós.AD.2.PL+INF+3+PL
perfectibilizarem-vos	perfectibilizar+V.vós.AD.2.PL+SBJF+3+PL
perfectibilizare-nos	perfectibilizar+nós.AD.1.PL+INF+2+SG
perfectibilizare-nos	perfectibilizar+nós.AD.1.PL+SBJF+2+SG
perfectibilizares-lhe	perfectibilizar+V.ele.DAT.3.SG+INF+2+SG
perfectibilizares-lhe	perfectibilizar+V.ele.DAT.3.SG+SBJF+2+SG
perfectibilizares-lhes	perfectibilizar+V.ele.DAT.3.PL+INF+2+SG
perfectibilizares-lhes	perfectibilizar+V.ele.DAT.3.PL+SBJF+2+SG
perfectibilizares-me	perfectibilizar+V.eu.AD.1.SG+INF+2+SG
perfectibilizares-me	perfectibilizar+V.eu.AD.1.SG+SBJF+2+SG
perfectibilizares-te	perfectibilizar+V.tu.AD.2.SG+INF+2+SG
perfectibilizares-te	perfectibilizar+V.tu.AD.2.SG+SBJF+2+SG
perfectibilizares-vos	perfectibilizar+V.vós.AD.2.PL+INF+2+SG
perfectibilizares-vos	perfectibilizar+V.vós.AD.2.PL+SBJF+2+SG
perfectibilizar-lhe-ão	perfectibilizar+V.ele.DAT.3.SG+FUT+3+PL
perfectibilizar-lhe-á	perfectibilizar+V.ele.DAT.3.SG+FUT+3+SG
perfectibilizar-lhe-ás	perfectibilizar+V.ele.DAT.3.SG+FUT+2+SG
perfectibilizar-lhe-ei	perfectibilizar+V.ele.DAT.3.SG+FUT+1+SG
perfectibilizar-lhe-eis	perfectibilizar+V.ele.DAT.3.SG+FUT+2+PL
perfectibilizar-lhe-emos	perfectibilizar+V.ele.DAT.3.SG+FUT+1+PL
perfectibilizar-lhe-íamos	perfectibilizar+V.ele.DAT.3.SG+COND+1+PL
perfectibilizar-lhe-iam	perfectibilizar+V.ele.DAT.3.SG+COND+3+PL
perfectibilizar-lhe-ia	perfectibilizar+V.ele.DAT.3.SG+COND+1+SG
perfectibilizar-lhe-ia	perfectibilizar+V.ele.DAT.3.SG+COND+3+SG
perfectibilizar-lhe-ias	perfectibilizar+V.ele.DAT.3.SG+COND+2+SG
perfectibilizar-lhe-íeis	perfectibilizar+V.ele.DAT.3.SG+COND+2+PL
perfectibilizar-lhe	perfectibilizar+V.ele.DAT.3.SG+INF
perfectibilizar-lhe	perfectibilizar+V.ele.DAT.3.SG+INF+1+SG
perfectibilizar-lhe	perfectibilizar+V.ele.DAT.3.SG+INF+3+SG
perfectibilizar-lhe	perfectibilizar+V.ele.DAT.3.SG+SBJF+1+SG
perfectibilizar-lhe	perfectibilizar+V.ele.DAT.3.SG+SBJF+3+SG
perfectibilizar-lhes-ão	perfectibilizar+V.ele.DAT.3.PL+FUT+3+PL
perfectibilizar-lhes-á	perfectibilizar+V.ele.DAT.3.PL+FUT+3+SG
perfectibilizar-lhes-ás	perfectibilizar+V.ele.DAT.3.PL+FUT+2+SG
perfectibilizar-lhes-ei	perfectibilizar+V.ele.DAT.3.PL+FUT+1+SG
perfectibilizar-lhes-eis	perfectibilizar+V.ele.DAT.3.PL+FUT+2+PL
perfectibilizar-lhes-emos	perfectibilizar+V.ele.DAT.3.PL+FUT+1+PL
perfectibilizar-lhes-íamos	perfectibilizar+V.ele.DAT.3.PL+COND+1+PL
perfectibilizar-lhes-iam	perfectibilizar+V.ele.DAT.3.PL+COND+3+PL
perfectibilizar-lhes-ia	perfectibilizar+V.ele.DAT.3.PL+COND+1+SG
perfectibilizar-lhes-ia	perfectibilizar+V.ele.DAT.3.PL+COND+3+SG
perfectibilizar-lhes-ias	perfectibilizar+V.ele.DAT.3.PL+COND+2+SG
perfectibilizar-lhes-íeis	perfectibilizar+V.ele.DAT.3.PL+COND+2+PL
perfectibilizar-lhes	perfectibilizar+V.ele.DAT.3.PL+INF
perfectibilizar-lhes	perfectibilizar+V.ele.DAT.3.PL+INF+1+SG
perfectibilizar-lhes	perfectibilizar+V.ele.DAT.3.PL+INF+3+SG
perfectibilizar-lhes	perfectibilizar+V.ele.DAT.3.PL+SBJF+1+SG
perfectibilizar-lhes	perfectibilizar+V.ele.DAT.3.PL+SBJF+3+SG
perfectibilizar-me-ão	perfectibilizar+V.eu.AD.1.SG+FUT+3+PL
perfectibilizar-me-á	perfectibilizar+V.eu.AD.1.SG+FUT+3+SG
perfectibilizar-me-ás	perfectibilizar+V.eu.AD.1.SG+FUT+2+SG
perfectibilizar-me-ei	perfectibilizar+V.eu.AD.1.SG+FUT+1+SG
perfectibilizar-me-eis	perfectibilizar+V.eu.AD.1.SG+FUT+2+PL
perfectibilizar-me-emos	perfectibilizar+V.eu.AD.1.SG+FUT+1+PL
perfectibilizar-me-íamos	perfectibilizar+V.eu.AD.1.SG+COND+1+PL
perfectibilizar-me-iam	perfectibilizar+V.eu.AD.1.SG+COND+3+PL
perfectibilizar-me-ia	perfectibilizar+V.eu.AD.1.SG+COND+1+SG
perfectibilizar-me-ia	perfectibilizar+V.eu.AD.1.SG+COND+3+SG
perfectibilizar-me-ias	perfectibilizar+V.eu.AD.1.SG+COND+2+SG
perfectibilizar-me-íeis	perfectibilizar+V.eu.AD.1.SG+COND+2+PL
perfectibilizar-me	perfectibilizar+V.eu.AD.1.SG+INF
perfectibilizar-me	perfectibilizar+V.eu.AD.1.SG+INF+1+SG
perfectibilizar-me	perfectibilizar+V.eu.AD.1.SG+INF+3+SG
perfectibilizar-me	perfectibilizar+V.eu.AD.1.SG+SBJF+1+SG
perfectibilizar-me	perfectibilizar+V.eu.AD.1.SG+SBJF+3+SG
perfectibilizarmo-la	perfectibilizar+V.ele.ACC.3.F.SG+INF+1+PL
perfectibilizarmo-la	perfectibilizar+V.ele.ACC.3.F.SG+SBJF+1+PL
perfectibilizarmo-las	perfectibilizar+V.ele.ACC.3.F.PL+INF+1+PL
perfectibilizarmo-las	perfectibilizar+V.ele.ACC.3.F.PL+SBJF+1+PL
perfectibilizarmo-lo	perfectibilizar+V.ele.ACC.3.M.SG+INF+1+PL
perfectibilizarmo-lo	perfectibilizar+V.ele.ACC.3.M.SG+SBJF+1+PL
perfectibilizarmo-los	perfectibilizar+V.ele.ACC.3.M.PL+INF+1+PL
perfectibilizarmo-los	perfectibilizar+V.ele.ACC.3.M.PL+SBJF+1+PL
perfectibilizarmo-nos	perfectibilizar+nós.AD.1.PL+INF+1+PL
perfectibilizarmo-nos	perfectibilizar+nós.AD.1.PL+SBJF+1+PL
perfectibilizarmos-lhe	perfectibilizar+V.ele.DAT.3.SG+INF+1+PL
perfectibilizarmos-lhe	perfectibilizar+V.ele.DAT.3.SG+SBJF+1+PL
perfectibilizarmos-lhes	perfectibilizar+V.ele.DAT.3.PL+INF+1+PL
perfectibilizarmos-lhes	perfectibilizar+V.ele.DAT.3.PL+SBJF+1+PL
perfectibilizarmos-me	perfectibilizar+V.eu.AD.1.SG+INF+1+PL
perfectibilizarmos-me	perfectibilizar+V.eu.AD.1.SG+SBJF+1+PL
perfectibilizarmos-te	perfectibilizar+V.tu.AD.2.SG+INF+1+PL
perfectibilizarmos-te	perfectibilizar+V.tu.AD.2.SG+SBJF+1+PL
perfectibilizarmos-vos	perfectibilizar+V.vós.AD.2.PL+INF+1+PL
perfectibilizarmos-vos	perfectibilizar+V.vós.AD.2.PL+SBJF+1+PL
perfectibilizar-nos-ão	perfectibilizar+nós.AD.1.PL+FUT+3+PL
perfectibilizar-nos-á	perfectibilizar+nós.AD.1.PL+FUT+3+SG
perfectibilizar-nos-ás	perfectibilizar+nós.AD.1.PL+FUT+2+SG
perfectibilizar-nos-ei	perfectibilizar+nós.AD.1.PL+FUT+1+SG
perfectibilizar-nos-eis	perfectibilizar+nós.AD.1.PL+FUT+2+PL
perfectibilizar-nos-emos	perfectibilizar+nós.AD.1.PL+FUT+1+PL
perfectibilizar-nos-íamos	perfectibilizar+nós.AD.1.PL+COND+1+PL
perfectibilizar-nos-iam	perfectibilizar+nós.AD.1.PL+COND+3+PL
perfectibilizar-nos-ia	perfectibilizar+nós.AD.1.PL+COND+1+SG
perfectibilizar-nos-ia	perfectibilizar+nós.AD.1.PL+COND+3+SG
perfectibilizar-nos-ias	perfectibilizar+nós.AD.1.PL+COND+2+SG
perfectibilizar-nos-íeis	perfectibilizar+nós.AD.1.PL+COND+2+PL
perfectibilizar-nos	perfectibilizar+nós.AD.1.PL+INF
perfectibilizar-nos	perfectibilizar+nós.AD.1.PL+INF+1+SG
perfectibilizar-nos	perfectibilizar+nós.AD.1.PL+INF+3+SG
perfectibilizar-nos	perfectibilizar+nós.AD.1.PL+SBJF+1+SG
perfectibilizar-nos	perfectibilizar+nós.AD.1.PL+SBJF+3+SG
perfectibilizar-se-ão	perfectibilizar+V.ele.REFL+FUT+3+PL
perfectibilizar-se-á	perfectibilizar+V.ele.REFL+FUT+3+SG
perfectibilizar-se-iam	perfectibilizar+V.ele.REFL+COND+3+PL
perfectibilizar-se-ia	perfectibilizar+V.ele.REFL+COND+3+SG
perfectibilizar-se	perfectibilizar+V.ele.REFL+INF
perfectibilizar-se	perfectibilizar+V.ele.REFL+INF+3+SG
perfectibilizar-se	perfectibilizar+V.ele.REFL+SBJF+3+SG
perfectibilizar-te-ão	perfectibilizar+V.tu.AD.2.SG+FUT+3+PL
perfectibilizar-te-á	perfectibilizar+V.tu.AD.2.SG+FUT+3+SG
perfectibilizar-te-ás	perfectibilizar+V.tu.AD.2.SG+FUT+2+SG
perfectibilizar-te-ei	perfectibilizar+V.tu.AD.2.SG+FUT+1+SG
perfectibilizar-te-eis	perfectibilizar+V.tu.AD.2.SG+FUT+2+PL
perfectibilizar-te-emos	perfectibilizar+V.tu.AD.2.SG+FUT+1+PL
perfectibilizar-te-íamos	perfectibilizar+V.tu.AD.2.SG+COND+1+PL
perfectibilizar-te-iam	perfectibilizar+V.tu.AD.2.SG+COND+3+PL
perfectibilizar-te-ia	perfectibilizar+V.tu.AD.2.SG+COND+1+SG
perfectibilizar-te-ia	perfectibilizar+V.tu.AD.2.SG+COND+3+SG
perfectibilizar-te-ias	perfectibilizar+V.tu.AD.2.SG+COND+2+SG
perfectibilizar-te-íeis	perfectibilizar+V.tu.AD.2.SG+COND+2+PL
perfectibilizar-te	perfectibilizar+V.tu.AD.2.SG+INF
perfectibilizar-te	perfectibilizar+V.tu.AD.2.SG+INF+1+SG
perfectibilizar-te	perfectibilizar+V.tu.AD.2.SG+INF+3+SG
perfectibilizar-te	perfectibilizar+V.tu.AD.2.SG+SBJF+1+SG
perfectibilizar-te	perfectibilizar+V.tu.AD.2.SG+SBJF+3+SG
perfectibilizar-vos-ão	perfectibilizar+V.vós.AD.2.PL+FUT+3+PL
perfectibilizar-vos-á	perfectibilizar+V.vós.AD.2.PL+FUT+3+SG
perfectibilizar-vos-ás	perfectibilizar+V.vós.AD.2.PL+FUT+2+SG
perfectibilizar-vos-ei	perfectibilizar+V.vós.AD.2.PL+FUT+1+SG
perfectibilizar-vos-eis	perfectibilizar+V.vós.AD.2.PL+FUT+2+PL
perfectibilizar-vos-emos	perfectibilizar+V.vós.AD.2.PL+FUT+1+PL
perfectibilizar-vos-íamos	perfectibilizar+V.vós.AD.2.PL+COND+1+PL
perfectibilizar-vos-iam	perfectibilizar+V.vós.AD.2.PL+COND+3+PL
perfectibilizar-vos-ia	perfectibilizar+V.vós.AD.2.PL+COND+1+SG
perfectibilizar-vos-ia	perfectibilizar+V.vós.AD.2.PL+COND+3+SG
perfectibilizar-vos-ias	perfectibilizar+V.vós.AD.2.PL+COND+2+SG
perfectibilizar-vos-íeis	perfectibilizar+V.vós.AD.2.PL+COND+2+PL
perfectibilizar-vos	perfectibilizar+V.vós.AD.2.PL+INF
perfectibilizar-vos	perfectibilizar+V.vós.AD.2.PL+INF+1+SG
perfectibilizar-vos	perfectibilizar+V.vós.AD.2.PL+INF+3+SG
perfectibilizar-vos	perfectibilizar+V.vós.AD.2.PL+SBJF+1+SG
perfectibilizar-vos	perfectibilizar+V.vós.AD.2.PL+SBJF+3+SG
perfectibiliza-se	perfectibilizar+V.ele.REFL+PRS+3+SG
perfectibilizas-lhe	perfectibilizar+V.ele.DAT.3.SG+PRS+2+SG
perfectibilizas-lhes	perfectibilizar+V.ele.DAT.3.PL+PRS+2+SG
perfectibilizas-me	perfectibilizar+V.eu.AD.1.SG+PRS+2+SG
perfectibilizaste-a	perfectibilizar+V.ele.ACC.3.F.SG+PRF+2+SG
perfectibilizaste-as	perfectibilizar+V.ele.ACC.3.F.PL+PRF+2+SG
perfectibilizaste-la	perfectibilizar+V.ele.ACC.3.F.SG+PRF+2+PL
perfectibilizaste-las	perfectibilizar+V.ele.ACC.3.F.PL+PRF+2+PL
perfectibilizaste-lhe	perfectibilizar+V.ele.DAT.3.SG+PRF+2+SG
perfectibilizaste-lhes	perfectibilizar+V.ele.DAT.3.PL+PRF+2+SG
perfectibilizaste-lo	perfectibilizar+V.ele.ACC.3.M.SG+PRF+2+PL
perfectibilizaste-los	perfectibilizar+V.ele.ACC.3.M.PL+PRF+2+PL
perfectibilizaste-me	perfectibilizar+V.eu.AD.1.SG+PRF+2+SG
perfectibilizaste-nos	perfectibilizar+nós.AD.1.PL+PRF+2+PL
perfectibilizaste-nos	perfectibilizar+nós.AD.1.PL+PRF+2+SG
perfectibilizaste-o	perfectibilizar+V.ele.ACC.3.M.SG+PRF+2+SG
perfectibilizaste-os	perfectibilizar+V.ele.ACC.3.M.PL+PRF+2+SG
perfectibilizas-te	perfectibilizar+V.tu.AD.2.SG+PRS+2+SG
perfectibilizastes-lhe	perfectibilizar+V.ele.DAT.3.SG+PRF+2+PL
perfectibilizastes-lhes	perfectibilizar+V.ele.DAT.3.PL+PRF+2+PL
perfectibilizastes-me	perfectibilizar+V.eu.AD.1.SG+PRF+2+PL
perfectibilizastes-te	perfectibilizar+V.tu.AD.2.SG+PRF+2+PL
perfectibilizastes-vos	perfectibilizar+V.vós.AD.2.PL+PRF+2+PL
perfectibilizaste-te	perfectibilizar+V.tu.AD.2.SG+PRF+2+SG
perfectibilizaste-vos	perfectibilizar+V.vós.AD.2.PL+PRF+2+SG
perfectibilizas-vos	perfectibilizar+V.vós.AD.2.PL+PRS+2+SG
perfectibiliza-te	perfectibilizar+V.tu.AD.2.SG+PRS+3+SG
perfectibilizava-a	perfectibilizar+V.ele.ACC.3.F.SG+IMPF+1+SG
perfectibilizava-a	perfectibilizar+V.ele.ACC.3.F.SG+IMPF+3+SG
perfectibilizava-as	perfectibilizar+V.ele.ACC.3.F.PL+IMPF+1+SG
perfectibilizava-as	perfectibilizar+V.ele.ACC.3.F.PL+IMPF+3+SG
perfectibilizava-la	perfectibilizar+V.ele.ACC.3.F.SG+IMPF+2+SG
perfectibilizava-las	perfectibilizar+V.ele.ACC.3.F.PL+IMPF+2+SG
perfectibilizava-lhe	perfectibilizar+V.ele.DAT.3.SG+IMPF+1+SG
perfectibilizava-lhe	perfectibilizar+V.ele.DAT.3.SG+IMPF+3+SG
perfectibilizava-lhes	perfectibilizar+V.ele.DAT.3.PL+IMPF+1+SG
perfectibilizava-lhes	perfectibilizar+V.ele.DAT.3.PL+IMPF+3+SG
perfectibilizava-lo	perfectibilizar+V.ele.ACC.3.M.SG+IMPF+2+SG
perfectibilizava-los	perfectibilizar+V.ele.ACC.3.M.PL+IMPF+2+SG
perfectibilizava-me	perfectibilizar+V.eu.AD.1.SG+IMPF+1+SG
perfectibilizava-me	perfectibilizar+V.eu.AD.1.SG+IMPF+3+SG
perfectibilizavam-lhe	perfectibilizar+V.ele.DAT.3.SG+IMPF+3+PL
perfectibilizavam-lhes	perfectibilizar+V.ele.DAT.3.PL+IMPF+3+PL
perfectibilizavam-me	perfectibilizar+V.eu.AD.1.SG+IMPF+3+PL
perfectibilizavam-na	perfectibilizar+V.ele.ACC.3.F.SG+IMPF+3+PL
perfectibilizavam-nas	perfectibilizar+V.ele.ACC.3.F.PL+IMPF+3+PL
perfectibilizavam-no	perfectibilizar+V.ele.ACC.3.M.SG+IMPF+3+PL
perfectibilizavam-nos	perfectibilizar+V.ele.ACC.3.M.PL+IMPF+3+PL
perfectibilizavam-nos	perfectibilizar+V.nós.AD.1.PL+IMPF+3+PL
perfectibilizávamo-la	perfectibilizar+V.ele.ACC.3.F.SG+IMPF+1+PL
perfectibilizávamo-las	perfectibilizar+V.ele.ACC.3.F.PL+IMPF+1+PL
perfectibilizávamo-lo	perfectibilizar+V.ele.ACC.3.M.SG+IMPF+1+PL
perfectibilizávamo-los	perfectibilizar+V.ele.ACC.3.M.PL+IMPF+1+PL
perfectibilizávamo-nos	perfectibilizar+nós.AD.1.PL+IMPF+1+PL
perfectibilizávamos-lhe	perfectibilizar+V.ele.DAT.3.SG+IMPF+1+PL
perfectibilizávamos-lhes	perfectibilizar+V.ele.DAT.3.PL+IMPF+1+PL
perfectibilizávamos-me	perfectibilizar+V.eu.AD.1.SG+IMPF+1+PL
perfectibilizávamos-te	perfectibilizar+V.tu.AD.2.SG+IMPF+1+PL
perfectibilizávamos-vos	perfectibilizar+V.vós.AD.2.PL+IMPF+1+PL
perfectibilizavam-se	perfectibilizar+V.ele.REFL+IMPF+3+PL
perfectibilizavam-te	perfectibilizar+V.tu.AD.2.SG+IMPF+3+PL
perfectibilizavam-vos	perfectibilizar+V.vós.AD.2.PL+IMPF+3+PL
perfectibilizava-nos	perfectibilizar+nós.AD.1.PL+IMPF+1+SG
perfectibilizava-nos	perfectibilizar+nós.AD.1.PL+IMPF+2+SG
perfectibilizava-nos	perfectibilizar+nós.AD.1.PL+IMPF+3+SG
perfectibilizava-o	perfectibilizar+V.ele.ACC.3.M.SG+IMPF+1+SG
perfectibilizava-o	perfectibilizar+V.ele.ACC.3.M.SG+IMPF+3+SG
perfectibilizava-os	perfectibilizar+V.ele.ACC.3.M.PL+IMPF+1+SG
perfectibilizava-os	perfectibilizar+V.ele.ACC.3.M.PL+IMPF+3+SG
perfectibilizava-se	perfectibilizar+V.ele.REFL+IMPF+1+SG
perfectibilizava-se	perfectibilizar+V.ele.REFL+IMPF+3+SG
perfectibilizavas-lhe	perfectibilizar+V.ele.DAT.3.SG+IMPF+2+SG
perfectibilizavas-lhes	perfectibilizar+V.ele.DAT.3.PL+IMPF+2+SG
perfectibilizavas-me	perfectibilizar+V.eu.AD.1.SG+IMPF+2+SG
perfectibilizavas-te	perfectibilizar+V.tu.AD.2.SG+IMPF+2+SG
perfectibilizavas-vos	perfectibilizar+V.vós.AD.2.PL+IMPF+2+SG
perfectibilizava-te	perfectibilizar+V.tu.AD.2.SG+IMPF+1+SG
perfectibilizava-te	perfectibilizar+V.tu.AD.2.SG+IMPF+3+SG
perfectibilizava-vos	perfectibilizar+V.vós.AD.2.PL+IMPF+1+SG
perfectibilizava-vos	perfectibilizar+V.vós.AD.2.PL+IMPF+3+SG
perfectibilizávei-la	perfectibilizar+V.ele.ACC.3.F.SG+IMPF+2+PL
perfectibilizávei-las	perfectibilizar+V.ele.ACC.3.F.PL+IMPF+2+PL
perfectibilizávei-lo	perfectibilizar+V.ele.ACC.3.M.SG+IMPF+2+PL
perfectibilizávei-los	perfectibilizar+V.ele.ACC.3.M.PL+IMPF+2+PL
perfectibilizávei-nos	perfectibilizar+nós.AD.1.PL+IMPF+2+PL
perfectibilizáveis-lhe	perfectibilizar+V.ele.DAT.3.SG+IMPF+2+PL
perfectibilizáveis-lhes	perfectibilizar+V.ele.DAT.3.PL+IMPF+2+PL
perfectibilizáveis-me	perfectibilizar+V.eu.AD.1.SG+IMPF+2+PL
perfectibilizáveis-te	perfectibilizar+V.tu.AD.2.SG+IMPF+2+PL
perfectibilizáveis-vos	perfectibilizar+V.vós.AD.2.PL+IMPF+2+PL
perfectibiliza-vos	perfectibilizar+V.vós.AD.2.PL+PRS+3+SG
perfectibilize-a	perfectibilizar+V.ele.ACC.3.F.SG+IMP+3+SG
perfectibilize-as	perfectibilizar+V.ele.ACC.3.F.PL+IMP+3+SG
perfectibilizei-a	perfectibilizar+V.ele.ACC.3.F.SG+PRF+1+SG
perfectibilizei-as	perfectibilizar+V.ele.ACC.3.F.PL+PRF+1+SG
perfectibilizei-lhe	perfectibilizar+V.ele.DAT.3.SG+PRF+1+SG
perfectibilizei-lhes	perfectibilizar+V.ele.DAT.3.PL+PRF+1+SG
perfectibilizei-me	perfectibilizar+V.eu.AD.1.SG+PRF+1+SG
perfectibilizei-nos	perfectibilizar+nós.AD.1.PL+PRF+1+SG
perfectibilizei-o	perfectibilizar+V.ele.ACC.3.M.SG+PRF+1+SG
perfectibilizei-os	perfectibilizar+V.ele.ACC.3.M.PL+PRF+1+SG
perfectibilizei-te	perfectibilizar+V.tu.AD.2.SG+PRF+1+SG
perfectibilizei-vos	perfectibilizar+V.vós.AD.2.PL+PRF+1+SG
perfectibilize-lhe	perfectibilizar+V.ele.DAT.3.SG+IMP+3+SG
perfectibilize-lhes	perfectibilizar+V.ele.DAT.3.PL+IMP+3+SG
perfectibilize-me	perfectibilizar+V.eu.AD.1.SG+IMP+3+SG
perfectibilizem-lhe	perfectibilizar+V.ele.DAT.3.SG+IMP+3+PL
perfectibilizem-lhes	perfectibilizar+V.ele.DAT.3.PL+IMP+3+PL
perfectibilizem-me	perfectibilizar+V.eu.AD.1.SG+IMP+3+PL
perfectibilizem-na	perfectibilizar+V.ele.ACC.3.F.SG+IMP+3+PL
perfectibilizem-nas	perfectibilizar+V.ele.ACC.3.F.PL+IMP+3+PL
perfectibilizem-no	perfectibilizar+V.ele.ACC.3.M.SG+IMP+3+PL
perfectibilizem-nos	perfectibilizar+V.ele.ACC.3.M.PL+IMP+3+PL
perfectibilizem-nos	perfectibilizar+V.nós.AD.1.PL+IMP+3+PL
perfectibilizemo-la	perfectibilizar+V.ele.ACC.3.F.SG+IMP+1+PL
perfectibilizemo-las	perfectibilizar+V.ele.ACC.3.F.PL+IMP+1+PL
perfectibilizemo-lo	perfectibilizar+V.ele.ACC.3.M.SG+IMP+1+PL
perfectibilizemo-los	perfectibilizar+V.ele.ACC.3.M.PL+IMP+1+PL
perfectibilizemo-nos	perfectibilizar+nós.AD.1.PL+IMP+1+PL
perfectibilizemos-lhe	perfectibilizar+V.ele.DAT.3.SG+IMP+1+PL
perfectibilizemos-lhes	perfectibilizar+V.ele.DAT.3.PL+IMP+1+PL
perfectibilizemos-me	perfectibilizar+V.eu.AD.1.SG+IMP+1+PL
perfectibilizemos-te	perfectibilizar+V.tu.AD.2.SG+IMP+1+PL
perfectibilizemos-vos	perfectibilizar+V.vós.AD.2.PL+IMP+1+PL
perfectibilizem-se	perfectibilizar+V.ele.REFL+IMP+3+PL
perfectibilizem-te	perfectibilizar+V.tu.AD.2.SG+IMP+3+PL
perfectibilizem-vos	perfectibilizar+V.vós.AD.2.PL+IMP+3+PL
perfectibilize-nos	perfectibilizar+nós.AD.1.PL+IMP+3+SG
perfectibilize-o	perfectibilizar+V.ele.ACC.3.M.SG+IMP+3+SG
perfectibilize-os	perfectibilizar+V.ele.ACC.3.M.PL+IMP+3+SG
perfectibilize-se	perfectibilizar+V.ele.REFL+IMP+3+SG
perfectibilize-te	perfectibilizar+V.tu.AD.2.SG+IMP+3+SG
perfectibilize-vos	perfectibilizar+V.vós.AD.2.PL+IMP+3+SG
perfectibilizo-a	perfectibilizar+V.ele.ACC.3.F.SG+PRS+1+SG
perfectibilizo-as	perfectibilizar+V.ele.ACC.3.F.PL+PRS+1+SG
perfectibilizo-lhe	perfectibilizar+V.ele.DAT.3.SG+PRS+1+SG
perfectibilizo-lhes	perfectibilizar+V.ele.DAT.3.PL+PRS+1+SG
perfectibilizo-me	perfectibilizar+V.eu.AD.1.SG+PRS+1+SG
perfectibilizo-nos	perfectibilizar+nós.AD.1.PL+PRS+1+SG
perfectibilizo-o	perfectibilizar+V.ele.ACC.3.M.SG+PRS+1+SG
perfectibilizo-os	perfectibilizar+V.ele.ACC.3.M.PL+PRS+1+SG
perfectibilizo-te	perfectibilizar+V.tu.AD.2.SG+PRS+1+SG
perfectibilizou-a	perfectibilizar+V.ele.ACC.3.F.SG+PRF+3+SG
perfectibilizou-as	perfectibilizar+V.ele.ACC.3.F.PL+PRF+3+SG
perfectibilizou-lhe	perfectibilizar+V.ele.DAT.3.SG+PRF+3+SG
perfectibilizou-lhes	perfectibilizar+V.ele.DAT.3.PL+PRF+3+SG
perfectibilizou-me	perfectibilizar+V.eu.AD.1.SG+PRF+3+SG
perfectibilizou-nos	perfectibilizar+nós.AD.1.PL+PRF+3+SG
perfectibilizou-o	perfectibilizar+V.ele.ACC.3.M.SG+PRF+3+SG
perfectibilizou-os	perfectibilizar+V.ele.ACC.3.M.PL+PRF+3+SG
perfectibilizou-se	perfectibilizar+V.ele.REFL+PRF+3+SG
perfectibilizou-te	perfectibilizar+V.tu.AD.2.SG+PRF+3+SG
perfectibilizou-vos	perfectibilizar+V.vós.AD.2.PL+PRF+3+SG
perfectibilizo-vos	perfectibilizar+V.vós.AD.2.PL+PRS+1+SG
perfeiçoa-a	perfeiçoar+V.ele.ACC.3.F.SG+PRS+3+SG
perfeiçoa-as	perfeiçoar+V.ele.ACC.3.F.PL+PRS+3+SG
perfeiçoai-la	perfeiçoar+V.ele.ACC.3.F.SG+PRS+2+PL
perfeiçoai-las	perfeiçoar+V.ele.ACC.3.F.PL+PRS+2+PL
perfeiçoai-lo	perfeiçoar+V.ele.ACC.3.M.SG+PRS+2+PL
perfeiçoai-los	perfeiçoar+V.ele.ACC.3.M.PL+PRS+2+PL
perfeiçoai-nos	perfeiçoar+nós.AD.1.PL+PRS+2+PL
perfeiçoais-lhe	perfeiçoar+V.ele.DAT.3.SG+PRS+2+PL
perfeiçoais-lhes	perfeiçoar+V.ele.DAT.3.PL+PRS+2+PL
perfeiçoais-me	perfeiçoar+V.eu.AD.1.SG+PRS+2+PL
perfeiçoais-te	perfeiçoar+V.tu.AD.2.SG+PRS+2+PL
perfeiçoais-vos	perfeiçoar+V.vós.AD.2.PL+PRS+2+PL
perfeiçoá-la-ão	perfeiçoar+V.ele.ACC.3.F.SG+FUT+3+PL
perfeiçoá-la-á	perfeiçoar+V.ele.ACC.3.F.SG+FUT+3+SG
perfeiçoá-la-ás	perfeiçoar+V.ele.ACC.3.F.SG+FUT+2+SG
perfeiçoá-la-ei	perfeiçoar+V.ele.ACC.3.F.SG+FUT+1+SG
perfeiçoá-la-eis	perfeiçoar+V.ele.ACC.3.F.SG+FUT+2+PL
perfeiçoá-la-emos	perfeiçoar+V.ele.ACC.3.F.SG+FUT+1+PL
perfeiçoá-la-íamos	perfeiçoar+V.ele.ACC.3.F.SG+COND+1+PL
perfeiçoá-la-iam	perfeiçoar+V.ele.ACC.3.F.SG+COND+3+PL
perfeiçoá-la-ia	perfeiçoar+V.ele.ACC.3.F.SG+COND+1+SG
perfeiçoá-la-ia	perfeiçoar+V.ele.ACC.3.F.SG+COND+3+SG
perfeiçoá-la-ias	perfeiçoar+V.ele.ACC.3.F.SG+COND+2+SG
perfeiçoá-la-íeis	perfeiçoar+V.ele.ACC.3.F.SG+COND+2+PL
perfeiçoá-la	perfeiçoar+V.ele.ACC.3.F.SG+INF+1+SG
perfeiçoá-la	perfeiçoar+V.ele.ACC.3.F.SG+INF+3+SG
perfeiçoa-la	perfeiçoar+V.ele.ACC.3.F.SG+PRS+2+SG
perfeiçoá-la	perfeiçoar+V.ele.ACC.3.F.SG+SBJF+1+SG
perfeiçoá-la	perfeiçoar+V.ele.ACC.3.F.SG+SBJF+3+SG
perfeiçoá-las-ão	perfeiçoar+V.ele.ACC.3.F.PL+FUT+3+PL
perfeiçoá-las-á	perfeiçoar+V.ele.ACC.3.F.PL+FUT+3+SG
perfeiçoá-las-ás	perfeiçoar+V.ele.ACC.3.F.PL+FUT+2+SG
perfeiçoá-las-ei	perfeiçoar+V.ele.ACC.3.F.PL+FUT+1+SG
perfeiçoá-las-eis	perfeiçoar+V.ele.ACC.3.F.PL+FUT+2+PL
perfeiçoá-las-emos	perfeiçoar+V.ele.ACC.3.F.PL+FUT+1+PL
perfeiçoá-las-íamos	perfeiçoar+V.ele.ACC.3.F.PL+COND+1+PL
perfeiçoá-las-iam	perfeiçoar+V.ele.ACC.3.F.PL+COND+3+PL
perfeiçoá-las-ia	perfeiçoar+V.ele.ACC.3.F.PL+COND+1+SG
perfeiçoá-las-ia	perfeiçoar+V.ele.ACC.3.F.PL+COND+3+SG
perfeiçoá-las-ias	perfeiçoar+V.ele.ACC.3.F.PL+COND+2+SG
perfeiçoá-las-íeis	perfeiçoar+V.ele.ACC.3.F.PL+COND+2+PL
perfeiçoá-las	perfeiçoar+V.ele.ACC.3.F.PL+INF+1+SG
perfeiçoá-las	perfeiçoar+V.ele.ACC.3.F.PL+INF+3+SG
perfeiçoa-las	perfeiçoar+V.ele.ACC.3.F.PL+PRS+2+SG
perfeiçoá-las	perfeiçoar+V.ele.ACC.3.F.PL+SBJF+1+SG
perfeiçoá-las	perfeiçoar+V.ele.ACC.3.F.PL+SBJF+3+SG
perfeiçoa-lhe	perfeiçoar+V.ele.DAT.3.SG+PRS+3+SG
perfeiçoa-lhes	perfeiçoar+V.ele.DAT.3.PL+PRS+3+SG
perfeiçoá-lo-ão	perfeiçoar+V.ele.ACC.3.M.SG+FUT+3+PL
perfeiçoá-lo-á	perfeiçoar+V.ele.ACC.3.M.SG+FUT+3+SG
perfeiçoá-lo-ás	perfeiçoar+V.ele.ACC.3.M.SG+FUT+2+SG
perfeiçoá-lo-ei	perfeiçoar+V.ele.ACC.3.M.SG+FUT+1+SG
perfeiçoá-lo-eis	perfeiçoar+V.ele.ACC.3.M.SG+FUT+2+PL
perfeiçoá-lo-emos	perfeiçoar+V.ele.ACC.3.M.SG+FUT+1+PL
perfeiçoá-lo-íamos	perfeiçoar+V.ele.ACC.3.M.SG+COND+1+PL
perfeiçoá-lo-iam	perfeiçoar+V.ele.ACC.3.M.SG+COND+3+PL
perfeiçoá-lo-ia	perfeiçoar+V.ele.ACC.3.M.SG+COND+1+SG
perfeiçoá-lo-ia	perfeiçoar+V.ele.ACC.3.M.SG+COND+3+SG
perfeiçoá-lo-ias	perfeiçoar+V.ele.ACC.3.M.SG+COND+2+SG
perfeiçoá-lo-íeis	perfeiçoar+V.ele.ACC.3.M.SG+COND+2+PL
perfeiçoá-lo	perfeiçoar+V.ele.ACC.3.M.SG+INF+1+SG
perfeiçoá-lo	perfeiçoar+V.ele.ACC.3.M.SG+INF+3+SG
perfeiçoa-lo	perfeiçoar+V.ele.ACC.3.M.SG+PRS+2+SG
perfeiçoá-lo	perfeiçoar+V.ele.ACC.3.M.SG+SBJF+1+SG
perfeiçoá-lo	perfeiçoar+V.ele.ACC.3.M.SG+SBJF+3+SG
perfeiçoá-los-ão	perfeiçoar+V.ele.ACC.3.M.PL+FUT+3+PL
perfeiçoá-los-á	perfeiçoar+V.ele.ACC.3.M.PL+FUT+3+SG
perfeiçoá-los-ás	perfeiçoar+V.ele.ACC.3.M.PL+FUT+2+SG
perfeiçoá-los-ei	perfeiçoar+V.ele.ACC.3.M.PL+FUT+1+SG
perfeiçoá-los-eis	perfeiçoar+V.ele.ACC.3.M.PL+FUT+2+PL
perfeiçoá-los-emos	perfeiçoar+V.ele.ACC.3.M.PL+FUT+1+PL
perfeiçoá-los-íamos	perfeiçoar+V.ele.ACC.3.M.PL+COND+1+PL
perfeiçoá-los-iam	perfeiçoar+V.ele.ACC.3.M.PL+COND+3+PL
perfeiçoá-los-ia	perfeiçoar+V.ele.ACC.3.M.PL+COND+1+SG
perfeiçoá-los-ia	perfeiçoar+V.ele.ACC.3.M.PL+COND+3+SG
perfeiçoá-los-ias	perfeiçoar+V.ele.ACC.3.M.PL+COND+2+SG
perfeiçoá-los-íeis	perfeiçoar+V.ele.ACC.3.M.PL+COND+2+PL
perfeiçoá-los	perfeiçoar+V.ele.ACC.3.M.PL+INF+1+SG
perfeiçoá-los	perfeiçoar+V.ele.ACC.3.M.PL+INF+3+SG
perfeiçoa-los	perfeiçoar+V.ele.ACC.3.M.PL+PRS+2+SG
perfeiçoá-los	perfeiçoar+V.ele.ACC.3.M.PL+SBJF+1+SG
perfeiçoá-los	perfeiçoar+V.ele.ACC.3.M.PL+SBJF+3+SG
perfeiçoa-me	perfeiçoar+V.eu.AD.1.SG+PRS+3+SG
perfeiçoam-lhe	perfeiçoar+V.ele.DAT.3.SG+PRS+3+PL
perfeiçoam-lhes	perfeiçoar+V.ele.DAT.3.PL+PRS+3+PL
perfeiçoam-me	perfeiçoar+V.eu.AD.1.SG+PRS+3+PL
perfeiçoam-na	perfeiçoar+V.ele.ACC.3.F.SG+PRS+3+PL
perfeiçoam-nas	perfeiçoar+V.ele.ACC.3.F.PL+PRS+3+PL
perfeiçoam-no	perfeiçoar+V.ele.ACC.3.M.SG+PRS+3+PL
perfeiçoam-nos	perfeiçoar+nós.AD.1.PL+PRS+3+PL
perfeiçoamo-la	perfeiçoar+V.ele.ACC.3.F.SG+PRF+1+PL
perfeiçoamo-la	perfeiçoar+V.ele.ACC.3.F.SG+PRS+1+PL
perfeiçoamo-las	perfeiçoar+V.ele.ACC.3.F.PL+PRF+1+PL
perfeiçoamo-las	perfeiçoar+V.ele.ACC.3.F.PL+PRS+1+PL
perfeiçoamo-lo	perfeiçoar+V.ele.ACC.3.M.SG+PRF+1+PL
perfeiçoamo-lo	perfeiçoar+V.ele.ACC.3.M.SG+PRS+1+PL
perfeiçoamo-los	perfeiçoar+V.ele.ACC.3.M.PL+PRF+1+PL
perfeiçoamo-los	perfeiçoar+V.ele.ACC.3.M.PL+PRS+1+PL
perfeiçoamo-nos	perfeiçoar+nós.AD.1.PL+PRF+1+PL
perfeiçoamo-nos	perfeiçoar+nós.AD.1.PL+PRS+1+PL
perfeiçoamos-lhe	perfeiçoar+V.ele.DAT.3.SG+PRF+1+PL
perfeiçoamos-lhe	perfeiçoar+V.ele.DAT.3.SG+PRS+1+PL
perfeiçoamos-lhes	perfeiçoar+V.ele.DAT.3.PL+PRF+1+PL
perfeiçoamos-lhes	perfeiçoar+V.ele.DAT.3.PL+PRS+1+PL
perfeiçoamos-me	perfeiçoar+V.eu.AD.1.SG+PRF+1+PL
perfeiçoamos-me	perfeiçoar+V.eu.AD.1.SG+PRS+1+PL
perfeiçoamos-te	perfeiçoar+V.tu.AD.2.SG+PRF+1+PL
perfeiçoamos-te	perfeiçoar+V.tu.AD.2.SG+PRS+1+PL
perfeiçoamos-vos	perfeiçoar+V.vós.AD.2.PL+PRF+1+PL
perfeiçoamos-vos	perfeiçoar+V.vós.AD.2.PL+PRS+1+PL
perfeiçoam-se	perfeiçoar+V.ele.REFL+PRS+3+PL
perfeiçoam-te	perfeiçoar+V.tu.AD.2.SG+PRS+3+PL
perfeiçoam-vos	perfeiçoar+V.vós.AD.2.PL+PRS+3+PL
perfeiçoando-a	perfeiçoar+V.ele.ACC.3.F.SG+GRD
perfeiçoando-as	perfeiçoar+V.ele.ACC.3.F.PL+GRD
perfeiçoando-lhe	perfeiçoar+V.ele.DAT.3.SG+GRD
perfeiçoando-lhes	perfeiçoar+V.ele.DAT.3.PL+GRD
perfeiçoando-me	perfeiçoar+V.eu.AD.1.SG+GRD
perfeiçoando-nos	perfeiçoar+nós.AD.1.PL+GRD
perfeiçoando-o	perfeiçoar+V.ele.ACC.3.M.SG+GRD
perfeiçoando-os	perfeiçoar+V.ele.ACC.3.M.PL+GRD
perfeiçoando-se	perfeiçoar+V.ele.REFL+GRD
perfeiçoando-te	perfeiçoar+V.tu.AD.2.SG+GRD
perfeiçoando-vos	perfeiçoar+V.vós.AD.2.PL+GRD
perfeiçoa-nos	perfeiçoar+nós.AD.1.PL+PRS+2+SG
perfeiçoa-nos	perfeiçoar+nós.AD.1.PL+PRS+3+SG
perfeiçoa-o	perfeiçoar+V.ele.ACC.3.M.SG+PRS+3+SG
perfeiçoa-os	perfeiçoar+V.ele.ACC.3.M.PL+PRS+3+SG
perfeiçoara-a	perfeiçoar+V.ele.ACC.3.F.SG+PQP+1+SG
perfeiçoara-a	perfeiçoar+V.ele.ACC.3.F.SG+PQP+3+SG
perfeiçoara-as	perfeiçoar+V.ele.ACC.3.F.PL+PQP+1+SG
perfeiçoara-as	perfeiçoar+V.ele.ACC.3.F.PL+PQP+3+SG
perfeiçoara-la	perfeiçoar+V.ele.ACC.3.F.SG+PQP+2+SG
perfeiçoara-las	perfeiçoar+V.ele.ACC.3.F.PL+PQP+2+SG
perfeiçoara-lhe	perfeiçoar+V.ele.DAT.3.SG+PQP+1+SG
perfeiçoara-lhe	perfeiçoar+V.ele.DAT.3.SG+PQP+3+SG
perfeiçoara-lhes	perfeiçoar+V.ele.DAT.3.PL+PQP+1+SG
perfeiçoara-lhes	perfeiçoar+V.ele.DAT.3.PL+PQP+3+SG
perfeiçoara-lo	perfeiçoar+V.ele.ACC.3.M.SG+PQP+2+SG
perfeiçoara-los	perfeiçoar+V.ele.ACC.3.M.PL+PQP+2+SG
perfeiçoara-me	perfeiçoar+V.eu.AD.1.SG+PQP+1+SG
perfeiçoara-me	perfeiçoar+V.eu.AD.1.SG+PQP+3+SG
perfeiçoaram-lhe	perfeiçoar+V.ele.DAT.3.SG+PQP+3+PL
perfeiçoaram-lhe	perfeiçoar+V.ele.DAT.3.SG+PRF+3+PL
perfeiçoaram-lhes	perfeiçoar+V.ele.DAT.3.PL+PQP+3+PL
perfeiçoaram-lhes	perfeiçoar+V.ele.DAT.3.PL+PRF+3+PL
perfeiçoaram-me	perfeiçoar+V.eu.AD.1.SG+PQP+3+PL
perfeiçoaram-me	perfeiçoar+V.eu.AD.1.SG+PRF+3+PL
perfeiçoaram-na	perfeiçoar+V.ele.ACC.3.F.SG+PQP+3+PL
perfeiçoaram-na	perfeiçoar+V.ele.ACC.3.F.SG+PRF+3+PL
perfeiçoaram-nas	perfeiçoar+V.ele.ACC.3.F.PL+PQP+3+PL
perfeiçoaram-nas	perfeiçoar+V.ele.ACC.3.F.PL+PRF+3+PL
perfeiçoaram-no	perfeiçoar+V.ele.ACC.3.M.SG+PQP+3+PL
perfeiçoaram-no	perfeiçoar+V.ele.ACC.3.M.SG+PRF+3+PL
perfeiçoaram-nos	perfeiçoar+nós.AD.1.PL+PQP+3+PL
perfeiçoaram-nos	perfeiçoar+nós.AD.1.PL+PRF+3+PL
perfeiçoáramo-la	perfeiçoar+V.ele.ACC.3.F.SG+PQP+1+PL
perfeiçoáramo-las	perfeiçoar+V.ele.ACC.3.F.PL+PQP+1+PL
perfeiçoáramo-lo	perfeiçoar+V.ele.ACC.3.M.SG+PQP+1+PL
perfeiçoáramo-los	perfeiçoar+V.ele.ACC.3.M.PL+PQP+1+PL
perfeiçoáramo-nos	perfeiçoar+nós.AD.1.PL+PQP+1+PL
perfeiçoáramos-lhe	perfeiçoar+V.ele.DAT.3.SG+PQP+1+PL
perfeiçoáramos-lhes	perfeiçoar+V.ele.DAT.3.PL+PQP+1+PL
perfeiçoáramos-me	perfeiçoar+V.eu.AD.1.SG+PQP+1+PL
perfeiçoáramos-te	perfeiçoar+V.tu.AD.2.SG+PQP+1+PL
perfeiçoáramos-vos	perfeiçoar+V.vós.AD.2.PL+PQP+1+PL
perfeiçoaram-se	perfeiçoar+V.ele.REFL+PQP+3+PL
perfeiçoaram-se	perfeiçoar+V.ele.REFL+PRF+3+PL
perfeiçoaram-te	perfeiçoar+V.tu.AD.2.SG+PQP+3+PL
perfeiçoaram-te	perfeiçoar+V.tu.AD.2.SG+PRF+3+PL
perfeiçoaram-vos	perfeiçoar+V.vós.AD.2.PL+PQP+3+PL
perfeiçoaram-vos	perfeiçoar+V.vós.AD.2.PL+PRF+3+PL
perfeiçoara-nos	perfeiçoar+nós.AD.1.PL+PQP+1+SG
perfeiçoara-nos	perfeiçoar+nós.AD.1.PL+PQP+2+SG
perfeiçoara-nos	perfeiçoar+nós.AD.1.PL+PQP+3+SG
perfeiçoara-o	perfeiçoar+V.ele.ACC.3.M.SG+PQP+1+SG
perfeiçoara-o	perfeiçoar+V.ele.ACC.3.M.SG+PQP+3+SG
perfeiçoara-os	perfeiçoar+V.ele.ACC.3.M.PL+PQP+1+SG
perfeiçoara-os	perfeiçoar+V.ele.ACC.3.M.PL+PQP+3+SG
perfeiçoara-se	perfeiçoar+V.ele.REFL+PQP+1+SG
perfeiçoara-se	perfeiçoar+V.ele.REFL+PQP+3+SG
