preceituar-vos-emos	preceituar+V.vós.AD.2.PL+FUT+1+PL
preceituar-vos-íamos	preceituar+V.vós.AD.2.PL+COND+1+PL
preceituar-vos-iam	preceituar+V.vós.AD.2.PL+COND+3+PL
preceituar-vos-ia	preceituar+V.vós.AD.2.PL+COND+1+SG
preceituar-vos-ia	preceituar+V.vós.AD.2.PL+COND+3+SG
preceituar-vos-ias	preceituar+V.vós.AD.2.PL+COND+2+SG
preceituar-vos-íeis	preceituar+V.vós.AD.2.PL+COND+2+PL
preceituar-vos	preceituar+V.vós.AD.2.PL+INF
preceituar-vos	preceituar+V.vós.AD.2.PL+INF+1+SG
preceituar-vos	preceituar+V.vós.AD.2.PL+INF+3+SG
preceituar-vos	preceituar+V.vós.AD.2.PL+SBJF+1+SG
preceituar-vos	preceituar+V.vós.AD.2.PL+SBJF+3+SG
preceitua-se	preceituar+V.ele.REFL+PRS+3+SG
preceituas-lhe	preceituar+V.ele.DAT.3.SG+PRS+2+SG
preceituas-lhes	preceituar+V.ele.DAT.3.PL+PRS+2+SG
preceituas-me	preceituar+V.eu.AD.1.SG+PRS+2+SG
preceituaste-a	preceituar+V.ele.ACC.3.F.SG+PRF+2+SG
preceituaste-as	preceituar+V.ele.ACC.3.F.PL+PRF+2+SG
preceituaste-la	preceituar+V.ele.ACC.3.F.SG+PRF+2+PL
preceituaste-las	preceituar+V.ele.ACC.3.F.PL+PRF+2+PL
preceituaste-lhe	preceituar+V.ele.DAT.3.SG+PRF+2+SG
preceituaste-lhes	preceituar+V.ele.DAT.3.PL+PRF+2+SG
preceituaste-lo	preceituar+V.ele.ACC.3.M.SG+PRF+2+PL
preceituaste-los	preceituar+V.ele.ACC.3.M.PL+PRF+2+PL
preceituaste-me	preceituar+V.eu.AD.1.SG+PRF+2+SG
preceituaste-nos	preceituar+nós.AD.1.PL+PRF+2+PL
preceituaste-nos	preceituar+nós.AD.1.PL+PRF+2+SG
preceituaste-o	preceituar+V.ele.ACC.3.M.SG+PRF+2+SG
preceituaste-os	preceituar+V.ele.ACC.3.M.PL+PRF+2+SG
preceituas-te	preceituar+V.tu.AD.2.SG+PRS+2+SG
preceituastes-lhe	preceituar+V.ele.DAT.3.SG+PRF+2+PL
preceituastes-lhes	preceituar+V.ele.DAT.3.PL+PRF+2+PL
preceituastes-me	preceituar+V.eu.AD.1.SG+PRF+2+PL
preceituastes-te	preceituar+V.tu.AD.2.SG+PRF+2+PL
preceituastes-vos	preceituar+V.vós.AD.2.PL+PRF+2+PL
preceituaste-te	preceituar+V.tu.AD.2.SG+PRF+2+SG
preceituaste-vos	preceituar+V.vós.AD.2.PL+PRF+2+SG
preceituas-vos	preceituar+V.vós.AD.2.PL+PRS+2+SG
preceitua-te	preceituar+V.tu.AD.2.SG+PRS+3+SG
preceituava-a	preceituar+V.ele.ACC.3.F.SG+IMPF+1+SG
preceituava-a	preceituar+V.ele.ACC.3.F.SG+IMPF+3+SG
preceituava-as	preceituar+V.ele.ACC.3.F.PL+IMPF+1+SG
preceituava-as	preceituar+V.ele.ACC.3.F.PL+IMPF+3+SG
preceituava-la	preceituar+V.ele.ACC.3.F.SG+IMPF+2+SG
preceituava-las	preceituar+V.ele.ACC.3.F.PL+IMPF+2+SG
preceituava-lhe	preceituar+V.ele.DAT.3.SG+IMPF+1+SG
preceituava-lhe	preceituar+V.ele.DAT.3.SG+IMPF+3+SG
preceituava-lhes	preceituar+V.ele.DAT.3.PL+IMPF+1+SG
preceituava-lhes	preceituar+V.ele.DAT.3.PL+IMPF+3+SG
preceituava-lo	preceituar+V.ele.ACC.3.M.SG+IMPF+2+SG
preceituava-los	preceituar+V.ele.ACC.3.M.PL+IMPF+2+SG
preceituava-me	preceituar+V.eu.AD.1.SG+IMPF+1+SG
preceituava-me	preceituar+V.eu.AD.1.SG+IMPF+3+SG
preceituavam-lhe	preceituar+V.ele.DAT.3.SG+IMPF+3+PL
preceituavam-lhes	preceituar+V.ele.DAT.3.PL+IMPF+3+PL
preceituavam-me	preceituar+V.eu.AD.1.SG+IMPF+3+PL
preceituavam-na	preceituar+V.ele.ACC.3.F.SG+IMPF+3+PL
preceituavam-nas	preceituar+V.ele.ACC.3.F.PL+IMPF+3+PL
preceituavam-no	preceituar+V.ele.ACC.3.M.SG+IMPF+3+PL
preceituavam-nos	preceituar+V.ele.ACC.3.M.PL+IMPF+3+PL
preceituavam-nos	preceituar+V.nós.AD.1.PL+IMPF+3+PL
preceituávamo-la	preceituar+V.ele.ACC.3.F.SG+IMPF+1+PL
preceituávamo-las	preceituar+V.ele.ACC.3.F.PL+IMPF+1+PL
preceituávamo-lo	preceituar+V.ele.ACC.3.M.SG+IMPF+1+PL
preceituávamo-los	preceituar+V.ele.ACC.3.M.PL+IMPF+1+PL
preceituávamo-nos	preceituar+nós.AD.1.PL+IMPF+1+PL
preceituávamos-lhe	preceituar+V.ele.DAT.3.SG+IMPF+1+PL
preceituávamos-lhes	preceituar+V.ele.DAT.3.PL+IMPF+1+PL
preceituávamos-me	preceituar+V.eu.AD.1.SG+IMPF+1+PL
preceituávamos-te	preceituar+V.tu.AD.2.SG+IMPF+1+PL
preceituávamos-vos	preceituar+V.vós.AD.2.PL+IMPF+1+PL
preceituavam-se	preceituar+V.ele.REFL+IMPF+3+PL
preceituavam-te	preceituar+V.tu.AD.2.SG+IMPF+3+PL
preceituavam-vos	preceituar+V.vós.AD.2.PL+IMPF+3+PL
preceituava-nos	preceituar+nós.AD.1.PL+IMPF+1+SG
preceituava-nos	preceituar+nós.AD.1.PL+IMPF+2+SG
preceituava-nos	preceituar+nós.AD.1.PL+IMPF+3+SG
preceituava-o	preceituar+V.ele.ACC.3.M.SG+IMPF+1+SG
preceituava-o	preceituar+V.ele.ACC.3.M.SG+IMPF+3+SG
preceituava-os	preceituar+V.ele.ACC.3.M.PL+IMPF+1+SG
preceituava-os	preceituar+V.ele.ACC.3.M.PL+IMPF+3+SG
preceituava-se	preceituar+V.ele.REFL+IMPF+1+SG
preceituava-se	preceituar+V.ele.REFL+IMPF+3+SG
preceituavas-lhe	preceituar+V.ele.DAT.3.SG+IMPF+2+SG
preceituavas-lhes	preceituar+V.ele.DAT.3.PL+IMPF+2+SG
preceituavas-me	preceituar+V.eu.AD.1.SG+IMPF+2+SG
preceituavas-te	preceituar+V.tu.AD.2.SG+IMPF+2+SG
preceituavas-vos	preceituar+V.vós.AD.2.PL+IMPF+2+SG
preceituava-te	preceituar+V.tu.AD.2.SG+IMPF+1+SG
preceituava-te	preceituar+V.tu.AD.2.SG+IMPF+3+SG
preceituava-vos	preceituar+V.vós.AD.2.PL+IMPF+1+SG
preceituava-vos	preceituar+V.vós.AD.2.PL+IMPF+3+SG
preceituávei-la	preceituar+V.ele.ACC.3.F.SG+IMPF+2+PL
preceituávei-las	preceituar+V.ele.ACC.3.F.PL+IMPF+2+PL
preceituávei-lo	preceituar+V.ele.ACC.3.M.SG+IMPF+2+PL
preceituávei-los	preceituar+V.ele.ACC.3.M.PL+IMPF+2+PL
preceituávei-nos	preceituar+nós.AD.1.PL+IMPF+2+PL
preceituáveis-lhe	preceituar+V.ele.DAT.3.SG+IMPF+2+PL
preceituáveis-lhes	preceituar+V.ele.DAT.3.PL+IMPF+2+PL
preceituáveis-me	preceituar+V.eu.AD.1.SG+IMPF+2+PL
preceituáveis-te	preceituar+V.tu.AD.2.SG+IMPF+2+PL
preceituáveis-vos	preceituar+V.vós.AD.2.PL+IMPF+2+PL
preceitua-vos	preceituar+V.vós.AD.2.PL+PRS+3+SG
preceitue-a	preceituar+V.ele.ACC.3.F.SG+IMP+3+SG
preceitue-as	preceituar+V.ele.ACC.3.F.PL+IMP+3+SG
preceituei-a	preceituar+V.ele.ACC.3.F.SG+PRF+1+SG
preceituei-as	preceituar+V.ele.ACC.3.F.PL+PRF+1+SG
preceituei-lhe	preceituar+V.ele.DAT.3.SG+PRF+1+SG
preceituei-lhes	preceituar+V.ele.DAT.3.PL+PRF+1+SG
preceituei-me	preceituar+V.eu.AD.1.SG+PRF+1+SG
preceituei-nos	preceituar+nós.AD.1.PL+PRF+1+SG
preceituei-o	preceituar+V.ele.ACC.3.M.SG+PRF+1+SG
preceituei-os	preceituar+V.ele.ACC.3.M.PL+PRF+1+SG
preceituei-te	preceituar+V.tu.AD.2.SG+PRF+1+SG
preceituei-vos	preceituar+V.vós.AD.2.PL+PRF+1+SG
preceitue-lhe	preceituar+V.ele.DAT.3.SG+IMP+3+SG
preceitue-lhes	preceituar+V.ele.DAT.3.PL+IMP+3+SG
preceitue-me	preceituar+V.eu.AD.1.SG+IMP+3+SG
preceituem-lhe	preceituar+V.ele.DAT.3.SG+IMP+3+PL
preceituem-lhes	preceituar+V.ele.DAT.3.PL+IMP+3+PL
preceituem-me	preceituar+V.eu.AD.1.SG+IMP+3+PL
preceituem-na	preceituar+V.ele.ACC.3.F.SG+IMP+3+PL
preceituem-nas	preceituar+V.ele.ACC.3.F.PL+IMP+3+PL
preceituem-no	preceituar+V.ele.ACC.3.M.SG+IMP+3+PL
preceituem-nos	preceituar+V.ele.ACC.3.M.PL+IMP+3+PL
preceituem-nos	preceituar+V.nós.AD.1.PL+IMP+3+PL
preceituemo-la	preceituar+V.ele.ACC.3.F.SG+IMP+1+PL
preceituemo-las	preceituar+V.ele.ACC.3.F.PL+IMP+1+PL
preceituemo-lo	preceituar+V.ele.ACC.3.M.SG+IMP+1+PL
preceituemo-los	preceituar+V.ele.ACC.3.M.PL+IMP+1+PL
preceituemo-nos	preceituar+nós.AD.1.PL+IMP+1+PL
preceituemos-lhe	preceituar+V.ele.DAT.3.SG+IMP+1+PL
preceituemos-lhes	preceituar+V.ele.DAT.3.PL+IMP+1+PL
preceituemos-me	preceituar+V.eu.AD.1.SG+IMP+1+PL
preceituemos-te	preceituar+V.tu.AD.2.SG+IMP+1+PL
preceituemos-vos	preceituar+V.vós.AD.2.PL+IMP+1+PL
preceituem-se	preceituar+V.ele.REFL+IMP+3+PL
preceituem-te	preceituar+V.tu.AD.2.SG+IMP+3+PL
preceituem-vos	preceituar+V.vós.AD.2.PL+IMP+3+PL
preceitue-nos	preceituar+nós.AD.1.PL+IMP+3+SG
preceitue-o	preceituar+V.ele.ACC.3.M.SG+IMP+3+SG
preceitue-os	preceituar+V.ele.ACC.3.M.PL+IMP+3+SG
preceitue-se	preceituar+V.ele.REFL+IMP+3+SG
preceitue-te	preceituar+V.tu.AD.2.SG+IMP+3+SG
preceitue-vos	preceituar+V.vós.AD.2.PL+IMP+3+SG
preceituo-a	preceituar+V.ele.ACC.3.F.SG+PRS+1+SG
preceituo-as	preceituar+V.ele.ACC.3.F.PL+PRS+1+SG
preceituo-lhe	preceituar+V.ele.DAT.3.SG+PRS+1+SG
preceituo-lhes	preceituar+V.ele.DAT.3.PL+PRS+1+SG
preceituo-me	preceituar+V.eu.AD.1.SG+PRS+1+SG
preceituo-nos	preceituar+nós.AD.1.PL+PRS+1+SG
preceituo-o	preceituar+V.ele.ACC.3.M.SG+PRS+1+SG
preceituo-os	preceituar+V.ele.ACC.3.M.PL+PRS+1+SG
preceituo-te	preceituar+V.tu.AD.2.SG+PRS+1+SG
preceituou-a	preceituar+V.ele.ACC.3.F.SG+PRF+3+SG
preceituou-as	preceituar+V.ele.ACC.3.F.PL+PRF+3+SG
preceituou-lhe	preceituar+V.ele.DAT.3.SG+PRF+3+SG
preceituou-lhes	preceituar+V.ele.DAT.3.PL+PRF+3+SG
preceituou-me	preceituar+V.eu.AD.1.SG+PRF+3+SG
preceituou-nos	preceituar+nós.AD.1.PL+PRF+3+SG
preceituou-o	preceituar+V.ele.ACC.3.M.SG+PRF+3+SG
preceituou-os	preceituar+V.ele.ACC.3.M.PL+PRF+3+SG
preceituou-se	preceituar+V.ele.REFL+PRF+3+SG
preceituou-te	preceituar+V.tu.AD.2.SG+PRF+3+SG
preceituou-vos	preceituar+V.vós.AD.2.PL+PRF+3+SG
preceituo-vos	preceituar+V.vós.AD.2.PL+PRS+1+SG
precinge-a	precingir+V.ele.ACC.3.F.SG+PRS+3+SG
precinge-as	precingir+V.ele.ACC.3.F.PL+PRS+3+SG
precinge-la	precingir+V.ele.ACC.3.F.SG+PRS+2+SG
precinge-las	precingir+V.ele.ACC.3.F.PL+PRS+2+SG
precinge-lhe	precingir+V.ele.DAT.3.SG+PRS+3+SG
precinge-lhes	precingir+V.ele.DAT.3.PL+PRS+3+SG
precinge-lo	precingir+V.ele.ACC.3.M.SG+PRS+2+SG
precinge-los	precingir+V.ele.ACC.3.M.PL+PRS+2+SG
precinge-me	precingir+V.eu.AD.1.SG+PRS+3+SG
precingem-lhe	precingir+V.ele.DAT.3.SG+PRS+3+PL
precingem-lhes	precingir+V.ele.DAT.3.PL+PRS+3+PL
precingem-me	precingir+V.eu.AD.1.SG+PRS+3+PL
precingem-na	precingir+V.ele.ACC.3.F.SG+PRS+3+PL
precingem-nas	precingir+V.ele.ACC.3.F.PL+PRS+3+PL
precingem-no	precingir+V.ele.ACC.3.M.SG+PRS+3+PL
precingem-nos	precingir+V.ele.ACC.3.M.PL+PRS+3+PL
precingem-nos	precingir+V.nós.AD.1.PL+PRS+3+PL
precingem-se	precingir+V.ele.REFL+PRS+3+PL
precingem-te	precingir+V.tu.AD.2.SG+PRS+3+PL
precingem-vos	precingir+V.vós.AD.2.PL+PRS+3+PL
precinge-nos	precingir+nós.AD.1.PL+PRS+2+SG
precinge-nos	precingir+nós.AD.1.PL+PRS+3+SG
precinge-o	precingir+V.ele.ACC.3.M.SG+PRS+3+SG
precinge-os	precingir+V.ele.ACC.3.M.PL+PRS+3+SG
precinge-se	precingir+V.ele.REFL+PRS+3+SG
precinges-lhe	precingir+V.ele.DAT.3.SG+PRS+2+SG
precinges-lhes	precingir+V.ele.DAT.3.PL+PRS+2+SG
precinges-me	precingir+V.eu.AD.1.SG+PRS+2+SG
precinges-te	precingir+V.tu.AD.2.SG+PRS+2+SG
precinges-vos	precingir+V.vós.AD.2.PL+PRS+2+SG
precinge-te	precingir+V.tu.AD.2.SG+PRS+3+SG
precinge-vos	precingir+V.vós.AD.2.PL+PRS+3+SG
precingia-a	precingir+V.ele.ACC.3.F.SG+IMPF+1+SG
precingia-a	precingir+V.ele.ACC.3.F.SG+IMPF+3+SG
precingia-as	precingir+V.ele.ACC.3.F.PL+IMPF+1+SG
precingia-as	precingir+V.ele.ACC.3.F.PL+IMPF+3+SG
precingia-la	precingir+V.ele.ACC.3.F.SG+IMPF+2+SG
precingia-las	precingir+V.ele.ACC.3.F.PL+IMPF+2+SG
precingia-lhe	precingir+V.ele.DAT.3.SG+IMPF+1+SG
precingia-lhe	precingir+V.ele.DAT.3.SG+IMPF+3+SG
precingia-lhes	precingir+V.ele.DAT.3.PL+IMPF+1+SG
precingia-lhes	precingir+V.ele.DAT.3.PL+IMPF+3+SG
precingia-lo	precingir+V.ele.ACC.3.M.SG+IMPF+2+SG
precingia-los	precingir+V.ele.ACC.3.M.PL+IMPF+2+SG
precingia-me	precingir+V.eu.AD.1.SG+IMPF+1+SG
precingia-me	precingir+V.eu.AD.1.SG+IMPF+3+SG
precingiam-lhe	precingir+V.ele.DAT.3.SG+IMPF+3+PL
precingiam-lhes	precingir+V.ele.DAT.3.PL+IMPF+3+PL
precingiam-me	precingir+V.eu.AD.1.SG+IMPF+3+PL
precingiam-na	precingir+V.ele.ACC.3.F.SG+IMPF+3+PL
precingiam-nas	precingir+V.ele.ACC.3.F.PL+IMPF+3+PL
precingiam-no	precingir+V.ele.ACC.3.M.SG+IMPF+3+PL
precingiam-nos	precingir+V.ele.ACC.3.M.PL+IMPF+3+PL
precingiam-nos	precingir+V.nós.AD.1.PL+IMPF+3+PL
precingíamo-la	precingir+V.ele.ACC.3.F.SG+IMPF+1+PL
precingíamo-las	precingir+V.ele.ACC.3.F.PL+IMPF+1+PL
precingíamo-lo	precingir+V.ele.ACC.3.M.SG+IMPF+1+PL
precingíamo-los	precingir+V.ele.ACC.3.M.PL+IMPF+1+PL
precingíamo-nos	precingir+nós.AD.1.PL+IMPF+1+PL
precingíamos-lhe	precingir+V.ele.DAT.3.SG+IMPF+1+PL
precingíamos-lhes	precingir+V.ele.DAT.3.PL+IMPF+1+PL
precingíamos-me	precingir+V.eu.AD.1.SG+IMPF+1+PL
precingíamos-te	precingir+V.tu.AD.2.SG+IMPF+1+PL
precingíamos-vos	precingir+V.vós.AD.2.PL+IMPF+1+PL
precingiam-se	precingir+V.ele.REFL+IMPF+3+PL
precingiam-te	precingir+V.tu.AD.2.SG+IMPF+3+PL
precingiam-vos	precingir+V.vós.AD.2.PL+IMPF+3+PL
precingia-nos	precingir+nós.AD.1.PL+IMPF+1+SG
precingia-nos	precingir+nós.AD.1.PL+IMPF+2+SG
precingia-nos	precingir+nós.AD.1.PL+IMPF+3+SG
precingia-o	precingir+V.ele.ACC.3.M.SG+IMPF+1+SG
precingia-o	precingir+V.ele.ACC.3.M.SG+IMPF+3+SG
precingia-os	precingir+V.ele.ACC.3.M.PL+IMPF+1+SG
precingia-os	precingir+V.ele.ACC.3.M.PL+IMPF+3+SG
precingi-a	precingir+V.ele.ACC.3.F.SG+PRF+1+SG
precingia-se	precingir+V.ele.REFL+IMPF+3+SG
precingias-lhe	precingir+V.ele.DAT.3.SG+IMPF+2+SG
precingias-lhes	precingir+V.ele.DAT.3.PL+IMPF+2+SG
precingias-me	precingir+V.eu.AD.1.SG+IMPF+2+SG
precingi-as	precingir+V.ele.ACC.3.F.PL+PRF+1+SG
precingias-te	precingir+V.tu.AD.2.SG+IMPF+2+SG
precingias-vos	precingir+V.vós.AD.2.PL+IMPF+2+SG
precingia-te	precingir+V.tu.AD.2.SG+IMPF+1+SG
precingia-te	precingir+V.tu.AD.2.SG+IMPF+3+SG
precingia-vos	precingir+V.vós.AD.2.PL+IMPF+1+SG
precingia-vos	precingir+V.vós.AD.2.PL+IMPF+3+SG
precingíei-la	precingir+V.ele.ACC.3.F.SG+IMPF+2+PL
precingíei-las	precingir+V.ele.ACC.3.F.PL+IMPF+2+PL
precingíei-lo	precingir+V.ele.ACC.3.M.SG+IMPF+2+PL
precingíei-los	precingir+V.ele.ACC.3.M.PL+IMPF+2+PL
precingíei-nos	precingir+nós.AD.1.PL+IMPF+2+PL
precingíeis-lhe	precingir+V.ele.DAT.3.SG+IMPF+2+PL
precingíeis-lhes	precingir+V.ele.DAT.3.PL+IMPF+2+PL
precingíeis-me	precingir+V.eu.AD.1.SG+IMPF+2+PL
precingíeis-te	precingir+V.tu.AD.2.SG+IMPF+2+PL
precingíeis-vos	precingir+V.vós.AD.2.PL+IMPF+2+PL
precingi-la-ão	precingir+V.ele.ACC.3.F.SG+FUT+3+PL
precingi-la-á	precingir+V.ele.ACC.3.F.SG+FUT+3+SG
precingi-la-ás	precingir+V.ele.ACC.3.F.SG+FUT+2+SG
precingi-la-ei	precingir+V.ele.ACC.3.F.SG+FUT+1+SG
precingi-la-eis	precingir+V.ele.ACC.3.F.SG+FUT+2+PL
precingi-la-emos	precingir+V.ele.ACC.3.F.SG+FUT+1+PL
precingi-la-íamos	precingir+V.ele.ACC.3.F.SG+COND+1+PL
precingi-la-iam	precingir+V.ele.ACC.3.F.SG+COND+3+PL
precingi-la-ia	precingir+V.ele.ACC.3.F.SG+COND+1+SG
precingi-la-ia	precingir+V.ele.ACC.3.F.SG+COND+3+SG
precingi-la-ias	precingir+V.ele.ACC.3.F.SG+COND+2+SG
precingi-la-íeis	precingir+V.ele.ACC.3.F.SG+COND+2+PL
precingi-la	precingir+V.ele.ACC.3.F.SG+INF+1+SG
precingi-la	precingir+V.ele.ACC.3.F.SG+INF+3+SG
precingi-la	precingir+V.ele.ACC.3.F.SG+PRS+2+PL
precingi-la	precingir+V.ele.ACC.3.F.SG+SBJF+1+SG
precingi-la	precingir+V.ele.ACC.3.F.SG+SBJF+3+SG
precingi-las-ão	precingir+V.ele.ACC.3.F.PL+FUT+3+PL
precingi-las-á	precingir+V.ele.ACC.3.F.PL+FUT+3+SG
precingi-las-ás	precingir+V.ele.ACC.3.F.PL+FUT+2+SG
precingi-las-ei	precingir+V.ele.ACC.3.F.PL+FUT+1+SG
precingi-las-eis	precingir+V.ele.ACC.3.F.PL+FUT+2+PL
precingi-las-emos	precingir+V.ele.ACC.3.F.PL+FUT+1+PL
precingi-las-íamos	precingir+V.ele.ACC.3.F.PL+COND+1+PL
precingi-las-iam	precingir+V.ele.ACC.3.F.PL+COND+3+PL
precingi-las-ia	precingir+V.ele.ACC.3.F.PL+COND+1+SG
precingi-las-ia	precingir+V.ele.ACC.3.F.PL+COND+3+SG
precingi-las-ias	precingir+V.ele.ACC.3.F.PL+COND+2+SG
precingi-las-íeis	precingir+V.ele.ACC.3.F.PL+COND+2+PL
precingi-las	precingir+V.ele.ACC.3.F.PL+INF+1+SG
precingi-las	precingir+V.ele.ACC.3.F.PL+INF+3+SG
precingi-las	precingir+V.ele.ACC.3.F.PL+PRS+2+PL
precingi-las	precingir+V.ele.ACC.3.F.PL+SBJF+1+SG
precingi-las	precingir+V.ele.ACC.3.F.PL+SBJF+3+SG
precingi-lhe	precingir+V.ele.DAT.3.SG+PRF+1+SG
precingi-lhes	precingir+V.ele.DAT.3.PL+PRF+1+SG
precingi-lo-ão	precingir+V.ele.ACC.3.M.SG+FUT+3+PL
precingi-lo-á	precingir+V.ele.ACC.3.M.SG+FUT+3+SG
precingi-lo-ás	precingir+V.ele.ACC.3.M.SG+FUT+2+SG
precingi-lo-ei	precingir+V.ele.ACC.3.M.SG+FUT+1+SG
precingi-lo-eis	precingir+V.ele.ACC.3.M.SG+FUT+2+PL
precingi-lo-emos	precingir+V.ele.ACC.3.M.SG+FUT+1+PL
precingi-lo-íamos	precingir+V.ele.ACC.3.M.SG+COND+1+PL
precingi-lo-iam	precingir+V.ele.ACC.3.M.SG+COND+3+PL
precingi-lo-ia	precingir+V.ele.ACC.3.M.SG+COND+1+SG
precingi-lo-ia	precingir+V.ele.ACC.3.M.SG+COND+3+SG
precingi-lo-ias	precingir+V.ele.ACC.3.M.SG+COND+2+SG
precingi-lo-íeis	precingir+V.ele.ACC.3.M.SG+COND+2+PL
precingi-lo	precingir+V.ele.ACC.3.M.SG+INF+1+SG
precingi-lo	precingir+V.ele.ACC.3.M.SG+INF+3+SG
precingi-lo	precingir+V.ele.ACC.3.M.SG+PRS+2+PL
precingi-lo	precingir+V.ele.ACC.3.M.SG+SBJF+1+SG
precingi-lo	precingir+V.ele.ACC.3.M.SG+SBJF+3+SG
precingi-los-ão	precingir+V.ele.ACC.3.M.PL+FUT+3+PL
precingi-los-á	precingir+V.ele.ACC.3.M.PL+FUT+3+SG
precingi-los-ás	precingir+V.ele.ACC.3.M.PL+FUT+2+SG
precingi-los-ei	precingir+V.ele.ACC.3.M.PL+FUT+1+SG
precingi-los-eis	precingir+V.ele.ACC.3.M.PL+FUT+2+PL
precingi-los-emos	precingir+V.ele.ACC.3.M.PL+FUT+1+PL
precingi-los-íamos	precingir+V.ele.ACC.3.M.PL+COND+1+PL
precingi-los-iam	precingir+V.ele.ACC.3.M.PL+COND+3+PL
precingi-los-ia	precingir+V.ele.ACC.3.M.PL+COND+1+SG
precingi-los-ia	precingir+V.ele.ACC.3.M.PL+COND+3+SG
precingi-los-ias	precingir+V.ele.ACC.3.M.PL+COND+2+SG
precingi-los-íeis	precingir+V.ele.ACC.3.M.PL+COND+2+PL
precingi-los	precingir+V.ele.ACC.3.M.PL+INF+1+SG
precingi-los	precingir+V.ele.ACC.3.M.PL+INF+3+SG
precingi-los	precingir+V.ele.ACC.3.M.PL+PRS+2+PL
precingi-los	precingir+V.ele.ACC.3.M.PL+SBJF+1+SG
precingi-los	precingir+V.ele.ACC.3.M.PL+SBJF+3+SG
precingi-me	precingir+V.eu.AD.1.SG+PRF+1+SG
precingimo-la	precingir+V.ele.ACC.3.F.SG+PRF+1+PL
precingimo-la	precingir+V.ele.ACC.3.F.SG+PRS+1+PL
precingimo-las	precingir+V.ele.ACC.3.F.PL+PRF+1+PL
precingimo-las	precingir+V.ele.ACC.3.F.PL+PRS+1+PL
precingimo-lo	precingir+V.ele.ACC.3.M.SG+PRF+1+PL
precingimo-lo	precingir+V.ele.ACC.3.M.SG+PRS+1+PL
precingimo-los	precingir+V.ele.ACC.3.M.PL+PRF+1+PL
precingimo-los	precingir+V.ele.ACC.3.M.PL+PRS+1+PL
precingimo-nos	precingir+nós.AD.1.PL+PRF+1+PL
precingimo-nos	precingir+nós.AD.1.PL+PRS+1+PL
precingimos-lhe	precingir+V.ele.DAT.3.SG+PRF+1+PL
precingimos-lhe	precingir+V.ele.DAT.3.SG+PRS+1+PL
precingimos-lhes	precingir+V.ele.DAT.3.PL+PRF+1+PL
precingimos-lhes	precingir+V.ele.DAT.3.PL+PRS+1+PL
precingimos-me	precingir+V.eu.AD.1.SG+PRF+1+PL
precingimos-me	precingir+V.eu.AD.1.SG+PRS+1+PL
precingimos-te	precingir+V.tu.AD.2.SG+PRF+1+PL
precingimos-te	precingir+V.tu.AD.2.SG+PRS+1+PL
precingimos-vos	precingir+V.vós.AD.2.PL+PRF+1+PL
precingimos-vos	precingir+V.vós.AD.2.PL+PRS+1+PL
precingindo-a	precingir+V.ele.ACC.3.F.SG+GRD
precingindo-as	precingir+V.ele.ACC.3.F.PL+GRD
precingindo-lhe	precingir+V.ele.DAT.3.SG+GRD
precingindo-lhes	precingir+V.ele.DAT.3.PL+GRD
precingindo-me	precingir+V.eu.AD.1.SG+GRD
precingindo-nos	precingir+nós.AD.1.PL+GRD
precingindo-o	precingir+V.ele.ACC.3.M.SG+GRD
precingindo-os	precingir+V.ele.ACC.3.M.PL+GRD
precingindo-se	precingir+V.ele.REFL+GRD
precingindo-te	precingir+V.tu.AD.2.SG+GRD
precingindo-vos	precingir+V.vós.AD.2.PL+GRD
precingi-nos	precingir+nós.AD.1.PL+PRF+1+SG
precingi-nos	precingir+nós.AD.1.PL+PRS+2+PL
precingi-o	precingir+V.ele.ACC.3.M.SG+PRF+1+SG
precingi-os	precingir+V.ele.ACC.3.M.PL+PRF+1+SG
precingiram-lhe	precingir+V.ele.DAT.3.SG+PRF+3+PL
precingiram-lhes	precingir+V.ele.DAT.3.PL+PRF+3+PL
precingiram-me	precingir+V.eu.AD.1.SG+PRF+3+PL
precingiram-na	precingir+V.ele.ACC.3.F.SG+PRF+3+PL
precingiram-nas	precingir+V.ele.ACC.3.F.PL+PRF+3+PL
precingiram-no	precingir+V.ele.ACC.3.M.SG+PRF+3+PL
precingiram-nos	precingir+V.ele.ACC.3.M.PL+PRF+3+PL
precingiram-nos	precingir+V.nós.AD.1.PL+PRF+3+PL
precingiram-se	precingir+V.ele.REFL+PRF+3+PL
precingiram-te	precingir+V.tu.AD.2.SG+PRF+3+PL
precingiram-vos	precingir+V.vós.AD.2.PL+PRF+3+PL
precingirde-la	precingir+V.ele.ACC.3.F.SG+INF+2+PL
precingirde-la	precingir+V.ele.ACC.3.F.SG+SBJF+2+PL
precingirde-las	precingir+V.ele.ACC.3.F.PL+INF+2+PL
precingirde-las	precingir+V.ele.ACC.3.F.PL+SBJF+2+PL
precingirde-lo	precingir+V.ele.ACC.3.M.SG+INF+2+PL
precingirde-lo	precingir+V.ele.ACC.3.M.SG+SBJF+2+PL
precingirde-los	precingir+V.ele.ACC.3.M.PL+INF+2+PL
precingirde-los	precingir+V.ele.ACC.3.M.PL+SBJF+2+PL
precingirde-nos	precingir+nós.AD.1.PL+INF+2+PL
precingirde-nos	precingir+nós.AD.1.PL+SBJF+2+PL
precingirdes-lhe	precingir+V.ele.DAT.3.SG+INF+2+PL
precingirdes-lhe	precingir+V.ele.DAT.3.SG+SBJF+2+PL
precingirdes-lhes	precingir+V.ele.DAT.3.PL+INF+2+PL
precingirdes-lhes	precingir+V.ele.DAT.3.PL+SBJF+2+PL
precingirdes-me	precingir+V.eu.AD.1.SG+INF+2+PL
precingirdes-me	precingir+V.eu.AD.1.SG+SBJF+2+PL
precingirdes-te	precingir+V.tu.AD.2.SG+INF+2+PL
precingirdes-te	precingir+V.tu.AD.2.SG+SBJF+2+PL
precingirdes-vos	precingir+V.vós.AD.2.PL+INF+2+PL
precingirdes-vos	precingir+V.vós.AD.2.PL+SBJF+2+PL
precingire-la	precingir+V.ele.ACC.3.F.SG+INF+2+SG
precingire-la	precingir+V.ele.ACC.3.F.SG+SBJF+2+SG
precingire-las	precingir+V.ele.ACC.3.F.PL+INF+2+SG
precingire-las	precingir+V.ele.ACC.3.F.PL+SBJF+2+SG
precingire-lo	precingir+V.ele.ACC.3.M.SG+INF+2+SG
precingire-lo	precingir+V.ele.ACC.3.M.SG+SBJF+2+SG
precingire-los	precingir+V.ele.ACC.3.M.PL+INF+2+SG
precingire-los	precingir+V.ele.ACC.3.M.PL+SBJF+2+SG
precingirem-lhe	precingir+V.ele.DAT.3.SG+INF+3+PL
precingirem-lhe	precingir+V.ele.DAT.3.SG+SBJF+3+PL
precingirem-lhes	precingir+V.ele.DAT.3.PL+INF+3+PL
precingirem-lhes	precingir+V.ele.DAT.3.PL+SBJF+3+PL
precingirem-me	precingir+V.eu.AD.1.SG+INF+3+PL
precingirem-me	precingir+V.eu.AD.1.SG+SBJF+3+PL
precingirem-na	precingir+V.ele.ACC.3.F.SG+INF+3+PL
precingirem-na	precingir+V.ele.ACC.3.F.SG+SBJF+3+PL
precingirem-nas	precingir+V.ele.ACC.3.F.PL+INF+3+PL
precingirem-nas	precingir+V.ele.ACC.3.F.PL+SBJF+3+PL
precingirem-no	precingir+V.ele.ACC.3.M.SG+INF+3+PL
precingirem-no	precingir+V.ele.ACC.3.M.SG+SBJF+3+PL
precingirem-nos	precingir+V.ele.ACC.3.M.PL+INF+3+PL
precingirem-nos	precingir+V.ele.ACC.3.M.PL+SBJF+3+PL
precingirem-nos	precingir+V.nós.AD.1.PL+INF+3+PL
precingirem-nos	precingir+V.nós.AD.1.PL+SBJF+3+PL
precingirem-se	precingir+V.ele.REFL+INF+3+PL
precingirem-se	precingir+V.ele.REFL+SBJF+3+PL
precingirem-te	precingir+V.tu.AD.2.SG+INF+3+PL
precingirem-te	precingir+V.tu.AD.2.SG+SBJF+3+PL
precingirem-vos	precingir+V.vós.AD.2.PL+INF+3+PL
precingirem-vos	precingir+V.vós.AD.2.PL+SBJF+3+PL
precingire-nos	precingir+nós.AD.1.PL+INF+2+SG
precingire-nos	precingir+nós.AD.1.PL+SBJF+2+SG
precingires-lhe	precingir+V.ele.DAT.3.SG+INF+2+SG
precingires-lhe	precingir+V.ele.DAT.3.SG+SBJF+2+SG
precingires-lhes	precingir+V.ele.DAT.3.PL+INF+2+SG
precingires-lhes	precingir+V.ele.DAT.3.PL+SBJF+2+SG
precingires-me	precingir+V.eu.AD.1.SG+INF+2+SG
precingires-me	precingir+V.eu.AD.1.SG+SBJF+2+SG
precingires-te	precingir+V.tu.AD.2.SG+INF+2+SG
precingires-te	precingir+V.tu.AD.2.SG+SBJF+2+SG
precingires-vos	precingir+V.vós.AD.2.PL+INF+2+SG
precingires-vos	precingir+V.vós.AD.2.PL+SBJF+2+SG
precingir-lhe-ão	precingir+V.ele.DAT.3.SG+FUT+3+PL
precingir-lhe-á	precingir+V.ele.DAT.3.SG+FUT+3+SG
precingir-lhe-ás	precingir+V.ele.DAT.3.SG+FUT+2+SG
precingir-lhe-ei	precingir+V.ele.DAT.3.SG+FUT+1+SG
precingir-lhe-eis	precingir+V.ele.DAT.3.SG+FUT+2+PL
precingir-lhe-emos	precingir+V.ele.DAT.3.SG+FUT+1+PL
precingir-lhe-íamos	precingir+V.ele.DAT.3.SG+COND+1+PL
precingir-lhe-iam	precingir+V.ele.DAT.3.SG+COND+3+PL
precingir-lhe-ia	precingir+V.ele.DAT.3.SG+COND+1+SG
precingir-lhe-ia	precingir+V.ele.DAT.3.SG+COND+3+SG
precingir-lhe-ias	precingir+V.ele.DAT.3.SG+COND+2+SG
precingir-lhe-íeis	precingir+V.ele.DAT.3.SG+COND+2+PL
precingir-lhe	precingir+V.ele.DAT.3.SG+INF
precingir-lhe	precingir+V.ele.DAT.3.SG+INF+1+SG
precingir-lhe	precingir+V.ele.DAT.3.SG+INF+3+SG
precingir-lhe	precingir+V.ele.DAT.3.SG+SBJF+1+SG
precingir-lhe	precingir+V.ele.DAT.3.SG+SBJF+3+SG
precingir-lhes-ão	precingir+V.ele.DAT.3.PL+FUT+3+PL
precingir-lhes-á	precingir+V.ele.DAT.3.PL+FUT+3+SG
precingir-lhes-ás	precingir+V.ele.DAT.3.PL+FUT+2+SG
precingir-lhes-ei	precingir+V.ele.DAT.3.PL+FUT+1+SG
precingir-lhes-eis	precingir+V.ele.DAT.3.PL+FUT+2+PL
precingir-lhes-emos	precingir+V.ele.DAT.3.PL+FUT+1+PL
precingir-lhes-íamos	precingir+V.ele.DAT.3.PL+COND+1+PL
precingir-lhes-iam	precingir+V.ele.DAT.3.PL+COND+3+PL
precingir-lhes-ia	precingir+V.ele.DAT.3.PL+COND+1+SG
precingir-lhes-ia	precingir+V.ele.DAT.3.PL+COND+3+SG
precingir-lhes-ias	precingir+V.ele.DAT.3.PL+COND+2+SG
precingir-lhes-íeis	precingir+V.ele.DAT.3.PL+COND+2+PL
precingir-lhes	precingir+V.ele.DAT.3.PL+INF
precingir-lhes	precingir+V.ele.DAT.3.PL+INF+1+SG
precingir-lhes	precingir+V.ele.DAT.3.PL+INF+3+SG
precingir-lhes	precingir+V.ele.DAT.3.PL+SBJF+1+SG
precingir-lhes	precingir+V.ele.DAT.3.PL+SBJF+3+SG
precingir-me-ão	precingir+V.eu.AD.1.SG+FUT+3+PL
precingir-me-á	precingir+V.eu.AD.1.SG+FUT+3+SG
precingir-me-ás	precingir+V.eu.AD.1.SG+FUT+2+SG
precingir-me-ei	precingir+V.eu.AD.1.SG+FUT+1+SG
precingir-me-eis	precingir+V.eu.AD.1.SG+FUT+2+PL
precingir-me-emos	precingir+V.eu.AD.1.SG+FUT+1+PL
precingir-me-íamos	precingir+V.eu.AD.1.SG+COND+1+PL
precingir-me-iam	precingir+V.eu.AD.1.SG+COND+3+PL
precingir-me-ia	precingir+V.eu.AD.1.SG+COND+1+SG
precingir-me-ia	precingir+V.eu.AD.1.SG+COND+3+SG
precingir-me-ias	precingir+V.eu.AD.1.SG+COND+2+SG
precingir-me-íeis	precingir+V.eu.AD.1.SG+COND+2+PL
precingir-me	precingir+V.eu.AD.1.SG+INF
precingir-me	precingir+V.eu.AD.1.SG+INF+1+SG
precingir-me	precingir+V.eu.AD.1.SG+INF+3+SG
precingir-me	precingir+V.eu.AD.1.SG+SBJF+1+SG
precingir-me	precingir+V.eu.AD.1.SG+SBJF+3+SG
precingirmo-la	precingir+V.ele.ACC.3.F.SG+INF+1+PL
precingirmo-la	precingir+V.ele.ACC.3.F.SG+SBJF+1+PL
precingirmo-las	precingir+V.ele.ACC.3.F.PL+INF+1+PL
precingirmo-las	precingir+V.ele.ACC.3.F.PL+SBJF+1+PL
precingirmo-lo	precingir+V.ele.ACC.3.M.SG+INF+1+PL
precingirmo-lo	precingir+V.ele.ACC.3.M.SG+SBJF+1+PL
precingirmo-los	precingir+V.ele.ACC.3.M.PL+INF+1+PL
precingirmo-los	precingir+V.ele.ACC.3.M.PL+SBJF+1+PL
precingirmo-nos	precingir+nós.AD.1.PL+INF+1+PL
precingirmo-nos	precingir+nós.AD.1.PL+SBJF+1+PL
precingirmos-lhe	precingir+V.ele.DAT.3.SG+INF+1+PL
precingirmos-lhe	precingir+V.ele.DAT.3.SG+SBJF+1+PL
precingirmos-lhes	precingir+V.ele.DAT.3.PL+INF+1+PL
precingirmos-lhes	precingir+V.ele.DAT.3.PL+SBJF+1+PL
precingirmos-me	precingir+V.eu.AD.1.SG+INF+1+PL
precingirmos-me	precingir+V.eu.AD.1.SG+SBJF+1+PL
precingirmos-te	precingir+V.tu.AD.2.SG+INF+1+PL
precingirmos-te	precingir+V.tu.AD.2.SG+SBJF+1+PL
precingirmos-vos	precingir+V.vós.AD.2.PL+INF+1+PL
precingirmos-vos	precingir+V.vós.AD.2.PL+SBJF+1+PL
precingir-nos-ão	precingir+nós.AD.1.PL+FUT+3+PL
precingir-nos-á	precingir+nós.AD.1.PL+FUT+3+SG
precingir-nos-ás	precingir+nós.AD.1.PL+FUT+2+SG
precingir-nos-ei	precingir+nós.AD.1.PL+FUT+1+SG
precingir-nos-eis	precingir+nós.AD.1.PL+FUT+2+PL
precingir-nos-emos	precingir+nós.AD.1.PL+FUT+1+PL
precingir-nos-íamos	precingir+nós.AD.1.PL+COND+1+PL
precingir-nos-iam	precingir+nós.AD.1.PL+COND+3+PL
precingir-nos-ia	precingir+nós.AD.1.PL+COND+1+SG
precingir-nos-ia	precingir+nós.AD.1.PL+COND+3+SG
precingir-nos-ias	precingir+nós.AD.1.PL+COND+2+SG
precingir-nos-íeis	precingir+nós.AD.1.PL+COND+2+PL
precingir-nos	precingir+nós.AD.1.PL+INF
precingir-nos	precingir+nós.AD.1.PL+INF+1+SG
precingir-nos	precingir+nós.AD.1.PL+INF+3+SG
precingir-nos	precingir+nós.AD.1.PL+SBJF+1+SG
precingir-nos	precingir+nós.AD.1.PL+SBJF+3+SG
precingir-se-ão	precingir+V.ele.REFL+FUT+3+PL
precingir-se-á	precingir+V.ele.REFL+FUT+3+SG
precingir-se-iam	precingir+V.ele.REFL+COND+3+PL
precingir-se-ia	precingir+V.ele.REFL+COND+3+SG
precingir-se	precingir+V.ele.REFL+INF
precingir-se	precingir+V.ele.REFL+INF+3+SG
precingir-se	precingir+V.ele.REFL+SBJF+3+SG
precingir-te-ão	precingir+V.tu.AD.2.SG+FUT+3+PL
precingir-te-á	precingir+V.tu.AD.2.SG+FUT+3+SG
precingir-te-ás	precingir+V.tu.AD.2.SG+FUT+2+SG
precingir-te-ei	precingir+V.tu.AD.2.SG+FUT+1+SG
precingir-te-eis	precingir+V.tu.AD.2.SG+FUT+2+PL
precingir-te-emos	precingir+V.tu.AD.2.SG+FUT+1+PL
precingir-te-íamos	precingir+V.tu.AD.2.SG+COND+1+PL
precingir-te-iam	precingir+V.tu.AD.2.SG+COND+3+PL
precingir-te-ia	precingir+V.tu.AD.2.SG+COND+1+SG
precingir-te-ia	precingir+V.tu.AD.2.SG+COND+3+SG
precingir-te-ias	precingir+V.tu.AD.2.SG+COND+2+SG
precingir-te-íeis	precingir+V.tu.AD.2.SG+COND+2+PL
precingir-te	precingir+V.tu.AD.2.SG+INF
precingir-te	precingir+V.tu.AD.2.SG+INF+1+SG
precingir-te	precingir+V.tu.AD.2.SG+INF+3+SG
precingir-te	precingir+V.tu.AD.2.SG+SBJF+1+SG
precingir-te	precingir+V.tu.AD.2.SG+SBJF+3+SG
precingir-vos-ão	precingir+V.vós.AD.2.PL+FUT+3+PL
precingir-vos-á	precingir+V.vós.AD.2.PL+FUT+3+SG
precingir-vos-ás	precingir+V.vós.AD.2.PL+FUT+2+SG
precingir-vos-ei	precingir+V.vós.AD.2.PL+FUT+1+SG
precingir-vos-eis	precingir+V.vós.AD.2.PL+FUT+2+PL
precingir-vos-emos	precingir+V.vós.AD.2.PL+FUT+1+PL
precingir-vos-íamos	precingir+V.vós.AD.2.PL+COND+1+PL
precingir-vos-iam	precingir+V.vós.AD.2.PL+COND+3+PL
precingir-vos-ia	precingir+V.vós.AD.2.PL+COND+1+SG
precingir-vos-ia	precingir+V.vós.AD.2.PL+COND+3+SG
precingir-vos-ias	precingir+V.vós.AD.2.PL+COND+2+SG
precingir-vos-íeis	precingir+V.vós.AD.2.PL+COND+2+PL
precingir-vos	precingir+V.vós.AD.2.PL+INF
precingir-vos	precingir+V.vós.AD.2.PL+INF+1+SG
precingir-vos	precingir+V.vós.AD.2.PL+INF+3+SG
precingir-vos	precingir+V.vós.AD.2.PL+SBJF+1+SG
precingir-vos	precingir+V.vós.AD.2.PL+SBJF+3+SG
precingis-lhe	precingir+V.ele.DAT.3.SG+PRS+2+PL
precingis-lhes	precingir+V.ele.DAT.3.PL+PRS+2+PL
precingis-me	precingir+V.eu.AD.1.SG+PRS+2+PL
precingiste-a	precingir+V.ele.ACC.3.F.SG+PRF+2+SG
precingiste-as	precingir+V.ele.ACC.3.F.PL+PRF+2+SG
precingiste-la	precingir+V.ele.ACC.3.F.SG+PRF+2+PL
precingiste-las	precingir+V.ele.ACC.3.F.PL+PRF+2+PL
precingiste-lhe	precingir+V.ele.DAT.3.SG+PRF+2+SG
precingiste-lhes	precingir+V.ele.DAT.3.PL+PRF+2+SG
precingiste-lo	precingir+V.ele.ACC.3.M.SG+PRF+2+PL
precingiste-los	precingir+V.ele.ACC.3.M.PL+PRF+2+PL
precingiste-me	precingir+V.eu.AD.1.SG+PRF+2+SG
precingiste-nos	precingir+nós.AD.1.PL+PRF+2+PL
precingiste-nos	precingir+nós.AD.1.PL+PRF+2+SG
precingiste-o	precingir+V.ele.ACC.3.M.SG+PRF+2+SG
precingiste-os	precingir+V.ele.ACC.3.M.PL+PRF+2+SG
precingis-te	precingir+V.tu.AD.2.SG+PRS+2+PL
precingistes-lhe	precingir+V.ele.DAT.3.SG+PRF+2+PL
precingistes-lhes	precingir+V.ele.DAT.3.PL+PRF+2+PL
precingistes-me	precingir+V.eu.AD.1.SG+PRF+2+PL
precingistes-te	precingir+V.tu.AD.2.SG+PRF+2+PL
precingistes-vos	precingir+V.vós.AD.2.PL+PRF+2+PL
precingiste-te	precingir+V.tu.AD.2.SG+PRF+2+SG
precingiste-vos	precingir+V.vós.AD.2.PL+PRF+2+SG
precingis-vos	precingir+V.vós.AD.2.PL+PRS+2+PL
precingi-te	precingir+V.tu.AD.2.SG+PRF+1+SG
precingiu-a	precingir+V.ele.ACC.3.F.SG+PRF+3+SG
precingiu-as	precingir+V.ele.ACC.3.F.PL+PRF+3+SG
precingiu-lhe	precingir+V.ele.DAT.3.SG+PRF+3+SG
precingiu-lhes	precingir+V.ele.DAT.3.PL+PRF+3+SG
precingiu-me	precingir+V.eu.AD.1.SG+PRF+3+SG
precingiu-nos	precingir+nós.AD.1.PL+PRF+3+SG
precingiu-o	precingir+V.ele.ACC.3.M.SG+PRF+3+SG
precingiu-os	precingir+V.ele.ACC.3.M.PL+PRF+3+SG
precingiu-se	precingir+V.ele.REFL+PRF+3+SG
precingiu-te	precingir+V.tu.AD.2.SG+PRF+3+SG
precingiu-vos	precingir+V.vós.AD.2.PL+PRF+3+SG
precingi-vos	precingir+V.vós.AD.2.PL+PRF+1+SG
precinja-a	precingir+V.ele.ACC.3.F.SG+IMP+3+SG
precinja-as	precingir+V.ele.ACC.3.F.PL+IMP+3+SG
precinja-lhe	precingir+V.ele.DAT.3.SG+IMP+3+SG
precinja-lhes	precingir+V.ele.DAT.3.PL+IMP+3+SG
precinja-me	precingir+V.eu.AD.1.SG+IMP+3+SG
precinjam-lhe	precingir+V.ele.DAT.3.SG+IMP+3+PL
precinjam-lhes	precingir+V.ele.DAT.3.PL+IMP+3+PL
precinjam-me	precingir+V.eu.AD.1.SG+IMP+3+PL
precinjam-na	precingir+V.ele.ACC.3.F.SG+IMP+3+PL
precinjam-nas	precingir+V.ele.ACC.3.F.PL+IMP+3+PL
precinjam-no	precingir+V.ele.ACC.3.M.SG+IMP+3+PL
precinjam-nos	precingir+V.ele.ACC.3.M.PL+IMP+3+PL
precinjam-nos	precingir+V.nós.AD.1.PL+IMP+3+PL
precinjamo-la	precingir+V.ele.ACC.3.F.SG+IMP+1+PL
precinjamo-las	precingir+V.ele.ACC.3.F.PL+IMP+1+PL
precinjamo-lo	precingir+V.ele.ACC.3.M.SG+IMP+1+PL
precinjamo-los	precingir+V.ele.ACC.3.M.PL+IMP+1+PL
precinjamo-nos	precingir+nós.AD.1.PL+IMP+1+PL
precinjamos-lhe	precingir+V.ele.DAT.3.SG+IMP+1+PL
precinjamos-lhes	precingir+V.ele.DAT.3.PL+IMP+1+PL
precinjamos-me	precingir+V.eu.AD.1.SG+IMP+1+PL
precinjamos-te	precingir+V.tu.AD.2.SG+IMP+1+PL
precinjamos-vos	precingir+V.vós.AD.2.PL+IMP+1+PL
precinjam-se	precingir+V.ele.REFL+IMP+3+PL
precinjam-te	precingir+V.tu.AD.2.SG+IMP+3+PL
precinjam-vos	precingir+V.vós.AD.2.PL+IMP+3+PL
precinja-nos	precingir+nós.AD.1.PL+IMP+3+SG
precinja-o	precingir+V.ele.ACC.3.M.SG+IMP+3+SG
precinja-os	precingir+V.ele.ACC.3.M.PL+IMP+3+SG
precinja-se	precingir+V.ele.REFL+IMP+3+SG
precinja-te	precingir+V.tu.AD.2.SG+IMP+3+SG
precinja-vos	precingir+V.vós.AD.2.PL+IMP+3+SG
precinjo-a	precingir+V.ele.ACC.3.F.SG+PRS+1+SG
precinjo-as	precingir+V.ele.ACC.3.F.PL+PRS+1+SG
precinjo-lhe	precingir+V.ele.DAT.3.SG+PRS+1+SG
precinjo-lhes	precingir+V.ele.DAT.3.PL+PRS+1+SG
precinjo-me	precingir+V.eu.AD.1.SG+PRS+1+SG
precinjo-nos	precingir+nós.AD.1.PL+PRS+1+SG
precinjo-o	precingir+V.ele.ACC.3.M.SG+PRS+1+SG
precinjo-os	precingir+V.ele.ACC.3.M.PL+PRS+1+SG
precinjo-te	precingir+V.tu.AD.2.SG+PRS+1+SG
precinjo-vos	precingir+V.vós.AD.2.PL+PRS+1+SG
precinta-a	precintar+V.ele.ACC.3.F.SG+PRS+3+SG
precinta-as	precintar+V.ele.ACC.3.F.PL+PRS+3+SG
precintai-la	precintar+V.ele.ACC.3.F.SG+PRS+2+PL
precintai-las	precintar+V.ele.ACC.3.F.PL+PRS+2+PL
precintai-lo	precintar+V.ele.ACC.3.M.SG+PRS+2+PL
precintai-los	precintar+V.ele.ACC.3.M.PL+PRS+2+PL
precintai-nos	precintar+nós.AD.1.PL+PRS+2+PL
precintais-lhe	precintar+V.ele.DAT.3.SG+PRS+2+PL
precintais-lhes	precintar+V.ele.DAT.3.PL+PRS+2+PL
precintais-me	precintar+V.eu.AD.1.SG+PRS+2+PL
precintais-te	precintar+V.tu.AD.2.SG+PRS+2+PL
precintais-vos	precintar+V.vós.AD.2.PL+PRS+2+PL
precintá-la-ão	precintar+V.ele.ACC.3.F.SG+FUT+3+PL
precintá-la-á	precintar+V.ele.ACC.3.F.SG+FUT+3+SG
precintá-la-ás	precintar+V.ele.ACC.3.F.SG+FUT+2+SG
precintá-la-ei	precintar+V.ele.ACC.3.F.SG+FUT+1+SG
precintá-la-eis	precintar+V.ele.ACC.3.F.SG+FUT+2+PL
precintá-la-emos	precintar+V.ele.ACC.3.F.SG+FUT+1+PL
precintá-la-íamos	precintar+V.ele.ACC.3.F.SG+COND+1+PL
precintá-la-iam	precintar+V.ele.ACC.3.F.SG+COND+3+PL
precintá-la-ia	precintar+V.ele.ACC.3.F.SG+COND+1+SG
precintá-la-ia	precintar+V.ele.ACC.3.F.SG+COND+3+SG
precintá-la-ias	precintar+V.ele.ACC.3.F.SG+COND+2+SG
precintá-la-íeis	precintar+V.ele.ACC.3.F.SG+COND+2+PL
precintá-la	precintar+V.ele.ACC.3.F.SG+INF+1+SG
precintá-la	precintar+V.ele.ACC.3.F.SG+INF+3+SG
precinta-la	precintar+V.ele.ACC.3.F.SG+PRS+2+SG
precintá-la	precintar+V.ele.ACC.3.F.SG+SBJF+1+SG
precintá-la	precintar+V.ele.ACC.3.F.SG+SBJF+3+SG
precintá-las-ão	precintar+V.ele.ACC.3.F.PL+FUT+3+PL
precintá-las-á	precintar+V.ele.ACC.3.F.PL+FUT+3+SG
precintá-las-ás	precintar+V.ele.ACC.3.F.PL+FUT+2+SG
precintá-las-ei	precintar+V.ele.ACC.3.F.PL+FUT+1+SG
precintá-las-eis	precintar+V.ele.ACC.3.F.PL+FUT+2+PL
precintá-las-emos	precintar+V.ele.ACC.3.F.PL+FUT+1+PL
precintá-las-íamos	precintar+V.ele.ACC.3.F.PL+COND+1+PL
precintá-las-iam	precintar+V.ele.ACC.3.F.PL+COND+3+PL
precintá-las-ia	precintar+V.ele.ACC.3.F.PL+COND+1+SG
precintá-las-ia	precintar+V.ele.ACC.3.F.PL+COND+3+SG
precintá-las-ias	precintar+V.ele.ACC.3.F.PL+COND+2+SG
precintá-las-íeis	precintar+V.ele.ACC.3.F.PL+COND+2+PL
precintá-las	precintar+V.ele.ACC.3.F.PL+INF+1+SG
precintá-las	precintar+V.ele.ACC.3.F.PL+INF+3+SG
precinta-las	precintar+V.ele.ACC.3.F.PL+PRS+2+SG
precintá-las	precintar+V.ele.ACC.3.F.PL+SBJF+1+SG
precintá-las	precintar+V.ele.ACC.3.F.PL+SBJF+3+SG
precinta-lhe	precintar+V.ele.DAT.3.SG+PRS+3+SG
precinta-lhes	precintar+V.ele.DAT.3.PL+PRS+3+SG
precintá-lo-ão	precintar+V.ele.ACC.3.M.SG+FUT+3+PL
precintá-lo-á	precintar+V.ele.ACC.3.M.SG+FUT+3+SG
precintá-lo-ás	precintar+V.ele.ACC.3.M.SG+FUT+2+SG
precintá-lo-ei	precintar+V.ele.ACC.3.M.SG+FUT+1+SG
precintá-lo-eis	precintar+V.ele.ACC.3.M.SG+FUT+2+PL
precintá-lo-emos	precintar+V.ele.ACC.3.M.SG+FUT+1+PL
precintá-lo-íamos	precintar+V.ele.ACC.3.M.SG+COND+1+PL
precintá-lo-iam	precintar+V.ele.ACC.3.M.SG+COND+3+PL
precintá-lo-ia	precintar+V.ele.ACC.3.M.SG+COND+1+SG
precintá-lo-ia	precintar+V.ele.ACC.3.M.SG+COND+3+SG
precintá-lo-ias	precintar+V.ele.ACC.3.M.SG+COND+2+SG
precintá-lo-íeis	precintar+V.ele.ACC.3.M.SG+COND+2+PL
precintá-lo	precintar+V.ele.ACC.3.M.SG+INF+1+SG
precintá-lo	precintar+V.ele.ACC.3.M.SG+INF+3+SG
precinta-lo	precintar+V.ele.ACC.3.M.SG+PRS+2+SG
precintá-lo	precintar+V.ele.ACC.3.M.SG+SBJF+1+SG
precintá-lo	precintar+V.ele.ACC.3.M.SG+SBJF+3+SG
precintá-los-ão	precintar+V.ele.ACC.3.M.PL+FUT+3+PL
precintá-los-á	precintar+V.ele.ACC.3.M.PL+FUT+3+SG
precintá-los-ás	precintar+V.ele.ACC.3.M.PL+FUT+2+SG
precintá-los-ei	precintar+V.ele.ACC.3.M.PL+FUT+1+SG
precintá-los-eis	precintar+V.ele.ACC.3.M.PL+FUT+2+PL
precintá-los-emos	precintar+V.ele.ACC.3.M.PL+FUT+1+PL
precintá-los-íamos	precintar+V.ele.ACC.3.M.PL+COND+1+PL
precintá-los-iam	precintar+V.ele.ACC.3.M.PL+COND+3+PL
precintá-los-ia	precintar+V.ele.ACC.3.M.PL+COND+1+SG
precintá-los-ia	precintar+V.ele.ACC.3.M.PL+COND+3+SG
precintá-los-ias	precintar+V.ele.ACC.3.M.PL+COND+2+SG
precintá-los-íeis	precintar+V.ele.ACC.3.M.PL+COND+2+PL
precintá-los	precintar+V.ele.ACC.3.M.PL+INF+1+SG
precintá-los	precintar+V.ele.ACC.3.M.PL+INF+3+SG
precinta-los	precintar+V.ele.ACC.3.M.PL+PRS+2+SG
precintá-los	precintar+V.ele.ACC.3.M.PL+SBJF+1+SG
precintá-los	precintar+V.ele.ACC.3.M.PL+SBJF+3+SG
precinta-me	precintar+V.eu.AD.1.SG+PRS+3+SG
precintam-lhe	precintar+V.ele.DAT.3.SG+PRS+3+PL
precintam-lhes	precintar+V.ele.DAT.3.PL+PRS+3+PL
precintam-me	precintar+V.eu.AD.1.SG+PRS+3+PL
precintam-na	precintar+V.ele.ACC.3.F.SG+PRS+3+PL
precintam-nas	precintar+V.ele.ACC.3.F.PL+PRS+3+PL
precintam-no	precintar+V.ele.ACC.3.M.SG+PRS+3+PL
precintam-nos	precintar+V.ele.ACC.3.M.PL+PRS+3+PL
precintam-nos	precintar+V.nós.AD.1.PL+PRS+3+PL
precintamo-la	precintar+V.ele.ACC.3.F.SG+PRF+1+PL
precintamo-la	precintar+V.ele.ACC.3.F.SG+PRS+1+PL
precintamo-las	precintar+V.ele.ACC.3.F.PL+PRF+1+PL
precintamo-las	precintar+V.ele.ACC.3.F.PL+PRS+1+PL
precintamo-lo	precintar+V.ele.ACC.3.M.SG+PRF+1+PL
precintamo-lo	precintar+V.ele.ACC.3.M.SG+PRS+1+PL
precintamo-los	precintar+V.ele.ACC.3.M.PL+PRF+1+PL
precintamo-los	precintar+V.ele.ACC.3.M.PL+PRS+1+PL
precintamo-nos	precintar+nós.AD.1.PL+PRF+1+PL
precintamo-nos	precintar+nós.AD.1.PL+PRS+1+PL
precintamos-lhe	precintar+V.ele.DAT.3.SG+PRF+1+PL
precintamos-lhe	precintar+V.ele.DAT.3.SG+PRS+1+PL
precintamos-lhes	precintar+V.ele.DAT.3.PL+PRF+1+PL
precintamos-lhes	precintar+V.ele.DAT.3.PL+PRS+1+PL
precintamos-me	precintar+V.eu.AD.1.SG+PRF+1+PL
precintamos-me	precintar+V.eu.AD.1.SG+PRS+1+PL
precintamos-te	precintar+V.tu.AD.2.SG+PRF+1+PL
precintamos-te	precintar+V.tu.AD.2.SG+PRS+1+PL
precintamos-vos	precintar+V.vós.AD.2.PL+PRF+1+PL
precintamos-vos	precintar+V.vós.AD.2.PL+PRS+1+PL
precintam-se	precintar+V.ele.REFL+PRS+3+PL
precintam-te	precintar+V.tu.AD.2.SG+PRS+3+PL
precintam-vos	precintar+V.vós.AD.2.PL+PRS+3+PL
precintando-a	precintar+V.ele.ACC.3.F.SG+GRD
precintando-as	precintar+V.ele.ACC.3.F.PL+GRD
precintando-lhe	precintar+V.ele.DAT.3.SG+GRD
precintando-lhes	precintar+V.ele.DAT.3.PL+GRD
precintando-me	precintar+V.eu.AD.1.SG+GRD
precintando-nos	precintar+nós.AD.1.PL+GRD
precintando-o	precintar+V.ele.ACC.3.M.SG+GRD
precintando-os	precintar+V.ele.ACC.3.M.PL+GRD
precintando-se	precintar+V.ele.REFL+GRD
precintando-te	precintar+V.tu.AD.2.SG+GRD
precintando-vos	precintar+V.vós.AD.2.PL+GRD
precinta-nos	precintar+nós.AD.1.PL+PRS+2+SG
precinta-nos	precintar+nós.AD.1.PL+PRS+3+SG
precinta-o	precintar+V.ele.ACC.3.M.SG+PRS+3+SG
precinta-os	precintar+V.ele.ACC.3.M.PL+PRS+3+SG
precintara-a	precintar+V.ele.ACC.3.F.SG+PQP+1+SG
precintara-a	precintar+V.ele.ACC.3.F.SG+PQP+3+SG
precintara-as	precintar+V.ele.ACC.3.F.PL+PQP+1+SG
precintara-as	precintar+V.ele.ACC.3.F.PL+PQP+3+SG
precintara-la	precintar+V.ele.ACC.3.F.SG+PQP+2+SG
precintara-las	precintar+V.ele.ACC.3.F.PL+PQP+2+SG
precintara-lhe	precintar+V.ele.DAT.3.SG+PQP+1+SG
precintara-lhe	precintar+V.ele.DAT.3.SG+PQP+3+SG
precintara-lhes	precintar+V.ele.DAT.3.PL+PQP+1+SG
precintara-lhes	precintar+V.ele.DAT.3.PL+PQP+3+SG
precintara-lo	precintar+V.ele.ACC.3.M.SG+PQP+2+SG
precintara-los	precintar+V.ele.ACC.3.M.PL+PQP+2+SG
precintara-me	precintar+V.eu.AD.1.SG+PQP+1+SG
precintara-me	precintar+V.eu.AD.1.SG+PQP+3+SG
precintaram-lhe	precintar+V.ele.DAT.3.SG+PQP+3+PL
precintaram-lhe	precintar+V.ele.DAT.3.SG+PRF+3+PL
precintaram-lhes	precintar+V.ele.DAT.3.PL+PQP+3+PL
precintaram-lhes	precintar+V.ele.DAT.3.PL+PRF+3+PL
precintaram-me	precintar+V.eu.AD.1.SG+PQP+3+PL
precintaram-me	precintar+V.eu.AD.1.SG+PRF+3+PL
precintaram-na	precintar+V.ele.ACC.3.F.SG+PQP+3+PL
precintaram-na	precintar+V.ele.ACC.3.F.SG+PRF+3+PL
precintaram-nas	precintar+V.ele.ACC.3.F.PL+PQP+3+PL
precintaram-nas	precintar+V.ele.ACC.3.F.PL+PRF+3+PL
precintaram-no	precintar+V.ele.ACC.3.M.SG+PQP+3+PL
precintaram-no	precintar+V.ele.ACC.3.M.SG+PRF+3+PL
precintaram-nos	precintar+V.ele.ACC.3.M.PL+PQP+3+PL
precintaram-nos	precintar+V.ele.ACC.3.M.PL+PRF+3+PL
precintaram-nos	precintar+V.nós.AD.1.PL+PQP+3+PL
precintaram-nos	precintar+V.nós.AD.1.PL+PRF+3+PL
precintáramo-la	precintar+V.ele.ACC.3.F.SG+PQP+1+PL
precintáramo-las	precintar+V.ele.ACC.3.F.PL+PQP+1+PL
precintáramo-lo	precintar+V.ele.ACC.3.M.SG+PQP+1+PL
precintáramo-los	precintar+V.ele.ACC.3.M.PL+PQP+1+PL
precintáramo-nos	precintar+nós.AD.1.PL+PQP+1+PL
precintáramos-lhe	precintar+V.ele.DAT.3.SG+PQP+1+PL
precintáramos-lhes	precintar+V.ele.DAT.3.PL+PQP+1+PL
precintáramos-me	precintar+V.eu.AD.1.SG+PQP+1+PL
precintáramos-te	precintar+V.tu.AD.2.SG+PQP+1+PL
precintáramos-vos	precintar+V.vós.AD.2.PL+PQP+1+PL
precintaram-se	precintar+V.ele.REFL+PQP+3+PL
precintaram-se	precintar+V.ele.REFL+PRF+3+PL
precintaram-te	precintar+V.tu.AD.2.SG+PQP+3+PL
precintaram-te	precintar+V.tu.AD.2.SG+PRF+3+PL
precintaram-vos	precintar+V.vós.AD.2.PL+PQP+3+PL
precintaram-vos	precintar+V.vós.AD.2.PL+PRF+3+PL
precintara-nos	precintar+nós.AD.1.PL+PQP+1+SG
precintara-nos	precintar+nós.AD.1.PL+PQP+2+SG
precintara-nos	precintar+nós.AD.1.PL+PQP+3+SG
precintara-o	precintar+V.ele.ACC.3.M.SG+PQP+1+SG
precintara-o	precintar+V.ele.ACC.3.M.SG+PQP+3+SG
precintara-os	precintar+V.ele.ACC.3.M.PL+PQP+1+SG
precintara-os	precintar+V.ele.ACC.3.M.PL+PQP+3+SG
precintara-se	precintar+V.ele.REFL+PQP+1+SG
precintara-se	precintar+V.ele.REFL+PQP+3+SG
precintaras-lhe	precintar+V.ele.DAT.3.SG+PQP+2+SG
precintaras-lhes	precintar+V.ele.DAT.3.PL+PQP+2+SG
precintaras-me	precintar+V.eu.AD.1.SG+PQP+2+SG
precintaras-te	precintar+V.tu.AD.2.SG+PQP+2+SG
precintaras-vos	precintar+V.vós.AD.2.PL+PQP+2+SG
precintara-te	precintar+V.tu.AD.2.SG+PQP+1+SG
precintara-te	precintar+V.tu.AD.2.SG+PQP+3+SG
precintara-vos	precintar+V.vós.AD.2.PL+PQP+1+SG
precintara-vos	precintar+V.vós.AD.2.PL+PQP+3+SG
precintarde-la	precintar+V.ele.ACC.3.F.SG+INF+2+PL
precintarde-la	precintar+V.ele.ACC.3.F.SG+SBJF+2+PL
precintarde-las	precintar+V.ele.ACC.3.F.PL+INF+2+PL
precintarde-las	precintar+V.ele.ACC.3.F.PL+SBJF+2+PL
precintarde-lo	precintar+V.ele.ACC.3.M.SG+INF+2+PL
precintarde-lo	precintar+V.ele.ACC.3.M.SG+SBJF+2+PL
precintarde-los	precintar+V.ele.ACC.3.M.PL+INF+2+PL
precintarde-los	precintar+V.ele.ACC.3.M.PL+SBJF+2+PL
precintarde-nos	precintar+nós.AD.1.PL+INF+2+PL
precintarde-nos	precintar+nós.AD.1.PL+SBJF+2+PL
precintardes-lhe	precintar+V.ele.DAT.3.SG+INF+2+PL
precintardes-lhe	precintar+V.ele.DAT.3.SG+SBJF+2+PL
precintardes-lhes	precintar+V.ele.DAT.3.PL+INF+2+PL
precintardes-lhes	precintar+V.ele.DAT.3.PL+SBJF+2+PL
precintardes-me	precintar+V.eu.AD.1.SG+INF+2+PL
precintardes-me	precintar+V.eu.AD.1.SG+SBJF+2+PL
precintardes-te	precintar+V.tu.AD.2.SG+INF+2+PL
precintardes-te	precintar+V.tu.AD.2.SG+SBJF+2+PL
precintardes-vos	precintar+V.vós.AD.2.PL+INF+2+PL
precintardes-vos	precintar+V.vós.AD.2.PL+SBJF+2+PL
precintárei-la	precintar+V.ele.ACC.3.F.SG+PQP+2+PL
precintárei-las	precintar+V.ele.ACC.3.F.PL+PQP+2+PL
precintárei-lo	precintar+V.ele.ACC.3.M.SG+PQP+2+PL
precintárei-los	precintar+V.ele.ACC.3.M.PL+PQP+2+PL
precintárei-nos	precintar+nós.AD.1.PL+PQP+2+PL
precintáreis-lhe	precintar+V.ele.DAT.3.SG+PQP+2+PL
precintáreis-lhes	precintar+V.ele.DAT.3.PL+PQP+2+PL
precintáreis-me	precintar+V.eu.AD.1.SG+PQP+2+PL
precintáreis-te	precintar+V.tu.AD.2.SG+PQP+2+PL
precintáreis-vos	precintar+V.vós.AD.2.PL+PQP+2+PL
precintare-la	precintar+V.ele.ACC.3.F.SG+INF+2+SG
precintare-la	precintar+V.ele.ACC.3.F.SG+SBJF+2+SG
precintare-las	precintar+V.ele.ACC.3.F.PL+INF+2+SG
precintare-las	precintar+V.ele.ACC.3.F.PL+SBJF+2+SG
precintare-lo	precintar+V.ele.ACC.3.M.SG+INF+2+SG
precintare-lo	precintar+V.ele.ACC.3.M.SG+SBJF+2+SG
precintare-los	precintar+V.ele.ACC.3.M.PL+INF+2+SG
precintare-los	precintar+V.ele.ACC.3.M.PL+SBJF+2+SG
precintarem-lhe	precintar+V.ele.DAT.3.SG+INF+3+PL
precintarem-lhe	precintar+V.ele.DAT.3.SG+SBJF+3+PL
precintarem-lhes	precintar+V.ele.DAT.3.PL+INF+3+PL
precintarem-lhes	precintar+V.ele.DAT.3.PL+SBJF+3+PL
precintarem-me	precintar+V.eu.AD.1.SG+INF+3+PL
precintarem-me	precintar+V.eu.AD.1.SG+SBJF+3+PL
precintarem-na	precintar+V.ele.ACC.3.F.SG+INF+3+PL
precintarem-na	precintar+V.ele.ACC.3.F.SG+SBJF+3+PL
precintarem-nas	precintar+V.ele.ACC.3.F.PL+INF+3+PL
precintarem-nas	precintar+V.ele.ACC.3.F.PL+SBJF+3+PL
precintarem-no	precintar+V.ele.ACC.3.M.SG+INF+3+PL
precintarem-no	precintar+V.ele.ACC.3.M.SG+SBJF+3+PL
precintarem-nos	precintar+V.ele.ACC.3.M.PL+INF+3+PL
precintarem-nos	precintar+V.ele.ACC.3.M.PL+SBJF+3+PL
precintarem-nos	precintar+V.nós.AD.1.PL+INF+3+PL
precintarem-nos	precintar+V.nós.AD.1.PL+SBJF+3+PL
precintarem-se	precintar+V.ele.REFL+INF+3+PL
precintarem-se	precintar+V.ele.REFL+SBJF+3+PL
precintarem-te	precintar+V.tu.AD.2.SG+INF+3+PL
precintarem-te	precintar+V.tu.AD.2.SG+SBJF+3+PL
precintarem-vos	precintar+V.vós.AD.2.PL+INF+3+PL
precintarem-vos	precintar+V.vós.AD.2.PL+SBJF+3+PL
precintare-nos	precintar+nós.AD.1.PL+INF+2+SG
precintare-nos	precintar+nós.AD.1.PL+SBJF+2+SG
precintares-lhe	precintar+V.ele.DAT.3.SG+INF+2+SG
precintares-lhe	precintar+V.ele.DAT.3.SG+SBJF+2+SG
precintares-lhes	precintar+V.ele.DAT.3.PL+INF+2+SG
precintares-lhes	precintar+V.ele.DAT.3.PL+SBJF+2+SG
precintares-me	precintar+V.eu.AD.1.SG+INF+2+SG
precintares-me	precintar+V.eu.AD.1.SG+SBJF+2+SG
precintares-te	precintar+V.tu.AD.2.SG+INF+2+SG
precintares-te	precintar+V.tu.AD.2.SG+SBJF+2+SG
precintares-vos	precintar+V.vós.AD.2.PL+INF+2+SG
precintares-vos	precintar+V.vós.AD.2.PL+SBJF+2+SG
precintar-lhe-ão	precintar+V.ele.DAT.3.SG+FUT+3+PL
precintar-lhe-á	precintar+V.ele.DAT.3.SG+FUT+3+SG
precintar-lhe-ás	precintar+V.ele.DAT.3.SG+FUT+2+SG
precintar-lhe-ei	precintar+V.ele.DAT.3.SG+FUT+1+SG
precintar-lhe-eis	precintar+V.ele.DAT.3.SG+FUT+2+PL
precintar-lhe-emos	precintar+V.ele.DAT.3.SG+FUT+1+PL
precintar-lhe-íamos	precintar+V.ele.DAT.3.SG+COND+1+PL
precintar-lhe-iam	precintar+V.ele.DAT.3.SG+COND+3+PL
precintar-lhe-ia	precintar+V.ele.DAT.3.SG+COND+1+SG
precintar-lhe-ia	precintar+V.ele.DAT.3.SG+COND+3+SG
precintar-lhe-ias	precintar+V.ele.DAT.3.SG+COND+2+SG
precintar-lhe-íeis	precintar+V.ele.DAT.3.SG+COND+2+PL
precintar-lhe	precintar+V.ele.DAT.3.SG+INF
precintar-lhe	precintar+V.ele.DAT.3.SG+INF+1+SG
precintar-lhe	precintar+V.ele.DAT.3.SG+INF+3+SG
precintar-lhe	precintar+V.ele.DAT.3.SG+SBJF+1+SG
precintar-lhe	precintar+V.ele.DAT.3.SG+SBJF+3+SG
precintar-lhes-ão	precintar+V.ele.DAT.3.PL+FUT+3+PL
precintar-lhes-á	precintar+V.ele.DAT.3.PL+FUT+3+SG
precintar-lhes-ás	precintar+V.ele.DAT.3.PL+FUT+2+SG
precintar-lhes-ei	precintar+V.ele.DAT.3.PL+FUT+1+SG
precintar-lhes-eis	precintar+V.ele.DAT.3.PL+FUT+2+PL
precintar-lhes-emos	precintar+V.ele.DAT.3.PL+FUT+1+PL
precintar-lhes-íamos	precintar+V.ele.DAT.3.PL+COND+1+PL
precintar-lhes-iam	precintar+V.ele.DAT.3.PL+COND+3+PL
precintar-lhes-ia	precintar+V.ele.DAT.3.PL+COND+1+SG
precintar-lhes-ia	precintar+V.ele.DAT.3.PL+COND+3+SG
precintar-lhes-ias	precintar+V.ele.DAT.3.PL+COND+2+SG
precintar-lhes-íeis	precintar+V.ele.DAT.3.PL+COND+2+PL
precintar-lhes	precintar+V.ele.DAT.3.PL+INF
precintar-lhes	precintar+V.ele.DAT.3.PL+INF+1+SG
precintar-lhes	precintar+V.ele.DAT.3.PL+INF+3+SG
precintar-lhes	precintar+V.ele.DAT.3.PL+SBJF+1+SG
precintar-lhes	precintar+V.ele.DAT.3.PL+SBJF+3+SG
precintar-me-ão	precintar+V.eu.AD.1.SG+FUT+3+PL
precintar-me-á	precintar+V.eu.AD.1.SG+FUT+3+SG
precintar-me-ás	precintar+V.eu.AD.1.SG+FUT+2+SG
precintar-me-ei	precintar+V.eu.AD.1.SG+FUT+1+SG
precintar-me-eis	precintar+V.eu.AD.1.SG+FUT+2+PL
precintar-me-emos	precintar+V.eu.AD.1.SG+FUT+1+PL
precintar-me-íamos	precintar+V.eu.AD.1.SG+COND+1+PL
precintar-me-iam	precintar+V.eu.AD.1.SG+COND+3+PL
precintar-me-ia	precintar+V.eu.AD.1.SG+COND+1+SG
precintar-me-ia	precintar+V.eu.AD.1.SG+COND+3+SG
precintar-me-ias	precintar+V.eu.AD.1.SG+COND+2+SG
precintar-me-íeis	precintar+V.eu.AD.1.SG+COND+2+PL
precintar-me	precintar+V.eu.AD.1.SG+INF
precintar-me	precintar+V.eu.AD.1.SG+INF+1+SG
precintar-me	precintar+V.eu.AD.1.SG+INF+3+SG
precintar-me	precintar+V.eu.AD.1.SG+SBJF+1+SG
precintar-me	precintar+V.eu.AD.1.SG+SBJF+3+SG
precintarmo-la	precintar+V.ele.ACC.3.F.SG+INF+1+PL
precintarmo-la	precintar+V.ele.ACC.3.F.SG+SBJF+1+PL
precintarmo-las	precintar+V.ele.ACC.3.F.PL+INF+1+PL
precintarmo-las	precintar+V.ele.ACC.3.F.PL+SBJF+1+PL
precintarmo-lo	precintar+V.ele.ACC.3.M.SG+INF+1+PL
precintarmo-lo	precintar+V.ele.ACC.3.M.SG+SBJF+1+PL
precintarmo-los	precintar+V.ele.ACC.3.M.PL+INF+1+PL
precintarmo-los	precintar+V.ele.ACC.3.M.PL+SBJF+1+PL
precintarmo-nos	precintar+nós.AD.1.PL+INF+1+PL
precintarmo-nos	precintar+nós.AD.1.PL+SBJF+1+PL
precintarmos-lhe	precintar+V.ele.DAT.3.SG+INF+1+PL
precintarmos-lhe	precintar+V.ele.DAT.3.SG+SBJF+1+PL
precintarmos-lhes	precintar+V.ele.DAT.3.PL+INF+1+PL
precintarmos-lhes	precintar+V.ele.DAT.3.PL+SBJF+1+PL
precintarmos-me	precintar+V.eu.AD.1.SG+INF+1+PL
precintarmos-me	precintar+V.eu.AD.1.SG+SBJF+1+PL
precintarmos-te	precintar+V.tu.AD.2.SG+INF+1+PL
precintarmos-te	precintar+V.tu.AD.2.SG+SBJF+1+PL
precintarmos-vos	precintar+V.vós.AD.2.PL+INF+1+PL
precintarmos-vos	precintar+V.vós.AD.2.PL+SBJF+1+PL
precintar-nos-ão	precintar+nós.AD.1.PL+FUT+3+PL
precintar-nos-á	precintar+nós.AD.1.PL+FUT+3+SG
precintar-nos-ás	precintar+nós.AD.1.PL+FUT+2+SG
precintar-nos-ei	precintar+nós.AD.1.PL+FUT+1+SG
precintar-nos-eis	precintar+nós.AD.1.PL+FUT+2+PL
precintar-nos-emos	precintar+nós.AD.1.PL+FUT+1+PL
precintar-nos-íamos	precintar+nós.AD.1.PL+COND+1+PL
precintar-nos-iam	precintar+nós.AD.1.PL+COND+3+PL
precintar-nos-ia	precintar+nós.AD.1.PL+COND+1+SG
precintar-nos-ia	precintar+nós.AD.1.PL+COND+3+SG
precintar-nos-ias	precintar+nós.AD.1.PL+COND+2+SG
precintar-nos-íeis	precintar+nós.AD.1.PL+COND+2+PL
precintar-nos	precintar+nós.AD.1.PL+INF
precintar-nos	precintar+nós.AD.1.PL+INF+1+SG
