pressionar-lhes-íeis	pressionar+V.ele.DAT.3.PL+COND+2+PL
pressionar-lhes	pressionar+V.ele.DAT.3.PL+INF
pressionar-lhes	pressionar+V.ele.DAT.3.PL+INF+1+SG
pressionar-lhes	pressionar+V.ele.DAT.3.PL+INF+3+SG
pressionar-lhes	pressionar+V.ele.DAT.3.PL+SBJF+1+SG
pressionar-lhes	pressionar+V.ele.DAT.3.PL+SBJF+3+SG
pressionar-me-ão	pressionar+V.eu.AD.1.SG+FUT+3+PL
pressionar-me-á	pressionar+V.eu.AD.1.SG+FUT+3+SG
pressionar-me-ás	pressionar+V.eu.AD.1.SG+FUT+2+SG
pressionar-me-ei	pressionar+V.eu.AD.1.SG+FUT+1+SG
pressionar-me-eis	pressionar+V.eu.AD.1.SG+FUT+2+PL
pressionar-me-emos	pressionar+V.eu.AD.1.SG+FUT+1+PL
pressionar-me-íamos	pressionar+V.eu.AD.1.SG+COND+1+PL
pressionar-me-iam	pressionar+V.eu.AD.1.SG+COND+3+PL
pressionar-me-ia	pressionar+V.eu.AD.1.SG+COND+1+SG
pressionar-me-ia	pressionar+V.eu.AD.1.SG+COND+3+SG
pressionar-me-ias	pressionar+V.eu.AD.1.SG+COND+2+SG
pressionar-me-íeis	pressionar+V.eu.AD.1.SG+COND+2+PL
pressionar-me	pressionar+V.eu.AD.1.SG+INF
pressionar-me	pressionar+V.eu.AD.1.SG+INF+1+SG
pressionar-me	pressionar+V.eu.AD.1.SG+INF+3+SG
pressionar-me	pressionar+V.eu.AD.1.SG+SBJF+1+SG
pressionar-me	pressionar+V.eu.AD.1.SG+SBJF+3+SG
pressionarmo-la	pressionar+V.ele.ACC.3.F.SG+INF+1+PL
pressionarmo-la	pressionar+V.ele.ACC.3.F.SG+SBJF+1+PL
pressionarmo-las	pressionar+V.ele.ACC.3.F.PL+INF+1+PL
pressionarmo-las	pressionar+V.ele.ACC.3.F.PL+SBJF+1+PL
pressionarmo-lo	pressionar+V.ele.ACC.3.M.SG+INF+1+PL
pressionarmo-lo	pressionar+V.ele.ACC.3.M.SG+SBJF+1+PL
pressionarmo-los	pressionar+V.ele.ACC.3.M.PL+INF+1+PL
pressionarmo-los	pressionar+V.ele.ACC.3.M.PL+SBJF+1+PL
pressionarmo-nos	pressionar+nós.AD.1.PL+INF+1+PL
pressionarmo-nos	pressionar+nós.AD.1.PL+SBJF+1+PL
pressionarmos-lhe	pressionar+V.ele.DAT.3.SG+INF+1+PL
pressionarmos-lhe	pressionar+V.ele.DAT.3.SG+SBJF+1+PL
pressionarmos-lhes	pressionar+V.ele.DAT.3.PL+INF+1+PL
pressionarmos-lhes	pressionar+V.ele.DAT.3.PL+SBJF+1+PL
pressionarmos-me	pressionar+V.eu.AD.1.SG+INF+1+PL
pressionarmos-me	pressionar+V.eu.AD.1.SG+SBJF+1+PL
pressionarmos-te	pressionar+V.tu.AD.2.SG+INF+1+PL
pressionarmos-te	pressionar+V.tu.AD.2.SG+SBJF+1+PL
pressionarmos-vos	pressionar+V.vós.AD.2.PL+INF+1+PL
pressionarmos-vos	pressionar+V.vós.AD.2.PL+SBJF+1+PL
pressionar-nos-ão	pressionar+nós.AD.1.PL+FUT+3+PL
pressionar-nos-á	pressionar+nós.AD.1.PL+FUT+3+SG
pressionar-nos-ás	pressionar+nós.AD.1.PL+FUT+2+SG
pressionar-nos-ei	pressionar+nós.AD.1.PL+FUT+1+SG
pressionar-nos-eis	pressionar+nós.AD.1.PL+FUT+2+PL
pressionar-nos-emos	pressionar+nós.AD.1.PL+FUT+1+PL
pressionar-nos-íamos	pressionar+nós.AD.1.PL+COND+1+PL
pressionar-nos-iam	pressionar+nós.AD.1.PL+COND+3+PL
pressionar-nos-ia	pressionar+nós.AD.1.PL+COND+1+SG
pressionar-nos-ia	pressionar+nós.AD.1.PL+COND+3+SG
pressionar-nos-ias	pressionar+nós.AD.1.PL+COND+2+SG
pressionar-nos-íeis	pressionar+nós.AD.1.PL+COND+2+PL
pressionar-nos	pressionar+nós.AD.1.PL+INF
pressionar-nos	pressionar+nós.AD.1.PL+INF+1+SG
pressionar-nos	pressionar+nós.AD.1.PL+INF+3+SG
pressionar-nos	pressionar+nós.AD.1.PL+SBJF+1+SG
pressionar-nos	pressionar+nós.AD.1.PL+SBJF+3+SG
pressionar-se-ão	pressionar+V.ele.REFL+FUT+3+PL
pressionar-se-á	pressionar+V.ele.REFL+FUT+3+SG
pressionar-se-iam	pressionar+V.ele.REFL+COND+3+PL
pressionar-se-ia	pressionar+V.ele.REFL+COND+3+SG
pressionar-se	pressionar+V.ele.REFL+INF
pressionar-se	pressionar+V.ele.REFL+INF+3+SG
pressionar-se	pressionar+V.ele.REFL+SBJF+3+SG
pressionar-te-ão	pressionar+V.tu.AD.2.SG+FUT+3+PL
pressionar-te-á	pressionar+V.tu.AD.2.SG+FUT+3+SG
pressionar-te-ás	pressionar+V.tu.AD.2.SG+FUT+2+SG
pressionar-te-ei	pressionar+V.tu.AD.2.SG+FUT+1+SG
pressionar-te-eis	pressionar+V.tu.AD.2.SG+FUT+2+PL
pressionar-te-emos	pressionar+V.tu.AD.2.SG+FUT+1+PL
pressionar-te-íamos	pressionar+V.tu.AD.2.SG+COND+1+PL
pressionar-te-iam	pressionar+V.tu.AD.2.SG+COND+3+PL
pressionar-te-ia	pressionar+V.tu.AD.2.SG+COND+1+SG
pressionar-te-ia	pressionar+V.tu.AD.2.SG+COND+3+SG
pressionar-te-ias	pressionar+V.tu.AD.2.SG+COND+2+SG
pressionar-te-íeis	pressionar+V.tu.AD.2.SG+COND+2+PL
pressionar-te	pressionar+V.tu.AD.2.SG+INF
pressionar-te	pressionar+V.tu.AD.2.SG+INF+1+SG
pressionar-te	pressionar+V.tu.AD.2.SG+INF+3+SG
pressionar-te	pressionar+V.tu.AD.2.SG+SBJF+1+SG
pressionar-te	pressionar+V.tu.AD.2.SG+SBJF+3+SG
pressionar-vos-ão	pressionar+V.vós.AD.2.PL+FUT+3+PL
pressionar-vos-á	pressionar+V.vós.AD.2.PL+FUT+3+SG
pressionar-vos-ás	pressionar+V.vós.AD.2.PL+FUT+2+SG
pressionar-vos-ei	pressionar+V.vós.AD.2.PL+FUT+1+SG
pressionar-vos-eis	pressionar+V.vós.AD.2.PL+FUT+2+PL
pressionar-vos-emos	pressionar+V.vós.AD.2.PL+FUT+1+PL
pressionar-vos-íamos	pressionar+V.vós.AD.2.PL+COND+1+PL
pressionar-vos-iam	pressionar+V.vós.AD.2.PL+COND+3+PL
pressionar-vos-ia	pressionar+V.vós.AD.2.PL+COND+1+SG
pressionar-vos-ia	pressionar+V.vós.AD.2.PL+COND+3+SG
pressionar-vos-ias	pressionar+V.vós.AD.2.PL+COND+2+SG
pressionar-vos-íeis	pressionar+V.vós.AD.2.PL+COND+2+PL
pressionar-vos	pressionar+V.vós.AD.2.PL+INF
pressionar-vos	pressionar+V.vós.AD.2.PL+INF+1+SG
pressionar-vos	pressionar+V.vós.AD.2.PL+INF+3+SG
pressionar-vos	pressionar+V.vós.AD.2.PL+SBJF+1+SG
pressionar-vos	pressionar+V.vós.AD.2.PL+SBJF+3+SG
pressiona-se	pressionar+V.ele.REFL+PRS+3+SG
pressionas-lhe	pressionar+V.ele.DAT.3.SG+PRS+2+SG
pressionas-lhes	pressionar+V.ele.DAT.3.PL+PRS+2+SG
pressionas-me	pressionar+V.eu.AD.1.SG+PRS+2+SG
pressionaste-a	pressionar+V.ele.ACC.3.F.SG+PRF+2+SG
pressionaste-as	pressionar+V.ele.ACC.3.F.PL+PRF+2+SG
pressionaste-la	pressionar+V.ele.ACC.3.F.SG+PRF+2+PL
pressionaste-las	pressionar+V.ele.ACC.3.F.PL+PRF+2+PL
pressionaste-lhe	pressionar+V.ele.DAT.3.SG+PRF+2+SG
pressionaste-lhes	pressionar+V.ele.DAT.3.PL+PRF+2+SG
pressionaste-lo	pressionar+V.ele.ACC.3.M.SG+PRF+2+PL
pressionaste-los	pressionar+V.ele.ACC.3.M.PL+PRF+2+PL
pressionaste-me	pressionar+V.eu.AD.1.SG+PRF+2+SG
pressionaste-nos	pressionar+nós.AD.1.PL+PRF+2+PL
pressionaste-nos	pressionar+nós.AD.1.PL+PRF+2+SG
pressionaste-o	pressionar+V.ele.ACC.3.M.SG+PRF+2+SG
pressionaste-os	pressionar+V.ele.ACC.3.M.PL+PRF+2+SG
pressionas-te	pressionar+V.tu.AD.2.SG+PRS+2+SG
pressionastes-lhe	pressionar+V.ele.DAT.3.SG+PRF+2+PL
pressionastes-lhes	pressionar+V.ele.DAT.3.PL+PRF+2+PL
pressionastes-me	pressionar+V.eu.AD.1.SG+PRF+2+PL
pressionastes-te	pressionar+V.tu.AD.2.SG+PRF+2+PL
pressionastes-vos	pressionar+V.vós.AD.2.PL+PRF+2+PL
pressionaste-te	pressionar+V.tu.AD.2.SG+PRF+2+SG
pressionaste-vos	pressionar+V.vós.AD.2.PL+PRF+2+SG
pressionas-vos	pressionar+V.vós.AD.2.PL+PRS+2+SG
pressiona-te	pressionar+V.tu.AD.2.SG+PRS+3+SG
pressionava-a	pressionar+V.ele.ACC.3.F.SG+IMPF+1+SG
pressionava-a	pressionar+V.ele.ACC.3.F.SG+IMPF+3+SG
pressionava-as	pressionar+V.ele.ACC.3.F.PL+IMPF+1+SG
pressionava-as	pressionar+V.ele.ACC.3.F.PL+IMPF+3+SG
pressionava-la	pressionar+V.ele.ACC.3.F.SG+IMPF+2+SG
pressionava-las	pressionar+V.ele.ACC.3.F.PL+IMPF+2+SG
pressionava-lhe	pressionar+V.ele.DAT.3.SG+IMPF+1+SG
pressionava-lhe	pressionar+V.ele.DAT.3.SG+IMPF+3+SG
pressionava-lhes	pressionar+V.ele.DAT.3.PL+IMPF+1+SG
pressionava-lhes	pressionar+V.ele.DAT.3.PL+IMPF+3+SG
pressionava-lo	pressionar+V.ele.ACC.3.M.SG+IMPF+2+SG
pressionava-los	pressionar+V.ele.ACC.3.M.PL+IMPF+2+SG
pressionava-me	pressionar+V.eu.AD.1.SG+IMPF+1+SG
pressionava-me	pressionar+V.eu.AD.1.SG+IMPF+3+SG
pressionavam-lhe	pressionar+V.ele.DAT.3.SG+IMPF+3+PL
pressionavam-lhes	pressionar+V.ele.DAT.3.PL+IMPF+3+PL
pressionavam-me	pressionar+V.eu.AD.1.SG+IMPF+3+PL
pressionavam-na	pressionar+V.ele.ACC.3.F.SG+IMPF+3+PL
pressionavam-nas	pressionar+V.ele.ACC.3.F.PL+IMPF+3+PL
pressionavam-no	pressionar+V.ele.ACC.3.M.SG+IMPF+3+PL
pressionavam-nos	pressionar+V.ele.ACC.3.M.PL+IMPF+3+PL
pressionavam-nos	pressionar+V.nós.AD.1.PL+IMPF+3+PL
pressionávamo-la	pressionar+V.ele.ACC.3.F.SG+IMPF+1+PL
pressionávamo-las	pressionar+V.ele.ACC.3.F.PL+IMPF+1+PL
pressionávamo-lo	pressionar+V.ele.ACC.3.M.SG+IMPF+1+PL
pressionávamo-los	pressionar+V.ele.ACC.3.M.PL+IMPF+1+PL
pressionávamo-nos	pressionar+nós.AD.1.PL+IMPF+1+PL
pressionávamos-lhe	pressionar+V.ele.DAT.3.SG+IMPF+1+PL
pressionávamos-lhes	pressionar+V.ele.DAT.3.PL+IMPF+1+PL
pressionávamos-me	pressionar+V.eu.AD.1.SG+IMPF+1+PL
pressionávamos-te	pressionar+V.tu.AD.2.SG+IMPF+1+PL
pressionávamos-vos	pressionar+V.vós.AD.2.PL+IMPF+1+PL
pressionavam-se	pressionar+V.ele.REFL+IMPF+3+PL
pressionavam-te	pressionar+V.tu.AD.2.SG+IMPF+3+PL
pressionavam-vos	pressionar+V.vós.AD.2.PL+IMPF+3+PL
pressionava-nos	pressionar+nós.AD.1.PL+IMPF+1+SG
pressionava-nos	pressionar+nós.AD.1.PL+IMPF+2+SG
pressionava-nos	pressionar+nós.AD.1.PL+IMPF+3+SG
pressionava-o	pressionar+V.ele.ACC.3.M.SG+IMPF+1+SG
pressionava-o	pressionar+V.ele.ACC.3.M.SG+IMPF+3+SG
pressionava-os	pressionar+V.ele.ACC.3.M.PL+IMPF+1+SG
pressionava-os	pressionar+V.ele.ACC.3.M.PL+IMPF+3+SG
pressionava-se	pressionar+V.ele.REFL+IMPF+1+SG
pressionava-se	pressionar+V.ele.REFL+IMPF+3+SG
pressionavas-lhe	pressionar+V.ele.DAT.3.SG+IMPF+2+SG
pressionavas-lhes	pressionar+V.ele.DAT.3.PL+IMPF+2+SG
pressionavas-me	pressionar+V.eu.AD.1.SG+IMPF+2+SG
pressionavas-te	pressionar+V.tu.AD.2.SG+IMPF+2+SG
pressionavas-vos	pressionar+V.vós.AD.2.PL+IMPF+2+SG
pressionava-te	pressionar+V.tu.AD.2.SG+IMPF+1+SG
pressionava-te	pressionar+V.tu.AD.2.SG+IMPF+3+SG
pressionava-vos	pressionar+V.vós.AD.2.PL+IMPF+1+SG
pressionava-vos	pressionar+V.vós.AD.2.PL+IMPF+3+SG
pressionávei-la	pressionar+V.ele.ACC.3.F.SG+IMPF+2+PL
pressionávei-las	pressionar+V.ele.ACC.3.F.PL+IMPF+2+PL
pressionávei-lo	pressionar+V.ele.ACC.3.M.SG+IMPF+2+PL
pressionávei-los	pressionar+V.ele.ACC.3.M.PL+IMPF+2+PL
pressionávei-nos	pressionar+nós.AD.1.PL+IMPF+2+PL
pressionáveis-lhe	pressionar+V.ele.DAT.3.SG+IMPF+2+PL
pressionáveis-lhes	pressionar+V.ele.DAT.3.PL+IMPF+2+PL
pressionáveis-me	pressionar+V.eu.AD.1.SG+IMPF+2+PL
pressionáveis-te	pressionar+V.tu.AD.2.SG+IMPF+2+PL
pressionáveis-vos	pressionar+V.vós.AD.2.PL+IMPF+2+PL
pressiona-vos	pressionar+V.vós.AD.2.PL+PRS+3+SG
pressione-a	pressionar+V.ele.ACC.3.F.SG+IMP+3+SG
pressione-as	pressionar+V.ele.ACC.3.F.PL+IMP+3+SG
pressionei-a	pressionar+V.ele.ACC.3.F.SG+PRF+1+SG
pressionei-as	pressionar+V.ele.ACC.3.F.PL+PRF+1+SG
pressionei-lhe	pressionar+V.ele.DAT.3.SG+PRF+1+SG
pressionei-lhes	pressionar+V.ele.DAT.3.PL+PRF+1+SG
pressionei-me	pressionar+V.eu.AD.1.SG+PRF+1+SG
pressionei-nos	pressionar+nós.AD.1.PL+PRF+1+SG
pressionei-o	pressionar+V.ele.ACC.3.M.SG+PRF+1+SG
pressionei-os	pressionar+V.ele.ACC.3.M.PL+PRF+1+SG
pressionei-te	pressionar+V.tu.AD.2.SG+PRF+1+SG
pressionei-vos	pressionar+V.vós.AD.2.PL+PRF+1+SG
pressione-lhe	pressionar+V.ele.DAT.3.SG+IMP+3+SG
pressione-lhes	pressionar+V.ele.DAT.3.PL+IMP+3+SG
pressione-me	pressionar+V.eu.AD.1.SG+IMP+3+SG
pressionem-lhe	pressionar+V.ele.DAT.3.SG+IMP+3+PL
pressionem-lhes	pressionar+V.ele.DAT.3.PL+IMP+3+PL
pressionem-me	pressionar+V.eu.AD.1.SG+IMP+3+PL
pressionem-na	pressionar+V.ele.ACC.3.F.SG+IMP+3+PL
pressionem-nas	pressionar+V.ele.ACC.3.F.PL+IMP+3+PL
pressionem-no	pressionar+V.ele.ACC.3.M.SG+IMP+3+PL
pressionem-nos	pressionar+V.ele.ACC.3.M.PL+IMP+3+PL
pressionem-nos	pressionar+V.nós.AD.1.PL+IMP+3+PL
pressionemo-la	pressionar+V.ele.ACC.3.F.SG+IMP+1+PL
pressionemo-las	pressionar+V.ele.ACC.3.F.PL+IMP+1+PL
pressionemo-lo	pressionar+V.ele.ACC.3.M.SG+IMP+1+PL
pressionemo-los	pressionar+V.ele.ACC.3.M.PL+IMP+1+PL
pressionemo-nos	pressionar+nós.AD.1.PL+IMP+1+PL
pressionemos-lhe	pressionar+V.ele.DAT.3.SG+IMP+1+PL
pressionemos-lhes	pressionar+V.ele.DAT.3.PL+IMP+1+PL
pressionemos-me	pressionar+V.eu.AD.1.SG+IMP+1+PL
pressionemos-te	pressionar+V.tu.AD.2.SG+IMP+1+PL
pressionemos-vos	pressionar+V.vós.AD.2.PL+IMP+1+PL
pressionem-se	pressionar+V.ele.REFL+IMP+3+PL
pressionem-te	pressionar+V.tu.AD.2.SG+IMP+3+PL
pressionem-vos	pressionar+V.vós.AD.2.PL+IMP+3+PL
pressione-nos	pressionar+nós.AD.1.PL+IMP+3+SG
pressione-o	pressionar+V.ele.ACC.3.M.SG+IMP+3+SG
pressione-os	pressionar+V.ele.ACC.3.M.PL+IMP+3+SG
pressione-se	pressionar+V.ele.REFL+IMP+3+SG
pressione-te	pressionar+V.tu.AD.2.SG+IMP+3+SG
pressione-vos	pressionar+V.vós.AD.2.PL+IMP+3+SG
pressiono-a	pressionar+V.ele.ACC.3.F.SG+PRS+1+SG
pressiono-as	pressionar+V.ele.ACC.3.F.PL+PRS+1+SG
pressiono-lhe	pressionar+V.ele.DAT.3.SG+PRS+1+SG
pressiono-lhes	pressionar+V.ele.DAT.3.PL+PRS+1+SG
pressiono-me	pressionar+V.eu.AD.1.SG+PRS+1+SG
pressiono-nos	pressionar+nós.AD.1.PL+PRS+1+SG
pressiono-o	pressionar+V.ele.ACC.3.M.SG+PRS+1+SG
pressiono-os	pressionar+V.ele.ACC.3.M.PL+PRS+1+SG
pressiono-te	pressionar+V.tu.AD.2.SG+PRS+1+SG
pressionou-a	pressionar+V.ele.ACC.3.F.SG+PRF+3+SG
pressionou-as	pressionar+V.ele.ACC.3.F.PL+PRF+3+SG
pressionou-lhe	pressionar+V.ele.DAT.3.SG+PRF+3+SG
pressionou-lhes	pressionar+V.ele.DAT.3.PL+PRF+3+SG
pressionou-me	pressionar+V.eu.AD.1.SG+PRF+3+SG
pressionou-nos	pressionar+nós.AD.1.PL+PRF+3+SG
pressionou-o	pressionar+V.ele.ACC.3.M.SG+PRF+3+SG
pressionou-os	pressionar+V.ele.ACC.3.M.PL+PRF+3+SG
pressionou-se	pressionar+V.ele.REFL+PRF+3+SG
pressionou-te	pressionar+V.tu.AD.2.SG+PRF+3+SG
pressionou-vos	pressionar+V.vós.AD.2.PL+PRF+3+SG
pressiono-vos	pressionar+V.vós.AD.2.PL+PRS+1+SG
pressupõe-la	pressupor+V.ele.ACC.3.F.SG+PRS+2+SG
pressupõe-las	pressupor+V.ele.ACC.3.F.PL+PRS+2+SG
pressupõe-lhe	pressupor+V.ele.DAT.3.SG+IMP+2+SG
pressupõe-lhe	pressupor+V.ele.DAT.3.SG+PRS+3+SG
pressupõe-lhes	pressupor+V.ele.DAT.3.PL+IMP+2+SG
pressupõe-lhes	pressupor+V.ele.DAT.3.PL+PRS+3+SG
pressupõe-lo	pressupor+V.ele.ACC.3.M.SG+PRS+2+SG
pressupõe-los	pressupor+V.ele.ACC.3.M.PL+PRS+2+SG
pressupõe-me	pressupor+V.eu.AD.1.SG+IMP+2+SG
pressupõe-me	pressupor+V.eu.AD.1.SG+PRS+3+SG
pressupõem-lhe	pressupor+V.ele.DAT.3.SG+PRS+3+PL
pressupõem-lhes	pressupor+V.ele.DAT.3.PL+PRS+3+PL
pressupõem-me	pressupor+V.eu.AD.1.SG+PRS+3+PL
pressupõem-na	pressupor+V.ele.ACC.3.F.SG+PRS+3+PL
pressupõem-nas	pressupor+V.ele.ACC.3.F.PL+PRS+3+PL
pressupõem-no	pressupor+V.ele.ACC.3.M.SG+PRS+3+PL
pressupõem-nos	pressupor+nós.AD.1.PL+PRS+3+PL
pressupõem-se	pressupor+V.ele.REFL+PRS+3+PL
pressupõem-te	pressupor+V.tu.AD.2.SG+PRS+3+PL
pressupõem-vos	pressupor+V.vós.AD.2.PL+PRS+3+PL
pressupõe-na	pressupor+V.ele.ACC.3.F.SG+IMP+2+SG
pressupõe-na	pressupor+V.ele.ACC.3.F.SG+PRS+3+SG
pressupõe-nas	pressupor+V.ele.ACC.3.F.PL+IMP+2+SG
pressupõe-nas	pressupor+V.ele.ACC.3.F.PL+PRS+3+SG
pressupõe-no	pressupor+V.ele.ACC.3.M.SG+IMP+2+SG
pressupõe-no	pressupor+V.ele.ACC.3.M.SG+PRS+3+SG
pressupõe-nos	pressupor+V.ele.ACC.3.M.PL+IMP+2+SG
pressupõe-nos	pressupor+V.ele.ACC.3.M.PL+PRS+2+SG
pressupõe-nos	pressupor+V.ele.ACC.3.M.PL+PRS+3+SG
pressupõe-nos	pressupor+V.nós.AD.1.PL+IMP+2+SG
pressupõe-nos	pressupor+V.nós.AD.1.PL+PRS+2+SG
pressupõe-nos	pressupor+V.nós.AD.1.PL+PRS+3+SG
pressupõe-se	pressupor+V.ele.REFL+PRS+3+SG
pressupões-lhe	pressupor+V.ele.DAT.3.SG+PRS+2+SG
pressupões-lhes	pressupor+V.ele.DAT.3.PL+PRS+2+SG
pressupões-me	pressupor+V.eu.AD.1.SG+PRS+2+SG
pressupões-te	pressupor+V.tu.AD.2.SG+PRS+2+SG
pressupões-vos	pressupor+V.vós.AD.2.PL+PRS+2+SG
pressupõe-te	pressupor+V.tu.AD.2.SG+IMP+2+SG
pressupõe-te	pressupor+V.tu.AD.2.SG+PRS+3+SG
pressupõe-vos	pressupor+V.vós.AD.2.PL+IMP+2+SG
pressupõe-vos	pressupor+V.vós.AD.2.PL+PRS+3+SG
pressupô-la-ão	pressupor+V.ele.ACC.3.F.SG+FUT+3+PL
pressupô-la-á	pressupor+V.ele.ACC.3.F.SG+FUT+3+SG
pressupô-la-ás	pressupor+V.ele.ACC.3.F.SG+FUT+2+SG
pressupô-la-ei	pressupor+V.ele.ACC.3.F.SG+FUT+1+SG
pressupô-la-eis	pressupor+V.ele.ACC.3.F.SG+FUT+2+PL
pressupô-la-emos	pressupor+V.ele.ACC.3.F.SG+FUT+1+PL
pressupô-la-íamos	pressupor+V.ele.ACC.3.F.SG+COND+1+PL
pressupô-la-iam	pressupor+V.ele.ACC.3.F.SG+COND+3+PL
pressupô-la-ia	pressupor+V.ele.ACC.3.F.SG+COND+1+SG
pressupô-la-ia	pressupor+V.ele.ACC.3.F.SG+COND+3+SG
pressupô-la-ias	pressupor+V.ele.ACC.3.F.SG+COND+2+SG
pressupô-la-íeis	pressupor+V.ele.ACC.3.F.SG+COND+2+PL
pressupô-la	pressupor+V.ele.ACC.3.F.SG+INF+1+SG
pressupô-la	pressupor+V.ele.ACC.3.F.SG+INF+3+SG
pressupô-las-ão	pressupor+V.ele.ACC.3.F.PL+FUT+3+PL
pressupô-las-á	pressupor+V.ele.ACC.3.F.PL+FUT+3+SG
pressupô-las-ás	pressupor+V.ele.ACC.3.F.PL+FUT+2+SG
pressupô-las-ei	pressupor+V.ele.ACC.3.F.PL+FUT+1+SG
pressupô-las-eis	pressupor+V.ele.ACC.3.F.PL+FUT+2+PL
pressupô-las-emos	pressupor+V.ele.ACC.3.F.PL+FUT+1+PL
pressupô-las-íamos	pressupor+V.ele.ACC.3.F.PL+COND+1+PL
pressupô-las-iam	pressupor+V.ele.ACC.3.F.PL+COND+3+PL
pressupô-las-ia	pressupor+V.ele.ACC.3.F.PL+COND+1+SG
pressupô-las-ia	pressupor+V.ele.ACC.3.F.PL+COND+3+SG
pressupô-las-ias	pressupor+V.ele.ACC.3.F.PL+COND+2+SG
pressupô-las-íeis	pressupor+V.ele.ACC.3.F.PL+COND+2+PL
pressupô-las	pressupor+V.ele.ACC.3.F.PL+INF+1+SG
pressupô-las	pressupor+V.ele.ACC.3.F.PL+INF+3+SG
pressupô-lo-ão	pressupor+V.ele.ACC.3.M.SG+FUT+3+PL
pressupô-lo-á	pressupor+V.ele.ACC.3.M.SG+FUT+3+SG
pressupô-lo-ás	pressupor+V.ele.ACC.3.M.SG+FUT+2+SG
pressupô-lo-ei	pressupor+V.ele.ACC.3.M.SG+FUT+1+SG
pressupô-lo-eis	pressupor+V.ele.ACC.3.M.SG+FUT+2+PL
pressupô-lo-emos	pressupor+V.ele.ACC.3.M.SG+FUT+1+PL
pressupô-lo-íamos	pressupor+V.ele.ACC.3.M.SG+COND+1+PL
pressupô-lo-iam	pressupor+V.ele.ACC.3.M.SG+COND+3+PL
pressupô-lo-ia	pressupor+V.ele.ACC.3.M.SG+COND+1+SG
pressupô-lo-ia	pressupor+V.ele.ACC.3.M.SG+COND+3+SG
pressupô-lo-ias	pressupor+V.ele.ACC.3.M.SG+COND+2+SG
pressupô-lo-íeis	pressupor+V.ele.ACC.3.M.SG+COND+2+PL
pressupô-lo	pressupor+V.ele.ACC.3.M.SG+INF+1+SG
pressupô-lo	pressupor+V.ele.ACC.3.M.SG+INF+3+SG
pressupô-los-ão	pressupor+V.ele.ACC.3.M.PL+FUT+3+PL
pressupô-los-á	pressupor+V.ele.ACC.3.M.PL+FUT+3+SG
pressupô-los-ás	pressupor+V.ele.ACC.3.M.PL+FUT+2+SG
pressupô-los-ei	pressupor+V.ele.ACC.3.M.PL+FUT+1+SG
pressupô-los-eis	pressupor+V.ele.ACC.3.M.PL+FUT+2+PL
pressupô-los-emos	pressupor+V.ele.ACC.3.M.PL+FUT+1+PL
pressupô-los-íamos	pressupor+V.ele.ACC.3.M.PL+COND+1+PL
pressupô-los-iam	pressupor+V.ele.ACC.3.M.PL+COND+3+PL
pressupô-los-ia	pressupor+V.ele.ACC.3.M.PL+COND+1+SG
pressupô-los-ia	pressupor+V.ele.ACC.3.M.PL+COND+3+SG
pressupô-los-ias	pressupor+V.ele.ACC.3.M.PL+COND+2+SG
pressupô-los-íeis	pressupor+V.ele.ACC.3.M.PL+COND+2+PL
pressupô-los	pressupor+V.ele.ACC.3.M.PL+INF+1+SG
pressupô-los	pressupor+V.ele.ACC.3.M.PL+INF+3+SG
pressupomo-la	pressupor+V.ele.ACC.3.F.SG+PRS+1+PL
pressupomo-las	pressupor+V.ele.ACC.3.F.PL+PRS+1+PL
pressupomo-lo	pressupor+V.ele.ACC.3.M.SG+PRS+1+PL
pressupomo-los	pressupor+V.ele.ACC.3.M.PL+PRS+1+PL
pressupomo-nos	pressupor+nós.AD.1.PL+PRS+1+PL
pressupomos-lhe	pressupor+V.ele.DAT.3.SG+PRS+1+PL
pressupomos-lhes	pressupor+V.ele.DAT.3.PL+PRS+1+PL
pressupomos-me	pressupor+V.eu.AD.1.SG+PRS+1+PL
pressupomos-te	pressupor+V.tu.AD.2.SG+PRS+1+PL
pressupomos-vos	pressupor+V.vós.AD.2.PL+PRS+1+PL
pressuponde-la	pressupor+V.ele.ACC.3.F.SG+PRS+2+PL
pressuponde-las	pressupor+V.ele.ACC.3.F.PL+PRS+2+PL
pressuponde-lo	pressupor+V.ele.ACC.3.M.SG+PRS+2+PL
pressuponde-los	pressupor+V.ele.ACC.3.M.PL+PRS+2+PL
pressuponde-nos	pressupor+nós.AD.1.PL+PRS+2+PL
pressupondes-lhe	pressupor+V.ele.DAT.3.SG+PRS+2+PL
pressupondes-lhes	pressupor+V.ele.DAT.3.PL+PRS+2+PL
pressupondes-me	pressupor+V.eu.AD.1.SG+PRS+2+PL
pressupondes-te	pressupor+V.tu.AD.2.SG+PRS+2+PL
pressupondes-vos	pressupor+V.vós.AD.2.PL+PRS+2+PL
pressupondo-a	pressupor+V.ele.ACC.3.F.SG+GRD
pressupondo-as	pressupor+V.ele.ACC.3.F.PL+GRD
pressupondo-lhe	pressupor+V.ele.DAT.3.SG+GRD
pressupondo-lhes	pressupor+V.ele.DAT.3.PL+GRD
pressupondo-me	pressupor+V.eu.AD.1.SG+GRD
pressupondo-nos	pressupor+nós.AD.1.PL+GRD
pressupondo-o	pressupor+V.ele.ACC.3.M.SG+GRD
pressupondo-os	pressupor+V.ele.ACC.3.M.PL+GRD
pressupondo-se	pressupor+V.ele.REFL+GRD
pressupondo-te	pressupor+V.tu.AD.2.SG+GRD
pressupondo-vos	pressupor+V.vós.AD.2.PL+GRD
pressuponha-a	pressupor+V.ele.ACC.3.F.SG+IMP+3+SG
pressuponha-as	pressupor+V.ele.ACC.3.F.PL+IMP+3+SG
pressuponha-lhe	pressupor+V.ele.DAT.3.SG+IMP+3+SG
pressuponha-lhes	pressupor+V.ele.DAT.3.PL+IMP+3+SG
pressuponha-me	pressupor+V.eu.AD.1.SG+IMP+3+SG
pressuponham-lhe	pressupor+V.ele.DAT.3.SG+IMP+3+PL
pressuponham-lhes	pressupor+V.ele.DAT.3.PL+IMP+3+PL
pressuponham-me	pressupor+V.eu.AD.1.SG+IMP+3+PL
pressuponham-na	pressupor+V.ele.ACC.3.F.SG+IMP+3+PL
pressuponham-nas	pressupor+V.ele.ACC.3.F.PL+IMP+3+PL
pressuponham-no	pressupor+V.ele.ACC.3.M.SG+IMP+3+PL
pressuponham-nos	pressupor+V.ele.ACC.3.M.PL+IMP+3+PL
pressuponham-nos	pressupor+V.nós.AD.1.PL+IMP+3+PL
pressuponhamo-la	pressupor+V.ele.ACC.3.F.SG+IMP+1+PL
pressuponhamo-las	pressupor+V.ele.ACC.3.F.PL+IMP+1+PL
pressuponhamo-lo	pressupor+V.ele.ACC.3.M.SG+IMP+1+PL
pressuponhamo-los	pressupor+V.ele.ACC.3.M.PL+IMP+1+PL
pressuponhamo-nos	pressupor+nós.AD.1.PL+IMP+1+PL
pressuponhamos-lhe	pressupor+V.ele.DAT.3.SG+IMP+1+PL
pressuponhamos-lhes	pressupor+V.ele.DAT.3.PL+IMP+1+PL
pressuponhamos-me	pressupor+V.eu.AD.1.SG+IMP+1+PL
pressuponhamos-te	pressupor+V.tu.AD.2.SG+IMP+1+PL
pressuponhamos-vos	pressupor+V.vós.AD.2.PL+IMP+1+PL
pressuponham-se	pressupor+V.ele.REFL+IMP+3+PL
pressuponham-te	pressupor+V.tu.AD.2.SG+IMP+3+PL
pressuponham-vos	pressupor+V.vós.AD.2.PL+IMP+3+PL
pressuponha-nos	pressupor+nós.AD.1.PL+IMP+3+SG
pressuponha-o	pressupor+V.ele.ACC.3.M.SG+IMP+3+SG
pressuponha-os	pressupor+V.ele.ACC.3.M.PL+IMP+3+SG
pressuponha-se	pressupor+V.ele.REFL+IMP+3+SG
pressuponha-te	pressupor+V.tu.AD.2.SG+IMP+3+SG
pressuponha-vos	pressupor+V.vós.AD.2.PL+IMP+3+SG
pressuponho-a	pressupor+V.ele.ACC.3.F.SG+PRS+1+SG
pressuponho-as	pressupor+V.ele.ACC.3.F.PL+PRS+1+SG
pressuponho-lhe	pressupor+V.ele.DAT.3.SG+PRS+1+SG
pressuponho-lhes	pressupor+V.ele.DAT.3.PL+PRS+1+SG
pressuponho-me	pressupor+V.eu.AD.1.SG+PRS+1+SG
pressuponho-nos	pressupor+nós.AD.1.PL+PRS+1+SG
pressuponho-o	pressupor+V.ele.ACC.3.M.SG+PRS+1+SG
pressuponho-os	pressupor+V.ele.ACC.3.M.PL+PRS+1+SG
pressuponho-te	pressupor+V.tu.AD.2.SG+PRS+1+SG
pressuponho-vos	pressupor+V.vós.AD.2.PL+PRS+1+SG
pressuporem-lhe	pressupor+V.ele.DAT.3.SG+INF+3+PL
pressuporem-lhes	pressupor+V.ele.DAT.3.PL+INF+3+PL
pressuporem-me	pressupor+V.eu.AD.1.SG+INF+3+PL
pressuporem-nos	pressupor+V.ele.ACC.3.M.PL+INF+3+PL
pressuporem-nos	pressupor+V.nós.AD.1.PL+INF+3+PL
pressuporem-se	pressupor+V.ele.REFL+INF+3+PL
pressuporem-te	pressupor+V.tu.AD.2.SG+INF+3+PL
pressuporem-vos	pressupor+V.vós.AD.2.PL+INF+3+PL
pressupor-lhe-ão	pressupor+V.ele.DAT.3.SG+FUT+3+PL
pressupor-lhe-á	pressupor+V.ele.DAT.3.SG+FUT+3+SG
pressupor-lhe-ás	pressupor+V.ele.DAT.3.SG+FUT+2+SG
pressupor-lhe-ei	pressupor+V.ele.DAT.3.SG+FUT+1+SG
pressupor-lhe-eis	pressupor+V.ele.DAT.3.SG+FUT+2+PL
pressupor-lhe-emos	pressupor+V.ele.DAT.3.SG+FUT+1+PL
pressupor-lhe-íamos	pressupor+V.ele.DAT.3.SG+COND+1+PL
pressupor-lhe-iam	pressupor+V.ele.DAT.3.SG+COND+3+PL
pressupor-lhe-ia	pressupor+V.ele.DAT.3.SG+COND+1+SG
pressupor-lhe-ia	pressupor+V.ele.DAT.3.SG+COND+3+SG
pressupor-lhe-ias	pressupor+V.ele.DAT.3.SG+COND+2+SG
pressupor-lhe-íeis	pressupor+V.ele.DAT.3.SG+COND+2+PL
pressupor-lhe	pressupor+V.ele.DAT.3.SG+INF
pressupor-lhe	pressupor+V.ele.DAT.3.SG+INF+1
pressupor-lhe	pressupor+V.ele.DAT.3.SG+INF+1+SG
pressupor-lhe	pressupor+V.ele.DAT.3.SG+INF+3
pressupor-lhe	pressupor+V.ele.DAT.3.SG+INF+3+SG
pressupor-lhes-ão	pressupor+V.ele.DAT.3.PL+FUT+3+PL
pressupor-lhes-á	pressupor+V.ele.DAT.3.PL+FUT+3+SG
pressupor-lhes-ás	pressupor+V.ele.DAT.3.PL+FUT+2+SG
pressupor-lhes-ei	pressupor+V.ele.DAT.3.PL+FUT+1+SG
pressupor-lhes-eis	pressupor+V.ele.DAT.3.PL+FUT+2+PL
pressupor-lhes-emos	pressupor+V.ele.DAT.3.PL+FUT+1+PL
pressupor-lhes-íamos	pressupor+V.ele.DAT.3.PL+COND+1+PL
pressupor-lhes-iam	pressupor+V.ele.DAT.3.PL+COND+3+PL
pressupor-lhes-ia	pressupor+V.ele.DAT.3.PL+COND+1+SG
pressupor-lhes-ia	pressupor+V.ele.DAT.3.PL+COND+3+SG
pressupor-lhes-ias	pressupor+V.ele.DAT.3.PL+COND+2+SG
pressupor-lhes-íeis	pressupor+V.ele.DAT.3.PL+COND+2+PL
pressupor-lhes	pressupor+V.ele.DAT.3.PL+INF
pressupor-lhes	pressupor+V.ele.DAT.3.PL+INF+1
pressupor-lhes	pressupor+V.ele.DAT.3.PL+INF+1+SG
pressupor-lhes	pressupor+V.ele.DAT.3.PL+INF+3
pressupor-lhes	pressupor+V.ele.DAT.3.PL+INF+3+SG
pressupor-me-ão	pressupor+V.eu.AD.1.SG+FUT+3+PL
pressupor-me-á	pressupor+V.eu.AD.1.SG+FUT+3+SG
pressupor-me-ás	pressupor+V.eu.AD.1.SG+FUT+2+SG
pressupor-me-ei	pressupor+V.eu.AD.1.SG+FUT+1+SG
pressupor-me-eis	pressupor+V.eu.AD.1.SG+FUT+2+PL
pressupor-me-emos	pressupor+V.eu.AD.1.SG+FUT+1+PL
pressupor-me-íamos	pressupor+V.eu.AD.1.SG+COND+1+PL
pressupor-me-iam	pressupor+V.eu.AD.1.SG+COND+3+PL
pressupor-me-ia	pressupor+V.eu.AD.1.SG+COND+1+SG
pressupor-me-ia	pressupor+V.eu.AD.1.SG+COND+3+SG
pressupor-me-ias	pressupor+V.eu.AD.1.SG+COND+2+SG
pressupor-me-íeis	pressupor+V.eu.AD.1.SG+COND+2+PL
pressupor-me	pressupor+V.eu.AD.1.SG+INF
pressupor-me	pressupor+V.eu.AD.1.SG+INF+1
pressupor-me	pressupor+V.eu.AD.1.SG+INF+1+SG
pressupor-me	pressupor+V.eu.AD.1.SG+INF+3
pressupor-me	pressupor+V.eu.AD.1.SG+INF+3+SG
pressupor-nos-ão	pressupor+nós.AD.1.PL+FUT+3+PL
pressupor-nos-á	pressupor+nós.AD.1.PL+FUT+3+SG
pressupor-nos-ás	pressupor+nós.AD.1.PL+FUT+2+SG
pressupor-nos-ei	pressupor+nós.AD.1.PL+FUT+1+SG
pressupor-nos-eis	pressupor+nós.AD.1.PL+FUT+2+PL
pressupor-nos-emos	pressupor+nós.AD.1.PL+FUT+1+PL
pressupor-nos-íamos	pressupor+nós.AD.1.PL+COND+1+PL
pressupor-nos-iam	pressupor+nós.AD.1.PL+COND+3+PL
pressupor-nos-ia	pressupor+nós.AD.1.PL+COND+1+SG
pressupor-nos-ia	pressupor+nós.AD.1.PL+COND+3+SG
pressupor-nos-ias	pressupor+nós.AD.1.PL+COND+2+SG
pressupor-nos-íeis	pressupor+nós.AD.1.PL+COND+2+PL
pressupor-nos	pressupor+nós.AD.1.PL+INF
pressupor-nos	pressupor+nós.AD.1.PL+INF+1
pressupor-nos	pressupor+nós.AD.1.PL+INF+1+SG
pressupor-nos	pressupor+nós.AD.1.PL+INF+3
pressupor-nos	pressupor+nós.AD.1.PL+INF+3+SG
pressupor-se-ão	pressupor+V.ele.REFL+FUT+3+PL
pressupor-se-á	pressupor+V.ele.REFL+FUT+3+SG
pressupor-se-iam	pressupor+V.ele.REFL+COND+3+PL
pressupor-se-ia	pressupor+V.ele.REFL+COND+3+SG
pressupor-se	pressupor+V.ele.REFL+INF
pressupor-se	pressupor+V.ele.REFL+INF+3
pressupor-se	pressupor+V.ele.REFL+INF+3+SG
pressupor-te-ão	pressupor+V.tu.AD.2.SG+FUT+3+PL
pressupor-te-á	pressupor+V.tu.AD.2.SG+FUT+3+SG
pressupor-te-ás	pressupor+V.tu.AD.2.SG+FUT+2+SG
pressupor-te-ei	pressupor+V.tu.AD.2.SG+FUT+1+SG
pressupor-te-eis	pressupor+V.tu.AD.2.SG+FUT+2+PL
pressupor-te-emos	pressupor+V.tu.AD.2.SG+FUT+1+PL
pressupor-te-íamos	pressupor+V.tu.AD.2.SG+COND+1+PL
pressupor-te-iam	pressupor+V.tu.AD.2.SG+COND+3+PL
pressupor-te-ia	pressupor+V.tu.AD.2.SG+COND+1+SG
pressupor-te-ia	pressupor+V.tu.AD.2.SG+COND+3+SG
pressupor-te-ias	pressupor+V.tu.AD.2.SG+COND+2+SG
pressupor-te-íeis	pressupor+V.tu.AD.2.SG+COND+2+PL
pressupor-te	pressupor+V.tu.AD.2.SG+INF
pressupor-te	pressupor+V.tu.AD.2.SG+INF+1
pressupor-te	pressupor+V.tu.AD.2.SG+INF+1+SG
pressupor-te	pressupor+V.tu.AD.2.SG+INF+3
pressupor-te	pressupor+V.tu.AD.2.SG+INF+3+SG
pressupor-vos-ão	pressupor+V.vós.AD.2.PL+FUT+3+PL
pressupor-vos-á	pressupor+V.vós.AD.2.PL+FUT+3+SG
pressupor-vos-ás	pressupor+V.vós.AD.2.PL+FUT+2+SG
pressupor-vos-ei	pressupor+V.vós.AD.2.PL+FUT+1+SG
pressupor-vos-eis	pressupor+V.vós.AD.2.PL+FUT+2+PL
pressupor-vos-emos	pressupor+V.vós.AD.2.PL+FUT+1+PL
pressupor-vos-íamos	pressupor+V.vós.AD.2.PL+COND+1+PL
pressupor-vos-iam	pressupor+V.vós.AD.2.PL+COND+3+PL
pressupor-vos-ia	pressupor+V.vós.AD.2.PL+COND+1+SG
pressupor-vos-ia	pressupor+V.vós.AD.2.PL+COND+3+SG
pressupor-vos-ias	pressupor+V.vós.AD.2.PL+COND+2+SG
pressupor-vos-íeis	pressupor+V.vós.AD.2.PL+COND+2+PL
pressupor-vos	pressupor+V.vós.AD.2.PL+INF
pressupor-vos	pressupor+V.vós.AD.2.PL+INF+1
pressupor-vos	pressupor+V.vós.AD.2.PL+INF+1+SG
pressupor-vos	pressupor+V.vós.AD.2.PL+INF+3
pressupor-vos	pressupor+V.vós.AD.2.PL+INF+3+SG
pressupôs-lhe	pressupor+V.ele.DAT.3.SG+PRF+3+SG
pressupôs-lhes	pressupor+V.ele.DAT.3.PL+PRF+3+SG
pressupôs-me	pressupor+V.eu.AD.1.SG+PRF+3+SG
pressupôs-nos	pressupor+nós.AD.1.PL+PRF+3+SG
pressupôs-se	pressupor+V.ele.REFL+PRF+3+SG
pressupôs-te	pressupor+V.tu.AD.2.SG+PRF+3+SG
pressupôs-vos	pressupor+V.vós.AD.2.PL+PRF+3+SG
pressupu-la	pressupor+V.ele.ACC.3.F.SG+PRF+1+SG
pressupu-las	pressupor+V.ele.ACC.3.F.PL+PRF+1+SG
pressupu-lo	pressupor+V.ele.ACC.3.M.SG+PRF+1+SG
pressupu-los	pressupor+V.ele.ACC.3.M.PL+PRF+1+SG
pressupunha-a	pressupor+V.ele.ACC.3.F.SG+IMPF+1+SG
pressupunha-a	pressupor+V.ele.ACC.3.F.SG+IMPF+3+SG
pressupunha-as	pressupor+V.ele.ACC.3.F.PL+IMPF+1+SG
pressupunha-as	pressupor+V.ele.ACC.3.F.PL+IMPF+3+SG
pressupunha-la	pressupor+V.ele.ACC.3.F.SG+IMPF+2+SG
pressupunha-las	pressupor+V.ele.ACC.3.F.PL+IMPF+2+SG
pressupunha-lhe	pressupor+V.ele.DAT.3.SG+IMPF+1+SG
pressupunha-lhe	pressupor+V.ele.DAT.3.SG+IMPF+3+SG
pressupunha-lhes	pressupor+V.ele.DAT.3.PL+IMPF+1+SG
pressupunha-lhes	pressupor+V.ele.DAT.3.PL+IMPF+3+SG
pressupunha-lo	pressupor+V.ele.ACC.3.M.SG+IMPF+2+SG
pressupunha-los	pressupor+V.ele.ACC.3.M.PL+IMPF+2+SG
pressupunha-me	pressupor+V.eu.AD.1.SG+IMPF+1+SG
pressupunha-me	pressupor+V.eu.AD.1.SG+IMPF+3+SG
pressupunham-lhe	pressupor+V.ele.DAT.3.SG+IMPF+3+PL
pressupunham-lhes	pressupor+V.ele.DAT.3.PL+IMPF+3+PL
pressupunham-me	pressupor+V.eu.AD.1.SG+IMPF+3+PL
pressupunham-na	pressupor+V.ele.ACC.3.F.SG+IMPF+3+PL
pressupunham-nas	pressupor+V.ele.ACC.3.F.PL+IMPF+3+PL
pressupunham-no	pressupor+V.ele.ACC.3.M.SG+IMPF+3+PL
pressupunham-nos	pressupor+V.ele.ACC.3.M.PL+IMPF+3+PL
pressupunham-nos	pressupor+V.nós.AD.1.PL+IMPF+3+PL
pressupúnhamo-la	pressupor+V.ele.ACC.3.F.SG+IMPF+1+PL
pressupúnhamo-las	pressupor+V.ele.ACC.3.F.PL+IMPF+1+PL
pressupúnhamo-lo	pressupor+V.ele.ACC.3.M.SG+IMPF+1+PL
pressupúnhamo-los	pressupor+V.ele.ACC.3.M.PL+IMPF+1+PL
pressupúnhamo-nos	pressupor+nós.AD.1.PL+IMPF+1+PL
pressupúnhamos-lhe	pressupor+V.ele.DAT.3.SG+IMPF+1+PL
pressupúnhamos-lhes	pressupor+V.ele.DAT.3.PL+IMPF+1+PL
pressupúnhamos-me	pressupor+V.eu.AD.1.SG+IMPF+1+PL
pressupúnhamos-te	pressupor+V.tu.AD.2.SG+IMPF+1+PL
pressupúnhamos-vos	pressupor+V.vós.AD.2.PL+IMPF+1+PL
pressupunham-se	pressupor+V.ele.REFL+IMPF+3+PL
pressupunham-te	pressupor+V.tu.AD.2.SG+IMPF+3+PL
pressupunham-vos	pressupor+V.vós.AD.2.PL+IMPF+3+PL
pressupunha-nos	pressupor+nós.AD.1.PL+IMPF+1+SG
pressupunha-nos	pressupor+nós.AD.1.PL+IMPF+2+SG
pressupunha-nos	pressupor+nós.AD.1.PL+IMPF+3+SG
pressupunha-o	pressupor+V.ele.ACC.3.M.SG+IMPF+1+SG
pressupunha-o	pressupor+V.ele.ACC.3.M.SG+IMPF+3+SG
pressupunha-os	pressupor+V.ele.ACC.3.M.PL+IMPF+1+SG
pressupunha-os	pressupor+V.ele.ACC.3.M.PL+IMPF+3+SG
pressupunha-se	pressupor+V.ele.REFL+IMPF+3+SG
pressupunhas-lhe	pressupor+V.ele.DAT.3.SG+IMPF+2+SG
pressupunhas-lhes	pressupor+V.ele.DAT.3.PL+IMPF+2+SG
pressupunhas-me	pressupor+V.eu.AD.1.SG+IMPF+2+SG
pressupunhas-te	pressupor+V.tu.AD.2.SG+IMPF+2+SG
pressupunhas-vos	pressupor+V.vós.AD.2.PL+IMPF+2+SG
pressupunha-te	pressupor+V.tu.AD.2.SG+IMPF+1+SG
pressupunha-te	pressupor+V.tu.AD.2.SG+IMPF+3+SG
pressupunha-vos	pressupor+V.vós.AD.2.PL+IMPF+1+SG
pressupunha-vos	pressupor+V.vós.AD.2.PL+IMPF+3+SG
pressupúnhei-la	pressupor+V.ele.ACC.3.F.SG+IMPF+2+PL
pressupúnhei-las	pressupor+V.ele.ACC.3.F.PL+IMPF+2+PL
pressupúnhei-lo	pressupor+V.ele.ACC.3.M.SG+IMPF+2+PL
pressupúnhei-los	pressupor+V.ele.ACC.3.M.PL+IMPF+2+PL
pressupúnhei-nos	pressupor+nós.AD.1.PL+IMPF+2+PL
pressupúnheis-lhe	pressupor+V.ele.DAT.3.SG+IMPF+2+PL
pressupúnheis-lhes	pressupor+V.ele.DAT.3.PL+IMPF+2+PL
pressupúnheis-me	pressupor+V.eu.AD.1.SG+IMPF+2+PL
pressupúnheis-te	pressupor+V.tu.AD.2.SG+IMPF+2+PL
pressupúnheis-vos	pressupor+V.vós.AD.2.PL+IMPF+2+PL
pressupusé-la	pressupor+V.ele.ACC.3.F.SG+SBJF+1+SG
pressupusé-la	pressupor+V.ele.ACC.3.F.SG+SBJF+3+SG
pressupusé-las	pressupor+V.ele.ACC.3.F.PL+SBJF+1+SG
pressupusé-las	pressupor+V.ele.ACC.3.F.PL+SBJF+3+SG
pressupusé-lo	pressupor+V.ele.ACC.3.M.SG+SBJF+1+SG
pressupusé-lo	pressupor+V.ele.ACC.3.M.SG+SBJF+3+SG
pressupusé-los	pressupor+V.ele.ACC.3.M.PL+SBJF+1+SG
pressupusé-los	pressupor+V.ele.ACC.3.M.PL+SBJF+3+SG
pressupusemo-la	pressupor+V.ele.ACC.3.F.SG+PRF+1+PL
pressupusemo-las	pressupor+V.ele.ACC.3.F.PL+PRF+1+PL
pressupusemo-lo	pressupor+V.ele.ACC.3.M.SG+PRF+1+PL
pressupusemo-los	pressupor+V.ele.ACC.3.M.PL+PRF+1+PL
pressupusemo-nos	pressupor+nós.AD.1.PL+PRF+1+PL
pressupusemos-lhe	pressupor+V.ele.DAT.3.SG+PRF+1+PL
pressupusemos-lhes	pressupor+V.ele.DAT.3.PL+PRF+1+PL
pressupusemos-me	pressupor+V.eu.AD.1.SG+PRF+1+PL
pressupusemos-te	pressupor+V.tu.AD.2.SG+PRF+1+PL
pressupusemos-vos	pressupor+V.vós.AD.2.PL+PRF+1+PL
pressupusera-a	pressupor+V.ele.ACC.3.F.SG+PQP+1+SG
pressupusera-a	pressupor+V.ele.ACC.3.F.SG+PQP+3+SG
pressupusera-as	pressupor+V.ele.ACC.3.F.PL+PQP+1+SG
pressupusera-as	pressupor+V.ele.ACC.3.F.PL+PQP+3+SG
pressupusera-la	pressupor+V.ele.ACC.3.F.SG+PQP+2+SG
pressupusera-las	pressupor+V.ele.ACC.3.F.PL+PQP+2+SG
pressupusera-lhe	pressupor+V.ele.DAT.3.SG+PQP+1+SG
pressupusera-lhe	pressupor+V.ele.DAT.3.SG+PQP+3+SG
pressupusera-lhes	pressupor+V.ele.DAT.3.PL+PQP+1+SG
pressupusera-lhes	pressupor+V.ele.DAT.3.PL+PQP+3+SG
pressupusera-lo	pressupor+V.ele.ACC.3.M.SG+PQP+2+SG
pressupusera-los	pressupor+V.ele.ACC.3.M.PL+PQP+2+SG
pressupusera-me	pressupor+V.eu.AD.1.SG+PQP+1+SG
pressupusera-me	pressupor+V.eu.AD.1.SG+PQP+3+SG
pressupuseram-lhe	pressupor+V.ele.DAT.3.SG+PQP+3+PL
pressupuseram-lhe	pressupor+V.ele.DAT.3.SG+PRF+3+PL
pressupuseram-lhes	pressupor+V.ele.DAT.3.PL+PQP+3+PL
pressupuseram-lhes	pressupor+V.ele.DAT.3.PL+PRF+3+PL
pressupuseram-me	pressupor+V.eu.AD.1.SG+PQP+3+PL
pressupuseram-me	pressupor+V.eu.AD.1.SG+PRF+3+PL
pressupuseram-na	pressupor+V.ele.ACC.3.F.SG+PQP+3+PL
pressupuseram-na	pressupor+V.ele.ACC.3.F.SG+PRF+3+PL
pressupuseram-nas	pressupor+V.ele.ACC.3.F.PL+PQP+3+PL
pressupuseram-nas	pressupor+V.ele.ACC.3.F.PL+PRF+3+PL
pressupuseram-no	pressupor+V.ele.ACC.3.M.SG+PQP+3+PL
pressupuseram-no	pressupor+V.ele.ACC.3.M.SG+PRF+3+PL
pressupuseram-nos	pressupor+V.ele.ACC.3.M.PL+PQP+3+PL
pressupuseram-nos	pressupor+V.ele.ACC.3.M.PL+PRF+3+PL
pressupuseram-nos	pressupor+V.nós.AD.1.PL+PQP+3+PL
pressupuseram-nos	pressupor+V.nós.AD.1.PL+PRF+3+PL
pressupuséramo-la	pressupor+V.ele.ACC.3.F.SG+PQP+1+PL
pressupuséramo-las	pressupor+V.ele.ACC.3.F.PL+PQP+1+PL
pressupuséramo-lo	pressupor+V.ele.ACC.3.M.SG+PQP+1+PL
pressupuséramo-los	pressupor+V.ele.ACC.3.M.PL+PQP+1+PL
pressupuséramo-nos	pressupor+nós.AD.1.PL+PQP+1+PL
pressupuséramos-lhe	pressupor+V.ele.DAT.3.SG+PQP+1+PL
pressupuséramos-lhes	pressupor+V.ele.DAT.3.PL+PQP+1+PL
pressupuséramos-me	pressupor+V.eu.AD.1.SG+PQP+1+PL
pressupuséramos-te	pressupor+V.tu.AD.2.SG+PQP+1+PL
pressupuséramos-vos	pressupor+V.vós.AD.2.PL+PQP+1+PL
pressupuseram-se	pressupor+V.ele.REFL+PQP+3+PL
pressupuseram-se	pressupor+V.ele.REFL+PRF+3+PL
pressupuseram-te	pressupor+V.tu.AD.2.SG+PQP+3+PL
pressupuseram-te	pressupor+V.tu.AD.2.SG+PRF+3+PL
pressupuseram-vos	pressupor+V.vós.AD.2.PL+PQP+3+PL
pressupuseram-vos	pressupor+V.vós.AD.2.PL+PRF+3+PL
pressupusera-nos	pressupor+nós.AD.1.PL+PQP+1+SG
pressupusera-nos	pressupor+nós.AD.1.PL+PQP+2+SG
pressupusera-nos	pressupor+nós.AD.1.PL+PQP+3+SG
pressupusera-o	pressupor+V.ele.ACC.3.M.SG+PQP+1+SG
pressupusera-o	pressupor+V.ele.ACC.3.M.SG+PQP+3+SG
pressupusera-os	pressupor+V.ele.ACC.3.M.PL+PQP+1+SG
pressupusera-os	pressupor+V.ele.ACC.3.M.PL+PQP+3+SG
pressupusera-se	pressupor+V.ele.REFL+PQP+3+SG
pressupuseras-lhe	pressupor+V.ele.DAT.3.SG+PQP+2+SG
pressupuseras-lhes	pressupor+V.ele.DAT.3.PL+PQP+2+SG
pressupuseras-me	pressupor+V.eu.AD.1.SG+PQP+2+SG
pressupuseras-te	pressupor+V.tu.AD.2.SG+PQP+2+SG
pressupuseras-vos	pressupor+V.vós.AD.2.PL+PQP+2+SG
pressupusera-te	pressupor+V.tu.AD.2.SG+PQP+1+SG
pressupusera-te	pressupor+V.tu.AD.2.SG+PQP+3+SG
pressupusera-vos	pressupor+V.vós.AD.2.PL+PQP+1+SG
pressupusera-vos	pressupor+V.vós.AD.2.PL+PQP+3+SG
pressupuserde-la	pressupor+V.ele.ACC.3.F.SG+SBJF+2+PL
pressupuserde-las	pressupor+V.ele.ACC.3.F.PL+SBJF+2+PL
pressupuserde-lo	pressupor+V.ele.ACC.3.M.SG+SBJF+2+PL
pressupuserde-los	pressupor+V.ele.ACC.3.M.PL+SBJF+2+PL
pressupuserde-nos	pressupor+nós.AD.1.PL+SBJF+2+PL
pressupuserdes-lhe	pressupor+V.ele.DAT.3.SG+SBJF+2+PL
pressupuserdes-lhes	pressupor+V.ele.DAT.3.PL+SBJF+2+PL
pressupuserdes-me	pressupor+V.eu.AD.1.SG+SBJF+2+PL
pressupuserdes-te	pressupor+V.tu.AD.2.SG+SBJF+2+PL
pressupuserdes-vos	pressupor+V.vós.AD.2.PL+SBJF+2+PL
pressupusérei-la	pressupor+V.ele.ACC.3.F.SG+PQP+2+PL
pressupusérei-las	pressupor+V.ele.ACC.3.F.PL+PQP+2+PL
pressupusérei-lo	pressupor+V.ele.ACC.3.M.SG+PQP+2+PL
pressupusérei-los	pressupor+V.ele.ACC.3.M.PL+PQP+2+PL
pressupusérei-nos	pressupor+nós.AD.1.PL+PQP+2+PL
pressupuséreis-lhe	pressupor+V.ele.DAT.3.SG+PQP+2+PL
pressupuséreis-lhes	pressupor+V.ele.DAT.3.PL+PQP+2+PL
pressupuséreis-me	pressupor+V.eu.AD.1.SG+PQP+2+PL
pressupuséreis-te	pressupor+V.tu.AD.2.SG+PQP+2+PL
pressupuséreis-vos	pressupor+V.vós.AD.2.PL+PQP+2+PL
pressupusere-la	pressupor+V.ele.ACC.3.F.SG+SBJF+2+SG
pressupusere-las	pressupor+V.ele.ACC.3.F.PL+SBJF+2+SG
pressupusere-lo	pressupor+V.ele.ACC.3.M.SG+SBJF+2+SG
pressupusere-los	pressupor+V.ele.ACC.3.M.PL+SBJF+2+SG
pressupuserem-lhe	pressupor+V.ele.DAT.3.SG+SBJF+3+PL
pressupuserem-lhes	pressupor+V.ele.DAT.3.PL+SBJF+3+PL
pressupuserem-me	pressupor+V.eu.AD.1.SG+SBJF+3+PL
pressupuserem-na	pressupor+V.ele.ACC.3.F.SG+SBJF+3+PL
pressupuserem-nas	pressupor+V.ele.ACC.3.F.PL+SBJF+3+PL
pressupuserem-no	pressupor+V.ele.ACC.3.M.SG+SBJF+3+PL
pressupuserem-nos	pressupor+V.ele.ACC.3.M.PL+SBJF+3+PL
pressupuserem-nos	pressupor+V.nós.AD.1.PL+SBJF+3+PL
pressupuserem-se	pressupor+V.ele.REFL+SBJF+3+PL
pressupuserem-te	pressupor+V.tu.AD.2.SG+SBJF+3+PL
pressupuserem-vos	pressupor+V.vós.AD.2.PL+SBJF+3+PL
pressupusere-nos	pressupor+nós.AD.1.PL+SBJF+2+SG
pressupuseres-lhe	pressupor+V.ele.DAT.3.SG+SBJF+2+SG
pressupuseres-lhes	pressupor+V.ele.DAT.3.PL+SBJF+2+SG
pressupuseres-me	pressupor+V.eu.AD.1.SG+SBJF+2+SG
pressupuseres-te	pressupor+V.tu.AD.2.SG+SBJF+2+SG
pressupuseres-vos	pressupor+V.vós.AD.2.PL+SBJF+2+SG
pressupuser-lhe	pressupor+V.ele.DAT.3.SG+SBJF+1+SG
pressupuser-lhe	pressupor+V.ele.DAT.3.SG+SBJF+3+SG
pressupuser-lhes	pressupor+V.ele.DAT.3.PL+SBJF+1+SG
pressupuser-lhes	pressupor+V.ele.DAT.3.PL+SBJF+3+SG
pressupuser-me	pressupor+V.eu.AD.1.SG+SBJF+1+SG
pressupuser-me	pressupor+V.eu.AD.1.SG+SBJF+3+SG
pressupusermo-la	pressupor+V.ele.ACC.3.F.SG+SBJF+1+PL
pressupusermo-las	pressupor+V.ele.ACC.3.F.PL+SBJF+1+PL
pressupusermo-lo	pressupor+V.ele.ACC.3.M.SG+SBJF+1+PL
pressupusermo-los	pressupor+V.ele.ACC.3.M.PL+SBJF+1+PL
pressupusermo-nos	pressupor+nós.AD.1.PL+SBJF+1+PL
pressupusermos-lhe	pressupor+V.ele.DAT.3.SG+SBJF+1+PL
pressupusermos-lhes	pressupor+V.ele.DAT.3.PL+SBJF+1+PL
pressupusermos-me	pressupor+V.eu.AD.1.SG+SBJF+1+PL
pressupusermos-te	pressupor+V.tu.AD.2.SG+SBJF+1+PL
pressupusermos-vos	pressupor+V.vós.AD.2.PL+SBJF+1+PL
pressupuser-nos	pressupor+nós.AD.1.PL+SBJF+1+SG
pressupuser-nos	pressupor+nós.AD.1.PL+SBJF+3+SG
pressupuser-se	pressupor+V.ele.REFL+SBJF+3+SG
pressupuser-te	pressupor+V.tu.AD.2.SG+SBJF+1+SG
pressupuser-te	pressupor+V.tu.AD.2.SG+SBJF+3+SG
pressupuser-vos	pressupor+V.vós.AD.2.PL+SBJF+1+SG
pressupuser-vos	pressupor+V.vós.AD.2.PL+SBJF+3+SG
pressupuseste-a	pressupor+V.ele.ACC.3.F.SG+PRF+2+SG
pressupuseste-as	pressupor+V.ele.ACC.3.F.PL+PRF+2+SG
pressupuseste-la	pressupor+V.ele.ACC.3.F.SG+PRF+2+PL
pressupuseste-las	pressupor+V.ele.ACC.3.F.PL+PRF+2+PL
pressupuseste-lhe	pressupor+V.ele.DAT.3.SG+PRF+2+SG
pressupuseste-lhes	pressupor+V.ele.DAT.3.PL+PRF+2+SG
pressupuseste-lo	pressupor+V.ele.ACC.3.M.SG+PRF+2+PL
pressupuseste-los	pressupor+V.ele.ACC.3.M.PL+PRF+2+PL
pressupuseste-me	pressupor+V.eu.AD.1.SG+PRF+2+SG
pressupuseste-nos	pressupor+nós.AD.1.PL+PRF+2+PL
pressupuseste-nos	pressupor+nós.AD.1.PL+PRF+2+SG
pressupuseste-o	pressupor+V.ele.ACC.3.M.SG+PRF+2+SG
pressupuseste-os	pressupor+V.ele.ACC.3.M.PL+PRF+2+SG
pressupusestes-lhe	pressupor+V.ele.DAT.3.SG+PRF+2+PL
pressupusestes-lhes	pressupor+V.ele.DAT.3.PL+PRF+2+PL
pressupusestes-me	pressupor+V.eu.AD.1.SG+PRF+2+PL
pressupusestes-te	pressupor+V.tu.AD.2.SG+PRF+2+PL
pressupusestes-vos	pressupor+V.vós.AD.2.PL+PRF+2+PL
pressupuseste-te	pressupor+V.tu.AD.2.SG+PRF+2+SG
pressupuseste-vos	pressupor+V.vós.AD.2.PL+PRF+2+SG
pressupus-lhe	pressupor+V.ele.DAT.3.SG+PRF+1+SG
pressupus-lhes	pressupor+V.ele.DAT.3.PL+PRF+1+SG
pressupus-me	pressupor+V.eu.AD.1.SG+PRF+1+SG
pressupus-nos	pressupor+nós.AD.1.PL+PRF+1+SG
pressupus-te	pressupor+V.tu.AD.2.SG+PRF+1+SG
pressupus-vos	pressupor+V.vós.AD.2.PL+PRF+1+SG
pressuriza-a	pressurizar+V.ele.ACC.3.F.SG+PRS+3+SG
pressuriza-as	pressurizar+V.ele.ACC.3.F.PL+PRS+3+SG
pressurizai-la	pressurizar+V.ele.ACC.3.F.SG+PRS+2+PL
pressurizai-las	pressurizar+V.ele.ACC.3.F.PL+PRS+2+PL
pressurizai-lo	pressurizar+V.ele.ACC.3.M.SG+PRS+2+PL
pressurizai-los	pressurizar+V.ele.ACC.3.M.PL+PRS+2+PL
pressurizai-nos	pressurizar+nós.AD.1.PL+PRS+2+PL
pressurizais-lhe	pressurizar+V.ele.DAT.3.SG+PRS+2+PL
pressurizais-lhes	pressurizar+V.ele.DAT.3.PL+PRS+2+PL
pressurizais-me	pressurizar+V.eu.AD.1.SG+PRS+2+PL
pressurizais-te	pressurizar+V.tu.AD.2.SG+PRS+2+PL
pressurizais-vos	pressurizar+V.vós.AD.2.PL+PRS+2+PL
pressurizá-la-ão	pressurizar+V.ele.ACC.3.F.SG+FUT+3+PL
pressurizá-la-á	pressurizar+V.ele.ACC.3.F.SG+FUT+3+SG
pressurizá-la-ás	pressurizar+V.ele.ACC.3.F.SG+FUT+2+SG
pressurizá-la-ei	pressurizar+V.ele.ACC.3.F.SG+FUT+1+SG
pressurizá-la-eis	pressurizar+V.ele.ACC.3.F.SG+FUT+2+PL
pressurizá-la-emos	pressurizar+V.ele.ACC.3.F.SG+FUT+1+PL
pressurizá-la-íamos	pressurizar+V.ele.ACC.3.F.SG+COND+1+PL
pressurizá-la-iam	pressurizar+V.ele.ACC.3.F.SG+COND+3+PL
pressurizá-la-ia	pressurizar+V.ele.ACC.3.F.SG+COND+1+SG
pressurizá-la-ia	pressurizar+V.ele.ACC.3.F.SG+COND+3+SG
pressurizá-la-ias	pressurizar+V.ele.ACC.3.F.SG+COND+2+SG
pressurizá-la-íeis	pressurizar+V.ele.ACC.3.F.SG+COND+2+PL
pressurizá-la	pressurizar+V.ele.ACC.3.F.SG+INF+1+SG
pressurizá-la	pressurizar+V.ele.ACC.3.F.SG+INF+3+SG
pressuriza-la	pressurizar+V.ele.ACC.3.F.SG+PRS+2+SG
pressurizá-la	pressurizar+V.ele.ACC.3.F.SG+SBJF+1+SG
pressurizá-la	pressurizar+V.ele.ACC.3.F.SG+SBJF+3+SG
pressurizá-las-ão	pressurizar+V.ele.ACC.3.F.PL+FUT+3+PL
pressurizá-las-á	pressurizar+V.ele.ACC.3.F.PL+FUT+3+SG
pressurizá-las-ás	pressurizar+V.ele.ACC.3.F.PL+FUT+2+SG
pressurizá-las-ei	pressurizar+V.ele.ACC.3.F.PL+FUT+1+SG
pressurizá-las-eis	pressurizar+V.ele.ACC.3.F.PL+FUT+2+PL
pressurizá-las-emos	pressurizar+V.ele.ACC.3.F.PL+FUT+1+PL
pressurizá-las-íamos	pressurizar+V.ele.ACC.3.F.PL+COND+1+PL
pressurizá-las-iam	pressurizar+V.ele.ACC.3.F.PL+COND+3+PL
pressurizá-las-ia	pressurizar+V.ele.ACC.3.F.PL+COND+1+SG
pressurizá-las-ia	pressurizar+V.ele.ACC.3.F.PL+COND+3+SG
pressurizá-las-ias	pressurizar+V.ele.ACC.3.F.PL+COND+2+SG
pressurizá-las-íeis	pressurizar+V.ele.ACC.3.F.PL+COND+2+PL
pressurizá-las	pressurizar+V.ele.ACC.3.F.PL+INF+1+SG
pressurizá-las	pressurizar+V.ele.ACC.3.F.PL+INF+3+SG
pressuriza-las	pressurizar+V.ele.ACC.3.F.PL+PRS+2+SG
pressurizá-las	pressurizar+V.ele.ACC.3.F.PL+SBJF+1+SG
pressurizá-las	pressurizar+V.ele.ACC.3.F.PL+SBJF+3+SG
pressuriza-lhe	pressurizar+V.ele.DAT.3.SG+PRS+3+SG
pressuriza-lhes	pressurizar+V.ele.DAT.3.PL+PRS+3+SG
pressurizá-lo-ão	pressurizar+V.ele.ACC.3.M.SG+FUT+3+PL
pressurizá-lo-á	pressurizar+V.ele.ACC.3.M.SG+FUT+3+SG
pressurizá-lo-ás	pressurizar+V.ele.ACC.3.M.SG+FUT+2+SG
pressurizá-lo-ei	pressurizar+V.ele.ACC.3.M.SG+FUT+1+SG
pressurizá-lo-eis	pressurizar+V.ele.ACC.3.M.SG+FUT+2+PL
pressurizá-lo-emos	pressurizar+V.ele.ACC.3.M.SG+FUT+1+PL
pressurizá-lo-íamos	pressurizar+V.ele.ACC.3.M.SG+COND+1+PL
pressurizá-lo-iam	pressurizar+V.ele.ACC.3.M.SG+COND+3+PL
pressurizá-lo-ia	pressurizar+V.ele.ACC.3.M.SG+COND+1+SG
pressurizá-lo-ia	pressurizar+V.ele.ACC.3.M.SG+COND+3+SG
pressurizá-lo-ias	pressurizar+V.ele.ACC.3.M.SG+COND+2+SG
pressurizá-lo-íeis	pressurizar+V.ele.ACC.3.M.SG+COND+2+PL
pressurizá-lo	pressurizar+V.ele.ACC.3.M.SG+INF+1+SG
pressurizá-lo	pressurizar+V.ele.ACC.3.M.SG+INF+3+SG
pressuriza-lo	pressurizar+V.ele.ACC.3.M.SG+PRS+2+SG
pressurizá-lo	pressurizar+V.ele.ACC.3.M.SG+SBJF+1+SG
pressurizá-lo	pressurizar+V.ele.ACC.3.M.SG+SBJF+3+SG
pressurizá-los-ão	pressurizar+V.ele.ACC.3.M.PL+FUT+3+PL
pressurizá-los-á	pressurizar+V.ele.ACC.3.M.PL+FUT+3+SG
pressurizá-los-ás	pressurizar+V.ele.ACC.3.M.PL+FUT+2+SG
pressurizá-los-ei	pressurizar+V.ele.ACC.3.M.PL+FUT+1+SG
pressurizá-los-eis	pressurizar+V.ele.ACC.3.M.PL+FUT+2+PL
pressurizá-los-emos	pressurizar+V.ele.ACC.3.M.PL+FUT+1+PL
pressurizá-los-íamos	pressurizar+V.ele.ACC.3.M.PL+COND+1+PL
pressurizá-los-iam	pressurizar+V.ele.ACC.3.M.PL+COND+3+PL
pressurizá-los-ia	pressurizar+V.ele.ACC.3.M.PL+COND+1+SG
pressurizá-los-ia	pressurizar+V.ele.ACC.3.M.PL+COND+3+SG
pressurizá-los-ias	pressurizar+V.ele.ACC.3.M.PL+COND+2+SG
pressurizá-los-íeis	pressurizar+V.ele.ACC.3.M.PL+COND+2+PL
pressurizá-los	pressurizar+V.ele.ACC.3.M.PL+INF+1+SG
pressurizá-los	pressurizar+V.ele.ACC.3.M.PL+INF+3+SG
pressuriza-los	pressurizar+V.ele.ACC.3.M.PL+PRS+2+SG
pressurizá-los	pressurizar+V.ele.ACC.3.M.PL+SBJF+1+SG
pressurizá-los	pressurizar+V.ele.ACC.3.M.PL+SBJF+3+SG
pressuriza-me	pressurizar+V.eu.AD.1.SG+PRS+3+SG
pressurizam-lhe	pressurizar+V.ele.DAT.3.SG+PRS+3+PL
pressurizam-lhes	pressurizar+V.ele.DAT.3.PL+PRS+3+PL
pressurizam-me	pressurizar+V.eu.AD.1.SG+PRS+3+PL
pressurizam-na	pressurizar+V.ele.ACC.3.F.SG+PRS+3+PL
pressurizam-nas	pressurizar+V.ele.ACC.3.F.PL+PRS+3+PL
pressurizam-no	pressurizar+V.ele.ACC.3.M.SG+PRS+3+PL
pressurizam-nos	pressurizar+V.ele.ACC.3.M.PL+PRS+3+PL
pressurizam-nos	pressurizar+V.nós.AD.1.PL+PRS+3+PL
pressurizamo-la	pressurizar+V.ele.ACC.3.F.SG+PRF+1+PL
pressurizamo-la	pressurizar+V.ele.ACC.3.F.SG+PRS+1+PL
pressurizamo-las	pressurizar+V.ele.ACC.3.F.PL+PRF+1+PL
pressurizamo-las	pressurizar+V.ele.ACC.3.F.PL+PRS+1+PL
pressurizamo-lo	pressurizar+V.ele.ACC.3.M.SG+PRF+1+PL
pressurizamo-lo	pressurizar+V.ele.ACC.3.M.SG+PRS+1+PL
pressurizamo-los	pressurizar+V.ele.ACC.3.M.PL+PRF+1+PL
pressurizamo-los	pressurizar+V.ele.ACC.3.M.PL+PRS+1+PL
pressurizamo-nos	pressurizar+nós.AD.1.PL+PRF+1+PL
pressurizamo-nos	pressurizar+nós.AD.1.PL+PRS+1+PL
pressurizamos-lhe	pressurizar+V.ele.DAT.3.SG+PRF+1+PL
pressurizamos-lhe	pressurizar+V.ele.DAT.3.SG+PRS+1+PL
pressurizamos-lhes	pressurizar+V.ele.DAT.3.PL+PRF+1+PL
pressurizamos-lhes	pressurizar+V.ele.DAT.3.PL+PRS+1+PL
pressurizamos-me	pressurizar+V.eu.AD.1.SG+PRF+1+PL
pressurizamos-me	pressurizar+V.eu.AD.1.SG+PRS+1+PL
pressurizamos-te	pressurizar+V.tu.AD.2.SG+PRF+1+PL
pressurizamos-te	pressurizar+V.tu.AD.2.SG+PRS+1+PL
pressurizamos-vos	pressurizar+V.vós.AD.2.PL+PRF+1+PL
pressurizamos-vos	pressurizar+V.vós.AD.2.PL+PRS+1+PL
pressurizam-se	pressurizar+V.ele.REFL+PRS+3+PL
pressurizam-te	pressurizar+V.tu.AD.2.SG+PRS+3+PL
pressurizam-vos	pressurizar+V.vós.AD.2.PL+PRS+3+PL
pressurizando-a	pressurizar+V.ele.ACC.3.F.SG+GRD
pressurizando-as	pressurizar+V.ele.ACC.3.F.PL+GRD
pressurizando-lhe	pressurizar+V.ele.DAT.3.SG+GRD
pressurizando-lhes	pressurizar+V.ele.DAT.3.PL+GRD
pressurizando-me	pressurizar+V.eu.AD.1.SG+GRD
pressurizando-nos	pressurizar+nós.AD.1.PL+GRD
pressurizando-o	pressurizar+V.ele.ACC.3.M.SG+GRD
pressurizando-os	pressurizar+V.ele.ACC.3.M.PL+GRD
pressurizando-se	pressurizar+V.ele.REFL+GRD
pressurizando-te	pressurizar+V.tu.AD.2.SG+GRD
pressurizando-vos	pressurizar+V.vós.AD.2.PL+GRD
pressuriza-nos	pressurizar+nós.AD.1.PL+PRS+2+SG
pressuriza-nos	pressurizar+nós.AD.1.PL+PRS+3+SG
pressuriza-o	pressurizar+V.ele.ACC.3.M.SG+PRS+3+SG
pressuriza-os	pressurizar+V.ele.ACC.3.M.PL+PRS+3+SG
pressurizara-a	pressurizar+V.ele.ACC.3.F.SG+PQP+1+SG
pressurizara-a	pressurizar+V.ele.ACC.3.F.SG+PQP+3+SG
pressurizara-as	pressurizar+V.ele.ACC.3.F.PL+PQP+1+SG
pressurizara-as	pressurizar+V.ele.ACC.3.F.PL+PQP+3+SG
pressurizara-la	pressurizar+V.ele.ACC.3.F.SG+PQP+2+SG
pressurizara-las	pressurizar+V.ele.ACC.3.F.PL+PQP+2+SG
pressurizara-lhe	pressurizar+V.ele.DAT.3.SG+PQP+1+SG
pressurizara-lhe	pressurizar+V.ele.DAT.3.SG+PQP+3+SG
pressurizara-lhes	pressurizar+V.ele.DAT.3.PL+PQP+1+SG
pressurizara-lhes	pressurizar+V.ele.DAT.3.PL+PQP+3+SG
pressurizara-lo	pressurizar+V.ele.ACC.3.M.SG+PQP+2+SG
pressurizara-los	pressurizar+V.ele.ACC.3.M.PL+PQP+2+SG
pressurizara-me	pressurizar+V.eu.AD.1.SG+PQP+1+SG
pressurizara-me	pressurizar+V.eu.AD.1.SG+PQP+3+SG
pressurizaram-lhe	pressurizar+V.ele.DAT.3.SG+PQP+3+PL
pressurizaram-lhe	pressurizar+V.ele.DAT.3.SG+PRF+3+PL
pressurizaram-lhes	pressurizar+V.ele.DAT.3.PL+PQP+3+PL
pressurizaram-lhes	pressurizar+V.ele.DAT.3.PL+PRF+3+PL
pressurizaram-me	pressurizar+V.eu.AD.1.SG+PQP+3+PL
pressurizaram-me	pressurizar+V.eu.AD.1.SG+PRF+3+PL
pressurizaram-na	pressurizar+V.ele.ACC.3.F.SG+PQP+3+PL
pressurizaram-na	pressurizar+V.ele.ACC.3.F.SG+PRF+3+PL
pressurizaram-nas	pressurizar+V.ele.ACC.3.F.PL+PQP+3+PL
pressurizaram-nas	pressurizar+V.ele.ACC.3.F.PL+PRF+3+PL
pressurizaram-no	pressurizar+V.ele.ACC.3.M.SG+PQP+3+PL
pressurizaram-no	pressurizar+V.ele.ACC.3.M.SG+PRF+3+PL
pressurizaram-nos	pressurizar+V.ele.ACC.3.M.PL+PQP+3+PL
pressurizaram-nos	pressurizar+V.ele.ACC.3.M.PL+PRF+3+PL
pressurizaram-nos	pressurizar+V.nós.AD.1.PL+PQP+3+PL
pressurizaram-nos	pressurizar+V.nós.AD.1.PL+PRF+3+PL
pressurizáramo-la	pressurizar+V.ele.ACC.3.F.SG+PQP+1+PL
pressurizáramo-las	pressurizar+V.ele.ACC.3.F.PL+PQP+1+PL
pressurizáramo-lo	pressurizar+V.ele.ACC.3.M.SG+PQP+1+PL
pressurizáramo-los	pressurizar+V.ele.ACC.3.M.PL+PQP+1+PL
pressurizáramo-nos	pressurizar+nós.AD.1.PL+PQP+1+PL
pressurizáramos-lhe	pressurizar+V.ele.DAT.3.SG+PQP+1+PL
pressurizáramos-lhes	pressurizar+V.ele.DAT.3.PL+PQP+1+PL
pressurizáramos-me	pressurizar+V.eu.AD.1.SG+PQP+1+PL
pressurizáramos-te	pressurizar+V.tu.AD.2.SG+PQP+1+PL
pressurizáramos-vos	pressurizar+V.vós.AD.2.PL+PQP+1+PL
pressurizaram-se	pressurizar+V.ele.REFL+PQP+3+PL
pressurizaram-se	pressurizar+V.ele.REFL+PRF+3+PL
pressurizaram-te	pressurizar+V.tu.AD.2.SG+PQP+3+PL
pressurizaram-te	pressurizar+V.tu.AD.2.SG+PRF+3+PL
pressurizaram-vos	pressurizar+V.vós.AD.2.PL+PQP+3+PL
pressurizaram-vos	pressurizar+V.vós.AD.2.PL+PRF+3+PL
pressurizara-nos	pressurizar+nós.AD.1.PL+PQP+1+SG
pressurizara-nos	pressurizar+nós.AD.1.PL+PQP+2+SG
pressurizara-nos	pressurizar+nós.AD.1.PL+PQP+3+SG
pressurizara-o	pressurizar+V.ele.ACC.3.M.SG+PQP+1+SG
pressurizara-o	pressurizar+V.ele.ACC.3.M.SG+PQP+3+SG
pressurizara-os	pressurizar+V.ele.ACC.3.M.PL+PQP+1+SG
pressurizara-os	pressurizar+V.ele.ACC.3.M.PL+PQP+3+SG
pressurizara-se	pressurizar+V.ele.REFL+PQP+1+SG
pressurizara-se	pressurizar+V.ele.REFL+PQP+3+SG
pressurizaras-lhe	pressurizar+V.ele.DAT.3.SG+PQP+2+SG
pressurizaras-lhes	pressurizar+V.ele.DAT.3.PL+PQP+2+SG
pressurizaras-me	pressurizar+V.eu.AD.1.SG+PQP+2+SG
pressurizaras-te	pressurizar+V.tu.AD.2.SG+PQP+2+SG
pressurizaras-vos	pressurizar+V.vós.AD.2.PL+PQP+2+SG
pressurizara-te	pressurizar+V.tu.AD.2.SG+PQP+1+SG
pressurizara-te	pressurizar+V.tu.AD.2.SG+PQP+3+SG
pressurizara-vos	pressurizar+V.vós.AD.2.PL+PQP+1+SG
pressurizara-vos	pressurizar+V.vós.AD.2.PL+PQP+3+SG
pressurizarde-la	pressurizar+V.ele.ACC.3.F.SG+INF+2+PL
pressurizarde-la	pressurizar+V.ele.ACC.3.F.SG+SBJF+2+PL
pressurizarde-las	pressurizar+V.ele.ACC.3.F.PL+INF+2+PL
pressurizarde-las	pressurizar+V.ele.ACC.3.F.PL+SBJF+2+PL
pressurizarde-lo	pressurizar+V.ele.ACC.3.M.SG+INF+2+PL
pressurizarde-lo	pressurizar+V.ele.ACC.3.M.SG+SBJF+2+PL
pressurizarde-los	pressurizar+V.ele.ACC.3.M.PL+INF+2+PL
pressurizarde-los	pressurizar+V.ele.ACC.3.M.PL+SBJF+2+PL
pressurizarde-nos	pressurizar+nós.AD.1.PL+INF+2+PL
pressurizarde-nos	pressurizar+nós.AD.1.PL+SBJF+2+PL
pressurizardes-lhe	pressurizar+V.ele.DAT.3.SG+INF+2+PL
pressurizardes-lhe	pressurizar+V.ele.DAT.3.SG+SBJF+2+PL
pressurizardes-lhes	pressurizar+V.ele.DAT.3.PL+INF+2+PL
pressurizardes-lhes	pressurizar+V.ele.DAT.3.PL+SBJF+2+PL
pressurizardes-me	pressurizar+V.eu.AD.1.SG+INF+2+PL
pressurizardes-me	pressurizar+V.eu.AD.1.SG+SBJF+2+PL
pressurizardes-te	pressurizar+V.tu.AD.2.SG+INF+2+PL
pressurizardes-te	pressurizar+V.tu.AD.2.SG+SBJF+2+PL
pressurizardes-vos	pressurizar+V.vós.AD.2.PL+INF+2+PL
pressurizardes-vos	pressurizar+V.vós.AD.2.PL+SBJF+2+PL
