profanar-lhes-íamos	profanar+V.ele.DAT.3.PL+COND+1+PL
profanar-lhes-iam	profanar+V.ele.DAT.3.PL+COND+3+PL
profanar-lhes-ia	profanar+V.ele.DAT.3.PL+COND+1+SG
profanar-lhes-ia	profanar+V.ele.DAT.3.PL+COND+3+SG
profanar-lhes-ias	profanar+V.ele.DAT.3.PL+COND+2+SG
profanar-lhes-íeis	profanar+V.ele.DAT.3.PL+COND+2+PL
profanar-lhes	profanar+V.ele.DAT.3.PL+INF
profanar-lhes	profanar+V.ele.DAT.3.PL+INF+1+SG
profanar-lhes	profanar+V.ele.DAT.3.PL+INF+3+SG
profanar-lhes	profanar+V.ele.DAT.3.PL+SBJF+1+SG
profanar-lhes	profanar+V.ele.DAT.3.PL+SBJF+3+SG
profanar-me-ão	profanar+V.eu.AD.1.SG+FUT+3+PL
profanar-me-á	profanar+V.eu.AD.1.SG+FUT+3+SG
profanar-me-ás	profanar+V.eu.AD.1.SG+FUT+2+SG
profanar-me-ei	profanar+V.eu.AD.1.SG+FUT+1+SG
profanar-me-eis	profanar+V.eu.AD.1.SG+FUT+2+PL
profanar-me-emos	profanar+V.eu.AD.1.SG+FUT+1+PL
profanar-me-íamos	profanar+V.eu.AD.1.SG+COND+1+PL
profanar-me-iam	profanar+V.eu.AD.1.SG+COND+3+PL
profanar-me-ia	profanar+V.eu.AD.1.SG+COND+1+SG
profanar-me-ia	profanar+V.eu.AD.1.SG+COND+3+SG
profanar-me-ias	profanar+V.eu.AD.1.SG+COND+2+SG
profanar-me-íeis	profanar+V.eu.AD.1.SG+COND+2+PL
profanar-me	profanar+V.eu.AD.1.SG+INF
profanar-me	profanar+V.eu.AD.1.SG+INF+1+SG
profanar-me	profanar+V.eu.AD.1.SG+INF+3+SG
profanar-me	profanar+V.eu.AD.1.SG+SBJF+1+SG
profanar-me	profanar+V.eu.AD.1.SG+SBJF+3+SG
profanarmo-la	profanar+V.ele.ACC.3.F.SG+INF+1+PL
profanarmo-la	profanar+V.ele.ACC.3.F.SG+SBJF+1+PL
profanarmo-las	profanar+V.ele.ACC.3.F.PL+INF+1+PL
profanarmo-las	profanar+V.ele.ACC.3.F.PL+SBJF+1+PL
profanarmo-lo	profanar+V.ele.ACC.3.M.SG+INF+1+PL
profanarmo-lo	profanar+V.ele.ACC.3.M.SG+SBJF+1+PL
profanarmo-los	profanar+V.ele.ACC.3.M.PL+INF+1+PL
profanarmo-los	profanar+V.ele.ACC.3.M.PL+SBJF+1+PL
profanarmo-nos	profanar+nós.AD.1.PL+INF+1+PL
profanarmo-nos	profanar+nós.AD.1.PL+SBJF+1+PL
profanarmos-lhe	profanar+V.ele.DAT.3.SG+INF+1+PL
profanarmos-lhe	profanar+V.ele.DAT.3.SG+SBJF+1+PL
profanarmos-lhes	profanar+V.ele.DAT.3.PL+INF+1+PL
profanarmos-lhes	profanar+V.ele.DAT.3.PL+SBJF+1+PL
profanarmos-me	profanar+V.eu.AD.1.SG+INF+1+PL
profanarmos-me	profanar+V.eu.AD.1.SG+SBJF+1+PL
profanarmos-te	profanar+V.tu.AD.2.SG+INF+1+PL
profanarmos-te	profanar+V.tu.AD.2.SG+SBJF+1+PL
profanarmos-vos	profanar+V.vós.AD.2.PL+INF+1+PL
profanarmos-vos	profanar+V.vós.AD.2.PL+SBJF+1+PL
profanar-nos-ão	profanar+nós.AD.1.PL+FUT+3+PL
profanar-nos-á	profanar+nós.AD.1.PL+FUT+3+SG
profanar-nos-ás	profanar+nós.AD.1.PL+FUT+2+SG
profanar-nos-ei	profanar+nós.AD.1.PL+FUT+1+SG
profanar-nos-eis	profanar+nós.AD.1.PL+FUT+2+PL
profanar-nos-emos	profanar+nós.AD.1.PL+FUT+1+PL
profanar-nos-íamos	profanar+nós.AD.1.PL+COND+1+PL
profanar-nos-iam	profanar+nós.AD.1.PL+COND+3+PL
profanar-nos-ia	profanar+nós.AD.1.PL+COND+1+SG
profanar-nos-ia	profanar+nós.AD.1.PL+COND+3+SG
profanar-nos-ias	profanar+nós.AD.1.PL+COND+2+SG
profanar-nos-íeis	profanar+nós.AD.1.PL+COND+2+PL
profanar-nos	profanar+nós.AD.1.PL+INF
profanar-nos	profanar+nós.AD.1.PL+INF+1+SG
profanar-nos	profanar+nós.AD.1.PL+INF+3+SG
profanar-nos	profanar+nós.AD.1.PL+SBJF+1+SG
profanar-nos	profanar+nós.AD.1.PL+SBJF+3+SG
profanar-se-ão	profanar+V.ele.REFL+FUT+3+PL
profanar-se-á	profanar+V.ele.REFL+FUT+3+SG
profanar-se-iam	profanar+V.ele.REFL+COND+3+PL
profanar-se-ia	profanar+V.ele.REFL+COND+3+SG
profanar-se	profanar+V.ele.REFL+INF
profanar-se	profanar+V.ele.REFL+INF+3+SG
profanar-se	profanar+V.ele.REFL+SBJF+3+SG
profanar-te-ão	profanar+V.tu.AD.2.SG+FUT+3+PL
profanar-te-á	profanar+V.tu.AD.2.SG+FUT+3+SG
profanar-te-ás	profanar+V.tu.AD.2.SG+FUT+2+SG
profanar-te-ei	profanar+V.tu.AD.2.SG+FUT+1+SG
profanar-te-eis	profanar+V.tu.AD.2.SG+FUT+2+PL
profanar-te-emos	profanar+V.tu.AD.2.SG+FUT+1+PL
profanar-te-íamos	profanar+V.tu.AD.2.SG+COND+1+PL
profanar-te-iam	profanar+V.tu.AD.2.SG+COND+3+PL
profanar-te-ia	profanar+V.tu.AD.2.SG+COND+1+SG
profanar-te-ia	profanar+V.tu.AD.2.SG+COND+3+SG
profanar-te-ias	profanar+V.tu.AD.2.SG+COND+2+SG
profanar-te-íeis	profanar+V.tu.AD.2.SG+COND+2+PL
profanar-te	profanar+V.tu.AD.2.SG+INF
profanar-te	profanar+V.tu.AD.2.SG+INF+1+SG
profanar-te	profanar+V.tu.AD.2.SG+INF+3+SG
profanar-te	profanar+V.tu.AD.2.SG+SBJF+1+SG
profanar-te	profanar+V.tu.AD.2.SG+SBJF+3+SG
profanar-vos-ão	profanar+V.vós.AD.2.PL+FUT+3+PL
profanar-vos-á	profanar+V.vós.AD.2.PL+FUT+3+SG
profanar-vos-ás	profanar+V.vós.AD.2.PL+FUT+2+SG
profanar-vos-ei	profanar+V.vós.AD.2.PL+FUT+1+SG
profanar-vos-eis	profanar+V.vós.AD.2.PL+FUT+2+PL
profanar-vos-emos	profanar+V.vós.AD.2.PL+FUT+1+PL
profanar-vos-íamos	profanar+V.vós.AD.2.PL+COND+1+PL
profanar-vos-iam	profanar+V.vós.AD.2.PL+COND+3+PL
profanar-vos-ia	profanar+V.vós.AD.2.PL+COND+1+SG
profanar-vos-ia	profanar+V.vós.AD.2.PL+COND+3+SG
profanar-vos-ias	profanar+V.vós.AD.2.PL+COND+2+SG
profanar-vos-íeis	profanar+V.vós.AD.2.PL+COND+2+PL
profanar-vos	profanar+V.vós.AD.2.PL+INF
profanar-vos	profanar+V.vós.AD.2.PL+INF+1+SG
profanar-vos	profanar+V.vós.AD.2.PL+INF+3+SG
profanar-vos	profanar+V.vós.AD.2.PL+SBJF+1+SG
profanar-vos	profanar+V.vós.AD.2.PL+SBJF+3+SG
profana-se	profanar+V.ele.REFL+PRS+3+SG
profanas-lhe	profanar+V.ele.DAT.3.SG+PRS+2+SG
profanas-lhes	profanar+V.ele.DAT.3.PL+PRS+2+SG
profanas-me	profanar+V.eu.AD.1.SG+PRS+2+SG
profanaste-a	profanar+V.ele.ACC.3.F.SG+PRF+2+SG
profanaste-as	profanar+V.ele.ACC.3.F.PL+PRF+2+SG
profanaste-la	profanar+V.ele.ACC.3.F.SG+PRF+2+PL
profanaste-las	profanar+V.ele.ACC.3.F.PL+PRF+2+PL
profanaste-lhe	profanar+V.ele.DAT.3.SG+PRF+2+SG
profanaste-lhes	profanar+V.ele.DAT.3.PL+PRF+2+SG
profanaste-lo	profanar+V.ele.ACC.3.M.SG+PRF+2+PL
profanaste-los	profanar+V.ele.ACC.3.M.PL+PRF+2+PL
profanaste-me	profanar+V.eu.AD.1.SG+PRF+2+SG
profanaste-nos	profanar+nós.AD.1.PL+PRF+2+PL
profanaste-nos	profanar+nós.AD.1.PL+PRF+2+SG
profanaste-o	profanar+V.ele.ACC.3.M.SG+PRF+2+SG
profanaste-os	profanar+V.ele.ACC.3.M.PL+PRF+2+SG
profanas-te	profanar+V.tu.AD.2.SG+PRS+2+SG
profanastes-lhe	profanar+V.ele.DAT.3.SG+PRF+2+PL
profanastes-lhes	profanar+V.ele.DAT.3.PL+PRF+2+PL
profanastes-me	profanar+V.eu.AD.1.SG+PRF+2+PL
profanastes-te	profanar+V.tu.AD.2.SG+PRF+2+PL
profanastes-vos	profanar+V.vós.AD.2.PL+PRF+2+PL
profanaste-te	profanar+V.tu.AD.2.SG+PRF+2+SG
profanaste-vos	profanar+V.vós.AD.2.PL+PRF+2+SG
profanas-vos	profanar+V.vós.AD.2.PL+PRS+2+SG
profana-te	profanar+V.tu.AD.2.SG+PRS+3+SG
profanava-a	profanar+V.ele.ACC.3.F.SG+IMPF+1+SG
profanava-a	profanar+V.ele.ACC.3.F.SG+IMPF+3+SG
profanava-as	profanar+V.ele.ACC.3.F.PL+IMPF+1+SG
profanava-as	profanar+V.ele.ACC.3.F.PL+IMPF+3+SG
profanava-la	profanar+V.ele.ACC.3.F.SG+IMPF+2+SG
profanava-las	profanar+V.ele.ACC.3.F.PL+IMPF+2+SG
profanava-lhe	profanar+V.ele.DAT.3.SG+IMPF+1+SG
profanava-lhe	profanar+V.ele.DAT.3.SG+IMPF+3+SG
profanava-lhes	profanar+V.ele.DAT.3.PL+IMPF+1+SG
profanava-lhes	profanar+V.ele.DAT.3.PL+IMPF+3+SG
profanava-lo	profanar+V.ele.ACC.3.M.SG+IMPF+2+SG
profanava-los	profanar+V.ele.ACC.3.M.PL+IMPF+2+SG
profanava-me	profanar+V.eu.AD.1.SG+IMPF+1+SG
profanava-me	profanar+V.eu.AD.1.SG+IMPF+3+SG
profanavam-lhe	profanar+V.ele.DAT.3.SG+IMPF+3+PL
profanavam-lhes	profanar+V.ele.DAT.3.PL+IMPF+3+PL
profanavam-me	profanar+V.eu.AD.1.SG+IMPF+3+PL
profanavam-na	profanar+V.ele.ACC.3.F.SG+IMPF+3+PL
profanavam-nas	profanar+V.ele.ACC.3.F.PL+IMPF+3+PL
profanavam-no	profanar+V.ele.ACC.3.M.SG+IMPF+3+PL
profanavam-nos	profanar+V.ele.ACC.3.M.PL+IMPF+3+PL
profanavam-nos	profanar+V.nós.AD.1.PL+IMPF+3+PL
profanávamo-la	profanar+V.ele.ACC.3.F.SG+IMPF+1+PL
profanávamo-las	profanar+V.ele.ACC.3.F.PL+IMPF+1+PL
profanávamo-lo	profanar+V.ele.ACC.3.M.SG+IMPF+1+PL
profanávamo-los	profanar+V.ele.ACC.3.M.PL+IMPF+1+PL
profanávamo-nos	profanar+nós.AD.1.PL+IMPF+1+PL
profanávamos-lhe	profanar+V.ele.DAT.3.SG+IMPF+1+PL
profanávamos-lhes	profanar+V.ele.DAT.3.PL+IMPF+1+PL
profanávamos-me	profanar+V.eu.AD.1.SG+IMPF+1+PL
profanávamos-te	profanar+V.tu.AD.2.SG+IMPF+1+PL
profanávamos-vos	profanar+V.vós.AD.2.PL+IMPF+1+PL
profanavam-se	profanar+V.ele.REFL+IMPF+3+PL
profanavam-te	profanar+V.tu.AD.2.SG+IMPF+3+PL
profanavam-vos	profanar+V.vós.AD.2.PL+IMPF+3+PL
profanava-nos	profanar+nós.AD.1.PL+IMPF+1+SG
profanava-nos	profanar+nós.AD.1.PL+IMPF+2+SG
profanava-nos	profanar+nós.AD.1.PL+IMPF+3+SG
profanava-o	profanar+V.ele.ACC.3.M.SG+IMPF+1+SG
profanava-o	profanar+V.ele.ACC.3.M.SG+IMPF+3+SG
profanava-os	profanar+V.ele.ACC.3.M.PL+IMPF+1+SG
profanava-os	profanar+V.ele.ACC.3.M.PL+IMPF+3+SG
profanava-se	profanar+V.ele.REFL+IMPF+1+SG
profanava-se	profanar+V.ele.REFL+IMPF+3+SG
profanavas-lhe	profanar+V.ele.DAT.3.SG+IMPF+2+SG
profanavas-lhes	profanar+V.ele.DAT.3.PL+IMPF+2+SG
profanavas-me	profanar+V.eu.AD.1.SG+IMPF+2+SG
profanavas-te	profanar+V.tu.AD.2.SG+IMPF+2+SG
profanavas-vos	profanar+V.vós.AD.2.PL+IMPF+2+SG
profanava-te	profanar+V.tu.AD.2.SG+IMPF+1+SG
profanava-te	profanar+V.tu.AD.2.SG+IMPF+3+SG
profanava-vos	profanar+V.vós.AD.2.PL+IMPF+1+SG
profanava-vos	profanar+V.vós.AD.2.PL+IMPF+3+SG
profanávei-la	profanar+V.ele.ACC.3.F.SG+IMPF+2+PL
profanávei-las	profanar+V.ele.ACC.3.F.PL+IMPF+2+PL
profanávei-lo	profanar+V.ele.ACC.3.M.SG+IMPF+2+PL
profanávei-los	profanar+V.ele.ACC.3.M.PL+IMPF+2+PL
profanávei-nos	profanar+nós.AD.1.PL+IMPF+2+PL
profanáveis-lhe	profanar+V.ele.DAT.3.SG+IMPF+2+PL
profanáveis-lhes	profanar+V.ele.DAT.3.PL+IMPF+2+PL
profanáveis-me	profanar+V.eu.AD.1.SG+IMPF+2+PL
profanáveis-te	profanar+V.tu.AD.2.SG+IMPF+2+PL
profanáveis-vos	profanar+V.vós.AD.2.PL+IMPF+2+PL
profana-vos	profanar+V.vós.AD.2.PL+PRS+3+SG
profane-a	profanar+V.ele.ACC.3.F.SG+IMP+3+SG
profane-as	profanar+V.ele.ACC.3.F.PL+IMP+3+SG
profanei-a	profanar+V.ele.ACC.3.F.SG+PRF+1+SG
profanei-as	profanar+V.ele.ACC.3.F.PL+PRF+1+SG
profanei-lhe	profanar+V.ele.DAT.3.SG+PRF+1+SG
profanei-lhes	profanar+V.ele.DAT.3.PL+PRF+1+SG
profanei-me	profanar+V.eu.AD.1.SG+PRF+1+SG
profanei-nos	profanar+nós.AD.1.PL+PRF+1+SG
profanei-o	profanar+V.ele.ACC.3.M.SG+PRF+1+SG
profanei-os	profanar+V.ele.ACC.3.M.PL+PRF+1+SG
profanei-te	profanar+V.tu.AD.2.SG+PRF+1+SG
profanei-vos	profanar+V.vós.AD.2.PL+PRF+1+SG
profane-lhe	profanar+V.ele.DAT.3.SG+IMP+3+SG
profane-lhes	profanar+V.ele.DAT.3.PL+IMP+3+SG
profane-me	profanar+V.eu.AD.1.SG+IMP+3+SG
profanem-lhe	profanar+V.ele.DAT.3.SG+IMP+3+PL
profanem-lhes	profanar+V.ele.DAT.3.PL+IMP+3+PL
profanem-me	profanar+V.eu.AD.1.SG+IMP+3+PL
profanem-na	profanar+V.ele.ACC.3.F.SG+IMP+3+PL
profanem-nas	profanar+V.ele.ACC.3.F.PL+IMP+3+PL
profanem-no	profanar+V.ele.ACC.3.M.SG+IMP+3+PL
profanem-nos	profanar+V.ele.ACC.3.M.PL+IMP+3+PL
profanem-nos	profanar+V.nós.AD.1.PL+IMP+3+PL
profanemo-la	profanar+V.ele.ACC.3.F.SG+IMP+1+PL
profanemo-las	profanar+V.ele.ACC.3.F.PL+IMP+1+PL
profanemo-lo	profanar+V.ele.ACC.3.M.SG+IMP+1+PL
profanemo-los	profanar+V.ele.ACC.3.M.PL+IMP+1+PL
profanemo-nos	profanar+nós.AD.1.PL+IMP+1+PL
profanemos-lhe	profanar+V.ele.DAT.3.SG+IMP+1+PL
profanemos-lhes	profanar+V.ele.DAT.3.PL+IMP+1+PL
profanemos-me	profanar+V.eu.AD.1.SG+IMP+1+PL
profanemos-te	profanar+V.tu.AD.2.SG+IMP+1+PL
profanemos-vos	profanar+V.vós.AD.2.PL+IMP+1+PL
profanem-se	profanar+V.ele.REFL+IMP+3+PL
profanem-te	profanar+V.tu.AD.2.SG+IMP+3+PL
profanem-vos	profanar+V.vós.AD.2.PL+IMP+3+PL
profane-nos	profanar+nós.AD.1.PL+IMP+3+SG
profane-o	profanar+V.ele.ACC.3.M.SG+IMP+3+SG
profane-os	profanar+V.ele.ACC.3.M.PL+IMP+3+SG
profane-se	profanar+V.ele.REFL+IMP+3+SG
profane-te	profanar+V.tu.AD.2.SG+IMP+3+SG
profane-vos	profanar+V.vós.AD.2.PL+IMP+3+SG
profano-a	profanar+V.ele.ACC.3.F.SG+PRS+1+SG
profano-as	profanar+V.ele.ACC.3.F.PL+PRS+1+SG
profano-lhe	profanar+V.ele.DAT.3.SG+PRS+1+SG
profano-lhes	profanar+V.ele.DAT.3.PL+PRS+1+SG
profano-me	profanar+V.eu.AD.1.SG+PRS+1+SG
profano-nos	profanar+nós.AD.1.PL+PRS+1+SG
profano-o	profanar+V.ele.ACC.3.M.SG+PRS+1+SG
profano-os	profanar+V.ele.ACC.3.M.PL+PRS+1+SG
profano-te	profanar+V.tu.AD.2.SG+PRS+1+SG
profanou-a	profanar+V.ele.ACC.3.F.SG+PRF+3+SG
profanou-as	profanar+V.ele.ACC.3.F.PL+PRF+3+SG
profanou-lhe	profanar+V.ele.DAT.3.SG+PRF+3+SG
profanou-lhes	profanar+V.ele.DAT.3.PL+PRF+3+SG
profanou-me	profanar+V.eu.AD.1.SG+PRF+3+SG
profanou-nos	profanar+nós.AD.1.PL+PRF+3+SG
profanou-o	profanar+V.ele.ACC.3.M.SG+PRF+3+SG
profanou-os	profanar+V.ele.ACC.3.M.PL+PRF+3+SG
profanou-se	profanar+V.ele.REFL+PRF+3+SG
profanou-te	profanar+V.tu.AD.2.SG+PRF+3+SG
profanou-vos	profanar+V.vós.AD.2.PL+PRF+3+SG
profano-vos	profanar+V.vós.AD.2.PL+PRS+1+SG
profere-a	proferir+V.ele.ACC.3.F.SG+PRS+3+SG
profere-as	proferir+V.ele.ACC.3.F.PL+PRS+3+SG
profere-la	proferir+V.ele.ACC.3.F.SG+PRS+2+SG
profere-las	proferir+V.ele.ACC.3.F.PL+PRS+2+SG
profere-lhe	proferir+V.ele.DAT.3.SG+PRS+3+SG
profere-lhes	proferir+V.ele.DAT.3.PL+PRS+3+SG
profere-lo	proferir+V.ele.ACC.3.M.SG+PRS+2+SG
profere-los	proferir+V.ele.ACC.3.M.PL+PRS+2+SG
profere-me	proferir+V.eu.AD.1.SG+PRS+3+SG
proferem-lhe	proferir+V.ele.DAT.3.SG+PRS+3+PL
proferem-lhes	proferir+V.ele.DAT.3.PL+PRS+3+PL
proferem-me	proferir+V.eu.AD.1.SG+PRS+3+PL
proferem-na	proferir+V.ele.ACC.3.F.SG+PRS+3+PL
proferem-nas	proferir+V.ele.ACC.3.F.PL+PRS+3+PL
proferem-no	proferir+V.ele.ACC.3.M.SG+PRS+3+PL
proferem-nos	proferir+V.ele.ACC.3.M.PL+PRS+3+PL
proferem-nos	proferir+V.nós.AD.1.PL+PRS+3+PL
proferem-se	proferir+V.ele.REFL+PRS+3+PL
proferem-te	proferir+V.tu.AD.2.SG+PRS+3+PL
proferem-vos	proferir+V.vós.AD.2.PL+PRS+3+PL
profere-nos	proferir+nós.AD.1.PL+PRS+2+SG
profere-nos	proferir+nós.AD.1.PL+PRS+3+SG
profere-o	proferir+V.ele.ACC.3.M.SG+PRS+3+SG
profere-os	proferir+V.ele.ACC.3.M.PL+PRS+3+SG
profere-se	proferir+V.ele.REFL+PRS+3+SG
proferes-lhe	proferir+V.ele.DAT.3.SG+PRS+2+SG
proferes-lhes	proferir+V.ele.DAT.3.PL+PRS+2+SG
proferes-me	proferir+V.eu.AD.1.SG+PRS+2+SG
proferes-te	proferir+V.tu.AD.2.SG+PRS+2+SG
proferes-vos	proferir+V.vós.AD.2.PL+PRS+2+SG
profere-te	proferir+V.tu.AD.2.SG+PRS+3+SG
profere-vos	proferir+V.vós.AD.2.PL+PRS+3+SG
proferia-a	proferir+V.ele.ACC.3.F.SG+IMPF+1+SG
proferia-a	proferir+V.ele.ACC.3.F.SG+IMPF+3+SG
proferia-as	proferir+V.ele.ACC.3.F.PL+IMPF+1+SG
proferia-as	proferir+V.ele.ACC.3.F.PL+IMPF+3+SG
proferia-la	proferir+V.ele.ACC.3.F.SG+IMPF+2+SG
proferia-las	proferir+V.ele.ACC.3.F.PL+IMPF+2+SG
proferia-lhe	proferir+V.ele.DAT.3.SG+IMPF+1+SG
proferia-lhe	proferir+V.ele.DAT.3.SG+IMPF+3+SG
proferia-lhes	proferir+V.ele.DAT.3.PL+IMPF+1+SG
proferia-lhes	proferir+V.ele.DAT.3.PL+IMPF+3+SG
proferia-lo	proferir+V.ele.ACC.3.M.SG+IMPF+2+SG
proferia-los	proferir+V.ele.ACC.3.M.PL+IMPF+2+SG
proferia-me	proferir+V.eu.AD.1.SG+IMPF+1+SG
proferia-me	proferir+V.eu.AD.1.SG+IMPF+3+SG
proferiam-lhe	proferir+V.ele.DAT.3.SG+IMPF+3+PL
proferiam-lhes	proferir+V.ele.DAT.3.PL+IMPF+3+PL
proferiam-me	proferir+V.eu.AD.1.SG+IMPF+3+PL
proferiam-na	proferir+V.ele.ACC.3.F.SG+IMPF+3+PL
proferiam-nas	proferir+V.ele.ACC.3.F.PL+IMPF+3+PL
proferiam-no	proferir+V.ele.ACC.3.M.SG+IMPF+3+PL
proferiam-nos	proferir+V.ele.ACC.3.M.PL+IMPF+3+PL
proferiam-nos	proferir+V.nós.AD.1.PL+IMPF+3+PL
proferíamo-la	proferir+V.ele.ACC.3.F.SG+IMPF+1+PL
proferíamo-las	proferir+V.ele.ACC.3.F.PL+IMPF+1+PL
proferíamo-lo	proferir+V.ele.ACC.3.M.SG+IMPF+1+PL
proferíamo-los	proferir+V.ele.ACC.3.M.PL+IMPF+1+PL
proferíamo-nos	proferir+nós.AD.1.PL+IMPF+1+PL
proferíamos-lhe	proferir+V.ele.DAT.3.SG+IMPF+1+PL
proferíamos-lhes	proferir+V.ele.DAT.3.PL+IMPF+1+PL
proferíamos-me	proferir+V.eu.AD.1.SG+IMPF+1+PL
proferíamos-te	proferir+V.tu.AD.2.SG+IMPF+1+PL
proferíamos-vos	proferir+V.vós.AD.2.PL+IMPF+1+PL
proferiam-se	proferir+V.ele.REFL+IMPF+3+PL
proferiam-te	proferir+V.tu.AD.2.SG+IMPF+3+PL
proferiam-vos	proferir+V.vós.AD.2.PL+IMPF+3+PL
proferia-nos	proferir+nós.AD.1.PL+IMPF+1+SG
proferia-nos	proferir+nós.AD.1.PL+IMPF+2+SG
proferia-nos	proferir+nós.AD.1.PL+IMPF+3+SG
proferia-o	proferir+V.ele.ACC.3.M.SG+IMPF+1+SG
proferia-o	proferir+V.ele.ACC.3.M.SG+IMPF+3+SG
proferia-os	proferir+V.ele.ACC.3.M.PL+IMPF+1+SG
proferia-os	proferir+V.ele.ACC.3.M.PL+IMPF+3+SG
proferi-a	proferir+V.ele.ACC.3.F.SG+PRF+1+SG
proferia-se	proferir+V.ele.REFL+IMPF+3+SG
proferias-lhe	proferir+V.ele.DAT.3.SG+IMPF+2+SG
proferias-lhes	proferir+V.ele.DAT.3.PL+IMPF+2+SG
proferias-me	proferir+V.eu.AD.1.SG+IMPF+2+SG
proferi-as	proferir+V.ele.ACC.3.F.PL+PRF+1+SG
proferias-te	proferir+V.tu.AD.2.SG+IMPF+2+SG
proferias-vos	proferir+V.vós.AD.2.PL+IMPF+2+SG
proferia-te	proferir+V.tu.AD.2.SG+IMPF+1+SG
proferia-te	proferir+V.tu.AD.2.SG+IMPF+3+SG
proferia-vos	proferir+V.vós.AD.2.PL+IMPF+1+SG
proferia-vos	proferir+V.vós.AD.2.PL+IMPF+3+SG
proferíei-la	proferir+V.ele.ACC.3.F.SG+IMPF+2+PL
proferíei-las	proferir+V.ele.ACC.3.F.PL+IMPF+2+PL
proferíei-lo	proferir+V.ele.ACC.3.M.SG+IMPF+2+PL
proferíei-los	proferir+V.ele.ACC.3.M.PL+IMPF+2+PL
proferíei-nos	proferir+nós.AD.1.PL+IMPF+2+PL
proferíeis-lhe	proferir+V.ele.DAT.3.SG+IMPF+2+PL
proferíeis-lhes	proferir+V.ele.DAT.3.PL+IMPF+2+PL
proferíeis-me	proferir+V.eu.AD.1.SG+IMPF+2+PL
proferíeis-te	proferir+V.tu.AD.2.SG+IMPF+2+PL
proferíeis-vos	proferir+V.vós.AD.2.PL+IMPF+2+PL
proferi-la-ão	proferir+V.ele.ACC.3.F.SG+FUT+3+PL
proferi-la-á	proferir+V.ele.ACC.3.F.SG+FUT+3+SG
proferi-la-ás	proferir+V.ele.ACC.3.F.SG+FUT+2+SG
proferi-la-ei	proferir+V.ele.ACC.3.F.SG+FUT+1+SG
proferi-la-eis	proferir+V.ele.ACC.3.F.SG+FUT+2+PL
proferi-la-emos	proferir+V.ele.ACC.3.F.SG+FUT+1+PL
proferi-la-íamos	proferir+V.ele.ACC.3.F.SG+COND+1+PL
proferi-la-iam	proferir+V.ele.ACC.3.F.SG+COND+3+PL
proferi-la-ia	proferir+V.ele.ACC.3.F.SG+COND+1+SG
proferi-la-ia	proferir+V.ele.ACC.3.F.SG+COND+3+SG
proferi-la-ias	proferir+V.ele.ACC.3.F.SG+COND+2+SG
proferi-la-íeis	proferir+V.ele.ACC.3.F.SG+COND+2+PL
proferi-la	proferir+V.ele.ACC.3.F.SG+INF+1+SG
proferi-la	proferir+V.ele.ACC.3.F.SG+INF+3+SG
proferi-la	proferir+V.ele.ACC.3.F.SG+PRS+2+PL
proferi-la	proferir+V.ele.ACC.3.F.SG+SBJF+1+SG
proferi-la	proferir+V.ele.ACC.3.F.SG+SBJF+3+SG
proferi-las-ão	proferir+V.ele.ACC.3.F.PL+FUT+3+PL
proferi-las-á	proferir+V.ele.ACC.3.F.PL+FUT+3+SG
proferi-las-ás	proferir+V.ele.ACC.3.F.PL+FUT+2+SG
proferi-las-ei	proferir+V.ele.ACC.3.F.PL+FUT+1+SG
proferi-las-eis	proferir+V.ele.ACC.3.F.PL+FUT+2+PL
proferi-las-emos	proferir+V.ele.ACC.3.F.PL+FUT+1+PL
proferi-las-íamos	proferir+V.ele.ACC.3.F.PL+COND+1+PL
proferi-las-iam	proferir+V.ele.ACC.3.F.PL+COND+3+PL
proferi-las-ia	proferir+V.ele.ACC.3.F.PL+COND+1+SG
proferi-las-ia	proferir+V.ele.ACC.3.F.PL+COND+3+SG
proferi-las-ias	proferir+V.ele.ACC.3.F.PL+COND+2+SG
proferi-las-íeis	proferir+V.ele.ACC.3.F.PL+COND+2+PL
proferi-las	proferir+V.ele.ACC.3.F.PL+INF+1+SG
proferi-las	proferir+V.ele.ACC.3.F.PL+INF+3+SG
proferi-las	proferir+V.ele.ACC.3.F.PL+PRS+2+PL
proferi-las	proferir+V.ele.ACC.3.F.PL+SBJF+1+SG
proferi-las	proferir+V.ele.ACC.3.F.PL+SBJF+3+SG
proferi-lhe	proferir+V.ele.DAT.3.SG+PRF+1+SG
proferi-lhes	proferir+V.ele.DAT.3.PL+PRF+1+SG
proferi-lo-ão	proferir+V.ele.ACC.3.M.SG+FUT+3+PL
proferi-lo-á	proferir+V.ele.ACC.3.M.SG+FUT+3+SG
proferi-lo-ás	proferir+V.ele.ACC.3.M.SG+FUT+2+SG
proferi-lo-ei	proferir+V.ele.ACC.3.M.SG+FUT+1+SG
proferi-lo-eis	proferir+V.ele.ACC.3.M.SG+FUT+2+PL
proferi-lo-emos	proferir+V.ele.ACC.3.M.SG+FUT+1+PL
proferi-lo-íamos	proferir+V.ele.ACC.3.M.SG+COND+1+PL
proferi-lo-iam	proferir+V.ele.ACC.3.M.SG+COND+3+PL
proferi-lo-ia	proferir+V.ele.ACC.3.M.SG+COND+1+SG
proferi-lo-ia	proferir+V.ele.ACC.3.M.SG+COND+3+SG
proferi-lo-ias	proferir+V.ele.ACC.3.M.SG+COND+2+SG
proferi-lo-íeis	proferir+V.ele.ACC.3.M.SG+COND+2+PL
proferi-lo	proferir+V.ele.ACC.3.M.SG+INF+1+SG
proferi-lo	proferir+V.ele.ACC.3.M.SG+INF+3+SG
proferi-lo	proferir+V.ele.ACC.3.M.SG+PRS+2+PL
proferi-lo	proferir+V.ele.ACC.3.M.SG+SBJF+1+SG
proferi-lo	proferir+V.ele.ACC.3.M.SG+SBJF+3+SG
proferi-los-ão	proferir+V.ele.ACC.3.M.PL+FUT+3+PL
proferi-los-á	proferir+V.ele.ACC.3.M.PL+FUT+3+SG
proferi-los-ás	proferir+V.ele.ACC.3.M.PL+FUT+2+SG
proferi-los-ei	proferir+V.ele.ACC.3.M.PL+FUT+1+SG
proferi-los-eis	proferir+V.ele.ACC.3.M.PL+FUT+2+PL
proferi-los-emos	proferir+V.ele.ACC.3.M.PL+FUT+1+PL
proferi-los-íamos	proferir+V.ele.ACC.3.M.PL+COND+1+PL
proferi-los-iam	proferir+V.ele.ACC.3.M.PL+COND+3+PL
proferi-los-ia	proferir+V.ele.ACC.3.M.PL+COND+1+SG
proferi-los-ia	proferir+V.ele.ACC.3.M.PL+COND+3+SG
proferi-los-ias	proferir+V.ele.ACC.3.M.PL+COND+2+SG
proferi-los-íeis	proferir+V.ele.ACC.3.M.PL+COND+2+PL
proferi-los	proferir+V.ele.ACC.3.M.PL+INF+1+SG
proferi-los	proferir+V.ele.ACC.3.M.PL+INF+3+SG
proferi-los	proferir+V.ele.ACC.3.M.PL+PRS+2+PL
proferi-los	proferir+V.ele.ACC.3.M.PL+SBJF+1+SG
proferi-los	proferir+V.ele.ACC.3.M.PL+SBJF+3+SG
proferi-me	proferir+V.eu.AD.1.SG+PRF+1+SG
proferimo-la	proferir+V.ele.ACC.3.F.SG+PRF+1+PL
proferimo-la	proferir+V.ele.ACC.3.F.SG+PRS+1+PL
proferimo-las	proferir+V.ele.ACC.3.F.PL+PRF+1+PL
proferimo-las	proferir+V.ele.ACC.3.F.PL+PRS+1+PL
proferimo-lo	proferir+V.ele.ACC.3.M.SG+PRF+1+PL
proferimo-lo	proferir+V.ele.ACC.3.M.SG+PRS+1+PL
proferimo-los	proferir+V.ele.ACC.3.M.PL+PRF+1+PL
proferimo-los	proferir+V.ele.ACC.3.M.PL+PRS+1+PL
proferimo-nos	proferir+nós.AD.1.PL+PRF+1+PL
proferimo-nos	proferir+nós.AD.1.PL+PRS+1+PL
proferimos-lhe	proferir+V.ele.DAT.3.SG+PRF+1+PL
proferimos-lhe	proferir+V.ele.DAT.3.SG+PRS+1+PL
proferimos-lhes	proferir+V.ele.DAT.3.PL+PRF+1+PL
proferimos-lhes	proferir+V.ele.DAT.3.PL+PRS+1+PL
proferimos-me	proferir+V.eu.AD.1.SG+PRF+1+PL
proferimos-me	proferir+V.eu.AD.1.SG+PRS+1+PL
proferimos-te	proferir+V.tu.AD.2.SG+PRF+1+PL
proferimos-te	proferir+V.tu.AD.2.SG+PRS+1+PL
proferimos-vos	proferir+V.vós.AD.2.PL+PRF+1+PL
proferimos-vos	proferir+V.vós.AD.2.PL+PRS+1+PL
proferindo-a	proferir+V.ele.ACC.3.F.SG+GRD
proferindo-as	proferir+V.ele.ACC.3.F.PL+GRD
proferindo-lhe	proferir+V.ele.DAT.3.SG+GRD
proferindo-lhes	proferir+V.ele.DAT.3.PL+GRD
proferindo-me	proferir+V.eu.AD.1.SG+GRD
proferindo-nos	proferir+nós.AD.1.PL+GRD
proferindo-o	proferir+V.ele.ACC.3.M.SG+GRD
proferindo-os	proferir+V.ele.ACC.3.M.PL+GRD
proferindo-se	proferir+V.ele.REFL+GRD
proferindo-te	proferir+V.tu.AD.2.SG+GRD
proferindo-vos	proferir+V.vós.AD.2.PL+GRD
proferi-nos	proferir+nós.AD.1.PL+PRF+1+SG
proferi-nos	proferir+nós.AD.1.PL+PRS+2+PL
proferi-o	proferir+V.ele.ACC.3.M.SG+PRF+1+SG
proferi-os	proferir+V.ele.ACC.3.M.PL+PRF+1+SG
proferiram-lhe	proferir+V.ele.DAT.3.SG+PRF+3+PL
proferiram-lhes	proferir+V.ele.DAT.3.PL+PRF+3+PL
proferiram-me	proferir+V.eu.AD.1.SG+PRF+3+PL
proferiram-na	proferir+V.ele.ACC.3.F.SG+PRF+3+PL
proferiram-nas	proferir+V.ele.ACC.3.F.PL+PRF+3+PL
proferiram-no	proferir+V.ele.ACC.3.M.SG+PRF+3+PL
proferiram-nos	proferir+V.ele.ACC.3.M.PL+PRF+3+PL
proferiram-nos	proferir+V.nós.AD.1.PL+PRF+3+PL
proferiram-se	proferir+V.ele.REFL+PRF+3+PL
proferiram-te	proferir+V.tu.AD.2.SG+PRF+3+PL
proferiram-vos	proferir+V.vós.AD.2.PL+PRF+3+PL
proferirde-la	proferir+V.ele.ACC.3.F.SG+INF+2+PL
proferirde-la	proferir+V.ele.ACC.3.F.SG+SBJF+2+PL
proferirde-las	proferir+V.ele.ACC.3.F.PL+INF+2+PL
proferirde-las	proferir+V.ele.ACC.3.F.PL+SBJF+2+PL
proferirde-lo	proferir+V.ele.ACC.3.M.SG+INF+2+PL
proferirde-lo	proferir+V.ele.ACC.3.M.SG+SBJF+2+PL
proferirde-los	proferir+V.ele.ACC.3.M.PL+INF+2+PL
proferirde-los	proferir+V.ele.ACC.3.M.PL+SBJF+2+PL
proferirde-nos	proferir+nós.AD.1.PL+INF+2+PL
proferirde-nos	proferir+nós.AD.1.PL+SBJF+2+PL
proferirdes-lhe	proferir+V.ele.DAT.3.SG+INF+2+PL
proferirdes-lhe	proferir+V.ele.DAT.3.SG+SBJF+2+PL
proferirdes-lhes	proferir+V.ele.DAT.3.PL+INF+2+PL
proferirdes-lhes	proferir+V.ele.DAT.3.PL+SBJF+2+PL
proferirdes-me	proferir+V.eu.AD.1.SG+INF+2+PL
proferirdes-me	proferir+V.eu.AD.1.SG+SBJF+2+PL
proferirdes-te	proferir+V.tu.AD.2.SG+INF+2+PL
proferirdes-te	proferir+V.tu.AD.2.SG+SBJF+2+PL
proferirdes-vos	proferir+V.vós.AD.2.PL+INF+2+PL
proferirdes-vos	proferir+V.vós.AD.2.PL+SBJF+2+PL
proferire-la	proferir+V.ele.ACC.3.F.SG+INF+2+SG
proferire-la	proferir+V.ele.ACC.3.F.SG+SBJF+2+SG
proferire-las	proferir+V.ele.ACC.3.F.PL+INF+2+SG
proferire-las	proferir+V.ele.ACC.3.F.PL+SBJF+2+SG
proferire-lo	proferir+V.ele.ACC.3.M.SG+INF+2+SG
proferire-lo	proferir+V.ele.ACC.3.M.SG+SBJF+2+SG
proferire-los	proferir+V.ele.ACC.3.M.PL+INF+2+SG
proferire-los	proferir+V.ele.ACC.3.M.PL+SBJF+2+SG
proferirem-lhe	proferir+V.ele.DAT.3.SG+INF+3+PL
proferirem-lhe	proferir+V.ele.DAT.3.SG+SBJF+3+PL
proferirem-lhes	proferir+V.ele.DAT.3.PL+INF+3+PL
proferirem-lhes	proferir+V.ele.DAT.3.PL+SBJF+3+PL
proferirem-me	proferir+V.eu.AD.1.SG+INF+3+PL
proferirem-me	proferir+V.eu.AD.1.SG+SBJF+3+PL
proferirem-na	proferir+V.ele.ACC.3.F.SG+INF+3+PL
proferirem-na	proferir+V.ele.ACC.3.F.SG+SBJF+3+PL
proferirem-nas	proferir+V.ele.ACC.3.F.PL+INF+3+PL
proferirem-nas	proferir+V.ele.ACC.3.F.PL+SBJF+3+PL
proferirem-no	proferir+V.ele.ACC.3.M.SG+INF+3+PL
proferirem-no	proferir+V.ele.ACC.3.M.SG+SBJF+3+PL
proferirem-nos	proferir+V.ele.ACC.3.M.PL+INF+3+PL
proferirem-nos	proferir+V.ele.ACC.3.M.PL+SBJF+3+PL
proferirem-nos	proferir+V.nós.AD.1.PL+INF+3+PL
proferirem-nos	proferir+V.nós.AD.1.PL+SBJF+3+PL
proferirem-se	proferir+V.ele.REFL+INF+3+PL
proferirem-se	proferir+V.ele.REFL+SBJF+3+PL
proferirem-te	proferir+V.tu.AD.2.SG+INF+3+PL
proferirem-te	proferir+V.tu.AD.2.SG+SBJF+3+PL
proferirem-vos	proferir+V.vós.AD.2.PL+INF+3+PL
proferirem-vos	proferir+V.vós.AD.2.PL+SBJF+3+PL
proferire-nos	proferir+nós.AD.1.PL+INF+2+SG
proferire-nos	proferir+nós.AD.1.PL+SBJF+2+SG
proferires-lhe	proferir+V.ele.DAT.3.SG+INF+2+SG
proferires-lhe	proferir+V.ele.DAT.3.SG+SBJF+2+SG
proferires-lhes	proferir+V.ele.DAT.3.PL+INF+2+SG
proferires-lhes	proferir+V.ele.DAT.3.PL+SBJF+2+SG
proferires-me	proferir+V.eu.AD.1.SG+INF+2+SG
proferires-me	proferir+V.eu.AD.1.SG+SBJF+2+SG
proferires-te	proferir+V.tu.AD.2.SG+INF+2+SG
proferires-te	proferir+V.tu.AD.2.SG+SBJF+2+SG
proferires-vos	proferir+V.vós.AD.2.PL+INF+2+SG
proferires-vos	proferir+V.vós.AD.2.PL+SBJF+2+SG
proferir-lhe-ão	proferir+V.ele.DAT.3.SG+FUT+3+PL
proferir-lhe-á	proferir+V.ele.DAT.3.SG+FUT+3+SG
proferir-lhe-ás	proferir+V.ele.DAT.3.SG+FUT+2+SG
proferir-lhe-ei	proferir+V.ele.DAT.3.SG+FUT+1+SG
proferir-lhe-eis	proferir+V.ele.DAT.3.SG+FUT+2+PL
proferir-lhe-emos	proferir+V.ele.DAT.3.SG+FUT+1+PL
proferir-lhe-íamos	proferir+V.ele.DAT.3.SG+COND+1+PL
proferir-lhe-iam	proferir+V.ele.DAT.3.SG+COND+3+PL
proferir-lhe-ia	proferir+V.ele.DAT.3.SG+COND+1+SG
proferir-lhe-ia	proferir+V.ele.DAT.3.SG+COND+3+SG
proferir-lhe-ias	proferir+V.ele.DAT.3.SG+COND+2+SG
proferir-lhe-íeis	proferir+V.ele.DAT.3.SG+COND+2+PL
proferir-lhe	proferir+V.ele.DAT.3.SG+INF
proferir-lhe	proferir+V.ele.DAT.3.SG+INF+1+SG
proferir-lhe	proferir+V.ele.DAT.3.SG+INF+3+SG
proferir-lhe	proferir+V.ele.DAT.3.SG+SBJF+1+SG
proferir-lhe	proferir+V.ele.DAT.3.SG+SBJF+3+SG
proferir-lhes-ão	proferir+V.ele.DAT.3.PL+FUT+3+PL
proferir-lhes-á	proferir+V.ele.DAT.3.PL+FUT+3+SG
proferir-lhes-ás	proferir+V.ele.DAT.3.PL+FUT+2+SG
proferir-lhes-ei	proferir+V.ele.DAT.3.PL+FUT+1+SG
proferir-lhes-eis	proferir+V.ele.DAT.3.PL+FUT+2+PL
proferir-lhes-emos	proferir+V.ele.DAT.3.PL+FUT+1+PL
proferir-lhes-íamos	proferir+V.ele.DAT.3.PL+COND+1+PL
proferir-lhes-iam	proferir+V.ele.DAT.3.PL+COND+3+PL
proferir-lhes-ia	proferir+V.ele.DAT.3.PL+COND+1+SG
proferir-lhes-ia	proferir+V.ele.DAT.3.PL+COND+3+SG
proferir-lhes-ias	proferir+V.ele.DAT.3.PL+COND+2+SG
proferir-lhes-íeis	proferir+V.ele.DAT.3.PL+COND+2+PL
proferir-lhes	proferir+V.ele.DAT.3.PL+INF
proferir-lhes	proferir+V.ele.DAT.3.PL+INF+1+SG
proferir-lhes	proferir+V.ele.DAT.3.PL+INF+3+SG
proferir-lhes	proferir+V.ele.DAT.3.PL+SBJF+1+SG
proferir-lhes	proferir+V.ele.DAT.3.PL+SBJF+3+SG
proferir-me-ão	proferir+V.eu.AD.1.SG+FUT+3+PL
proferir-me-á	proferir+V.eu.AD.1.SG+FUT+3+SG
proferir-me-ás	proferir+V.eu.AD.1.SG+FUT+2+SG
proferir-me-ei	proferir+V.eu.AD.1.SG+FUT+1+SG
proferir-me-eis	proferir+V.eu.AD.1.SG+FUT+2+PL
proferir-me-emos	proferir+V.eu.AD.1.SG+FUT+1+PL
proferir-me-íamos	proferir+V.eu.AD.1.SG+COND+1+PL
proferir-me-iam	proferir+V.eu.AD.1.SG+COND+3+PL
proferir-me-ia	proferir+V.eu.AD.1.SG+COND+1+SG
proferir-me-ia	proferir+V.eu.AD.1.SG+COND+3+SG
proferir-me-ias	proferir+V.eu.AD.1.SG+COND+2+SG
proferir-me-íeis	proferir+V.eu.AD.1.SG+COND+2+PL
proferir-me	proferir+V.eu.AD.1.SG+INF
proferir-me	proferir+V.eu.AD.1.SG+INF+1+SG
proferir-me	proferir+V.eu.AD.1.SG+INF+3+SG
proferir-me	proferir+V.eu.AD.1.SG+SBJF+1+SG
proferir-me	proferir+V.eu.AD.1.SG+SBJF+3+SG
proferirmo-la	proferir+V.ele.ACC.3.F.SG+INF+1+PL
proferirmo-la	proferir+V.ele.ACC.3.F.SG+SBJF+1+PL
proferirmo-las	proferir+V.ele.ACC.3.F.PL+INF+1+PL
proferirmo-las	proferir+V.ele.ACC.3.F.PL+SBJF+1+PL
proferirmo-lo	proferir+V.ele.ACC.3.M.SG+INF+1+PL
proferirmo-lo	proferir+V.ele.ACC.3.M.SG+SBJF+1+PL
proferirmo-los	proferir+V.ele.ACC.3.M.PL+INF+1+PL
proferirmo-los	proferir+V.ele.ACC.3.M.PL+SBJF+1+PL
proferirmo-nos	proferir+nós.AD.1.PL+INF+1+PL
proferirmo-nos	proferir+nós.AD.1.PL+SBJF+1+PL
proferirmos-lhe	proferir+V.ele.DAT.3.SG+INF+1+PL
proferirmos-lhe	proferir+V.ele.DAT.3.SG+SBJF+1+PL
proferirmos-lhes	proferir+V.ele.DAT.3.PL+INF+1+PL
proferirmos-lhes	proferir+V.ele.DAT.3.PL+SBJF+1+PL
proferirmos-me	proferir+V.eu.AD.1.SG+INF+1+PL
proferirmos-me	proferir+V.eu.AD.1.SG+SBJF+1+PL
proferirmos-te	proferir+V.tu.AD.2.SG+INF+1+PL
proferirmos-te	proferir+V.tu.AD.2.SG+SBJF+1+PL
proferirmos-vos	proferir+V.vós.AD.2.PL+INF+1+PL
proferirmos-vos	proferir+V.vós.AD.2.PL+SBJF+1+PL
proferir-nos-ão	proferir+nós.AD.1.PL+FUT+3+PL
proferir-nos-á	proferir+nós.AD.1.PL+FUT+3+SG
proferir-nos-ás	proferir+nós.AD.1.PL+FUT+2+SG
proferir-nos-ei	proferir+nós.AD.1.PL+FUT+1+SG
proferir-nos-eis	proferir+nós.AD.1.PL+FUT+2+PL
proferir-nos-emos	proferir+nós.AD.1.PL+FUT+1+PL
proferir-nos-íamos	proferir+nós.AD.1.PL+COND+1+PL
proferir-nos-iam	proferir+nós.AD.1.PL+COND+3+PL
proferir-nos-ia	proferir+nós.AD.1.PL+COND+1+SG
proferir-nos-ia	proferir+nós.AD.1.PL+COND+3+SG
proferir-nos-ias	proferir+nós.AD.1.PL+COND+2+SG
proferir-nos-íeis	proferir+nós.AD.1.PL+COND+2+PL
proferir-nos	proferir+nós.AD.1.PL+INF
proferir-nos	proferir+nós.AD.1.PL+INF+1+SG
proferir-nos	proferir+nós.AD.1.PL+INF+3+SG
proferir-nos	proferir+nós.AD.1.PL+SBJF+1+SG
proferir-nos	proferir+nós.AD.1.PL+SBJF+3+SG
proferir-se-ão	proferir+V.ele.REFL+FUT+3+PL
proferir-se-á	proferir+V.ele.REFL+FUT+3+SG
proferir-se-iam	proferir+V.ele.REFL+COND+3+PL
proferir-se-ia	proferir+V.ele.REFL+COND+3+SG
proferir-se	proferir+V.ele.REFL+INF
proferir-se	proferir+V.ele.REFL+INF+3+SG
proferir-se	proferir+V.ele.REFL+SBJF+3+SG
proferir-te-ão	proferir+V.tu.AD.2.SG+FUT+3+PL
proferir-te-á	proferir+V.tu.AD.2.SG+FUT+3+SG
proferir-te-ás	proferir+V.tu.AD.2.SG+FUT+2+SG
proferir-te-ei	proferir+V.tu.AD.2.SG+FUT+1+SG
proferir-te-eis	proferir+V.tu.AD.2.SG+FUT+2+PL
proferir-te-emos	proferir+V.tu.AD.2.SG+FUT+1+PL
proferir-te-íamos	proferir+V.tu.AD.2.SG+COND+1+PL
proferir-te-iam	proferir+V.tu.AD.2.SG+COND+3+PL
proferir-te-ia	proferir+V.tu.AD.2.SG+COND+1+SG
proferir-te-ia	proferir+V.tu.AD.2.SG+COND+3+SG
proferir-te-ias	proferir+V.tu.AD.2.SG+COND+2+SG
proferir-te-íeis	proferir+V.tu.AD.2.SG+COND+2+PL
proferir-te	proferir+V.tu.AD.2.SG+INF
proferir-te	proferir+V.tu.AD.2.SG+INF+1+SG
proferir-te	proferir+V.tu.AD.2.SG+INF+3+SG
proferir-te	proferir+V.tu.AD.2.SG+SBJF+1+SG
proferir-te	proferir+V.tu.AD.2.SG+SBJF+3+SG
proferir-vos-ão	proferir+V.vós.AD.2.PL+FUT+3+PL
proferir-vos-á	proferir+V.vós.AD.2.PL+FUT+3+SG
proferir-vos-ás	proferir+V.vós.AD.2.PL+FUT+2+SG
proferir-vos-ei	proferir+V.vós.AD.2.PL+FUT+1+SG
proferir-vos-eis	proferir+V.vós.AD.2.PL+FUT+2+PL
proferir-vos-emos	proferir+V.vós.AD.2.PL+FUT+1+PL
proferir-vos-íamos	proferir+V.vós.AD.2.PL+COND+1+PL
proferir-vos-iam	proferir+V.vós.AD.2.PL+COND+3+PL
proferir-vos-ia	proferir+V.vós.AD.2.PL+COND+1+SG
proferir-vos-ia	proferir+V.vós.AD.2.PL+COND+3+SG
proferir-vos-ias	proferir+V.vós.AD.2.PL+COND+2+SG
proferir-vos-íeis	proferir+V.vós.AD.2.PL+COND+2+PL
proferir-vos	proferir+V.vós.AD.2.PL+INF
proferir-vos	proferir+V.vós.AD.2.PL+INF+1+SG
proferir-vos	proferir+V.vós.AD.2.PL+INF+3+SG
proferir-vos	proferir+V.vós.AD.2.PL+SBJF+1+SG
proferir-vos	proferir+V.vós.AD.2.PL+SBJF+3+SG
proferis-lhe	proferir+V.ele.DAT.3.SG+PRS+2+PL
proferis-lhes	proferir+V.ele.DAT.3.PL+PRS+2+PL
proferis-me	proferir+V.eu.AD.1.SG+PRS+2+PL
proferiste-a	proferir+V.ele.ACC.3.F.SG+PRF+2+SG
proferiste-as	proferir+V.ele.ACC.3.F.PL+PRF+2+SG
proferiste-la	proferir+V.ele.ACC.3.F.SG+PRF+2+PL
proferiste-las	proferir+V.ele.ACC.3.F.PL+PRF+2+PL
proferiste-lhe	proferir+V.ele.DAT.3.SG+PRF+2+SG
proferiste-lhes	proferir+V.ele.DAT.3.PL+PRF+2+SG
proferiste-lo	proferir+V.ele.ACC.3.M.SG+PRF+2+PL
proferiste-los	proferir+V.ele.ACC.3.M.PL+PRF+2+PL
proferiste-me	proferir+V.eu.AD.1.SG+PRF+2+SG
proferiste-nos	proferir+nós.AD.1.PL+PRF+2+PL
proferiste-nos	proferir+nós.AD.1.PL+PRF+2+SG
proferiste-o	proferir+V.ele.ACC.3.M.SG+PRF+2+SG
proferiste-os	proferir+V.ele.ACC.3.M.PL+PRF+2+SG
proferis-te	proferir+V.tu.AD.2.SG+PRS+2+PL
proferistes-lhe	proferir+V.ele.DAT.3.SG+PRF+2+PL
proferistes-lhes	proferir+V.ele.DAT.3.PL+PRF+2+PL
proferistes-me	proferir+V.eu.AD.1.SG+PRF+2+PL
proferistes-te	proferir+V.tu.AD.2.SG+PRF+2+PL
proferistes-vos	proferir+V.vós.AD.2.PL+PRF+2+PL
proferiste-te	proferir+V.tu.AD.2.SG+PRF+2+SG
proferiste-vos	proferir+V.vós.AD.2.PL+PRF+2+SG
proferis-vos	proferir+V.vós.AD.2.PL+PRS+2+PL
proferi-te	proferir+V.tu.AD.2.SG+PRF+1+SG
proferiu-a	proferir+V.ele.ACC.3.F.SG+PRF+3+SG
proferiu-as	proferir+V.ele.ACC.3.F.PL+PRF+3+SG
proferiu-lhe	proferir+V.ele.DAT.3.SG+PRF+3+SG
proferiu-lhes	proferir+V.ele.DAT.3.PL+PRF+3+SG
proferiu-me	proferir+V.eu.AD.1.SG+PRF+3+SG
proferiu-nos	proferir+nós.AD.1.PL+PRF+3+SG
proferiu-o	proferir+V.ele.ACC.3.M.SG+PRF+3+SG
proferiu-os	proferir+V.ele.ACC.3.M.PL+PRF+3+SG
proferiu-se	proferir+V.ele.REFL+PRF+3+SG
proferiu-te	proferir+V.tu.AD.2.SG+PRF+3+SG
proferiu-vos	proferir+V.vós.AD.2.PL+PRF+3+SG
proferi-vos	proferir+V.vós.AD.2.PL+PRF+1+SG
profesgue-a	professar+V.ele.ACC.3.F.SG+IMP+3+SG
profesgue-as	professar+V.ele.ACC.3.F.PL+IMP+3+SG
profesguei-a	professar+V.ele.ACC.3.F.SG+PRF+1+SG
profesguei-as	professar+V.ele.ACC.3.F.PL+PRF+1+SG
profesguei-lhe	professar+V.ele.DAT.3.SG+PRF+1+SG
profesguei-lhes	professar+V.ele.DAT.3.PL+PRF+1+SG
profesguei-me	professar+V.eu.AD.1.SG+PRF+1+SG
profesguei-nos	professar+nós.AD.1.PL+PRF+1+SG
profesguei-o	professar+V.ele.ACC.3.M.SG+PRF+1+SG
profesguei-os	professar+V.ele.ACC.3.M.PL+PRF+1+SG
profesguei-te	professar+V.tu.AD.2.SG+PRF+1+SG
profesguei-vos	professar+V.vós.AD.2.PL+PRF+1+SG
profesgue-lhe	professar+V.ele.DAT.3.SG+IMP+3+SG
profesgue-lhes	professar+V.ele.DAT.3.PL+IMP+3+SG
profesgue-me	professar+V.eu.AD.1.SG+IMP+3+SG
profesguem-lhe	professar+V.ele.DAT.3.SG+IMP+3+PL
profesguem-lhes	professar+V.ele.DAT.3.PL+IMP+3+PL
profesguem-me	professar+V.eu.AD.1.SG+IMP+3+PL
profesguem-na	professar+V.ele.ACC.3.F.SG+IMP+3+PL
profesguem-nas	professar+V.ele.ACC.3.F.PL+IMP+3+PL
profesguem-no	professar+V.ele.ACC.3.M.SG+IMP+3+PL
profesguem-nos	professar+V.ele.ACC.3.M.PL+IMP+3+PL
profesguem-nos	professar+V.nós.AD.1.PL+IMP+3+PL
profesguemo-la	professar+V.ele.ACC.3.F.SG+IMP+1+PL
profesguemo-las	professar+V.ele.ACC.3.F.PL+IMP+1+PL
profesguemo-lo	professar+V.ele.ACC.3.M.SG+IMP+1+PL
profesguemo-los	professar+V.ele.ACC.3.M.PL+IMP+1+PL
profesguemo-nos	professar+nós.AD.1.PL+IMP+1+PL
profesguemos-lhe	professar+V.ele.DAT.3.SG+IMP+1+PL
profesguemos-lhes	professar+V.ele.DAT.3.PL+IMP+1+PL
profesguemos-me	professar+V.eu.AD.1.SG+IMP+1+PL
profesguemos-te	professar+V.tu.AD.2.SG+IMP+1+PL
profesguemos-vos	professar+V.vós.AD.2.PL+IMP+1+PL
profesguem-se	professar+V.ele.REFL+IMP+3+PL
profesguem-te	professar+V.tu.AD.2.SG+IMP+3+PL
profesguem-vos	professar+V.vós.AD.2.PL+IMP+3+PL
profesgue-nos	professar+nós.AD.1.PL+IMP+3+SG
profesgue-o	professar+V.ele.ACC.3.M.SG+IMP+3+SG
profesgue-os	professar+V.ele.ACC.3.M.PL+IMP+3+SG
profesgue-se	professar+V.ele.REFL+IMP+3+SG
profesgue-te	professar+V.tu.AD.2.SG+IMP+3+SG
profesgue-vos	professar+V.vós.AD.2.PL+IMP+3+SG
professa-a	professar+V.ele.ACC.3.F.SG+PRS+3+SG
professa-as	professar+V.ele.ACC.3.F.PL+PRS+3+SG
professai-la	professar+V.ele.ACC.3.F.SG+PRS+2+PL
professai-las	professar+V.ele.ACC.3.F.PL+PRS+2+PL
professai-lo	professar+V.ele.ACC.3.M.SG+PRS+2+PL
professai-los	professar+V.ele.ACC.3.M.PL+PRS+2+PL
professai-nos	professar+nós.AD.1.PL+PRS+2+PL
professais-lhe	professar+V.ele.DAT.3.SG+PRS+2+PL
professais-lhes	professar+V.ele.DAT.3.PL+PRS+2+PL
professais-me	professar+V.eu.AD.1.SG+PRS+2+PL
professais-te	professar+V.tu.AD.2.SG+PRS+2+PL
professais-vos	professar+V.vós.AD.2.PL+PRS+2+PL
professá-la-ão	professar+V.ele.ACC.3.F.SG+FUT+3+PL
professá-la-á	professar+V.ele.ACC.3.F.SG+FUT+3+SG
professá-la-ás	professar+V.ele.ACC.3.F.SG+FUT+2+SG
professá-la-ei	professar+V.ele.ACC.3.F.SG+FUT+1+SG
professá-la-eis	professar+V.ele.ACC.3.F.SG+FUT+2+PL
professá-la-emos	professar+V.ele.ACC.3.F.SG+FUT+1+PL
professá-la-íamos	professar+V.ele.ACC.3.F.SG+COND+1+PL
professá-la-iam	professar+V.ele.ACC.3.F.SG+COND+3+PL
professá-la-ia	professar+V.ele.ACC.3.F.SG+COND+1+SG
professá-la-ia	professar+V.ele.ACC.3.F.SG+COND+3+SG
professá-la-ias	professar+V.ele.ACC.3.F.SG+COND+2+SG
professá-la-íeis	professar+V.ele.ACC.3.F.SG+COND+2+PL
professá-la	professar+V.ele.ACC.3.F.SG+INF+1+SG
professá-la	professar+V.ele.ACC.3.F.SG+INF+3+SG
professa-la	professar+V.ele.ACC.3.F.SG+PRS+2+SG
professá-la	professar+V.ele.ACC.3.F.SG+SBJF+1+SG
professá-la	professar+V.ele.ACC.3.F.SG+SBJF+3+SG
professá-las-ão	professar+V.ele.ACC.3.F.PL+FUT+3+PL
professá-las-á	professar+V.ele.ACC.3.F.PL+FUT+3+SG
professá-las-ás	professar+V.ele.ACC.3.F.PL+FUT+2+SG
professá-las-ei	professar+V.ele.ACC.3.F.PL+FUT+1+SG
professá-las-eis	professar+V.ele.ACC.3.F.PL+FUT+2+PL
professá-las-emos	professar+V.ele.ACC.3.F.PL+FUT+1+PL
professá-las-íamos	professar+V.ele.ACC.3.F.PL+COND+1+PL
professá-las-iam	professar+V.ele.ACC.3.F.PL+COND+3+PL
professá-las-ia	professar+V.ele.ACC.3.F.PL+COND+1+SG
professá-las-ia	professar+V.ele.ACC.3.F.PL+COND+3+SG
professá-las-ias	professar+V.ele.ACC.3.F.PL+COND+2+SG
professá-las-íeis	professar+V.ele.ACC.3.F.PL+COND+2+PL
professá-las	professar+V.ele.ACC.3.F.PL+INF+1+SG
professá-las	professar+V.ele.ACC.3.F.PL+INF+3+SG
professa-las	professar+V.ele.ACC.3.F.PL+PRS+2+SG
professá-las	professar+V.ele.ACC.3.F.PL+SBJF+1+SG
professá-las	professar+V.ele.ACC.3.F.PL+SBJF+3+SG
professa-lhe	professar+V.ele.DAT.3.SG+PRS+3+SG
professa-lhes	professar+V.ele.DAT.3.PL+PRS+3+SG
professá-lo-ão	professar+V.ele.ACC.3.M.SG+FUT+3+PL
professá-lo-á	professar+V.ele.ACC.3.M.SG+FUT+3+SG
professá-lo-ás	professar+V.ele.ACC.3.M.SG+FUT+2+SG
professá-lo-ei	professar+V.ele.ACC.3.M.SG+FUT+1+SG
professá-lo-eis	professar+V.ele.ACC.3.M.SG+FUT+2+PL
professá-lo-emos	professar+V.ele.ACC.3.M.SG+FUT+1+PL
professá-lo-íamos	professar+V.ele.ACC.3.M.SG+COND+1+PL
professá-lo-iam	professar+V.ele.ACC.3.M.SG+COND+3+PL
professá-lo-ia	professar+V.ele.ACC.3.M.SG+COND+1+SG
professá-lo-ia	professar+V.ele.ACC.3.M.SG+COND+3+SG
professá-lo-ias	professar+V.ele.ACC.3.M.SG+COND+2+SG
professá-lo-íeis	professar+V.ele.ACC.3.M.SG+COND+2+PL
professá-lo	professar+V.ele.ACC.3.M.SG+INF+1+SG
professá-lo	professar+V.ele.ACC.3.M.SG+INF+3+SG
professa-lo	professar+V.ele.ACC.3.M.SG+PRS+2+SG
professá-lo	professar+V.ele.ACC.3.M.SG+SBJF+1+SG
professá-lo	professar+V.ele.ACC.3.M.SG+SBJF+3+SG
professá-los-ão	professar+V.ele.ACC.3.M.PL+FUT+3+PL
professá-los-á	professar+V.ele.ACC.3.M.PL+FUT+3+SG
professá-los-ás	professar+V.ele.ACC.3.M.PL+FUT+2+SG
professá-los-ei	professar+V.ele.ACC.3.M.PL+FUT+1+SG
professá-los-eis	professar+V.ele.ACC.3.M.PL+FUT+2+PL
professá-los-emos	professar+V.ele.ACC.3.M.PL+FUT+1+PL
professá-los-íamos	professar+V.ele.ACC.3.M.PL+COND+1+PL
professá-los-iam	professar+V.ele.ACC.3.M.PL+COND+3+PL
professá-los-ia	professar+V.ele.ACC.3.M.PL+COND+1+SG
professá-los-ia	professar+V.ele.ACC.3.M.PL+COND+3+SG
professá-los-ias	professar+V.ele.ACC.3.M.PL+COND+2+SG
professá-los-íeis	professar+V.ele.ACC.3.M.PL+COND+2+PL
professá-los	professar+V.ele.ACC.3.M.PL+INF+1+SG
professá-los	professar+V.ele.ACC.3.M.PL+INF+3+SG
professa-los	professar+V.ele.ACC.3.M.PL+PRS+2+SG
professá-los	professar+V.ele.ACC.3.M.PL+SBJF+1+SG
professá-los	professar+V.ele.ACC.3.M.PL+SBJF+3+SG
professa-me	professar+V.eu.AD.1.SG+PRS+3+SG
professam-lhe	professar+V.ele.DAT.3.SG+PRS+3+PL
professam-lhes	professar+V.ele.DAT.3.PL+PRS+3+PL
professam-me	professar+V.eu.AD.1.SG+PRS+3+PL
professam-na	professar+V.ele.ACC.3.F.SG+PRS+3+PL
professam-nas	professar+V.ele.ACC.3.F.PL+PRS+3+PL
professam-no	professar+V.ele.ACC.3.M.SG+PRS+3+PL
professam-nos	professar+V.ele.ACC.3.M.PL+PRS+3+PL
professam-nos	professar+V.nós.AD.1.PL+PRS+3+PL
professamo-la	professar+V.ele.ACC.3.F.SG+PRF+1+PL
professamo-la	professar+V.ele.ACC.3.F.SG+PRS+1+PL
professamo-las	professar+V.ele.ACC.3.F.PL+PRF+1+PL
professamo-las	professar+V.ele.ACC.3.F.PL+PRS+1+PL
professamo-lo	professar+V.ele.ACC.3.M.SG+PRF+1+PL
professamo-lo	professar+V.ele.ACC.3.M.SG+PRS+1+PL
professamo-los	professar+V.ele.ACC.3.M.PL+PRF+1+PL
professamo-los	professar+V.ele.ACC.3.M.PL+PRS+1+PL
professamo-nos	professar+nós.AD.1.PL+PRF+1+PL
professamo-nos	professar+nós.AD.1.PL+PRS+1+PL
professamos-lhe	professar+V.ele.DAT.3.SG+PRF+1+PL
professamos-lhe	professar+V.ele.DAT.3.SG+PRS+1+PL
professamos-lhes	professar+V.ele.DAT.3.PL+PRF+1+PL
professamos-lhes	professar+V.ele.DAT.3.PL+PRS+1+PL
professamos-me	professar+V.eu.AD.1.SG+PRF+1+PL
professamos-me	professar+V.eu.AD.1.SG+PRS+1+PL
professamos-te	professar+V.tu.AD.2.SG+PRF+1+PL
professamos-te	professar+V.tu.AD.2.SG+PRS+1+PL
professamos-vos	professar+V.vós.AD.2.PL+PRF+1+PL
professamos-vos	professar+V.vós.AD.2.PL+PRS+1+PL
professam-se	professar+V.ele.REFL+PRS+3+PL
professam-te	professar+V.tu.AD.2.SG+PRS+3+PL
professam-vos	professar+V.vós.AD.2.PL+PRS+3+PL
professando-a	professar+V.ele.ACC.3.F.SG+GRD
professando-as	professar+V.ele.ACC.3.F.PL+GRD
professando-lhe	professar+V.ele.DAT.3.SG+GRD
professando-lhes	professar+V.ele.DAT.3.PL+GRD
professando-me	professar+V.eu.AD.1.SG+GRD
professando-nos	professar+nós.AD.1.PL+GRD
professando-o	professar+V.ele.ACC.3.M.SG+GRD
professando-os	professar+V.ele.ACC.3.M.PL+GRD
professando-se	professar+V.ele.REFL+GRD
professando-te	professar+V.tu.AD.2.SG+GRD
professando-vos	professar+V.vós.AD.2.PL+GRD
professa-nos	professar+nós.AD.1.PL+PRS+2+SG
professa-nos	professar+nós.AD.1.PL+PRS+3+SG
professa-o	professar+V.ele.ACC.3.M.SG+PRS+3+SG
professa-os	professar+V.ele.ACC.3.M.PL+PRS+3+SG
professara-a	professar+V.ele.ACC.3.F.SG+PQP+1+SG
professara-a	professar+V.ele.ACC.3.F.SG+PQP+3+SG
professara-as	professar+V.ele.ACC.3.F.PL+PQP+1+SG
professara-as	professar+V.ele.ACC.3.F.PL+PQP+3+SG
professara-la	professar+V.ele.ACC.3.F.SG+PQP+2+SG
professara-las	professar+V.ele.ACC.3.F.PL+PQP+2+SG
professara-lhe	professar+V.ele.DAT.3.SG+PQP+1+SG
professara-lhe	professar+V.ele.DAT.3.SG+PQP+3+SG
professara-lhes	professar+V.ele.DAT.3.PL+PQP+1+SG
professara-lhes	professar+V.ele.DAT.3.PL+PQP+3+SG
professara-lo	professar+V.ele.ACC.3.M.SG+PQP+2+SG
professara-los	professar+V.ele.ACC.3.M.PL+PQP+2+SG
professara-me	professar+V.eu.AD.1.SG+PQP+1+SG
professara-me	professar+V.eu.AD.1.SG+PQP+3+SG
professaram-lhe	professar+V.ele.DAT.3.SG+PQP+3+PL
professaram-lhe	professar+V.ele.DAT.3.SG+PRF+3+PL
professaram-lhes	professar+V.ele.DAT.3.PL+PQP+3+PL
professaram-lhes	professar+V.ele.DAT.3.PL+PRF+3+PL
professaram-me	professar+V.eu.AD.1.SG+PQP+3+PL
professaram-me	professar+V.eu.AD.1.SG+PRF+3+PL
professaram-na	professar+V.ele.ACC.3.F.SG+PQP+3+PL
professaram-na	professar+V.ele.ACC.3.F.SG+PRF+3+PL
professaram-nas	professar+V.ele.ACC.3.F.PL+PQP+3+PL
professaram-nas	professar+V.ele.ACC.3.F.PL+PRF+3+PL
professaram-no	professar+V.ele.ACC.3.M.SG+PQP+3+PL
professaram-no	professar+V.ele.ACC.3.M.SG+PRF+3+PL
professaram-nos	professar+V.ele.ACC.3.M.PL+PQP+3+PL
professaram-nos	professar+V.ele.ACC.3.M.PL+PRF+3+PL
professaram-nos	professar+V.nós.AD.1.PL+PQP+3+PL
professaram-nos	professar+V.nós.AD.1.PL+PRF+3+PL
professáramo-la	professar+V.ele.ACC.3.F.SG+PQP+1+PL
professáramo-las	professar+V.ele.ACC.3.F.PL+PQP+1+PL
professáramo-lo	professar+V.ele.ACC.3.M.SG+PQP+1+PL
professáramo-los	professar+V.ele.ACC.3.M.PL+PQP+1+PL
professáramo-nos	professar+nós.AD.1.PL+PQP+1+PL
professáramos-lhe	professar+V.ele.DAT.3.SG+PQP+1+PL
professáramos-lhes	professar+V.ele.DAT.3.PL+PQP+1+PL
professáramos-me	professar+V.eu.AD.1.SG+PQP+1+PL
professáramos-te	professar+V.tu.AD.2.SG+PQP+1+PL
professáramos-vos	professar+V.vós.AD.2.PL+PQP+1+PL
professaram-se	professar+V.ele.REFL+PQP+3+PL
professaram-se	professar+V.ele.REFL+PRF+3+PL
professaram-te	professar+V.tu.AD.2.SG+PQP+3+PL
professaram-te	professar+V.tu.AD.2.SG+PRF+3+PL
professaram-vos	professar+V.vós.AD.2.PL+PQP+3+PL
professaram-vos	professar+V.vós.AD.2.PL+PRF+3+PL
professara-nos	professar+nós.AD.1.PL+PQP+1+SG
professara-nos	professar+nós.AD.1.PL+PQP+2+SG
professara-nos	professar+nós.AD.1.PL+PQP+3+SG
professara-o	professar+V.ele.ACC.3.M.SG+PQP+1+SG
professara-o	professar+V.ele.ACC.3.M.SG+PQP+3+SG
professara-os	professar+V.ele.ACC.3.M.PL+PQP+1+SG
professara-os	professar+V.ele.ACC.3.M.PL+PQP+3+SG
professara-se	professar+V.ele.REFL+PQP+1+SG
professara-se	professar+V.ele.REFL+PQP+3+SG
professaras-lhe	professar+V.ele.DAT.3.SG+PQP+2+SG
professaras-lhes	professar+V.ele.DAT.3.PL+PQP+2+SG
professaras-me	professar+V.eu.AD.1.SG+PQP+2+SG
professaras-te	professar+V.tu.AD.2.SG+PQP+2+SG
professaras-vos	professar+V.vós.AD.2.PL+PQP+2+SG
professara-te	professar+V.tu.AD.2.SG+PQP+1+SG
professara-te	professar+V.tu.AD.2.SG+PQP+3+SG
professara-vos	professar+V.vós.AD.2.PL+PQP+1+SG
professara-vos	professar+V.vós.AD.2.PL+PQP+3+SG
professarde-la	professar+V.ele.ACC.3.F.SG+INF+2+PL
professarde-la	professar+V.ele.ACC.3.F.SG+SBJF+2+PL
professarde-las	professar+V.ele.ACC.3.F.PL+INF+2+PL
professarde-las	professar+V.ele.ACC.3.F.PL+SBJF+2+PL
professarde-lo	professar+V.ele.ACC.3.M.SG+INF+2+PL
professarde-lo	professar+V.ele.ACC.3.M.SG+SBJF+2+PL
professarde-los	professar+V.ele.ACC.3.M.PL+INF+2+PL
professarde-los	professar+V.ele.ACC.3.M.PL+SBJF+2+PL
professarde-nos	professar+nós.AD.1.PL+INF+2+PL
professarde-nos	professar+nós.AD.1.PL+SBJF+2+PL
professardes-lhe	professar+V.ele.DAT.3.SG+INF+2+PL
professardes-lhe	professar+V.ele.DAT.3.SG+SBJF+2+PL
professardes-lhes	professar+V.ele.DAT.3.PL+INF+2+PL
professardes-lhes	professar+V.ele.DAT.3.PL+SBJF+2+PL
professardes-me	professar+V.eu.AD.1.SG+INF+2+PL
professardes-me	professar+V.eu.AD.1.SG+SBJF+2+PL
professardes-te	professar+V.tu.AD.2.SG+INF+2+PL
professardes-te	professar+V.tu.AD.2.SG+SBJF+2+PL
professardes-vos	professar+V.vós.AD.2.PL+INF+2+PL
professardes-vos	professar+V.vós.AD.2.PL+SBJF+2+PL
professárei-la	professar+V.ele.ACC.3.F.SG+PQP+2+PL
professárei-las	professar+V.ele.ACC.3.F.PL+PQP+2+PL
professárei-lo	professar+V.ele.ACC.3.M.SG+PQP+2+PL
professárei-los	professar+V.ele.ACC.3.M.PL+PQP+2+PL
professárei-nos	professar+nós.AD.1.PL+PQP+2+PL
professáreis-lhe	professar+V.ele.DAT.3.SG+PQP+2+PL
professáreis-lhes	professar+V.ele.DAT.3.PL+PQP+2+PL
professáreis-me	professar+V.eu.AD.1.SG+PQP+2+PL
professáreis-te	professar+V.tu.AD.2.SG+PQP+2+PL
professáreis-vos	professar+V.vós.AD.2.PL+PQP+2+PL
professare-la	professar+V.ele.ACC.3.F.SG+INF+2+SG
professare-la	professar+V.ele.ACC.3.F.SG+SBJF+2+SG
professare-las	professar+V.ele.ACC.3.F.PL+INF+2+SG
professare-las	professar+V.ele.ACC.3.F.PL+SBJF+2+SG
professare-lo	professar+V.ele.ACC.3.M.SG+INF+2+SG
professare-lo	professar+V.ele.ACC.3.M.SG+SBJF+2+SG
professare-los	professar+V.ele.ACC.3.M.PL+INF+2+SG
professare-los	professar+V.ele.ACC.3.M.PL+SBJF+2+SG
professarem-lhe	professar+V.ele.DAT.3.SG+INF+3+PL
professarem-lhe	professar+V.ele.DAT.3.SG+SBJF+3+PL
professarem-lhes	professar+V.ele.DAT.3.PL+INF+3+PL
professarem-lhes	professar+V.ele.DAT.3.PL+SBJF+3+PL
professarem-me	professar+V.eu.AD.1.SG+INF+3+PL
professarem-me	professar+V.eu.AD.1.SG+SBJF+3+PL
professarem-na	professar+V.ele.ACC.3.F.SG+INF+3+PL
professarem-na	professar+V.ele.ACC.3.F.SG+SBJF+3+PL
professarem-nas	professar+V.ele.ACC.3.F.PL+INF+3+PL
professarem-nas	professar+V.ele.ACC.3.F.PL+SBJF+3+PL
professarem-no	professar+V.ele.ACC.3.M.SG+INF+3+PL
professarem-no	professar+V.ele.ACC.3.M.SG+SBJF+3+PL
professarem-nos	professar+V.ele.ACC.3.M.PL+INF+3+PL
professarem-nos	professar+V.ele.ACC.3.M.PL+SBJF+3+PL
professarem-nos	professar+V.nós.AD.1.PL+INF+3+PL
professarem-nos	professar+V.nós.AD.1.PL+SBJF+3+PL
professarem-se	professar+V.ele.REFL+INF+3+PL
professarem-se	professar+V.ele.REFL+SBJF+3+PL
professarem-te	professar+V.tu.AD.2.SG+INF+3+PL
professarem-te	professar+V.tu.AD.2.SG+SBJF+3+PL
professarem-vos	professar+V.vós.AD.2.PL+INF+3+PL
professarem-vos	professar+V.vós.AD.2.PL+SBJF+3+PL
professare-nos	professar+nós.AD.1.PL+INF+2+SG
professare-nos	professar+nós.AD.1.PL+SBJF+2+SG
professares-lhe	professar+V.ele.DAT.3.SG+INF+2+SG
