progredires-lhe	progredir+V.ele.DAT.3.SG+SBJF+2+SG
progredires-lhes	progredir+V.ele.DAT.3.PL+INF+2+SG
progredires-lhes	progredir+V.ele.DAT.3.PL+SBJF+2+SG
progredires-me	progredir+V.eu.AD.1.SG+INF+2+SG
progredires-me	progredir+V.eu.AD.1.SG+SBJF+2+SG
progredires-te	progredir+V.tu.AD.2.SG+INF+2+SG
progredires-te	progredir+V.tu.AD.2.SG+SBJF+2+SG
progredires-vos	progredir+V.vós.AD.2.PL+INF+2+SG
progredires-vos	progredir+V.vós.AD.2.PL+SBJF+2+SG
progredir-lhe-ão	progredir+V.ele.DAT.3.SG+FUT+3+PL
progredir-lhe-á	progredir+V.ele.DAT.3.SG+FUT+3+SG
progredir-lhe-ás	progredir+V.ele.DAT.3.SG+FUT+2+SG
progredir-lhe-ei	progredir+V.ele.DAT.3.SG+FUT+1+SG
progredir-lhe-eis	progredir+V.ele.DAT.3.SG+FUT+2+PL
progredir-lhe-emos	progredir+V.ele.DAT.3.SG+FUT+1+PL
progredir-lhe-íamos	progredir+V.ele.DAT.3.SG+COND+1+PL
progredir-lhe-iam	progredir+V.ele.DAT.3.SG+COND+3+PL
progredir-lhe-ia	progredir+V.ele.DAT.3.SG+COND+1+SG
progredir-lhe-ia	progredir+V.ele.DAT.3.SG+COND+3+SG
progredir-lhe-ias	progredir+V.ele.DAT.3.SG+COND+2+SG
progredir-lhe-íeis	progredir+V.ele.DAT.3.SG+COND+2+PL
progredir-lhe	progredir+V.ele.DAT.3.SG+INF
progredir-lhe	progredir+V.ele.DAT.3.SG+INF+1+SG
progredir-lhe	progredir+V.ele.DAT.3.SG+INF+3+SG
progredir-lhe	progredir+V.ele.DAT.3.SG+SBJF+1+SG
progredir-lhe	progredir+V.ele.DAT.3.SG+SBJF+3+SG
progredir-lhes-ão	progredir+V.ele.DAT.3.PL+FUT+3+PL
progredir-lhes-á	progredir+V.ele.DAT.3.PL+FUT+3+SG
progredir-lhes-ás	progredir+V.ele.DAT.3.PL+FUT+2+SG
progredir-lhes-ei	progredir+V.ele.DAT.3.PL+FUT+1+SG
progredir-lhes-eis	progredir+V.ele.DAT.3.PL+FUT+2+PL
progredir-lhes-emos	progredir+V.ele.DAT.3.PL+FUT+1+PL
progredir-lhes-íamos	progredir+V.ele.DAT.3.PL+COND+1+PL
progredir-lhes-iam	progredir+V.ele.DAT.3.PL+COND+3+PL
progredir-lhes-ia	progredir+V.ele.DAT.3.PL+COND+1+SG
progredir-lhes-ia	progredir+V.ele.DAT.3.PL+COND+3+SG
progredir-lhes-ias	progredir+V.ele.DAT.3.PL+COND+2+SG
progredir-lhes-íeis	progredir+V.ele.DAT.3.PL+COND+2+PL
progredir-lhes	progredir+V.ele.DAT.3.PL+INF
progredir-lhes	progredir+V.ele.DAT.3.PL+INF+1+SG
progredir-lhes	progredir+V.ele.DAT.3.PL+INF+3+SG
progredir-lhes	progredir+V.ele.DAT.3.PL+SBJF+1+SG
progredir-lhes	progredir+V.ele.DAT.3.PL+SBJF+3+SG
progredir-me-ão	progredir+V.eu.AD.1.SG+FUT+3+PL
progredir-me-á	progredir+V.eu.AD.1.SG+FUT+3+SG
progredir-me-ás	progredir+V.eu.AD.1.SG+FUT+2+SG
progredir-me-ei	progredir+V.eu.AD.1.SG+FUT+1+SG
progredir-me-eis	progredir+V.eu.AD.1.SG+FUT+2+PL
progredir-me-emos	progredir+V.eu.AD.1.SG+FUT+1+PL
progredir-me-íamos	progredir+V.eu.AD.1.SG+COND+1+PL
progredir-me-iam	progredir+V.eu.AD.1.SG+COND+3+PL
progredir-me-ia	progredir+V.eu.AD.1.SG+COND+1+SG
progredir-me-ia	progredir+V.eu.AD.1.SG+COND+3+SG
progredir-me-ias	progredir+V.eu.AD.1.SG+COND+2+SG
progredir-me-íeis	progredir+V.eu.AD.1.SG+COND+2+PL
progredir-me	progredir+V.eu.AD.1.SG+INF
progredir-me	progredir+V.eu.AD.1.SG+INF+1+SG
progredir-me	progredir+V.eu.AD.1.SG+INF+3+SG
progredir-me	progredir+V.eu.AD.1.SG+SBJF+1+SG
progredir-me	progredir+V.eu.AD.1.SG+SBJF+3+SG
progredirmo-la	progredir+V.ele.ACC.3.F.SG+INF+1+PL
progredirmo-la	progredir+V.ele.ACC.3.F.SG+SBJF+1+PL
progredirmo-las	progredir+V.ele.ACC.3.F.PL+INF+1+PL
progredirmo-las	progredir+V.ele.ACC.3.F.PL+SBJF+1+PL
progredirmo-lo	progredir+V.ele.ACC.3.M.SG+INF+1+PL
progredirmo-lo	progredir+V.ele.ACC.3.M.SG+SBJF+1+PL
progredirmo-los	progredir+V.ele.ACC.3.M.PL+INF+1+PL
progredirmo-los	progredir+V.ele.ACC.3.M.PL+SBJF+1+PL
progredirmo-nos	progredir+nós.AD.1.PL+INF+1+PL
progredirmo-nos	progredir+nós.AD.1.PL+SBJF+1+PL
progredirmos-lhe	progredir+V.ele.DAT.3.SG+INF+1+PL
progredirmos-lhe	progredir+V.ele.DAT.3.SG+SBJF+1+PL
progredirmos-lhes	progredir+V.ele.DAT.3.PL+INF+1+PL
progredirmos-lhes	progredir+V.ele.DAT.3.PL+SBJF+1+PL
progredirmos-me	progredir+V.eu.AD.1.SG+INF+1+PL
progredirmos-me	progredir+V.eu.AD.1.SG+SBJF+1+PL
progredirmos-te	progredir+V.tu.AD.2.SG+INF+1+PL
progredirmos-te	progredir+V.tu.AD.2.SG+SBJF+1+PL
progredirmos-vos	progredir+V.vós.AD.2.PL+INF+1+PL
progredirmos-vos	progredir+V.vós.AD.2.PL+SBJF+1+PL
progredir-nos-ão	progredir+nós.AD.1.PL+FUT+3+PL
progredir-nos-á	progredir+nós.AD.1.PL+FUT+3+SG
progredir-nos-ás	progredir+nós.AD.1.PL+FUT+2+SG
progredir-nos-ei	progredir+nós.AD.1.PL+FUT+1+SG
progredir-nos-eis	progredir+nós.AD.1.PL+FUT+2+PL
progredir-nos-emos	progredir+nós.AD.1.PL+FUT+1+PL
progredir-nos-íamos	progredir+nós.AD.1.PL+COND+1+PL
progredir-nos-iam	progredir+nós.AD.1.PL+COND+3+PL
progredir-nos-ia	progredir+nós.AD.1.PL+COND+1+SG
progredir-nos-ia	progredir+nós.AD.1.PL+COND+3+SG
progredir-nos-ias	progredir+nós.AD.1.PL+COND+2+SG
progredir-nos-íeis	progredir+nós.AD.1.PL+COND+2+PL
progredir-nos	progredir+nós.AD.1.PL+INF
progredir-nos	progredir+nós.AD.1.PL+INF+1+SG
progredir-nos	progredir+nós.AD.1.PL+INF+3+SG
progredir-nos	progredir+nós.AD.1.PL+SBJF+1+SG
progredir-nos	progredir+nós.AD.1.PL+SBJF+3+SG
progredir-se-ão	progredir+V.ele.REFL+FUT+3+PL
progredir-se-á	progredir+V.ele.REFL+FUT+3+SG
progredir-se-iam	progredir+V.ele.REFL+COND+3+PL
progredir-se-ia	progredir+V.ele.REFL+COND+3+SG
progredir-se	progredir+V.ele.REFL+INF
progredir-se	progredir+V.ele.REFL+INF+3+SG
progredir-se	progredir+V.ele.REFL+SBJF+3+SG
progredir-te-ão	progredir+V.tu.AD.2.SG+FUT+3+PL
progredir-te-á	progredir+V.tu.AD.2.SG+FUT+3+SG
progredir-te-ás	progredir+V.tu.AD.2.SG+FUT+2+SG
progredir-te-ei	progredir+V.tu.AD.2.SG+FUT+1+SG
progredir-te-eis	progredir+V.tu.AD.2.SG+FUT+2+PL
progredir-te-emos	progredir+V.tu.AD.2.SG+FUT+1+PL
progredir-te-íamos	progredir+V.tu.AD.2.SG+COND+1+PL
progredir-te-iam	progredir+V.tu.AD.2.SG+COND+3+PL
progredir-te-ia	progredir+V.tu.AD.2.SG+COND+1+SG
progredir-te-ia	progredir+V.tu.AD.2.SG+COND+3+SG
progredir-te-ias	progredir+V.tu.AD.2.SG+COND+2+SG
progredir-te-íeis	progredir+V.tu.AD.2.SG+COND+2+PL
progredir-te	progredir+V.tu.AD.2.SG+INF
progredir-te	progredir+V.tu.AD.2.SG+INF+1+SG
progredir-te	progredir+V.tu.AD.2.SG+INF+3+SG
progredir-te	progredir+V.tu.AD.2.SG+SBJF+1+SG
progredir-te	progredir+V.tu.AD.2.SG+SBJF+3+SG
progredir-vos-ão	progredir+V.vós.AD.2.PL+FUT+3+PL
progredir-vos-á	progredir+V.vós.AD.2.PL+FUT+3+SG
progredir-vos-ás	progredir+V.vós.AD.2.PL+FUT+2+SG
progredir-vos-ei	progredir+V.vós.AD.2.PL+FUT+1+SG
progredir-vos-eis	progredir+V.vós.AD.2.PL+FUT+2+PL
progredir-vos-emos	progredir+V.vós.AD.2.PL+FUT+1+PL
progredir-vos-íamos	progredir+V.vós.AD.2.PL+COND+1+PL
progredir-vos-iam	progredir+V.vós.AD.2.PL+COND+3+PL
progredir-vos-ia	progredir+V.vós.AD.2.PL+COND+1+SG
progredir-vos-ia	progredir+V.vós.AD.2.PL+COND+3+SG
progredir-vos-ias	progredir+V.vós.AD.2.PL+COND+2+SG
progredir-vos-íeis	progredir+V.vós.AD.2.PL+COND+2+PL
progredir-vos	progredir+V.vós.AD.2.PL+INF
progredir-vos	progredir+V.vós.AD.2.PL+INF+1+SG
progredir-vos	progredir+V.vós.AD.2.PL+INF+3+SG
progredir-vos	progredir+V.vós.AD.2.PL+SBJF+1+SG
progredir-vos	progredir+V.vós.AD.2.PL+SBJF+3+SG
progredis-lhe	progredir+V.ele.DAT.3.SG+PRS+2+PL
progredis-lhes	progredir+V.ele.DAT.3.PL+PRS+2+PL
progredis-me	progredir+V.eu.AD.1.SG+PRS+2+PL
progrediste-a	progredir+V.ele.ACC.3.F.SG+PRF+2+SG
progrediste-as	progredir+V.ele.ACC.3.F.PL+PRF+2+SG
progrediste-la	progredir+V.ele.ACC.3.F.SG+PRF+2+PL
progrediste-las	progredir+V.ele.ACC.3.F.PL+PRF+2+PL
progrediste-lhe	progredir+V.ele.DAT.3.SG+PRF+2+SG
progrediste-lhes	progredir+V.ele.DAT.3.PL+PRF+2+SG
progrediste-lo	progredir+V.ele.ACC.3.M.SG+PRF+2+PL
progrediste-los	progredir+V.ele.ACC.3.M.PL+PRF+2+PL
progrediste-me	progredir+V.eu.AD.1.SG+PRF+2+SG
progrediste-nos	progredir+nós.AD.1.PL+PRF+2+PL
progrediste-nos	progredir+nós.AD.1.PL+PRF+2+SG
progrediste-o	progredir+V.ele.ACC.3.M.SG+PRF+2+SG
progrediste-os	progredir+V.ele.ACC.3.M.PL+PRF+2+SG
progredis-te	progredir+V.tu.AD.2.SG+PRS+2+PL
progredistes-lhe	progredir+V.ele.DAT.3.SG+PRF+2+PL
progredistes-lhes	progredir+V.ele.DAT.3.PL+PRF+2+PL
progredistes-me	progredir+V.eu.AD.1.SG+PRF+2+PL
progredistes-te	progredir+V.tu.AD.2.SG+PRF+2+PL
progredistes-vos	progredir+V.vós.AD.2.PL+PRF+2+PL
progrediste-te	progredir+V.tu.AD.2.SG+PRF+2+SG
progrediste-vos	progredir+V.vós.AD.2.PL+PRF+2+SG
progredis-vos	progredir+V.vós.AD.2.PL+PRS+2+PL
progredi-te	progredir+V.tu.AD.2.SG+PRF+1+SG
progrediu-a	progredir+V.ele.ACC.3.F.SG+PRF+3+SG
progrediu-as	progredir+V.ele.ACC.3.F.PL+PRF+3+SG
progrediu-lhe	progredir+V.ele.DAT.3.SG+PRF+3+SG
progrediu-lhes	progredir+V.ele.DAT.3.PL+PRF+3+SG
progrediu-me	progredir+V.eu.AD.1.SG+PRF+3+SG
progrediu-nos	progredir+nós.AD.1.PL+PRF+3+SG
progrediu-o	progredir+V.ele.ACC.3.M.SG+PRF+3+SG
progrediu-os	progredir+V.ele.ACC.3.M.PL+PRF+3+SG
progrediu-se	progredir+V.ele.REFL+PRF+3+SG
progrediu-te	progredir+V.tu.AD.2.SG+PRF+3+SG
progrediu-vos	progredir+V.vós.AD.2.PL+PRF+3+SG
progredi-vos	progredir+V.vós.AD.2.PL+PRF+1+SG
progrida-a	progredir+V.ele.ACC.3.F.SG+IMP+3+SG
progrida-as	progredir+V.ele.ACC.3.F.PL+IMP+3+SG
progrida-lhe	progredir+V.ele.DAT.3.SG+IMP+3+SG
progrida-lhes	progredir+V.ele.DAT.3.PL+IMP+3+SG
progrida-me	progredir+V.eu.AD.1.SG+IMP+3+SG
progridam-lhe	progredir+V.ele.DAT.3.SG+IMP+3+PL
progridam-lhes	progredir+V.ele.DAT.3.PL+IMP+3+PL
progridam-me	progredir+V.eu.AD.1.SG+IMP+3+PL
progridam-na	progredir+V.ele.ACC.3.F.SG+IMP+3+PL
progridam-nas	progredir+V.ele.ACC.3.F.PL+IMP+3+PL
progridam-no	progredir+V.ele.ACC.3.M.SG+IMP+3+PL
progridam-nos	progredir+V.ele.ACC.3.M.PL+IMP+3+PL
progridam-nos	progredir+V.nós.AD.1.PL+IMP+3+PL
progridamo-la	progredir+V.ele.ACC.3.F.SG+IMP+1+PL
progridamo-las	progredir+V.ele.ACC.3.F.PL+IMP+1+PL
progridamo-lo	progredir+V.ele.ACC.3.M.SG+IMP+1+PL
progridamo-los	progredir+V.ele.ACC.3.M.PL+IMP+1+PL
progridamo-nos	progredir+nós.AD.1.PL+IMP+1+PL
progridamos-lhe	progredir+V.ele.DAT.3.SG+IMP+1+PL
progridamos-lhes	progredir+V.ele.DAT.3.PL+IMP+1+PL
progridamos-me	progredir+V.eu.AD.1.SG+IMP+1+PL
progridamos-te	progredir+V.tu.AD.2.SG+IMP+1+PL
progridamos-vos	progredir+V.vós.AD.2.PL+IMP+1+PL
progridam-se	progredir+V.ele.REFL+IMP+3+PL
progridam-te	progredir+V.tu.AD.2.SG+IMP+3+PL
progridam-vos	progredir+V.vós.AD.2.PL+IMP+3+PL
progrida-nos	progredir+nós.AD.1.PL+IMP+3+SG
progrida-o	progredir+V.ele.ACC.3.M.SG+IMP+3+SG
progrida-os	progredir+V.ele.ACC.3.M.PL+IMP+3+SG
progrida-se	progredir+V.ele.REFL+IMP+3+SG
progrida-te	progredir+V.tu.AD.2.SG+IMP+3+SG
progrida-vos	progredir+V.vós.AD.2.PL+IMP+3+SG
progride-a	progredir+V.ele.ACC.3.F.SG+PRS+3+SG
progride-as	progredir+V.ele.ACC.3.F.PL+PRS+3+SG
progride-la	progredir+V.ele.ACC.3.F.SG+PRS+2+SG
progride-las	progredir+V.ele.ACC.3.F.PL+PRS+2+SG
progride-lhe	progredir+V.ele.DAT.3.SG+PRS+3+SG
progride-lhes	progredir+V.ele.DAT.3.PL+PRS+3+SG
progride-lo	progredir+V.ele.ACC.3.M.SG+PRS+2+SG
progride-los	progredir+V.ele.ACC.3.M.PL+PRS+2+SG
progride-me	progredir+V.eu.AD.1.SG+PRS+3+SG
progridem-lhe	progredir+V.ele.DAT.3.SG+PRS+3+PL
progridem-lhes	progredir+V.ele.DAT.3.PL+PRS+3+PL
progridem-me	progredir+V.eu.AD.1.SG+PRS+3+PL
progridem-na	progredir+V.ele.ACC.3.F.SG+PRS+3+PL
progridem-nas	progredir+V.ele.ACC.3.F.PL+PRS+3+PL
progridem-no	progredir+V.ele.ACC.3.M.SG+PRS+3+PL
progridem-nos	progredir+V.ele.ACC.3.M.PL+PRS+3+PL
progridem-nos	progredir+V.nós.AD.1.PL+PRS+3+PL
progridem-se	progredir+V.ele.REFL+PRS+3+PL
progridem-te	progredir+V.tu.AD.2.SG+PRS+3+PL
progridem-vos	progredir+V.vós.AD.2.PL+PRS+3+PL
progride-nos	progredir+nós.AD.1.PL+PRS+2+SG
progride-nos	progredir+nós.AD.1.PL+PRS+3+SG
progride-o	progredir+V.ele.ACC.3.M.SG+PRS+3+SG
progride-os	progredir+V.ele.ACC.3.M.PL+PRS+3+SG
progride-se	progredir+V.ele.REFL+PRS+3+SG
progrides-lhe	progredir+V.ele.DAT.3.SG+PRS+2+SG
progrides-lhes	progredir+V.ele.DAT.3.PL+PRS+2+SG
progrides-me	progredir+V.eu.AD.1.SG+PRS+2+SG
progrides-te	progredir+V.tu.AD.2.SG+PRS+2+SG
progrides-vos	progredir+V.vós.AD.2.PL+PRS+2+SG
progride-te	progredir+V.tu.AD.2.SG+PRS+3+SG
progride-vos	progredir+V.vós.AD.2.PL+PRS+3+SG
progrido-a	progredir+V.ele.ACC.3.F.SG+PRS+1+SG
progrido-as	progredir+V.ele.ACC.3.F.PL+PRS+1+SG
progrido-lhe	progredir+V.ele.DAT.3.SG+PRS+1+SG
progrido-lhes	progredir+V.ele.DAT.3.PL+PRS+1+SG
progrido-me	progredir+V.eu.AD.1.SG+PRS+1+SG
progrido-nos	progredir+nós.AD.1.PL+PRS+1+SG
progrido-o	progredir+V.ele.ACC.3.M.SG+PRS+1+SG
progrido-os	progredir+V.ele.ACC.3.M.PL+PRS+1+SG
progrido-te	progredir+V.tu.AD.2.SG+PRS+1+SG
progrido-vos	progredir+V.vós.AD.2.PL+PRS+1+SG
proíba-a	proibir+V.ele.ACC.3.F.SG+IMP+3+SG
proíba-as	proibir+V.ele.ACC.3.F.PL+IMP+3+SG
proíba-lhe	proibir+V.ele.DAT.3.SG+IMP+3+SG
proíba-lhes	proibir+V.ele.DAT.3.PL+IMP+3+SG
proíba-me	proibir+V.eu.AD.1.SG+IMP+3+SG
proíbam-lhe	proibir+V.ele.DAT.3.SG+IMP+3+PL
proíbam-lhes	proibir+V.ele.DAT.3.PL+IMP+3+PL
proíbam-me	proibir+V.eu.AD.1.SG+IMP+3+PL
proíbam-na	proibir+V.ele.ACC.3.F.SG+IMP+3+PL
proíbam-nas	proibir+V.ele.ACC.3.F.PL+IMP+3+PL
proíbam-no	proibir+V.ele.ACC.3.M.SG+IMP+3+PL
proíbam-nos	proibir+nós.AD.1.PL+IMP+3+PL
proibamo-la	proibir+V.ele.ACC.3.F.SG+IMP+1+PL
proibamo-las	proibir+V.ele.ACC.3.F.PL+IMP+1+PL
proibamo-lo	proibir+V.ele.ACC.3.M.SG+IMP+1+PL
proibamo-los	proibir+V.ele.ACC.3.M.PL+IMP+1+PL
proibamo-nos	proibir+nós.AD.1.PL+IMP+1+PL
proibamos-lhe	proibir+V.ele.DAT.3.SG+IMP+1+PL
proibamos-lhes	proibir+V.ele.DAT.3.PL+IMP+1+PL
proibamos-me	proibir+V.eu.AD.1.SG+IMP+1+PL
proibamos-te	proibir+V.tu.AD.2.SG+IMP+1+PL
proibamos-vos	proibir+V.vós.AD.2.PL+IMP+1+PL
proíbam-se	proibir+V.ele.REFL+IMP+3+PL
proíbam-te	proibir+V.tu.AD.2.SG+IMP+3+PL
proíbam-vos	proibir+V.vós.AD.2.PL+IMP+3+PL
proíba-nos	proibir+nós.AD.1.PL+IMP+3+SG
proíba-o	proibir+V.ele.ACC.3.M.SG+IMP+3+SG
proíba-os	proibir+V.ele.ACC.3.M.PL+IMP+3+SG
proíba-se	proibir+V.ele.REFL+IMP+3+SG
proíba-te	proibir+V.tu.AD.2.SG+IMP+3+SG
proíba-vos	proibir+V.vós.AD.2.PL+IMP+3+SG
proíbe-a	proibir+V.ele.ACC.3.F.SG+PRS+3+SG
proíbe-as	proibir+V.ele.ACC.3.F.PL+PRS+3+SG
proíbe-la	proibir+V.ele.ACC.3.F.SG+PRS+2+SG
proíbe-las	proibir+V.ele.ACC.3.F.PL+PRS+2+SG
proíbe-lhe	proibir+V.ele.DAT.3.SG+PRS+3+SG
proíbe-lhes	proibir+V.ele.DAT.3.PL+PRS+3+SG
proíbe-lo	proibir+V.ele.ACC.3.M.SG+PRS+2+SG
proíbe-los	proibir+V.ele.ACC.3.M.PL+PRS+2+SG
proíbe-me	proibir+V.eu.AD.1.SG+PRS+3+SG
proíbem-lhe	proibir+V.ele.DAT.3.SG+PRS+3+PL
proíbem-lhes	proibir+V.ele.DAT.3.PL+PRS+3+PL
proíbem-me	proibir+V.eu.AD.1.SG+PRS+3+PL
proíbem-na	proibir+V.ele.ACC.3.F.SG+PRS+3+PL
proíbem-nas	proibir+V.ele.ACC.3.F.PL+PRS+3+PL
proíbem-no	proibir+V.ele.ACC.3.M.SG+PRS+3+PL
proíbem-nos	proibir+nós.AD.1.PL+PRS+3+PL
proíbem-se	proibir+V.ele.REFL+PRS+3+PL
proíbem-te	proibir+V.tu.AD.2.SG+PRS+3+PL
proíbem-vos	proibir+V.vós.AD.2.PL+PRS+3+PL
proíbe-nos	proibir+nós.AD.1.PL+PRS+2+SG
proíbe-nos	proibir+nós.AD.1.PL+PRS+3+SG
proíbe-o	proibir+V.ele.ACC.3.M.SG+PRS+3+SG
proíbe-os	proibir+V.ele.ACC.3.M.PL+PRS+3+SG
proíbe-se	proibir+V.ele.REFL+PRS+3+SG
proíbes-lhe	proibir+V.ele.DAT.3.SG+PRS+2+SG
proíbes-lhes	proibir+V.ele.DAT.3.PL+PRS+2+SG
proíbes-me	proibir+V.eu.AD.1.SG+PRS+2+SG
proíbes-te	proibir+V.tu.AD.2.SG+PRS+2+SG
proíbes-vos	proibir+V.vós.AD.2.PL+PRS+2+SG
proíbe-te	proibir+V.tu.AD.2.SG+PRS+3+SG
proíbe-vos	proibir+V.vós.AD.2.PL+PRS+3+SG
proibia-a	proibir+V.ele.ACC.3.F.SG+IMPF+1+SG
proibia-a	proibir+V.ele.ACC.3.F.SG+IMPF+3+SG
proibia-as	proibir+V.ele.ACC.3.F.PL+IMPF+1+SG
proibia-as	proibir+V.ele.ACC.3.F.PL+IMPF+3+SG
proibia-la	proibir+V.ele.ACC.3.F.SG+IMPF+2+SG
proibia-las	proibir+V.ele.ACC.3.F.PL+IMPF+2+SG
proibia-lhe	proibir+V.ele.DAT.3.SG+IMPF+1+SG
proibia-lhe	proibir+V.ele.DAT.3.SG+IMPF+3+SG
proibia-lhes	proibir+V.ele.DAT.3.PL+IMPF+1+SG
proibia-lhes	proibir+V.ele.DAT.3.PL+IMPF+3+SG
proibia-lo	proibir+V.ele.ACC.3.M.SG+IMPF+2+SG
proibia-los	proibir+V.ele.ACC.3.M.PL+IMPF+2+SG
proibia-me	proibir+V.eu.AD.1.SG+IMPF+1+SG
proibia-me	proibir+V.eu.AD.1.SG+IMPF+3+SG
proibiam-lhe	proibir+V.ele.DAT.3.SG+IMPF+3+PL
proibiam-lhes	proibir+V.ele.DAT.3.PL+IMPF+3+PL
proibiam-me	proibir+V.eu.AD.1.SG+IMPF+3+PL
proibiam-na	proibir+V.ele.ACC.3.F.SG+IMPF+3+PL
proibiam-nas	proibir+V.ele.ACC.3.F.PL+IMPF+3+PL
proibiam-no	proibir+V.ele.ACC.3.M.SG+IMPF+3+PL
proibiam-nos	proibir+V.ele.ACC.3.M.PL+IMPF+3+PL
proibiam-nos	proibir+V.nós.AD.1.PL+IMPF+3+PL
proibíamo-la	proibir+V.ele.ACC.3.F.SG+IMPF+1+PL
proibíamo-las	proibir+V.ele.ACC.3.F.PL+IMPF+1+PL
proibíamo-lo	proibir+V.ele.ACC.3.M.SG+IMPF+1+PL
proibíamo-los	proibir+V.ele.ACC.3.M.PL+IMPF+1+PL
proibíamo-nos	proibir+nós.AD.1.PL+IMPF+1+PL
proibíamos-lhe	proibir+V.ele.DAT.3.SG+IMPF+1+PL
proibíamos-lhes	proibir+V.ele.DAT.3.PL+IMPF+1+PL
proibíamos-me	proibir+V.eu.AD.1.SG+IMPF+1+PL
proibíamos-te	proibir+V.tu.AD.2.SG+IMPF+1+PL
proibíamos-vos	proibir+V.vós.AD.2.PL+IMPF+1+PL
proibiam-se	proibir+V.ele.REFL+IMPF+3+PL
proibiam-te	proibir+V.tu.AD.2.SG+IMPF+3+PL
proibiam-vos	proibir+V.vós.AD.2.PL+IMPF+3+PL
proibia-nos	proibir+nós.AD.1.PL+IMPF+1+SG
proibia-nos	proibir+nós.AD.1.PL+IMPF+2+SG
proibia-nos	proibir+nós.AD.1.PL+IMPF+3+SG
proibia-o	proibir+V.ele.ACC.3.M.SG+IMPF+1+SG
proibia-o	proibir+V.ele.ACC.3.M.SG+IMPF+3+SG
proibia-os	proibir+V.ele.ACC.3.M.PL+IMPF+1+SG
proibia-os	proibir+V.ele.ACC.3.M.PL+IMPF+3+SG
proibi-a	proibir+V.ele.ACC.3.F.SG+PRF+1+SG
proibia-se	proibir+V.ele.REFL+IMPF+3+SG
proibias-lhe	proibir+V.ele.DAT.3.SG+IMPF+2+SG
proibias-lhes	proibir+V.ele.DAT.3.PL+IMPF+2+SG
proibias-me	proibir+V.eu.AD.1.SG+IMPF+2+SG
proibi-as	proibir+V.ele.ACC.3.F.PL+PRF+1+SG
proibias-te	proibir+V.tu.AD.2.SG+IMPF+2+SG
proibias-vos	proibir+V.vós.AD.2.PL+IMPF+2+SG
proibia-te	proibir+V.tu.AD.2.SG+IMPF+1+SG
proibia-te	proibir+V.tu.AD.2.SG+IMPF+3+SG
proibia-vos	proibir+V.vós.AD.2.PL+IMPF+1+SG
proibia-vos	proibir+V.vós.AD.2.PL+IMPF+3+SG
proibíei-la	proibir+V.ele.ACC.3.F.SG+IMPF+2+PL
proibíei-las	proibir+V.ele.ACC.3.F.PL+IMPF+2+PL
proibíei-lo	proibir+V.ele.ACC.3.M.SG+IMPF+2+PL
proibíei-los	proibir+V.ele.ACC.3.M.PL+IMPF+2+PL
proibíei-nos	proibir+nós.AD.1.PL+IMPF+2+PL
proibíeis-lhe	proibir+V.ele.DAT.3.SG+IMPF+2+PL
proibíeis-lhes	proibir+V.ele.DAT.3.PL+IMPF+2+PL
proibíeis-me	proibir+V.eu.AD.1.SG+IMPF+2+PL
proibíeis-te	proibir+V.tu.AD.2.SG+IMPF+2+PL
proibíeis-vos	proibir+V.vós.AD.2.PL+IMPF+2+PL
proibi-la-ão	proibir+V.ele.ACC.3.F.SG+FUT+3+PL
proibi-la-á	proibir+V.ele.ACC.3.F.SG+FUT+3+SG
proibi-la-ás	proibir+V.ele.ACC.3.F.SG+FUT+2+SG
proibi-la-ei	proibir+V.ele.ACC.3.F.SG+FUT+1+SG
proibi-la-eis	proibir+V.ele.ACC.3.F.SG+FUT+2+PL
proibi-la-emos	proibir+V.ele.ACC.3.F.SG+FUT+1+PL
proibi-la-íamos	proibir+V.ele.ACC.3.F.SG+COND+1+PL
proibi-la-iam	proibir+V.ele.ACC.3.F.SG+COND+3+PL
proibi-la-ia	proibir+V.ele.ACC.3.F.SG+COND+1+SG
proibi-la-ia	proibir+V.ele.ACC.3.F.SG+COND+3+SG
proibi-la-ias	proibir+V.ele.ACC.3.F.SG+COND+2+SG
proibi-la-íeis	proibir+V.ele.ACC.3.F.SG+COND+2+PL
proibi-la	proibir+V.ele.ACC.3.F.SG+INF+1+SG
proibi-la	proibir+V.ele.ACC.3.F.SG+INF+3+SG
proibi-la	proibir+V.ele.ACC.3.F.SG+PRS+2+PL
proibi-la	proibir+V.ele.ACC.3.F.SG+SBJF+1+SG
proibi-la	proibir+V.ele.ACC.3.F.SG+SBJF+3+SG
proibi-las-ão	proibir+V.ele.ACC.3.F.PL+FUT+3+PL
proibi-las-á	proibir+V.ele.ACC.3.F.PL+FUT+3+SG
proibi-las-ás	proibir+V.ele.ACC.3.F.PL+FUT+2+SG
proibi-las-ei	proibir+V.ele.ACC.3.F.PL+FUT+1+SG
proibi-las-eis	proibir+V.ele.ACC.3.F.PL+FUT+2+PL
proibi-las-emos	proibir+V.ele.ACC.3.F.PL+FUT+1+PL
proibi-las-íamos	proibir+V.ele.ACC.3.F.PL+COND+1+PL
proibi-las-iam	proibir+V.ele.ACC.3.F.PL+COND+3+PL
proibi-las-ia	proibir+V.ele.ACC.3.F.PL+COND+1+SG
proibi-las-ia	proibir+V.ele.ACC.3.F.PL+COND+3+SG
proibi-las-ias	proibir+V.ele.ACC.3.F.PL+COND+2+SG
proibi-las-íeis	proibir+V.ele.ACC.3.F.PL+COND+2+PL
proibi-las	proibir+V.ele.ACC.3.F.PL+INF+1+SG
proibi-las	proibir+V.ele.ACC.3.F.PL+INF+3+SG
proibi-las	proibir+V.ele.ACC.3.F.PL+PRS+2+PL
proibi-las	proibir+V.ele.ACC.3.F.PL+SBJF+1+SG
proibi-las	proibir+V.ele.ACC.3.F.PL+SBJF+3+SG
proibi-lhe	proibir+V.ele.DAT.3.SG+PRF+1+SG
proibi-lhes	proibir+V.ele.DAT.3.PL+PRF+1+SG
proibi-lo-ão	proibir+V.ele.ACC.3.M.SG+FUT+3+PL
proibi-lo-á	proibir+V.ele.ACC.3.M.SG+FUT+3+SG
proibi-lo-ás	proibir+V.ele.ACC.3.M.SG+FUT+2+SG
proibi-lo-ei	proibir+V.ele.ACC.3.M.SG+FUT+1+SG
proibi-lo-eis	proibir+V.ele.ACC.3.M.SG+FUT+2+PL
proibi-lo-emos	proibir+V.ele.ACC.3.M.SG+FUT+1+PL
proibi-lo-íamos	proibir+V.ele.ACC.3.M.SG+COND+1+PL
proibi-lo-iam	proibir+V.ele.ACC.3.M.SG+COND+3+PL
proibi-lo-ia	proibir+V.ele.ACC.3.M.SG+COND+1+SG
proibi-lo-ia	proibir+V.ele.ACC.3.M.SG+COND+3+SG
proibi-lo-ias	proibir+V.ele.ACC.3.M.SG+COND+2+SG
proibi-lo-íeis	proibir+V.ele.ACC.3.M.SG+COND+2+PL
proibi-lo	proibir+V.ele.ACC.3.M.SG+INF+1+SG
proibi-lo	proibir+V.ele.ACC.3.M.SG+INF+3+SG
proibi-lo	proibir+V.ele.ACC.3.M.SG+PRS+2+PL
proibi-lo	proibir+V.ele.ACC.3.M.SG+SBJF+1+SG
proibi-lo	proibir+V.ele.ACC.3.M.SG+SBJF+3+SG
proibi-los-ão	proibir+V.ele.ACC.3.M.PL+FUT+3+PL
proibi-los-á	proibir+V.ele.ACC.3.M.PL+FUT+3+SG
proibi-los-ás	proibir+V.ele.ACC.3.M.PL+FUT+2+SG
proibi-los-ei	proibir+V.ele.ACC.3.M.PL+FUT+1+SG
proibi-los-eis	proibir+V.ele.ACC.3.M.PL+FUT+2+PL
proibi-los-emos	proibir+V.ele.ACC.3.M.PL+FUT+1+PL
proibi-los-íamos	proibir+V.ele.ACC.3.M.PL+COND+1+PL
proibi-los-iam	proibir+V.ele.ACC.3.M.PL+COND+3+PL
proibi-los-ia	proibir+V.ele.ACC.3.M.PL+COND+1+SG
proibi-los-ia	proibir+V.ele.ACC.3.M.PL+COND+3+SG
proibi-los-ias	proibir+V.ele.ACC.3.M.PL+COND+2+SG
proibi-los-íeis	proibir+V.ele.ACC.3.M.PL+COND+2+PL
proibi-los	proibir+V.ele.ACC.3.M.PL+INF+1+SG
proibi-los	proibir+V.ele.ACC.3.M.PL+INF+3+SG
proibi-los	proibir+V.ele.ACC.3.M.PL+PRS+2+PL
proibi-los	proibir+V.ele.ACC.3.M.PL+SBJF+1+SG
proibi-los	proibir+V.ele.ACC.3.M.PL+SBJF+3+SG
proibi-me	proibir+V.eu.AD.1.SG+PRF+1+SG
proibimo-la	proibir+V.ele.ACC.3.F.SG+PRF+1+PL
proibimo-la	proibir+V.ele.ACC.3.F.SG+PRS+1+PL
proibimo-las	proibir+V.ele.ACC.3.F.PL+PRF+1+PL
proibimo-las	proibir+V.ele.ACC.3.F.PL+PRS+1+PL
proibimo-lo	proibir+V.ele.ACC.3.M.SG+PRF+1+PL
proibimo-lo	proibir+V.ele.ACC.3.M.SG+PRS+1+PL
proibimo-los	proibir+V.ele.ACC.3.M.PL+PRF+1+PL
proibimo-los	proibir+V.ele.ACC.3.M.PL+PRS+1+PL
proibimo-nos	proibir+nós.AD.1.PL+PRF+1+PL
proibimo-nos	proibir+nós.AD.1.PL+PRS+1+PL
proibimos-lhe	proibir+V.ele.DAT.3.SG+PRF+1+PL
proibimos-lhe	proibir+V.ele.DAT.3.SG+PRS+1+PL
proibimos-lhes	proibir+V.ele.DAT.3.PL+PRF+1+PL
proibimos-lhes	proibir+V.ele.DAT.3.PL+PRS+1+PL
proibimos-me	proibir+V.eu.AD.1.SG+PRF+1+PL
proibimos-me	proibir+V.eu.AD.1.SG+PRS+1+PL
proibimos-te	proibir+V.tu.AD.2.SG+PRF+1+PL
proibimos-te	proibir+V.tu.AD.2.SG+PRS+1+PL
proibimos-vos	proibir+V.vós.AD.2.PL+PRF+1+PL
proibimos-vos	proibir+V.vós.AD.2.PL+PRS+1+PL
proibi-nos	proibir+nós.AD.1.PL+PRF+1+SG
proibi-nos	proibir+nós.AD.1.PL+PRS+2+PL
proibi-o	proibir+V.ele.ACC.3.M.SG+PRF+1+SG
proibi-os	proibir+V.ele.ACC.3.M.PL+PRF+1+SG
proibiram-lhe	proibir+V.ele.DAT.3.SG+PRF+3+PL
proibiram-lhes	proibir+V.ele.DAT.3.PL+PRF+3+PL
proibiram-me	proibir+V.eu.AD.1.SG+PRF+3+PL
proibiram-na	proibir+V.ele.ACC.3.F.SG+PRF+3+PL
proibiram-nas	proibir+V.ele.ACC.3.F.PL+PRF+3+PL
proibiram-no	proibir+V.ele.ACC.3.M.SG+PRF+3+PL
proibiram-nos	proibir+V.ele.ACC.3.M.PL+PRF+3+PL
proibiram-nos	proibir+V.nós.AD.1.PL+PRF+3+PL
proibiram-se	proibir+V.ele.REFL+PRF+3+PL
proibiram-te	proibir+V.tu.AD.2.SG+PRF+3+PL
proibiram-vos	proibir+V.vós.AD.2.PL+PRF+3+PL
proibirde-la	proibir+V.ele.ACC.3.F.SG+INF+2+PL
proibirde-la	proibir+V.ele.ACC.3.F.SG+SBJF+2+PL
proibirde-las	proibir+V.ele.ACC.3.F.PL+INF+2+PL
proibirde-las	proibir+V.ele.ACC.3.F.PL+SBJF+2+PL
proibirde-lo	proibir+V.ele.ACC.3.M.SG+INF+2+PL
proibirde-lo	proibir+V.ele.ACC.3.M.SG+SBJF+2+PL
proibirde-los	proibir+V.ele.ACC.3.M.PL+INF+2+PL
proibirde-los	proibir+V.ele.ACC.3.M.PL+SBJF+2+PL
proibirde-nos	proibir+nós.AD.1.PL+INF+2+PL
proibirde-nos	proibir+nós.AD.1.PL+SBJF+2+PL
proibirdes-lhe	proibir+V.ele.DAT.3.SG+INF+2+PL
proibirdes-lhe	proibir+V.ele.DAT.3.SG+SBJF+2+PL
proibirdes-lhes	proibir+V.ele.DAT.3.PL+INF+2+PL
proibirdes-lhes	proibir+V.ele.DAT.3.PL+SBJF+2+PL
proibirdes-me	proibir+V.eu.AD.1.SG+INF+2+PL
proibirdes-me	proibir+V.eu.AD.1.SG+SBJF+2+PL
proibirdes-te	proibir+V.tu.AD.2.SG+INF+2+PL
proibirdes-te	proibir+V.tu.AD.2.SG+SBJF+2+PL
proibirdes-vos	proibir+V.vós.AD.2.PL+INF+2+PL
proibirdes-vos	proibir+V.vós.AD.2.PL+SBJF+2+PL
proibire-la	proibir+V.ele.ACC.3.F.SG+INF+2+SG
proibire-la	proibir+V.ele.ACC.3.F.SG+SBJF+2+SG
proibire-las	proibir+V.ele.ACC.3.F.PL+INF+2+SG
proibire-las	proibir+V.ele.ACC.3.F.PL+SBJF+2+SG
proibire-lo	proibir+V.ele.ACC.3.M.SG+INF+2+SG
proibire-lo	proibir+V.ele.ACC.3.M.SG+SBJF+2+SG
proibire-los	proibir+V.ele.ACC.3.M.PL+INF+2+SG
proibire-los	proibir+V.ele.ACC.3.M.PL+SBJF+2+SG
proibirem-lhe	proibir+V.ele.DAT.3.SG+INF+3+PL
proibirem-lhe	proibir+V.ele.DAT.3.SG+SBJF+3+PL
proibirem-lhes	proibir+V.ele.DAT.3.PL+INF+3+PL
proibirem-lhes	proibir+V.ele.DAT.3.PL+SBJF+3+PL
proibirem-me	proibir+V.eu.AD.1.SG+INF+3+PL
proibirem-me	proibir+V.eu.AD.1.SG+SBJF+3+PL
proibirem-na	proibir+V.ele.ACC.3.F.SG+INF+3+PL
proibirem-na	proibir+V.ele.ACC.3.F.SG+SBJF+3+PL
proibirem-nas	proibir+V.ele.ACC.3.F.PL+INF+3+PL
proibirem-nas	proibir+V.ele.ACC.3.F.PL+SBJF+3+PL
proibirem-no	proibir+V.ele.ACC.3.M.SG+INF+3+PL
proibirem-no	proibir+V.ele.ACC.3.M.SG+SBJF+3+PL
proibirem-nos	proibir+V.ele.ACC.3.M.PL+INF+3+PL
proibirem-nos	proibir+V.ele.ACC.3.M.PL+SBJF+3+PL
proibirem-nos	proibir+V.nós.AD.1.PL+INF+3+PL
proibirem-nos	proibir+V.nós.AD.1.PL+SBJF+3+PL
proibirem-se	proibir+V.ele.REFL+INF+3+PL
proibirem-se	proibir+V.ele.REFL+SBJF+3+PL
proibirem-te	proibir+V.tu.AD.2.SG+INF+3+PL
proibirem-te	proibir+V.tu.AD.2.SG+SBJF+3+PL
proibirem-vos	proibir+V.vós.AD.2.PL+INF+3+PL
proibirem-vos	proibir+V.vós.AD.2.PL+SBJF+3+PL
proibire-nos	proibir+nós.AD.1.PL+INF+2+SG
proibire-nos	proibir+nós.AD.1.PL+SBJF+2+SG
proibires-lhe	proibir+V.ele.DAT.3.SG+INF+2+SG
proibires-lhe	proibir+V.ele.DAT.3.SG+SBJF+2+SG
proibires-lhes	proibir+V.ele.DAT.3.PL+INF+2+SG
proibires-lhes	proibir+V.ele.DAT.3.PL+SBJF+2+SG
proibires-me	proibir+V.eu.AD.1.SG+INF+2+SG
proibires-me	proibir+V.eu.AD.1.SG+SBJF+2+SG
proibires-te	proibir+V.tu.AD.2.SG+INF+2+SG
proibires-te	proibir+V.tu.AD.2.SG+SBJF+2+SG
proibires-vos	proibir+V.vós.AD.2.PL+INF+2+SG
proibires-vos	proibir+V.vós.AD.2.PL+SBJF+2+SG
proibir-lhe-ão	proibir+V.ele.DAT.3.SG+FUT+3+PL
proibir-lhe-á	proibir+V.ele.DAT.3.SG+FUT+3+SG
proibir-lhe-ás	proibir+V.ele.DAT.3.SG+FUT+2+SG
proibir-lhe-ei	proibir+V.ele.DAT.3.SG+FUT+1+SG
proibir-lhe-eis	proibir+V.ele.DAT.3.SG+FUT+2+PL
proibir-lhe-emos	proibir+V.ele.DAT.3.SG+FUT+1+PL
proibir-lhe-íamos	proibir+V.ele.DAT.3.SG+COND+1+PL
proibir-lhe-iam	proibir+V.ele.DAT.3.SG+COND+3+PL
proibir-lhe-ia	proibir+V.ele.DAT.3.SG+COND+1+SG
proibir-lhe-ia	proibir+V.ele.DAT.3.SG+COND+3+SG
proibir-lhe-ias	proibir+V.ele.DAT.3.SG+COND+2+SG
proibir-lhe-íeis	proibir+V.ele.DAT.3.SG+COND+2+PL
proibir-lhe	proibir+V.ele.DAT.3.SG+INF
proibir-lhe	proibir+V.ele.DAT.3.SG+INF+1+SG
proibir-lhe	proibir+V.ele.DAT.3.SG+INF+3+SG
proibir-lhe	proibir+V.ele.DAT.3.SG+SBJF+1+SG
proibir-lhe	proibir+V.ele.DAT.3.SG+SBJF+3+SG
proibir-lhes-ão	proibir+V.ele.DAT.3.PL+FUT+3+PL
proibir-lhes-á	proibir+V.ele.DAT.3.PL+FUT+3+SG
proibir-lhes-ás	proibir+V.ele.DAT.3.PL+FUT+2+SG
proibir-lhes-ei	proibir+V.ele.DAT.3.PL+FUT+1+SG
proibir-lhes-eis	proibir+V.ele.DAT.3.PL+FUT+2+PL
proibir-lhes-emos	proibir+V.ele.DAT.3.PL+FUT+1+PL
proibir-lhes-íamos	proibir+V.ele.DAT.3.PL+COND+1+PL
proibir-lhes-iam	proibir+V.ele.DAT.3.PL+COND+3+PL
proibir-lhes-ia	proibir+V.ele.DAT.3.PL+COND+1+SG
proibir-lhes-ia	proibir+V.ele.DAT.3.PL+COND+3+SG
proibir-lhes-ias	proibir+V.ele.DAT.3.PL+COND+2+SG
proibir-lhes-íeis	proibir+V.ele.DAT.3.PL+COND+2+PL
proibir-lhes	proibir+V.ele.DAT.3.PL+INF
proibir-lhes	proibir+V.ele.DAT.3.PL+INF+1+SG
proibir-lhes	proibir+V.ele.DAT.3.PL+INF+3+SG
proibir-lhes	proibir+V.ele.DAT.3.PL+SBJF+1+SG
proibir-lhes	proibir+V.ele.DAT.3.PL+SBJF+3+SG
proibir-me-ão	proibir+V.eu.AD.1.SG+FUT+3+PL
proibir-me-á	proibir+V.eu.AD.1.SG+FUT+3+SG
proibir-me-ás	proibir+V.eu.AD.1.SG+FUT+2+SG
proibir-me-ei	proibir+V.eu.AD.1.SG+FUT+1+SG
proibir-me-eis	proibir+V.eu.AD.1.SG+FUT+2+PL
proibir-me-emos	proibir+V.eu.AD.1.SG+FUT+1+PL
proibir-me-íamos	proibir+V.eu.AD.1.SG+COND+1+PL
proibir-me-iam	proibir+V.eu.AD.1.SG+COND+3+PL
proibir-me-ia	proibir+V.eu.AD.1.SG+COND+1+SG
proibir-me-ia	proibir+V.eu.AD.1.SG+COND+3+SG
proibir-me-ias	proibir+V.eu.AD.1.SG+COND+2+SG
proibir-me-íeis	proibir+V.eu.AD.1.SG+COND+2+PL
proibir-me	proibir+V.eu.AD.1.SG+INF
proibir-me	proibir+V.eu.AD.1.SG+INF+1+SG
proibir-me	proibir+V.eu.AD.1.SG+INF+3+SG
proibir-me	proibir+V.eu.AD.1.SG+SBJF+1+SG
proibir-me	proibir+V.eu.AD.1.SG+SBJF+3+SG
proibirmo-la	proibir+V.ele.ACC.3.F.SG+INF+1+PL
proibirmo-la	proibir+V.ele.ACC.3.F.SG+SBJF+1+PL
proibirmo-las	proibir+V.ele.ACC.3.F.PL+INF+1+PL
proibirmo-las	proibir+V.ele.ACC.3.F.PL+SBJF+1+PL
proibirmo-lo	proibir+V.ele.ACC.3.M.SG+INF+1+PL
proibirmo-lo	proibir+V.ele.ACC.3.M.SG+SBJF+1+PL
proibirmo-los	proibir+V.ele.ACC.3.M.PL+INF+1+PL
proibirmo-los	proibir+V.ele.ACC.3.M.PL+SBJF+1+PL
proibirmo-nos	proibir+nós.AD.1.PL+INF+1+PL
proibirmo-nos	proibir+nós.AD.1.PL+SBJF+1+PL
proibirmos-lhe	proibir+V.ele.DAT.3.SG+INF+1+PL
proibirmos-lhe	proibir+V.ele.DAT.3.SG+SBJF+1+PL
proibirmos-lhes	proibir+V.ele.DAT.3.PL+INF+1+PL
proibirmos-lhes	proibir+V.ele.DAT.3.PL+SBJF+1+PL
proibirmos-me	proibir+V.eu.AD.1.SG+INF+1+PL
proibirmos-me	proibir+V.eu.AD.1.SG+SBJF+1+PL
proibirmos-te	proibir+V.tu.AD.2.SG+INF+1+PL
proibirmos-te	proibir+V.tu.AD.2.SG+SBJF+1+PL
proibirmos-vos	proibir+V.vós.AD.2.PL+INF+1+PL
proibirmos-vos	proibir+V.vós.AD.2.PL+SBJF+1+PL
proibir-nos-ão	proibir+nós.AD.1.PL+FUT+3+PL
proibir-nos-á	proibir+nós.AD.1.PL+FUT+3+SG
proibir-nos-ás	proibir+nós.AD.1.PL+FUT+2+SG
proibir-nos-ei	proibir+nós.AD.1.PL+FUT+1+SG
proibir-nos-eis	proibir+nós.AD.1.PL+FUT+2+PL
proibir-nos-emos	proibir+nós.AD.1.PL+FUT+1+PL
proibir-nos-íamos	proibir+nós.AD.1.PL+COND+1+PL
proibir-nos-iam	proibir+nós.AD.1.PL+COND+3+PL
proibir-nos-ia	proibir+nós.AD.1.PL+COND+1+SG
proibir-nos-ia	proibir+nós.AD.1.PL+COND+3+SG
proibir-nos-ias	proibir+nós.AD.1.PL+COND+2+SG
proibir-nos-íeis	proibir+nós.AD.1.PL+COND+2+PL
proibir-nos	proibir+nós.AD.1.PL+INF
proibir-nos	proibir+nós.AD.1.PL+INF+1+SG
proibir-nos	proibir+nós.AD.1.PL+INF+3+SG
proibir-nos	proibir+nós.AD.1.PL+SBJF+1+SG
proibir-nos	proibir+nós.AD.1.PL+SBJF+3+SG
proibir-se-ão	proibir+V.ele.REFL+FUT+3+PL
proibir-se-á	proibir+V.ele.REFL+FUT+3+SG
proibir-se-iam	proibir+V.ele.REFL+COND+3+PL
proibir-se-ia	proibir+V.ele.REFL+COND+3+SG
proibir-se	proibir+V.ele.REFL+INF
proibir-se	proibir+V.ele.REFL+INF+3+SG
proibir-se	proibir+V.ele.REFL+SBJF+3+SG
proibir-te-ão	proibir+V.tu.AD.2.SG+FUT+3+PL
proibir-te-á	proibir+V.tu.AD.2.SG+FUT+3+SG
proibir-te-ás	proibir+V.tu.AD.2.SG+FUT+2+SG
proibir-te-ei	proibir+V.tu.AD.2.SG+FUT+1+SG
proibir-te-eis	proibir+V.tu.AD.2.SG+FUT+2+PL
proibir-te-emos	proibir+V.tu.AD.2.SG+FUT+1+PL
proibir-te-íamos	proibir+V.tu.AD.2.SG+COND+1+PL
proibir-te-iam	proibir+V.tu.AD.2.SG+COND+3+PL
proibir-te-ia	proibir+V.tu.AD.2.SG+COND+1+SG
proibir-te-ia	proibir+V.tu.AD.2.SG+COND+3+SG
proibir-te-ias	proibir+V.tu.AD.2.SG+COND+2+SG
proibir-te-íeis	proibir+V.tu.AD.2.SG+COND+2+PL
proibir-te	proibir+V.tu.AD.2.SG+INF
proibir-te	proibir+V.tu.AD.2.SG+INF+1+SG
proibir-te	proibir+V.tu.AD.2.SG+INF+3+SG
proibir-te	proibir+V.tu.AD.2.SG+SBJF+1+SG
proibir-te	proibir+V.tu.AD.2.SG+SBJF+3+SG
proibir-vos-ão	proibir+V.vós.AD.2.PL+FUT+3+PL
proibir-vos-á	proibir+V.vós.AD.2.PL+FUT+3+SG
proibir-vos-ás	proibir+V.vós.AD.2.PL+FUT+2+SG
proibir-vos-ei	proibir+V.vós.AD.2.PL+FUT+1+SG
proibir-vos-eis	proibir+V.vós.AD.2.PL+FUT+2+PL
proibir-vos-emos	proibir+V.vós.AD.2.PL+FUT+1+PL
proibir-vos-íamos	proibir+V.vós.AD.2.PL+COND+1+PL
proibir-vos-iam	proibir+V.vós.AD.2.PL+COND+3+PL
proibir-vos-ia	proibir+V.vós.AD.2.PL+COND+1+SG
proibir-vos-ia	proibir+V.vós.AD.2.PL+COND+3+SG
proibir-vos-ias	proibir+V.vós.AD.2.PL+COND+2+SG
proibir-vos-íeis	proibir+V.vós.AD.2.PL+COND+2+PL
proibir-vos	proibir+V.vós.AD.2.PL+INF
proibir-vos	proibir+V.vós.AD.2.PL+INF+1+SG
proibir-vos	proibir+V.vós.AD.2.PL+INF+3+SG
proibir-vos	proibir+V.vós.AD.2.PL+SBJF+1+SG
proibir-vos	proibir+V.vós.AD.2.PL+SBJF+3+SG
proibis-lhe	proibir+V.ele.DAT.3.SG+PRS+2+PL
proibis-lhes	proibir+V.ele.DAT.3.PL+PRS+2+PL
proibis-me	proibir+V.eu.AD.1.SG+PRS+2+PL
proibiste-a	proibir+V.ele.ACC.3.F.SG+PRF+2+SG
proibiste-as	proibir+V.ele.ACC.3.F.PL+PRF+2+SG
proibiste-la	proibir+V.ele.ACC.3.F.SG+PRF+2+PL
proibiste-las	proibir+V.ele.ACC.3.F.PL+PRF+2+PL
proibiste-lhe	proibir+V.ele.DAT.3.SG+PRF+2+SG
proibiste-lhes	proibir+V.ele.DAT.3.PL+PRF+2+SG
proibiste-lo	proibir+V.ele.ACC.3.M.SG+PRF+2+PL
proibiste-los	proibir+V.ele.ACC.3.M.PL+PRF+2+PL
proibiste-me	proibir+V.eu.AD.1.SG+PRF+2+SG
proibiste-nos	proibir+nós.AD.1.PL+PRF+2+PL
proibiste-nos	proibir+nós.AD.1.PL+PRF+2+SG
proibiste-o	proibir+V.ele.ACC.3.M.SG+PRF+2+SG
proibiste-os	proibir+V.ele.ACC.3.M.PL+PRF+2+SG
proibis-te	proibir+V.tu.AD.2.SG+PRS+2+PL
proibistes-lhe	proibir+V.ele.DAT.3.SG+PRF+2+PL
proibistes-lhes	proibir+V.ele.DAT.3.PL+PRF+2+PL
proibistes-me	proibir+V.eu.AD.1.SG+PRF+2+PL
proibistes-te	proibir+V.tu.AD.2.SG+PRF+2+PL
proibistes-vos	proibir+V.vós.AD.2.PL+PRF+2+PL
proibiste-te	proibir+V.tu.AD.2.SG+PRF+2+SG
proibiste-vos	proibir+V.vós.AD.2.PL+PRF+2+SG
proibis-vos	proibir+V.vós.AD.2.PL+PRS+2+PL
proibi-te	proibir+V.tu.AD.2.SG+PRF+1+SG
proibiu-a	proibir+V.ele.ACC.3.F.SG+PRF+3+SG
proibiu-as	proibir+V.ele.ACC.3.F.PL+PRF+3+SG
proibiu-lhe	proibir+V.ele.DAT.3.SG+PRF+3+SG
proibiu-lhes	proibir+V.ele.DAT.3.PL+PRF+3+SG
proibiu-me	proibir+V.eu.AD.1.SG+PRF+3+SG
proibiu-nos	proibir+nós.AD.1.PL+PRF+3+SG
proibiu-o	proibir+V.ele.ACC.3.M.SG+PRF+3+SG
proibiu-os	proibir+V.ele.ACC.3.M.PL+PRF+3+SG
proibiu-se	proibir+V.ele.REFL+PRF+3+SG
proibiu-te	proibir+V.tu.AD.2.SG+PRF+3+SG
proibiu-vos	proibir+V.vós.AD.2.PL+PRF+3+SG
proibi-vos	proibir+V.vós.AD.2.PL+PRF+1+SG
proíbo-a	proibir+V.ele.ACC.3.F.SG+PRS+1+SG
proíbo-as	proibir+V.ele.ACC.3.F.PL+PRS+1+SG
proíbo-lhe	proibir+V.ele.DAT.3.SG+PRS+1+SG
proíbo-lhes	proibir+V.ele.DAT.3.PL+PRS+1+SG
proíbo-me	proibir+V.eu.AD.1.SG+PRS+1+SG
proíbo-nos	proibir+nós.AD.1.PL+PRS+1+SG
proíbo-o	proibir+V.ele.ACC.3.M.SG+PRS+1+SG
proíbo-os	proibir+V.ele.ACC.3.M.PL+PRS+1+SG
proíbo-te	proibir+V.tu.AD.2.SG+PRS+1+SG
proíbo-vos	proibir+V.vós.AD.2.PL+PRS+1+SG
projeta-a	projetar+V.ele.ACC.3.F.SG+PRS+3+SG
projeta-as	projetar+V.ele.ACC.3.F.PL+PRS+3+SG
projetai-la	projetar+V.ele.ACC.3.F.SG+PRS+2+PL
projetai-las	projetar+V.ele.ACC.3.F.PL+PRS+2+PL
projetai-lo	projetar+V.ele.ACC.3.M.SG+PRS+2+PL
projetai-los	projetar+V.ele.ACC.3.M.PL+PRS+2+PL
projetai-nos	projetar+nós.AD.1.PL+PRS+2+PL
projetais-lhe	projetar+V.ele.DAT.3.SG+PRS+2+PL
projetais-lhes	projetar+V.ele.DAT.3.PL+PRS+2+PL
projetais-me	projetar+V.eu.AD.1.SG+PRS+2+PL
projetais-te	projetar+V.tu.AD.2.SG+PRS+2+PL
projetais-vos	projetar+V.vós.AD.2.PL+PRS+2+PL
projetá-la-ão	projetar+V.ele.ACC.3.F.SG+FUT+3+PL
projetá-la-á	projetar+V.ele.ACC.3.F.SG+FUT+3+SG
projetá-la-ás	projetar+V.ele.ACC.3.F.SG+FUT+2+SG
projetá-la-ei	projetar+V.ele.ACC.3.F.SG+FUT+1+SG
projetá-la-eis	projetar+V.ele.ACC.3.F.SG+FUT+2+PL
projetá-la-emos	projetar+V.ele.ACC.3.F.SG+FUT+1+PL
projetá-la-íamos	projetar+V.ele.ACC.3.F.SG+COND+1+PL
projetá-la-iam	projetar+V.ele.ACC.3.F.SG+COND+3+PL
projetá-la-ia	projetar+V.ele.ACC.3.F.SG+COND+1+SG
projetá-la-ia	projetar+V.ele.ACC.3.F.SG+COND+3+SG
projetá-la-ias	projetar+V.ele.ACC.3.F.SG+COND+2+SG
projetá-la-íeis	projetar+V.ele.ACC.3.F.SG+COND+2+PL
projetá-la	projetar+V.ele.ACC.3.F.SG+INF+1+SG
projetá-la	projetar+V.ele.ACC.3.F.SG+INF+3+SG
projeta-la	projetar+V.ele.ACC.3.F.SG+PRS+2+SG
projetá-la	projetar+V.ele.ACC.3.F.SG+SBJF+1+SG
projetá-la	projetar+V.ele.ACC.3.F.SG+SBJF+3+SG
projetá-las-ão	projetar+V.ele.ACC.3.F.PL+FUT+3+PL
projetá-las-á	projetar+V.ele.ACC.3.F.PL+FUT+3+SG
projetá-las-ás	projetar+V.ele.ACC.3.F.PL+FUT+2+SG
projetá-las-ei	projetar+V.ele.ACC.3.F.PL+FUT+1+SG
projetá-las-eis	projetar+V.ele.ACC.3.F.PL+FUT+2+PL
projetá-las-emos	projetar+V.ele.ACC.3.F.PL+FUT+1+PL
projetá-las-íamos	projetar+V.ele.ACC.3.F.PL+COND+1+PL
projetá-las-iam	projetar+V.ele.ACC.3.F.PL+COND+3+PL
projetá-las-ia	projetar+V.ele.ACC.3.F.PL+COND+1+SG
projetá-las-ia	projetar+V.ele.ACC.3.F.PL+COND+3+SG
projetá-las-ias	projetar+V.ele.ACC.3.F.PL+COND+2+SG
projetá-las-íeis	projetar+V.ele.ACC.3.F.PL+COND+2+PL
projetá-las	projetar+V.ele.ACC.3.F.PL+INF+1+SG
projetá-las	projetar+V.ele.ACC.3.F.PL+INF+3+SG
projeta-las	projetar+V.ele.ACC.3.F.PL+PRS+2+SG
projetá-las	projetar+V.ele.ACC.3.F.PL+SBJF+1+SG
projetá-las	projetar+V.ele.ACC.3.F.PL+SBJF+3+SG
projeta-lhe	projetar+V.ele.DAT.3.SG+PRS+3+SG
projeta-lhes	projetar+V.ele.DAT.3.PL+PRS+3+SG
projetá-lo-ão	projetar+V.ele.ACC.3.M.SG+FUT+3+PL
projetá-lo-á	projetar+V.ele.ACC.3.M.SG+FUT+3+SG
projetá-lo-ás	projetar+V.ele.ACC.3.M.SG+FUT+2+SG
projetá-lo-ei	projetar+V.ele.ACC.3.M.SG+FUT+1+SG
projetá-lo-eis	projetar+V.ele.ACC.3.M.SG+FUT+2+PL
projetá-lo-emos	projetar+V.ele.ACC.3.M.SG+FUT+1+PL
projetá-lo-íamos	projetar+V.ele.ACC.3.M.SG+COND+1+PL
projetá-lo-iam	projetar+V.ele.ACC.3.M.SG+COND+3+PL
projetá-lo-ia	projetar+V.ele.ACC.3.M.SG+COND+1+SG
projetá-lo-ia	projetar+V.ele.ACC.3.M.SG+COND+3+SG
projetá-lo-ias	projetar+V.ele.ACC.3.M.SG+COND+2+SG
projetá-lo-íeis	projetar+V.ele.ACC.3.M.SG+COND+2+PL
projetá-lo	projetar+V.ele.ACC.3.M.SG+INF+1+SG
projetá-lo	projetar+V.ele.ACC.3.M.SG+INF+3+SG
projeta-lo	projetar+V.ele.ACC.3.M.SG+PRS+2+SG
projetá-lo	projetar+V.ele.ACC.3.M.SG+SBJF+1+SG
projetá-lo	projetar+V.ele.ACC.3.M.SG+SBJF+3+SG
projetá-los-ão	projetar+V.ele.ACC.3.M.PL+FUT+3+PL
projetá-los-á	projetar+V.ele.ACC.3.M.PL+FUT+3+SG
projetá-los-ás	projetar+V.ele.ACC.3.M.PL+FUT+2+SG
projetá-los-ei	projetar+V.ele.ACC.3.M.PL+FUT+1+SG
projetá-los-eis	projetar+V.ele.ACC.3.M.PL+FUT+2+PL
projetá-los-emos	projetar+V.ele.ACC.3.M.PL+FUT+1+PL
projetá-los-íamos	projetar+V.ele.ACC.3.M.PL+COND+1+PL
projetá-los-iam	projetar+V.ele.ACC.3.M.PL+COND+3+PL
projetá-los-ia	projetar+V.ele.ACC.3.M.PL+COND+1+SG
projetá-los-ia	projetar+V.ele.ACC.3.M.PL+COND+3+SG
projetá-los-ias	projetar+V.ele.ACC.3.M.PL+COND+2+SG
projetá-los-íeis	projetar+V.ele.ACC.3.M.PL+COND+2+PL
projetá-los	projetar+V.ele.ACC.3.M.PL+INF+1+SG
projetá-los	projetar+V.ele.ACC.3.M.PL+INF+3+SG
projeta-los	projetar+V.ele.ACC.3.M.PL+PRS+2+SG
projetá-los	projetar+V.ele.ACC.3.M.PL+SBJF+1+SG
projetá-los	projetar+V.ele.ACC.3.M.PL+SBJF+3+SG
projeta-me	projetar+V.eu.AD.1.SG+PRS+3+SG
projetam-lhe	projetar+V.ele.DAT.3.SG+PRS+3+PL
projetam-lhes	projetar+V.ele.DAT.3.PL+PRS+3+PL
projetam-me	projetar+V.eu.AD.1.SG+PRS+3+PL
projetam-na	projetar+V.ele.ACC.3.F.SG+PRS+3+PL
projetam-nas	projetar+V.ele.ACC.3.F.PL+PRS+3+PL
projetam-no	projetar+V.ele.ACC.3.M.SG+PRS+3+PL
projetam-nos	projetar+V.ele.ACC.3.M.PL+PRS+3+PL
projetam-nos	projetar+V.nós.AD.1.PL+PRS+3+PL
projetamo-la	projetar+V.ele.ACC.3.F.SG+PRF+1+PL
projetamo-la	projetar+V.ele.ACC.3.F.SG+PRS+1+PL
projetamo-las	projetar+V.ele.ACC.3.F.PL+PRF+1+PL
projetamo-las	projetar+V.ele.ACC.3.F.PL+PRS+1+PL
projetamo-lo	projetar+V.ele.ACC.3.M.SG+PRF+1+PL
projetamo-lo	projetar+V.ele.ACC.3.M.SG+PRS+1+PL
projetamo-los	projetar+V.ele.ACC.3.M.PL+PRF+1+PL
projetamo-los	projetar+V.ele.ACC.3.M.PL+PRS+1+PL
projetamo-nos	projetar+nós.AD.1.PL+PRF+1+PL
projetamo-nos	projetar+nós.AD.1.PL+PRS+1+PL
projetamos-lhe	projetar+V.ele.DAT.3.SG+PRF+1+PL
projetamos-lhe	projetar+V.ele.DAT.3.SG+PRS+1+PL
projetamos-lhes	projetar+V.ele.DAT.3.PL+PRF+1+PL
projetamos-lhes	projetar+V.ele.DAT.3.PL+PRS+1+PL
projetamos-me	projetar+V.eu.AD.1.SG+PRF+1+PL
projetamos-me	projetar+V.eu.AD.1.SG+PRS+1+PL
projetamos-te	projetar+V.tu.AD.2.SG+PRF+1+PL
projetamos-te	projetar+V.tu.AD.2.SG+PRS+1+PL
projetamos-vos	projetar+V.vós.AD.2.PL+PRF+1+PL
projetamos-vos	projetar+V.vós.AD.2.PL+PRS+1+PL
projetam-se	projetar+V.ele.REFL+PRS+3+PL
projetam-te	projetar+V.tu.AD.2.SG+PRS+3+PL
projetam-vos	projetar+V.vós.AD.2.PL+PRS+3+PL
projetando-a	projetar+V.ele.ACC.3.F.SG+GRD
projetando-as	projetar+V.ele.ACC.3.F.PL+GRD
projetando-lhe	projetar+V.ele.DAT.3.SG+GRD
projetando-lhes	projetar+V.ele.DAT.3.PL+GRD
projetando-me	projetar+V.eu.AD.1.SG+GRD
projetando-nos	projetar+nós.AD.1.PL+GRD
projetando-o	projetar+V.ele.ACC.3.M.SG+GRD
projetando-os	projetar+V.ele.ACC.3.M.PL+GRD
projetando-se	projetar+V.ele.REFL+GRD
projetando-te	projetar+V.tu.AD.2.SG+GRD
projetando-vos	projetar+V.vós.AD.2.PL+GRD
projeta-nos	projetar+nós.AD.1.PL+PRS+2+SG
projeta-nos	projetar+nós.AD.1.PL+PRS+3+SG
projeta-o	projetar+V.ele.ACC.3.M.SG+PRS+3+SG
projeta-os	projetar+V.ele.ACC.3.M.PL+PRS+3+SG
projetara-a	projetar+V.ele.ACC.3.F.SG+PQP+1+SG
projetara-a	projetar+V.ele.ACC.3.F.SG+PQP+3+SG
projetara-as	projetar+V.ele.ACC.3.F.PL+PQP+1+SG
projetara-as	projetar+V.ele.ACC.3.F.PL+PQP+3+SG
projetara-la	projetar+V.ele.ACC.3.F.SG+PQP+2+SG
projetara-las	projetar+V.ele.ACC.3.F.PL+PQP+2+SG
projetara-lhe	projetar+V.ele.DAT.3.SG+PQP+1+SG
projetara-lhe	projetar+V.ele.DAT.3.SG+PQP+3+SG
projetara-lhes	projetar+V.ele.DAT.3.PL+PQP+1+SG
projetara-lhes	projetar+V.ele.DAT.3.PL+PQP+3+SG
projetara-lo	projetar+V.ele.ACC.3.M.SG+PQP+2+SG
projetara-los	projetar+V.ele.ACC.3.M.PL+PQP+2+SG
projetara-me	projetar+V.eu.AD.1.SG+PQP+1+SG
projetara-me	projetar+V.eu.AD.1.SG+PQP+3+SG
projetaram-lhe	projetar+V.ele.DAT.3.SG+PQP+3+PL
projetaram-lhe	projetar+V.ele.DAT.3.SG+PRF+3+PL
projetaram-lhes	projetar+V.ele.DAT.3.PL+PQP+3+PL
projetaram-lhes	projetar+V.ele.DAT.3.PL+PRF+3+PL
projetaram-me	projetar+V.eu.AD.1.SG+PQP+3+PL
projetaram-me	projetar+V.eu.AD.1.SG+PRF+3+PL
projetaram-na	projetar+V.ele.ACC.3.F.SG+PQP+3+PL
projetaram-na	projetar+V.ele.ACC.3.F.SG+PRF+3+PL
projetaram-nas	projetar+V.ele.ACC.3.F.PL+PQP+3+PL
projetaram-nas	projetar+V.ele.ACC.3.F.PL+PRF+3+PL
projetaram-no	projetar+V.ele.ACC.3.M.SG+PQP+3+PL
projetaram-no	projetar+V.ele.ACC.3.M.SG+PRF+3+PL
projetaram-nos	projetar+V.ele.ACC.3.M.PL+PQP+3+PL
projetaram-nos	projetar+V.ele.ACC.3.M.PL+PRF+3+PL
projetaram-nos	projetar+V.nós.AD.1.PL+PQP+3+PL
projetaram-nos	projetar+V.nós.AD.1.PL+PRF+3+PL
projetáramo-la	projetar+V.ele.ACC.3.F.SG+PQP+1+PL
projetáramo-las	projetar+V.ele.ACC.3.F.PL+PQP+1+PL
projetáramo-lo	projetar+V.ele.ACC.3.M.SG+PQP+1+PL
projetáramo-los	projetar+V.ele.ACC.3.M.PL+PQP+1+PL
projetáramo-nos	projetar+nós.AD.1.PL+PQP+1+PL
projetáramos-lhe	projetar+V.ele.DAT.3.SG+PQP+1+PL
projetáramos-lhes	projetar+V.ele.DAT.3.PL+PQP+1+PL
projetáramos-me	projetar+V.eu.AD.1.SG+PQP+1+PL
projetáramos-te	projetar+V.tu.AD.2.SG+PQP+1+PL
projetáramos-vos	projetar+V.vós.AD.2.PL+PQP+1+PL
projetaram-se	projetar+V.ele.REFL+PQP+3+PL
projetaram-se	projetar+V.ele.REFL+PRF+3+PL
projetaram-te	projetar+V.tu.AD.2.SG+PQP+3+PL
projetaram-te	projetar+V.tu.AD.2.SG+PRF+3+PL
projetaram-vos	projetar+V.vós.AD.2.PL+PQP+3+PL
projetaram-vos	projetar+V.vós.AD.2.PL+PRF+3+PL
projetara-nos	projetar+nós.AD.1.PL+PQP+1+SG
projetara-nos	projetar+nós.AD.1.PL+PQP+2+SG
projetara-nos	projetar+nós.AD.1.PL+PQP+3+SG
projetara-o	projetar+V.ele.ACC.3.M.SG+PQP+1+SG
projetara-o	projetar+V.ele.ACC.3.M.SG+PQP+3+SG
projetara-os	projetar+V.ele.ACC.3.M.PL+PQP+1+SG
projetara-os	projetar+V.ele.ACC.3.M.PL+PQP+3+SG
projetara-se	projetar+V.ele.REFL+PQP+1+SG
projetara-se	projetar+V.ele.REFL+PQP+3+SG
projetaras-lhe	projetar+V.ele.DAT.3.SG+PQP+2+SG
projetaras-lhes	projetar+V.ele.DAT.3.PL+PQP+2+SG
projetaras-me	projetar+V.eu.AD.1.SG+PQP+2+SG
projetaras-te	projetar+V.tu.AD.2.SG+PQP+2+SG
projetaras-vos	projetar+V.vós.AD.2.PL+PQP+2+SG
projetara-te	projetar+V.tu.AD.2.SG+PQP+1+SG
projetara-te	projetar+V.tu.AD.2.SG+PQP+3+SG
projetara-vos	projetar+V.vós.AD.2.PL+PQP+1+SG
projetara-vos	projetar+V.vós.AD.2.PL+PQP+3+SG
projetarde-la	projetar+V.ele.ACC.3.F.SG+INF+2+PL
projetarde-la	projetar+V.ele.ACC.3.F.SG+SBJF+2+PL
projetarde-las	projetar+V.ele.ACC.3.F.PL+INF+2+PL
projetarde-las	projetar+V.ele.ACC.3.F.PL+SBJF+2+PL
projetarde-lo	projetar+V.ele.ACC.3.M.SG+INF+2+PL
projetarde-lo	projetar+V.ele.ACC.3.M.SG+SBJF+2+PL
projetarde-los	projetar+V.ele.ACC.3.M.PL+INF+2+PL
projetarde-los	projetar+V.ele.ACC.3.M.PL+SBJF+2+PL
projetarde-nos	projetar+nós.AD.1.PL+INF+2+PL
projetarde-nos	projetar+nós.AD.1.PL+SBJF+2+PL
projetardes-lhe	projetar+V.ele.DAT.3.SG+INF+2+PL
projetardes-lhe	projetar+V.ele.DAT.3.SG+SBJF+2+PL
projetardes-lhes	projetar+V.ele.DAT.3.PL+INF+2+PL
projetardes-lhes	projetar+V.ele.DAT.3.PL+SBJF+2+PL
projetardes-me	projetar+V.eu.AD.1.SG+INF+2+PL
projetardes-me	projetar+V.eu.AD.1.SG+SBJF+2+PL
projetardes-te	projetar+V.tu.AD.2.SG+INF+2+PL
projetardes-te	projetar+V.tu.AD.2.SG+SBJF+2+PL
projetardes-vos	projetar+V.vós.AD.2.PL+INF+2+PL
projetardes-vos	projetar+V.vós.AD.2.PL+SBJF+2+PL
projetárei-la	projetar+V.ele.ACC.3.F.SG+PQP+2+PL
projetárei-las	projetar+V.ele.ACC.3.F.PL+PQP+2+PL
projetárei-lo	projetar+V.ele.ACC.3.M.SG+PQP+2+PL
projetárei-los	projetar+V.ele.ACC.3.M.PL+PQP+2+PL
projetárei-nos	projetar+nós.AD.1.PL+PQP+2+PL
projetáreis-lhe	projetar+V.ele.DAT.3.SG+PQP+2+PL
projetáreis-lhes	projetar+V.ele.DAT.3.PL+PQP+2+PL
projetáreis-me	projetar+V.eu.AD.1.SG+PQP+2+PL
projetáreis-te	projetar+V.tu.AD.2.SG+PQP+2+PL
projetáreis-vos	projetar+V.vós.AD.2.PL+PQP+2+PL
projetare-la	projetar+V.ele.ACC.3.F.SG+INF+2+SG
projetare-la	projetar+V.ele.ACC.3.F.SG+SBJF+2+SG
projetare-las	projetar+V.ele.ACC.3.F.PL+INF+2+SG
projetare-las	projetar+V.ele.ACC.3.F.PL+SBJF+2+SG
projetare-lo	projetar+V.ele.ACC.3.M.SG+INF+2+SG
projetare-lo	projetar+V.ele.ACC.3.M.SG+SBJF+2+SG
projetare-los	projetar+V.ele.ACC.3.M.PL+INF+2+SG
projetare-los	projetar+V.ele.ACC.3.M.PL+SBJF+2+SG
projetarem-lhe	projetar+V.ele.DAT.3.SG+INF+3+PL
projetarem-lhe	projetar+V.ele.DAT.3.SG+SBJF+3+PL
projetarem-lhes	projetar+V.ele.DAT.3.PL+INF+3+PL
projetarem-lhes	projetar+V.ele.DAT.3.PL+SBJF+3+PL
projetarem-me	projetar+V.eu.AD.1.SG+INF+3+PL
projetarem-me	projetar+V.eu.AD.1.SG+SBJF+3+PL
projetarem-na	projetar+V.ele.ACC.3.F.SG+INF+3+PL
projetarem-na	projetar+V.ele.ACC.3.F.SG+SBJF+3+PL
projetarem-nas	projetar+V.ele.ACC.3.F.PL+INF+3+PL
projetarem-nas	projetar+V.ele.ACC.3.F.PL+SBJF+3+PL
projetarem-no	projetar+V.ele.ACC.3.M.SG+INF+3+PL
projetarem-no	projetar+V.ele.ACC.3.M.SG+SBJF+3+PL
projetarem-nos	projetar+V.ele.ACC.3.M.PL+INF+3+PL
projetarem-nos	projetar+V.ele.ACC.3.M.PL+SBJF+3+PL
projetarem-nos	projetar+V.nós.AD.1.PL+INF+3+PL
projetarem-nos	projetar+V.nós.AD.1.PL+SBJF+3+PL
projetarem-se	projetar+V.ele.REFL+INF+3+PL
projetarem-se	projetar+V.ele.REFL+SBJF+3+PL
projetarem-te	projetar+V.tu.AD.2.SG+INF+3+PL
projetarem-te	projetar+V.tu.AD.2.SG+SBJF+3+PL
projetarem-vos	projetar+V.vós.AD.2.PL+INF+3+PL
projetarem-vos	projetar+V.vós.AD.2.PL+SBJF+3+PL
projetare-nos	projetar+nós.AD.1.PL+INF+2+SG
projetare-nos	projetar+nós.AD.1.PL+SBJF+2+SG
projetares-lhe	projetar+V.ele.DAT.3.SG+INF+2+SG
projetares-lhe	projetar+V.ele.DAT.3.SG+SBJF+2+SG
projetares-lhes	projetar+V.ele.DAT.3.PL+INF+2+SG
projetares-lhes	projetar+V.ele.DAT.3.PL+SBJF+2+SG
projetares-me	projetar+V.eu.AD.1.SG+INF+2+SG
projetares-me	projetar+V.eu.AD.1.SG+SBJF+2+SG
projetares-te	projetar+V.tu.AD.2.SG+INF+2+SG
projetares-te	projetar+V.tu.AD.2.SG+SBJF+2+SG
projetares-vos	projetar+V.vós.AD.2.PL+INF+2+SG
projetares-vos	projetar+V.vós.AD.2.PL+SBJF+2+SG
projetar-lhe-ão	projetar+V.ele.DAT.3.SG+FUT+3+PL
projetar-lhe-á	projetar+V.ele.DAT.3.SG+FUT+3+SG
projetar-lhe-ás	projetar+V.ele.DAT.3.SG+FUT+2+SG
projetar-lhe-ei	projetar+V.ele.DAT.3.SG+FUT+1+SG
projetar-lhe-eis	projetar+V.ele.DAT.3.SG+FUT+2+PL
projetar-lhe-emos	projetar+V.ele.DAT.3.SG+FUT+1+PL
projetar-lhe-íamos	projetar+V.ele.DAT.3.SG+COND+1+PL
projetar-lhe-iam	projetar+V.ele.DAT.3.SG+COND+3+PL
projetar-lhe-ia	projetar+V.ele.DAT.3.SG+COND+1+SG
projetar-lhe-ia	projetar+V.ele.DAT.3.SG+COND+3+SG
projetar-lhe-ias	projetar+V.ele.DAT.3.SG+COND+2+SG
projetar-lhe-íeis	projetar+V.ele.DAT.3.SG+COND+2+PL
projetar-lhe	projetar+V.ele.DAT.3.SG+INF
projetar-lhe	projetar+V.ele.DAT.3.SG+INF+1+SG
