reboquearmos-lhe	reboquear+V.ele.DAT.3.SG+SBJF+1+PL
reboquearmos-lhes	reboquear+V.ele.DAT.3.PL+INF+1+PL
reboquearmos-lhes	reboquear+V.ele.DAT.3.PL+SBJF+1+PL
reboquearmos-me	reboquear+V.eu.AD.1.SG+INF+1+PL
reboquearmos-me	reboquear+V.eu.AD.1.SG+SBJF+1+PL
reboquearmos-te	reboquear+V.tu.AD.2.SG+INF+1+PL
reboquearmos-te	reboquear+V.tu.AD.2.SG+SBJF+1+PL
reboquearmos-vos	reboquear+V.vós.AD.2.PL+INF+1+PL
reboquearmos-vos	reboquear+V.vós.AD.2.PL+SBJF+1+PL
reboquear-nos-ão	reboquear+nós.AD.1.PL+FUT+3+PL
reboquear-nos-á	reboquear+nós.AD.1.PL+FUT+3+SG
reboquear-nos-ás	reboquear+nós.AD.1.PL+FUT+2+SG
reboquear-nos-ei	reboquear+nós.AD.1.PL+FUT+1+SG
reboquear-nos-eis	reboquear+nós.AD.1.PL+FUT+2+PL
reboquear-nos-emos	reboquear+nós.AD.1.PL+FUT+1+PL
reboquear-nos-íamos	reboquear+nós.AD.1.PL+COND+1+PL
reboquear-nos-iam	reboquear+nós.AD.1.PL+COND+3+PL
reboquear-nos-ia	reboquear+nós.AD.1.PL+COND+1+SG
reboquear-nos-ia	reboquear+nós.AD.1.PL+COND+3+SG
reboquear-nos-ias	reboquear+nós.AD.1.PL+COND+2+SG
reboquear-nos-íeis	reboquear+nós.AD.1.PL+COND+2+PL
reboquear-nos	reboquear+nós.AD.1.PL+INF
reboquear-nos	reboquear+nós.AD.1.PL+INF+1+SG
reboquear-nos	reboquear+nós.AD.1.PL+INF+3+SG
reboquear-nos	reboquear+nós.AD.1.PL+SBJF+1+SG
reboquear-nos	reboquear+nós.AD.1.PL+SBJF+3+SG
reboquear-se-ão	reboquear+V.ele.REFL+FUT+3+PL
reboquear-se-á	reboquear+V.ele.REFL+FUT+3+SG
reboquear-se-iam	reboquear+V.ele.REFL+COND+3+PL
reboquear-se-ia	reboquear+V.ele.REFL+COND+3+SG
reboquear-se	reboquear+V.ele.REFL+INF
reboquear-se	reboquear+V.ele.REFL+INF+3+SG
reboquear-se	reboquear+V.ele.REFL+SBJF+3+SG
reboquear-te-ão	reboquear+V.tu.AD.2.SG+FUT+3+PL
reboquear-te-á	reboquear+V.tu.AD.2.SG+FUT+3+SG
reboquear-te-ás	reboquear+V.tu.AD.2.SG+FUT+2+SG
reboquear-te-ei	reboquear+V.tu.AD.2.SG+FUT+1+SG
reboquear-te-eis	reboquear+V.tu.AD.2.SG+FUT+2+PL
reboquear-te-emos	reboquear+V.tu.AD.2.SG+FUT+1+PL
reboquear-te-íamos	reboquear+V.tu.AD.2.SG+COND+1+PL
reboquear-te-iam	reboquear+V.tu.AD.2.SG+COND+3+PL
reboquear-te-ia	reboquear+V.tu.AD.2.SG+COND+1+SG
reboquear-te-ia	reboquear+V.tu.AD.2.SG+COND+3+SG
reboquear-te-ias	reboquear+V.tu.AD.2.SG+COND+2+SG
reboquear-te-íeis	reboquear+V.tu.AD.2.SG+COND+2+PL
reboquear-te	reboquear+V.tu.AD.2.SG+INF
reboquear-te	reboquear+V.tu.AD.2.SG+INF+1+SG
reboquear-te	reboquear+V.tu.AD.2.SG+INF+3+SG
reboquear-te	reboquear+V.tu.AD.2.SG+SBJF+1+SG
reboquear-te	reboquear+V.tu.AD.2.SG+SBJF+3+SG
reboquear-vos-ão	reboquear+V.vós.AD.2.PL+FUT+3+PL
reboquear-vos-á	reboquear+V.vós.AD.2.PL+FUT+3+SG
reboquear-vos-ás	reboquear+V.vós.AD.2.PL+FUT+2+SG
reboquear-vos-ei	reboquear+V.vós.AD.2.PL+FUT+1+SG
reboquear-vos-eis	reboquear+V.vós.AD.2.PL+FUT+2+PL
reboquear-vos-emos	reboquear+V.vós.AD.2.PL+FUT+1+PL
reboquear-vos-íamos	reboquear+V.vós.AD.2.PL+COND+1+PL
reboquear-vos-iam	reboquear+V.vós.AD.2.PL+COND+3+PL
reboquear-vos-ia	reboquear+V.vós.AD.2.PL+COND+1+SG
reboquear-vos-ia	reboquear+V.vós.AD.2.PL+COND+3+SG
reboquear-vos-ias	reboquear+V.vós.AD.2.PL+COND+2+SG
reboquear-vos-íeis	reboquear+V.vós.AD.2.PL+COND+2+PL
reboquear-vos	reboquear+V.vós.AD.2.PL+INF
reboquear-vos	reboquear+V.vós.AD.2.PL+INF+1+SG
reboquear-vos	reboquear+V.vós.AD.2.PL+INF+3+SG
reboquear-vos	reboquear+V.vós.AD.2.PL+SBJF+1+SG
reboquear-vos	reboquear+V.vós.AD.2.PL+SBJF+3+SG
reboque-as	rebocar+V.ele.ACC.3.F.PL+IMP+3+SG
reboqueaste-a	reboquear+V.ele.ACC.3.F.SG+PRF+2+SG
reboqueaste-as	reboquear+V.ele.ACC.3.F.PL+PRF+2+SG
reboqueaste-la	reboquear+V.ele.ACC.3.F.SG+PRF+2+PL
reboqueaste-las	reboquear+V.ele.ACC.3.F.PL+PRF+2+PL
reboqueaste-lhe	reboquear+V.ele.DAT.3.SG+PRF+2+SG
reboqueaste-lhes	reboquear+V.ele.DAT.3.PL+PRF+2+SG
reboqueaste-lo	reboquear+V.ele.ACC.3.M.SG+PRF+2+PL
reboqueaste-los	reboquear+V.ele.ACC.3.M.PL+PRF+2+PL
reboqueaste-me	reboquear+V.eu.AD.1.SG+PRF+2+SG
reboqueaste-nos	reboquear+nós.AD.1.PL+PRF+2+PL
reboqueaste-nos	reboquear+nós.AD.1.PL+PRF+2+SG
reboqueaste-o	reboquear+V.ele.ACC.3.M.SG+PRF+2+SG
reboqueaste-os	reboquear+V.ele.ACC.3.M.PL+PRF+2+SG
reboqueastes-lhe	reboquear+V.ele.DAT.3.SG+PRF+2+PL
reboqueastes-lhes	reboquear+V.ele.DAT.3.PL+PRF+2+PL
reboqueastes-me	reboquear+V.eu.AD.1.SG+PRF+2+PL
reboqueastes-te	reboquear+V.tu.AD.2.SG+PRF+2+PL
reboqueastes-vos	reboquear+V.vós.AD.2.PL+PRF+2+PL
reboqueaste-te	reboquear+V.tu.AD.2.SG+PRF+2+SG
reboqueaste-vos	reboquear+V.vós.AD.2.PL+PRF+2+SG
reboqueava-a	reboquear+V.ele.ACC.3.F.SG+IMPF+1+SG
reboqueava-a	reboquear+V.ele.ACC.3.F.SG+IMPF+3+SG
reboqueava-as	reboquear+V.ele.ACC.3.F.PL+IMPF+1+SG
reboqueava-as	reboquear+V.ele.ACC.3.F.PL+IMPF+3+SG
reboqueava-la	reboquear+V.ele.ACC.3.F.SG+IMPF+2+SG
reboqueava-las	reboquear+V.ele.ACC.3.F.PL+IMPF+2+SG
reboqueava-lhe	reboquear+V.ele.DAT.3.SG+IMPF+1+SG
reboqueava-lhe	reboquear+V.ele.DAT.3.SG+IMPF+3+SG
reboqueava-lhes	reboquear+V.ele.DAT.3.PL+IMPF+1+SG
reboqueava-lhes	reboquear+V.ele.DAT.3.PL+IMPF+3+SG
reboqueava-lo	reboquear+V.ele.ACC.3.M.SG+IMPF+2+SG
reboqueava-los	reboquear+V.ele.ACC.3.M.PL+IMPF+2+SG
reboqueava-me	reboquear+V.eu.AD.1.SG+IMPF+1+SG
reboqueava-me	reboquear+V.eu.AD.1.SG+IMPF+3+SG
reboqueavam-lhe	reboquear+V.ele.DAT.3.SG+IMPF+3+PL
reboqueavam-lhes	reboquear+V.ele.DAT.3.PL+IMPF+3+PL
reboqueavam-me	reboquear+V.eu.AD.1.SG+IMPF+3+PL
reboqueavam-na	reboquear+V.ele.ACC.3.F.SG+IMPF+3+PL
reboqueavam-nas	reboquear+V.ele.ACC.3.F.PL+IMPF+3+PL
reboqueavam-no	reboquear+V.ele.ACC.3.M.SG+IMPF+3+PL
reboqueavam-nos	reboquear+V.ele.ACC.3.M.PL+IMPF+3+PL
reboqueavam-nos	reboquear+V.nós.AD.1.PL+IMPF+3+PL
reboqueávamo-la	reboquear+V.ele.ACC.3.F.SG+IMPF+1+PL
reboqueávamo-las	reboquear+V.ele.ACC.3.F.PL+IMPF+1+PL
reboqueávamo-lo	reboquear+V.ele.ACC.3.M.SG+IMPF+1+PL
reboqueávamo-los	reboquear+V.ele.ACC.3.M.PL+IMPF+1+PL
reboqueávamo-nos	reboquear+nós.AD.1.PL+IMPF+1+PL
reboqueávamos-lhe	reboquear+V.ele.DAT.3.SG+IMPF+1+PL
reboqueávamos-lhes	reboquear+V.ele.DAT.3.PL+IMPF+1+PL
reboqueávamos-me	reboquear+V.eu.AD.1.SG+IMPF+1+PL
reboqueávamos-te	reboquear+V.tu.AD.2.SG+IMPF+1+PL
reboqueávamos-vos	reboquear+V.vós.AD.2.PL+IMPF+1+PL
reboqueavam-se	reboquear+V.ele.REFL+IMPF+3+PL
reboqueavam-te	reboquear+V.tu.AD.2.SG+IMPF+3+PL
reboqueavam-vos	reboquear+V.vós.AD.2.PL+IMPF+3+PL
reboqueava-nos	reboquear+nós.AD.1.PL+IMPF+1+SG
reboqueava-nos	reboquear+nós.AD.1.PL+IMPF+2+SG
reboqueava-nos	reboquear+nós.AD.1.PL+IMPF+3+SG
reboqueava-o	reboquear+V.ele.ACC.3.M.SG+IMPF+1+SG
reboqueava-o	reboquear+V.ele.ACC.3.M.SG+IMPF+3+SG
reboqueava-os	reboquear+V.ele.ACC.3.M.PL+IMPF+1+SG
reboqueava-os	reboquear+V.ele.ACC.3.M.PL+IMPF+3+SG
reboqueava-se	reboquear+V.ele.REFL+IMPF+1+SG
reboqueava-se	reboquear+V.ele.REFL+IMPF+3+SG
reboqueavas-lhe	reboquear+V.ele.DAT.3.SG+IMPF+2+SG
reboqueavas-lhes	reboquear+V.ele.DAT.3.PL+IMPF+2+SG
reboqueavas-me	reboquear+V.eu.AD.1.SG+IMPF+2+SG
reboqueavas-te	reboquear+V.tu.AD.2.SG+IMPF+2+SG
reboqueavas-vos	reboquear+V.vós.AD.2.PL+IMPF+2+SG
reboqueava-te	reboquear+V.tu.AD.2.SG+IMPF+1+SG
reboqueava-te	reboquear+V.tu.AD.2.SG+IMPF+3+SG
reboqueava-vos	reboquear+V.vós.AD.2.PL+IMPF+1+SG
reboqueava-vos	reboquear+V.vós.AD.2.PL+IMPF+3+SG
reboqueávei-la	reboquear+V.ele.ACC.3.F.SG+IMPF+2+PL
reboqueávei-las	reboquear+V.ele.ACC.3.F.PL+IMPF+2+PL
reboqueávei-lo	reboquear+V.ele.ACC.3.M.SG+IMPF+2+PL
reboqueávei-los	reboquear+V.ele.ACC.3.M.PL+IMPF+2+PL
reboqueávei-nos	reboquear+nós.AD.1.PL+IMPF+2+PL
reboqueáveis-lhe	reboquear+V.ele.DAT.3.SG+IMPF+2+PL
reboqueáveis-lhes	reboquear+V.ele.DAT.3.PL+IMPF+2+PL
reboqueáveis-me	reboquear+V.eu.AD.1.SG+IMPF+2+PL
reboqueáveis-te	reboquear+V.tu.AD.2.SG+IMPF+2+PL
reboqueáveis-vos	reboquear+V.vós.AD.2.PL+IMPF+2+PL
reboqueei-a	reboquear+V.ele.ACC.3.F.SG+PRF+1+SG
reboqueei-as	reboquear+V.ele.ACC.3.F.PL+PRF+1+SG
reboqueei-lhe	reboquear+V.ele.DAT.3.SG+PRF+1+SG
reboqueei-lhes	reboquear+V.ele.DAT.3.PL+PRF+1+SG
reboqueei-me	reboquear+V.eu.AD.1.SG+PRF+1+SG
reboqueei-nos	reboquear+nós.AD.1.PL+PRF+1+SG
reboqueei-o	reboquear+V.ele.ACC.3.M.SG+PRF+1+SG
reboqueei-os	reboquear+V.ele.ACC.3.M.PL+PRF+1+SG
reboqueei-te	reboquear+V.tu.AD.2.SG+PRF+1+SG
reboqueei-vos	reboquear+V.vós.AD.2.PL+PRF+1+SG
reboqueia-a	reboquear+V.ele.ACC.3.F.SG+PRS+3+SG
reboqueia-as	reboquear+V.ele.ACC.3.F.PL+PRS+3+SG
reboqueia-la	reboquear+V.ele.ACC.3.F.SG+PRS+2+SG
reboqueia-las	reboquear+V.ele.ACC.3.F.PL+PRS+2+SG
reboqueia-lhe	reboquear+V.ele.DAT.3.SG+PRS+3+SG
reboqueia-lhes	reboquear+V.ele.DAT.3.PL+PRS+3+SG
reboqueia-lo	reboquear+V.ele.ACC.3.M.SG+PRS+2+SG
reboqueia-los	reboquear+V.ele.ACC.3.M.PL+PRS+2+SG
reboqueia-me	reboquear+V.eu.AD.1.SG+PRS+3+SG
reboqueiam-lhe	reboquear+V.ele.DAT.3.SG+PRS+3+PL
reboqueiam-lhes	reboquear+V.ele.DAT.3.PL+PRS+3+PL
reboqueiam-me	reboquear+V.eu.AD.1.SG+PRS+3+PL
reboqueiam-na	reboquear+V.ele.ACC.3.F.SG+PRS+3+PL
reboqueiam-nas	reboquear+V.ele.ACC.3.F.PL+PRS+3+PL
reboqueiam-no	reboquear+V.ele.ACC.3.M.SG+PRS+3+PL
reboqueiam-nos	reboquear+V.ele.ACC.3.M.PL+PRS+3+PL
reboqueiam-nos	reboquear+V.nós.AD.1.PL+PRS+3+PL
reboqueiam-se	reboquear+V.ele.REFL+PRS+3+PL
reboqueiam-te	reboquear+V.tu.AD.2.SG+PRS+3+PL
reboqueiam-vos	reboquear+V.vós.AD.2.PL+PRS+3+PL
reboqueia-nos	reboquear+nós.AD.1.PL+PRS+2+SG
reboqueia-nos	reboquear+nós.AD.1.PL+PRS+3+SG
reboqueia-o	reboquear+V.ele.ACC.3.M.SG+PRS+3+SG
reboqueia-os	reboquear+V.ele.ACC.3.M.PL+PRS+3+SG
reboquei-a	rebocar+V.ele.ACC.3.F.SG+PRF+1+SG
reboqueia-se	reboquear+V.ele.REFL+PRS+3+SG
reboqueias-lhe	reboquear+V.ele.DAT.3.SG+PRS+2+SG
reboqueias-lhes	reboquear+V.ele.DAT.3.PL+PRS+2+SG
reboqueias-me	reboquear+V.eu.AD.1.SG+PRS+2+SG
reboquei-as	rebocar+V.ele.ACC.3.F.PL+PRF+1+SG
reboqueias-te	reboquear+V.tu.AD.2.SG+PRS+2+SG
reboqueias-vos	reboquear+V.vós.AD.2.PL+PRS+2+SG
reboqueia-te	reboquear+V.tu.AD.2.SG+PRS+3+SG
reboqueia-vos	reboquear+V.vós.AD.2.PL+PRS+3+SG
reboquei-lhe	rebocar+V.ele.DAT.3.SG+PRF+1+SG
reboquei-lhes	rebocar+V.ele.DAT.3.PL+PRF+1+SG
reboquei-me	rebocar+V.eu.AD.1.SG+PRF+1+SG
reboquei-nos	rebocar+nós.AD.1.PL+PRF+1+SG
reboqueio-a	reboquear+V.ele.ACC.3.F.SG+PRS+1+SG
reboqueio-as	reboquear+V.ele.ACC.3.F.PL+PRS+1+SG
reboqueio-lhe	reboquear+V.ele.DAT.3.SG+PRS+1+SG
reboqueio-lhes	reboquear+V.ele.DAT.3.PL+PRS+1+SG
reboqueio-me	reboquear+V.eu.AD.1.SG+PRS+1+SG
reboqueio-nos	reboquear+nós.AD.1.PL+PRS+1+SG
reboqueio-o	reboquear+V.ele.ACC.3.M.SG+PRS+1+SG
reboqueio-os	reboquear+V.ele.ACC.3.M.PL+PRS+1+SG
reboquei-o	rebocar+V.ele.ACC.3.M.SG+PRF+1+SG
reboquei-os	rebocar+V.ele.ACC.3.M.PL+PRF+1+SG
reboqueio-te	reboquear+V.tu.AD.2.SG+PRS+1+SG
reboqueio-vos	reboquear+V.vós.AD.2.PL+PRS+1+SG
reboquei-te	rebocar+V.tu.AD.2.SG+PRF+1+SG
reboquei-vos	rebocar+V.vós.AD.2.PL+PRF+1+SG
reboque-lhe	rebocar+V.ele.DAT.3.SG+IMP+3+SG
reboque-lhes	rebocar+V.ele.DAT.3.PL+IMP+3+SG
reboque-me	rebocar+V.eu.AD.1.SG+IMP+3+SG
reboquem-lhe	rebocar+V.ele.DAT.3.SG+IMP+3+PL
reboquem-lhes	rebocar+V.ele.DAT.3.PL+IMP+3+PL
reboquem-me	rebocar+V.eu.AD.1.SG+IMP+3+PL
reboquem-na	rebocar+V.ele.ACC.3.F.SG+IMP+3+PL
reboquem-nas	rebocar+V.ele.ACC.3.F.PL+IMP+3+PL
reboquem-no	rebocar+V.ele.ACC.3.M.SG+IMP+3+PL
reboquem-nos	rebocar+V.ele.ACC.3.M.PL+IMP+3+PL
reboquem-nos	rebocar+V.nós.AD.1.PL+IMP+3+PL
reboquemo-la	rebocar+V.ele.ACC.3.F.SG+IMP+1+PL
reboquemo-las	rebocar+V.ele.ACC.3.F.PL+IMP+1+PL
reboquemo-lo	rebocar+V.ele.ACC.3.M.SG+IMP+1+PL
reboquemo-los	rebocar+V.ele.ACC.3.M.PL+IMP+1+PL
reboquemo-nos	rebocar+nós.AD.1.PL+IMP+1+PL
reboquemos-lhe	rebocar+V.ele.DAT.3.SG+IMP+1+PL
reboquemos-lhes	rebocar+V.ele.DAT.3.PL+IMP+1+PL
reboquemos-me	rebocar+V.eu.AD.1.SG+IMP+1+PL
reboquemos-te	rebocar+V.tu.AD.2.SG+IMP+1+PL
reboquemos-vos	rebocar+V.vós.AD.2.PL+IMP+1+PL
reboquem-se	rebocar+V.ele.REFL+IMP+3+PL
reboquem-te	rebocar+V.tu.AD.2.SG+IMP+3+PL
reboquem-vos	rebocar+V.vós.AD.2.PL+IMP+3+PL
reboque-nos	rebocar+nós.AD.1.PL+IMP+3+SG
reboque-o	rebocar+V.ele.ACC.3.M.SG+IMP+3+SG
reboque-os	rebocar+V.ele.ACC.3.M.PL+IMP+3+SG
reboqueou-a	reboquear+V.ele.ACC.3.F.SG+PRF+3+SG
reboqueou-as	reboquear+V.ele.ACC.3.F.PL+PRF+3+SG
reboqueou-lhe	reboquear+V.ele.DAT.3.SG+PRF+3+SG
reboqueou-lhes	reboquear+V.ele.DAT.3.PL+PRF+3+SG
reboqueou-me	reboquear+V.eu.AD.1.SG+PRF+3+SG
reboqueou-nos	reboquear+nós.AD.1.PL+PRF+3+SG
reboqueou-o	reboquear+V.ele.ACC.3.M.SG+PRF+3+SG
reboqueou-os	reboquear+V.ele.ACC.3.M.PL+PRF+3+SG
reboqueou-se	reboquear+V.ele.REFL+PRF+3+SG
reboqueou-te	reboquear+V.tu.AD.2.SG+PRF+3+SG
reboqueou-vos	reboquear+V.vós.AD.2.PL+PRF+3+SG
reboque-se	rebocar+V.ele.REFL+IMP+3+SG
reboque-te	rebocar+V.tu.AD.2.SG+IMP+3+SG
reboque-vos	rebocar+V.vós.AD.2.PL+IMP+3+SG
reborda-a	rebordar+V.ele.ACC.3.F.SG+PRS+3+SG
reborda-as	rebordar+V.ele.ACC.3.F.PL+PRS+3+SG
rebordai-la	rebordar+V.ele.ACC.3.F.SG+PRS+2+PL
rebordai-las	rebordar+V.ele.ACC.3.F.PL+PRS+2+PL
rebordai-lo	rebordar+V.ele.ACC.3.M.SG+PRS+2+PL
rebordai-los	rebordar+V.ele.ACC.3.M.PL+PRS+2+PL
rebordai-nos	rebordar+nós.AD.1.PL+PRS+2+PL
rebordais-lhe	rebordar+V.ele.DAT.3.SG+PRS+2+PL
rebordais-lhes	rebordar+V.ele.DAT.3.PL+PRS+2+PL
rebordais-me	rebordar+V.eu.AD.1.SG+PRS+2+PL
rebordais-te	rebordar+V.tu.AD.2.SG+PRS+2+PL
rebordais-vos	rebordar+V.vós.AD.2.PL+PRS+2+PL
rebordá-la-ão	rebordar+V.ele.ACC.3.F.SG+FUT+3+PL
rebordá-la-á	rebordar+V.ele.ACC.3.F.SG+FUT+3+SG
rebordá-la-ás	rebordar+V.ele.ACC.3.F.SG+FUT+2+SG
rebordá-la-ei	rebordar+V.ele.ACC.3.F.SG+FUT+1+SG
rebordá-la-eis	rebordar+V.ele.ACC.3.F.SG+FUT+2+PL
rebordá-la-emos	rebordar+V.ele.ACC.3.F.SG+FUT+1+PL
rebordá-la-íamos	rebordar+V.ele.ACC.3.F.SG+COND+1+PL
rebordá-la-iam	rebordar+V.ele.ACC.3.F.SG+COND+3+PL
rebordá-la-ia	rebordar+V.ele.ACC.3.F.SG+COND+1+SG
rebordá-la-ia	rebordar+V.ele.ACC.3.F.SG+COND+3+SG
rebordá-la-ias	rebordar+V.ele.ACC.3.F.SG+COND+2+SG
rebordá-la-íeis	rebordar+V.ele.ACC.3.F.SG+COND+2+PL
rebordá-la	rebordar+V.ele.ACC.3.F.SG+INF+1+SG
rebordá-la	rebordar+V.ele.ACC.3.F.SG+INF+3+SG
reborda-la	rebordar+V.ele.ACC.3.F.SG+PRS+2+SG
rebordá-la	rebordar+V.ele.ACC.3.F.SG+SBJF+1+SG
rebordá-la	rebordar+V.ele.ACC.3.F.SG+SBJF+3+SG
rebordá-las-ão	rebordar+V.ele.ACC.3.F.PL+FUT+3+PL
rebordá-las-á	rebordar+V.ele.ACC.3.F.PL+FUT+3+SG
rebordá-las-ás	rebordar+V.ele.ACC.3.F.PL+FUT+2+SG
rebordá-las-ei	rebordar+V.ele.ACC.3.F.PL+FUT+1+SG
rebordá-las-eis	rebordar+V.ele.ACC.3.F.PL+FUT+2+PL
rebordá-las-emos	rebordar+V.ele.ACC.3.F.PL+FUT+1+PL
rebordá-las-íamos	rebordar+V.ele.ACC.3.F.PL+COND+1+PL
rebordá-las-iam	rebordar+V.ele.ACC.3.F.PL+COND+3+PL
rebordá-las-ia	rebordar+V.ele.ACC.3.F.PL+COND+1+SG
rebordá-las-ia	rebordar+V.ele.ACC.3.F.PL+COND+3+SG
rebordá-las-ias	rebordar+V.ele.ACC.3.F.PL+COND+2+SG
rebordá-las-íeis	rebordar+V.ele.ACC.3.F.PL+COND+2+PL
rebordá-las	rebordar+V.ele.ACC.3.F.PL+INF+1+SG
rebordá-las	rebordar+V.ele.ACC.3.F.PL+INF+3+SG
reborda-las	rebordar+V.ele.ACC.3.F.PL+PRS+2+SG
rebordá-las	rebordar+V.ele.ACC.3.F.PL+SBJF+1+SG
rebordá-las	rebordar+V.ele.ACC.3.F.PL+SBJF+3+SG
reborda-lhe	rebordar+V.ele.DAT.3.SG+PRS+3+SG
reborda-lhes	rebordar+V.ele.DAT.3.PL+PRS+3+SG
rebordá-lo-ão	rebordar+V.ele.ACC.3.M.SG+FUT+3+PL
rebordá-lo-á	rebordar+V.ele.ACC.3.M.SG+FUT+3+SG
rebordá-lo-ás	rebordar+V.ele.ACC.3.M.SG+FUT+2+SG
rebordá-lo-ei	rebordar+V.ele.ACC.3.M.SG+FUT+1+SG
rebordá-lo-eis	rebordar+V.ele.ACC.3.M.SG+FUT+2+PL
rebordá-lo-emos	rebordar+V.ele.ACC.3.M.SG+FUT+1+PL
rebordá-lo-íamos	rebordar+V.ele.ACC.3.M.SG+COND+1+PL
rebordá-lo-iam	rebordar+V.ele.ACC.3.M.SG+COND+3+PL
rebordá-lo-ia	rebordar+V.ele.ACC.3.M.SG+COND+1+SG
rebordá-lo-ia	rebordar+V.ele.ACC.3.M.SG+COND+3+SG
rebordá-lo-ias	rebordar+V.ele.ACC.3.M.SG+COND+2+SG
rebordá-lo-íeis	rebordar+V.ele.ACC.3.M.SG+COND+2+PL
rebordá-lo	rebordar+V.ele.ACC.3.M.SG+INF+1+SG
rebordá-lo	rebordar+V.ele.ACC.3.M.SG+INF+3+SG
reborda-lo	rebordar+V.ele.ACC.3.M.SG+PRS+2+SG
rebordá-lo	rebordar+V.ele.ACC.3.M.SG+SBJF+1+SG
rebordá-lo	rebordar+V.ele.ACC.3.M.SG+SBJF+3+SG
rebordá-los-ão	rebordar+V.ele.ACC.3.M.PL+FUT+3+PL
rebordá-los-á	rebordar+V.ele.ACC.3.M.PL+FUT+3+SG
rebordá-los-ás	rebordar+V.ele.ACC.3.M.PL+FUT+2+SG
rebordá-los-ei	rebordar+V.ele.ACC.3.M.PL+FUT+1+SG
rebordá-los-eis	rebordar+V.ele.ACC.3.M.PL+FUT+2+PL
rebordá-los-emos	rebordar+V.ele.ACC.3.M.PL+FUT+1+PL
rebordá-los-íamos	rebordar+V.ele.ACC.3.M.PL+COND+1+PL
rebordá-los-iam	rebordar+V.ele.ACC.3.M.PL+COND+3+PL
rebordá-los-ia	rebordar+V.ele.ACC.3.M.PL+COND+1+SG
rebordá-los-ia	rebordar+V.ele.ACC.3.M.PL+COND+3+SG
rebordá-los-ias	rebordar+V.ele.ACC.3.M.PL+COND+2+SG
rebordá-los-íeis	rebordar+V.ele.ACC.3.M.PL+COND+2+PL
rebordá-los	rebordar+V.ele.ACC.3.M.PL+INF+1+SG
rebordá-los	rebordar+V.ele.ACC.3.M.PL+INF+3+SG
reborda-los	rebordar+V.ele.ACC.3.M.PL+PRS+2+SG
rebordá-los	rebordar+V.ele.ACC.3.M.PL+SBJF+1+SG
rebordá-los	rebordar+V.ele.ACC.3.M.PL+SBJF+3+SG
reborda-me	rebordar+V.eu.AD.1.SG+PRS+3+SG
rebordam-lhe	rebordar+V.ele.DAT.3.SG+PRS+3+PL
rebordam-lhes	rebordar+V.ele.DAT.3.PL+PRS+3+PL
rebordam-me	rebordar+V.eu.AD.1.SG+PRS+3+PL
rebordam-na	rebordar+V.ele.ACC.3.F.SG+PRS+3+PL
rebordam-nas	rebordar+V.ele.ACC.3.F.PL+PRS+3+PL
rebordam-no	rebordar+V.ele.ACC.3.M.SG+PRS+3+PL
rebordam-nos	rebordar+V.ele.ACC.3.M.PL+PRS+3+PL
rebordam-nos	rebordar+V.nós.AD.1.PL+PRS+3+PL
rebordamo-la	rebordar+V.ele.ACC.3.F.SG+PRF+1+PL
rebordamo-la	rebordar+V.ele.ACC.3.F.SG+PRS+1+PL
rebordamo-las	rebordar+V.ele.ACC.3.F.PL+PRF+1+PL
rebordamo-las	rebordar+V.ele.ACC.3.F.PL+PRS+1+PL
rebordamo-lo	rebordar+V.ele.ACC.3.M.SG+PRF+1+PL
rebordamo-lo	rebordar+V.ele.ACC.3.M.SG+PRS+1+PL
rebordamo-los	rebordar+V.ele.ACC.3.M.PL+PRF+1+PL
rebordamo-los	rebordar+V.ele.ACC.3.M.PL+PRS+1+PL
rebordamo-nos	rebordar+nós.AD.1.PL+PRF+1+PL
rebordamo-nos	rebordar+nós.AD.1.PL+PRS+1+PL
rebordamos-lhe	rebordar+V.ele.DAT.3.SG+PRF+1+PL
rebordamos-lhe	rebordar+V.ele.DAT.3.SG+PRS+1+PL
rebordamos-lhes	rebordar+V.ele.DAT.3.PL+PRF+1+PL
rebordamos-lhes	rebordar+V.ele.DAT.3.PL+PRS+1+PL
rebordamos-me	rebordar+V.eu.AD.1.SG+PRF+1+PL
rebordamos-me	rebordar+V.eu.AD.1.SG+PRS+1+PL
rebordamos-te	rebordar+V.tu.AD.2.SG+PRF+1+PL
rebordamos-te	rebordar+V.tu.AD.2.SG+PRS+1+PL
rebordamos-vos	rebordar+V.vós.AD.2.PL+PRF+1+PL
rebordamos-vos	rebordar+V.vós.AD.2.PL+PRS+1+PL
rebordam-se	rebordar+V.ele.REFL+PRS+3+PL
rebordam-te	rebordar+V.tu.AD.2.SG+PRS+3+PL
rebordam-vos	rebordar+V.vós.AD.2.PL+PRS+3+PL
rebordando-a	rebordar+V.ele.ACC.3.F.SG+GRD
rebordando-as	rebordar+V.ele.ACC.3.F.PL+GRD
rebordando-lhe	rebordar+V.ele.DAT.3.SG+GRD
rebordando-lhes	rebordar+V.ele.DAT.3.PL+GRD
rebordando-me	rebordar+V.eu.AD.1.SG+GRD
rebordando-nos	rebordar+nós.AD.1.PL+GRD
rebordando-o	rebordar+V.ele.ACC.3.M.SG+GRD
rebordando-os	rebordar+V.ele.ACC.3.M.PL+GRD
rebordando-se	rebordar+V.ele.REFL+GRD
rebordando-te	rebordar+V.tu.AD.2.SG+GRD
rebordando-vos	rebordar+V.vós.AD.2.PL+GRD
reborda-nos	rebordar+nós.AD.1.PL+PRS+2+SG
reborda-nos	rebordar+nós.AD.1.PL+PRS+3+SG
reborda-o	rebordar+V.ele.ACC.3.M.SG+PRS+3+SG
reborda-os	rebordar+V.ele.ACC.3.M.PL+PRS+3+SG
rebordara-a	rebordar+V.ele.ACC.3.F.SG+PQP+1+SG
rebordara-a	rebordar+V.ele.ACC.3.F.SG+PQP+3+SG
rebordara-as	rebordar+V.ele.ACC.3.F.PL+PQP+1+SG
rebordara-as	rebordar+V.ele.ACC.3.F.PL+PQP+3+SG
rebordara-la	rebordar+V.ele.ACC.3.F.SG+PQP+2+SG
rebordara-las	rebordar+V.ele.ACC.3.F.PL+PQP+2+SG
rebordara-lhe	rebordar+V.ele.DAT.3.SG+PQP+1+SG
rebordara-lhe	rebordar+V.ele.DAT.3.SG+PQP+3+SG
rebordara-lhes	rebordar+V.ele.DAT.3.PL+PQP+1+SG
rebordara-lhes	rebordar+V.ele.DAT.3.PL+PQP+3+SG
rebordara-lo	rebordar+V.ele.ACC.3.M.SG+PQP+2+SG
rebordara-los	rebordar+V.ele.ACC.3.M.PL+PQP+2+SG
rebordara-me	rebordar+V.eu.AD.1.SG+PQP+1+SG
rebordara-me	rebordar+V.eu.AD.1.SG+PQP+3+SG
rebordaram-lhe	rebordar+V.ele.DAT.3.SG+PQP+3+PL
rebordaram-lhe	rebordar+V.ele.DAT.3.SG+PRF+3+PL
rebordaram-lhes	rebordar+V.ele.DAT.3.PL+PQP+3+PL
rebordaram-lhes	rebordar+V.ele.DAT.3.PL+PRF+3+PL
rebordaram-me	rebordar+V.eu.AD.1.SG+PQP+3+PL
rebordaram-me	rebordar+V.eu.AD.1.SG+PRF+3+PL
rebordaram-na	rebordar+V.ele.ACC.3.F.SG+PQP+3+PL
rebordaram-na	rebordar+V.ele.ACC.3.F.SG+PRF+3+PL
rebordaram-nas	rebordar+V.ele.ACC.3.F.PL+PQP+3+PL
rebordaram-nas	rebordar+V.ele.ACC.3.F.PL+PRF+3+PL
rebordaram-no	rebordar+V.ele.ACC.3.M.SG+PQP+3+PL
rebordaram-no	rebordar+V.ele.ACC.3.M.SG+PRF+3+PL
rebordaram-nos	rebordar+V.ele.ACC.3.M.PL+PQP+3+PL
rebordaram-nos	rebordar+V.ele.ACC.3.M.PL+PRF+3+PL
rebordaram-nos	rebordar+V.nós.AD.1.PL+PQP+3+PL
rebordaram-nos	rebordar+V.nós.AD.1.PL+PRF+3+PL
rebordáramo-la	rebordar+V.ele.ACC.3.F.SG+PQP+1+PL
rebordáramo-las	rebordar+V.ele.ACC.3.F.PL+PQP+1+PL
rebordáramo-lo	rebordar+V.ele.ACC.3.M.SG+PQP+1+PL
rebordáramo-los	rebordar+V.ele.ACC.3.M.PL+PQP+1+PL
rebordáramo-nos	rebordar+nós.AD.1.PL+PQP+1+PL
rebordáramos-lhe	rebordar+V.ele.DAT.3.SG+PQP+1+PL
rebordáramos-lhes	rebordar+V.ele.DAT.3.PL+PQP+1+PL
rebordáramos-me	rebordar+V.eu.AD.1.SG+PQP+1+PL
rebordáramos-te	rebordar+V.tu.AD.2.SG+PQP+1+PL
rebordáramos-vos	rebordar+V.vós.AD.2.PL+PQP+1+PL
rebordaram-se	rebordar+V.ele.REFL+PQP+3+PL
rebordaram-se	rebordar+V.ele.REFL+PRF+3+PL
rebordaram-te	rebordar+V.tu.AD.2.SG+PQP+3+PL
rebordaram-te	rebordar+V.tu.AD.2.SG+PRF+3+PL
rebordaram-vos	rebordar+V.vós.AD.2.PL+PQP+3+PL
rebordaram-vos	rebordar+V.vós.AD.2.PL+PRF+3+PL
rebordara-nos	rebordar+nós.AD.1.PL+PQP+1+SG
rebordara-nos	rebordar+nós.AD.1.PL+PQP+2+SG
rebordara-nos	rebordar+nós.AD.1.PL+PQP+3+SG
rebordara-o	rebordar+V.ele.ACC.3.M.SG+PQP+1+SG
rebordara-o	rebordar+V.ele.ACC.3.M.SG+PQP+3+SG
rebordara-os	rebordar+V.ele.ACC.3.M.PL+PQP+1+SG
rebordara-os	rebordar+V.ele.ACC.3.M.PL+PQP+3+SG
rebordara-se	rebordar+V.ele.REFL+PQP+1+SG
rebordara-se	rebordar+V.ele.REFL+PQP+3+SG
rebordaras-lhe	rebordar+V.ele.DAT.3.SG+PQP+2+SG
rebordaras-lhes	rebordar+V.ele.DAT.3.PL+PQP+2+SG
rebordaras-me	rebordar+V.eu.AD.1.SG+PQP+2+SG
rebordaras-te	rebordar+V.tu.AD.2.SG+PQP+2+SG
rebordaras-vos	rebordar+V.vós.AD.2.PL+PQP+2+SG
rebordara-te	rebordar+V.tu.AD.2.SG+PQP+1+SG
rebordara-te	rebordar+V.tu.AD.2.SG+PQP+3+SG
rebordara-vos	rebordar+V.vós.AD.2.PL+PQP+1+SG
rebordara-vos	rebordar+V.vós.AD.2.PL+PQP+3+SG
rebordarde-la	rebordar+V.ele.ACC.3.F.SG+INF+2+PL
rebordarde-la	rebordar+V.ele.ACC.3.F.SG+SBJF+2+PL
rebordarde-las	rebordar+V.ele.ACC.3.F.PL+INF+2+PL
rebordarde-las	rebordar+V.ele.ACC.3.F.PL+SBJF+2+PL
rebordarde-lo	rebordar+V.ele.ACC.3.M.SG+INF+2+PL
rebordarde-lo	rebordar+V.ele.ACC.3.M.SG+SBJF+2+PL
rebordarde-los	rebordar+V.ele.ACC.3.M.PL+INF+2+PL
rebordarde-los	rebordar+V.ele.ACC.3.M.PL+SBJF+2+PL
rebordarde-nos	rebordar+nós.AD.1.PL+INF+2+PL
rebordarde-nos	rebordar+nós.AD.1.PL+SBJF+2+PL
rebordardes-lhe	rebordar+V.ele.DAT.3.SG+INF+2+PL
rebordardes-lhe	rebordar+V.ele.DAT.3.SG+SBJF+2+PL
rebordardes-lhes	rebordar+V.ele.DAT.3.PL+INF+2+PL
rebordardes-lhes	rebordar+V.ele.DAT.3.PL+SBJF+2+PL
rebordardes-me	rebordar+V.eu.AD.1.SG+INF+2+PL
rebordardes-me	rebordar+V.eu.AD.1.SG+SBJF+2+PL
rebordardes-te	rebordar+V.tu.AD.2.SG+INF+2+PL
rebordardes-te	rebordar+V.tu.AD.2.SG+SBJF+2+PL
rebordardes-vos	rebordar+V.vós.AD.2.PL+INF+2+PL
rebordardes-vos	rebordar+V.vós.AD.2.PL+SBJF+2+PL
rebordárei-la	rebordar+V.ele.ACC.3.F.SG+PQP+2+PL
rebordárei-las	rebordar+V.ele.ACC.3.F.PL+PQP+2+PL
rebordárei-lo	rebordar+V.ele.ACC.3.M.SG+PQP+2+PL
rebordárei-los	rebordar+V.ele.ACC.3.M.PL+PQP+2+PL
rebordárei-nos	rebordar+nós.AD.1.PL+PQP+2+PL
rebordáreis-lhe	rebordar+V.ele.DAT.3.SG+PQP+2+PL
rebordáreis-lhes	rebordar+V.ele.DAT.3.PL+PQP+2+PL
rebordáreis-me	rebordar+V.eu.AD.1.SG+PQP+2+PL
rebordáreis-te	rebordar+V.tu.AD.2.SG+PQP+2+PL
rebordáreis-vos	rebordar+V.vós.AD.2.PL+PQP+2+PL
rebordare-la	rebordar+V.ele.ACC.3.F.SG+INF+2+SG
rebordare-la	rebordar+V.ele.ACC.3.F.SG+SBJF+2+SG
rebordare-las	rebordar+V.ele.ACC.3.F.PL+INF+2+SG
rebordare-las	rebordar+V.ele.ACC.3.F.PL+SBJF+2+SG
rebordare-lo	rebordar+V.ele.ACC.3.M.SG+INF+2+SG
rebordare-lo	rebordar+V.ele.ACC.3.M.SG+SBJF+2+SG
rebordare-los	rebordar+V.ele.ACC.3.M.PL+INF+2+SG
rebordare-los	rebordar+V.ele.ACC.3.M.PL+SBJF+2+SG
rebordarem-lhe	rebordar+V.ele.DAT.3.SG+INF+3+PL
rebordarem-lhe	rebordar+V.ele.DAT.3.SG+SBJF+3+PL
rebordarem-lhes	rebordar+V.ele.DAT.3.PL+INF+3+PL
rebordarem-lhes	rebordar+V.ele.DAT.3.PL+SBJF+3+PL
rebordarem-me	rebordar+V.eu.AD.1.SG+INF+3+PL
rebordarem-me	rebordar+V.eu.AD.1.SG+SBJF+3+PL
rebordarem-na	rebordar+V.ele.ACC.3.F.SG+INF+3+PL
rebordarem-na	rebordar+V.ele.ACC.3.F.SG+SBJF+3+PL
rebordarem-nas	rebordar+V.ele.ACC.3.F.PL+INF+3+PL
rebordarem-nas	rebordar+V.ele.ACC.3.F.PL+SBJF+3+PL
rebordarem-no	rebordar+V.ele.ACC.3.M.SG+INF+3+PL
rebordarem-no	rebordar+V.ele.ACC.3.M.SG+SBJF+3+PL
rebordarem-nos	rebordar+V.ele.ACC.3.M.PL+INF+3+PL
rebordarem-nos	rebordar+V.ele.ACC.3.M.PL+SBJF+3+PL
rebordarem-nos	rebordar+V.nós.AD.1.PL+INF+3+PL
rebordarem-nos	rebordar+V.nós.AD.1.PL+SBJF+3+PL
rebordarem-se	rebordar+V.ele.REFL+INF+3+PL
rebordarem-se	rebordar+V.ele.REFL+SBJF+3+PL
rebordarem-te	rebordar+V.tu.AD.2.SG+INF+3+PL
rebordarem-te	rebordar+V.tu.AD.2.SG+SBJF+3+PL
rebordarem-vos	rebordar+V.vós.AD.2.PL+INF+3+PL
rebordarem-vos	rebordar+V.vós.AD.2.PL+SBJF+3+PL
rebordare-nos	rebordar+nós.AD.1.PL+INF+2+SG
rebordare-nos	rebordar+nós.AD.1.PL+SBJF+2+SG
rebordares-lhe	rebordar+V.ele.DAT.3.SG+INF+2+SG
rebordares-lhe	rebordar+V.ele.DAT.3.SG+SBJF+2+SG
rebordares-lhes	rebordar+V.ele.DAT.3.PL+INF+2+SG
rebordares-lhes	rebordar+V.ele.DAT.3.PL+SBJF+2+SG
rebordares-me	rebordar+V.eu.AD.1.SG+INF+2+SG
rebordares-me	rebordar+V.eu.AD.1.SG+SBJF+2+SG
rebordares-te	rebordar+V.tu.AD.2.SG+INF+2+SG
rebordares-te	rebordar+V.tu.AD.2.SG+SBJF+2+SG
rebordares-vos	rebordar+V.vós.AD.2.PL+INF+2+SG
rebordares-vos	rebordar+V.vós.AD.2.PL+SBJF+2+SG
rebordar-lhe-ão	rebordar+V.ele.DAT.3.SG+FUT+3+PL
rebordar-lhe-á	rebordar+V.ele.DAT.3.SG+FUT+3+SG
rebordar-lhe-ás	rebordar+V.ele.DAT.3.SG+FUT+2+SG
rebordar-lhe-ei	rebordar+V.ele.DAT.3.SG+FUT+1+SG
rebordar-lhe-eis	rebordar+V.ele.DAT.3.SG+FUT+2+PL
rebordar-lhe-emos	rebordar+V.ele.DAT.3.SG+FUT+1+PL
rebordar-lhe-íamos	rebordar+V.ele.DAT.3.SG+COND+1+PL
rebordar-lhe-iam	rebordar+V.ele.DAT.3.SG+COND+3+PL
rebordar-lhe-ia	rebordar+V.ele.DAT.3.SG+COND+1+SG
rebordar-lhe-ia	rebordar+V.ele.DAT.3.SG+COND+3+SG
rebordar-lhe-ias	rebordar+V.ele.DAT.3.SG+COND+2+SG
rebordar-lhe-íeis	rebordar+V.ele.DAT.3.SG+COND+2+PL
rebordar-lhe	rebordar+V.ele.DAT.3.SG+INF
rebordar-lhe	rebordar+V.ele.DAT.3.SG+INF+1+SG
rebordar-lhe	rebordar+V.ele.DAT.3.SG+INF+3+SG
rebordar-lhe	rebordar+V.ele.DAT.3.SG+SBJF+1+SG
rebordar-lhe	rebordar+V.ele.DAT.3.SG+SBJF+3+SG
rebordar-lhes-ão	rebordar+V.ele.DAT.3.PL+FUT+3+PL
rebordar-lhes-á	rebordar+V.ele.DAT.3.PL+FUT+3+SG
rebordar-lhes-ás	rebordar+V.ele.DAT.3.PL+FUT+2+SG
rebordar-lhes-ei	rebordar+V.ele.DAT.3.PL+FUT+1+SG
rebordar-lhes-eis	rebordar+V.ele.DAT.3.PL+FUT+2+PL
rebordar-lhes-emos	rebordar+V.ele.DAT.3.PL+FUT+1+PL
rebordar-lhes-íamos	rebordar+V.ele.DAT.3.PL+COND+1+PL
rebordar-lhes-iam	rebordar+V.ele.DAT.3.PL+COND+3+PL
rebordar-lhes-ia	rebordar+V.ele.DAT.3.PL+COND+1+SG
rebordar-lhes-ia	rebordar+V.ele.DAT.3.PL+COND+3+SG
rebordar-lhes-ias	rebordar+V.ele.DAT.3.PL+COND+2+SG
rebordar-lhes-íeis	rebordar+V.ele.DAT.3.PL+COND+2+PL
rebordar-lhes	rebordar+V.ele.DAT.3.PL+INF
rebordar-lhes	rebordar+V.ele.DAT.3.PL+INF+1+SG
rebordar-lhes	rebordar+V.ele.DAT.3.PL+INF+3+SG
rebordar-lhes	rebordar+V.ele.DAT.3.PL+SBJF+1+SG
rebordar-lhes	rebordar+V.ele.DAT.3.PL+SBJF+3+SG
rebordar-me-ão	rebordar+V.eu.AD.1.SG+FUT+3+PL
rebordar-me-á	rebordar+V.eu.AD.1.SG+FUT+3+SG
rebordar-me-ás	rebordar+V.eu.AD.1.SG+FUT+2+SG
rebordar-me-ei	rebordar+V.eu.AD.1.SG+FUT+1+SG
rebordar-me-eis	rebordar+V.eu.AD.1.SG+FUT+2+PL
rebordar-me-emos	rebordar+V.eu.AD.1.SG+FUT+1+PL
rebordar-me-íamos	rebordar+V.eu.AD.1.SG+COND+1+PL
rebordar-me-iam	rebordar+V.eu.AD.1.SG+COND+3+PL
rebordar-me-ia	rebordar+V.eu.AD.1.SG+COND+1+SG
rebordar-me-ia	rebordar+V.eu.AD.1.SG+COND+3+SG
rebordar-me-ias	rebordar+V.eu.AD.1.SG+COND+2+SG
rebordar-me-íeis	rebordar+V.eu.AD.1.SG+COND+2+PL
rebordar-me	rebordar+V.eu.AD.1.SG+INF
rebordar-me	rebordar+V.eu.AD.1.SG+INF+1+SG
rebordar-me	rebordar+V.eu.AD.1.SG+INF+3+SG
rebordar-me	rebordar+V.eu.AD.1.SG+SBJF+1+SG
rebordar-me	rebordar+V.eu.AD.1.SG+SBJF+3+SG
rebordarmo-la	rebordar+V.ele.ACC.3.F.SG+INF+1+PL
rebordarmo-la	rebordar+V.ele.ACC.3.F.SG+SBJF+1+PL
rebordarmo-las	rebordar+V.ele.ACC.3.F.PL+INF+1+PL
rebordarmo-las	rebordar+V.ele.ACC.3.F.PL+SBJF+1+PL
rebordarmo-lo	rebordar+V.ele.ACC.3.M.SG+INF+1+PL
rebordarmo-lo	rebordar+V.ele.ACC.3.M.SG+SBJF+1+PL
rebordarmo-los	rebordar+V.ele.ACC.3.M.PL+INF+1+PL
rebordarmo-los	rebordar+V.ele.ACC.3.M.PL+SBJF+1+PL
rebordarmo-nos	rebordar+nós.AD.1.PL+INF+1+PL
rebordarmo-nos	rebordar+nós.AD.1.PL+SBJF+1+PL
rebordarmos-lhe	rebordar+V.ele.DAT.3.SG+INF+1+PL
rebordarmos-lhe	rebordar+V.ele.DAT.3.SG+SBJF+1+PL
rebordarmos-lhes	rebordar+V.ele.DAT.3.PL+INF+1+PL
rebordarmos-lhes	rebordar+V.ele.DAT.3.PL+SBJF+1+PL
rebordarmos-me	rebordar+V.eu.AD.1.SG+INF+1+PL
rebordarmos-me	rebordar+V.eu.AD.1.SG+SBJF+1+PL
rebordarmos-te	rebordar+V.tu.AD.2.SG+INF+1+PL
rebordarmos-te	rebordar+V.tu.AD.2.SG+SBJF+1+PL
rebordarmos-vos	rebordar+V.vós.AD.2.PL+INF+1+PL
rebordarmos-vos	rebordar+V.vós.AD.2.PL+SBJF+1+PL
rebordar-nos-ão	rebordar+nós.AD.1.PL+FUT+3+PL
rebordar-nos-á	rebordar+nós.AD.1.PL+FUT+3+SG
rebordar-nos-ás	rebordar+nós.AD.1.PL+FUT+2+SG
rebordar-nos-ei	rebordar+nós.AD.1.PL+FUT+1+SG
rebordar-nos-eis	rebordar+nós.AD.1.PL+FUT+2+PL
rebordar-nos-emos	rebordar+nós.AD.1.PL+FUT+1+PL
rebordar-nos-íamos	rebordar+nós.AD.1.PL+COND+1+PL
rebordar-nos-iam	rebordar+nós.AD.1.PL+COND+3+PL
rebordar-nos-ia	rebordar+nós.AD.1.PL+COND+1+SG
rebordar-nos-ia	rebordar+nós.AD.1.PL+COND+3+SG
rebordar-nos-ias	rebordar+nós.AD.1.PL+COND+2+SG
rebordar-nos-íeis	rebordar+nós.AD.1.PL+COND+2+PL
rebordar-nos	rebordar+nós.AD.1.PL+INF
rebordar-nos	rebordar+nós.AD.1.PL+INF+1+SG
rebordar-nos	rebordar+nós.AD.1.PL+INF+3+SG
rebordar-nos	rebordar+nós.AD.1.PL+SBJF+1+SG
rebordar-nos	rebordar+nós.AD.1.PL+SBJF+3+SG
rebordar-se-ão	rebordar+V.ele.REFL+FUT+3+PL
rebordar-se-á	rebordar+V.ele.REFL+FUT+3+SG
rebordar-se-iam	rebordar+V.ele.REFL+COND+3+PL
rebordar-se-ia	rebordar+V.ele.REFL+COND+3+SG
rebordar-se	rebordar+V.ele.REFL+INF
rebordar-se	rebordar+V.ele.REFL+INF+3+SG
rebordar-se	rebordar+V.ele.REFL+SBJF+3+SG
rebordar-te-ão	rebordar+V.tu.AD.2.SG+FUT+3+PL
rebordar-te-á	rebordar+V.tu.AD.2.SG+FUT+3+SG
rebordar-te-ás	rebordar+V.tu.AD.2.SG+FUT+2+SG
rebordar-te-ei	rebordar+V.tu.AD.2.SG+FUT+1+SG
rebordar-te-eis	rebordar+V.tu.AD.2.SG+FUT+2+PL
rebordar-te-emos	rebordar+V.tu.AD.2.SG+FUT+1+PL
rebordar-te-íamos	rebordar+V.tu.AD.2.SG+COND+1+PL
rebordar-te-iam	rebordar+V.tu.AD.2.SG+COND+3+PL
rebordar-te-ia	rebordar+V.tu.AD.2.SG+COND+1+SG
rebordar-te-ia	rebordar+V.tu.AD.2.SG+COND+3+SG
rebordar-te-ias	rebordar+V.tu.AD.2.SG+COND+2+SG
rebordar-te-íeis	rebordar+V.tu.AD.2.SG+COND+2+PL
rebordar-te	rebordar+V.tu.AD.2.SG+INF
rebordar-te	rebordar+V.tu.AD.2.SG+INF+1+SG
rebordar-te	rebordar+V.tu.AD.2.SG+INF+3+SG
rebordar-te	rebordar+V.tu.AD.2.SG+SBJF+1+SG
rebordar-te	rebordar+V.tu.AD.2.SG+SBJF+3+SG
rebordar-vos-ão	rebordar+V.vós.AD.2.PL+FUT+3+PL
rebordar-vos-á	rebordar+V.vós.AD.2.PL+FUT+3+SG
rebordar-vos-ás	rebordar+V.vós.AD.2.PL+FUT+2+SG
rebordar-vos-ei	rebordar+V.vós.AD.2.PL+FUT+1+SG
rebordar-vos-eis	rebordar+V.vós.AD.2.PL+FUT+2+PL
rebordar-vos-emos	rebordar+V.vós.AD.2.PL+FUT+1+PL
rebordar-vos-íamos	rebordar+V.vós.AD.2.PL+COND+1+PL
rebordar-vos-iam	rebordar+V.vós.AD.2.PL+COND+3+PL
rebordar-vos-ia	rebordar+V.vós.AD.2.PL+COND+1+SG
rebordar-vos-ia	rebordar+V.vós.AD.2.PL+COND+3+SG
rebordar-vos-ias	rebordar+V.vós.AD.2.PL+COND+2+SG
rebordar-vos-íeis	rebordar+V.vós.AD.2.PL+COND+2+PL
rebordar-vos	rebordar+V.vós.AD.2.PL+INF
rebordar-vos	rebordar+V.vós.AD.2.PL+INF+1+SG
rebordar-vos	rebordar+V.vós.AD.2.PL+INF+3+SG
rebordar-vos	rebordar+V.vós.AD.2.PL+SBJF+1+SG
rebordar-vos	rebordar+V.vós.AD.2.PL+SBJF+3+SG
reborda-se	rebordar+V.ele.REFL+PRS+3+SG
rebordas-lhe	rebordar+V.ele.DAT.3.SG+PRS+2+SG
rebordas-lhes	rebordar+V.ele.DAT.3.PL+PRS+2+SG
rebordas-me	rebordar+V.eu.AD.1.SG+PRS+2+SG
rebordaste-a	rebordar+V.ele.ACC.3.F.SG+PRF+2+SG
rebordaste-as	rebordar+V.ele.ACC.3.F.PL+PRF+2+SG
rebordaste-la	rebordar+V.ele.ACC.3.F.SG+PRF+2+PL
rebordaste-las	rebordar+V.ele.ACC.3.F.PL+PRF+2+PL
rebordaste-lhe	rebordar+V.ele.DAT.3.SG+PRF+2+SG
rebordaste-lhes	rebordar+V.ele.DAT.3.PL+PRF+2+SG
rebordaste-lo	rebordar+V.ele.ACC.3.M.SG+PRF+2+PL
rebordaste-los	rebordar+V.ele.ACC.3.M.PL+PRF+2+PL
rebordaste-me	rebordar+V.eu.AD.1.SG+PRF+2+SG
rebordaste-nos	rebordar+nós.AD.1.PL+PRF+2+PL
rebordaste-nos	rebordar+nós.AD.1.PL+PRF+2+SG
rebordaste-o	rebordar+V.ele.ACC.3.M.SG+PRF+2+SG
rebordaste-os	rebordar+V.ele.ACC.3.M.PL+PRF+2+SG
rebordas-te	rebordar+V.tu.AD.2.SG+PRS+2+SG
rebordastes-lhe	rebordar+V.ele.DAT.3.SG+PRF+2+PL
rebordastes-lhes	rebordar+V.ele.DAT.3.PL+PRF+2+PL
rebordastes-me	rebordar+V.eu.AD.1.SG+PRF+2+PL
rebordastes-te	rebordar+V.tu.AD.2.SG+PRF+2+PL
rebordastes-vos	rebordar+V.vós.AD.2.PL+PRF+2+PL
rebordaste-te	rebordar+V.tu.AD.2.SG+PRF+2+SG
rebordaste-vos	rebordar+V.vós.AD.2.PL+PRF+2+SG
rebordas-vos	rebordar+V.vós.AD.2.PL+PRS+2+SG
reborda-te	rebordar+V.tu.AD.2.SG+PRS+3+SG
rebordava-a	rebordar+V.ele.ACC.3.F.SG+IMPF+1+SG
rebordava-a	rebordar+V.ele.ACC.3.F.SG+IMPF+3+SG
rebordava-as	rebordar+V.ele.ACC.3.F.PL+IMPF+1+SG
rebordava-as	rebordar+V.ele.ACC.3.F.PL+IMPF+3+SG
rebordava-la	rebordar+V.ele.ACC.3.F.SG+IMPF+2+SG
rebordava-las	rebordar+V.ele.ACC.3.F.PL+IMPF+2+SG
rebordava-lhe	rebordar+V.ele.DAT.3.SG+IMPF+1+SG
rebordava-lhe	rebordar+V.ele.DAT.3.SG+IMPF+3+SG
rebordava-lhes	rebordar+V.ele.DAT.3.PL+IMPF+1+SG
rebordava-lhes	rebordar+V.ele.DAT.3.PL+IMPF+3+SG
rebordava-lo	rebordar+V.ele.ACC.3.M.SG+IMPF+2+SG
rebordava-los	rebordar+V.ele.ACC.3.M.PL+IMPF+2+SG
rebordava-me	rebordar+V.eu.AD.1.SG+IMPF+1+SG
rebordava-me	rebordar+V.eu.AD.1.SG+IMPF+3+SG
rebordavam-lhe	rebordar+V.ele.DAT.3.SG+IMPF+3+PL
rebordavam-lhes	rebordar+V.ele.DAT.3.PL+IMPF+3+PL
rebordavam-me	rebordar+V.eu.AD.1.SG+IMPF+3+PL
rebordavam-na	rebordar+V.ele.ACC.3.F.SG+IMPF+3+PL
rebordavam-nas	rebordar+V.ele.ACC.3.F.PL+IMPF+3+PL
rebordavam-no	rebordar+V.ele.ACC.3.M.SG+IMPF+3+PL
rebordavam-nos	rebordar+V.ele.ACC.3.M.PL+IMPF+3+PL
rebordavam-nos	rebordar+V.nós.AD.1.PL+IMPF+3+PL
rebordávamo-la	rebordar+V.ele.ACC.3.F.SG+IMPF+1+PL
rebordávamo-las	rebordar+V.ele.ACC.3.F.PL+IMPF+1+PL
rebordávamo-lo	rebordar+V.ele.ACC.3.M.SG+IMPF+1+PL
rebordávamo-los	rebordar+V.ele.ACC.3.M.PL+IMPF+1+PL
rebordávamo-nos	rebordar+nós.AD.1.PL+IMPF+1+PL
rebordávamos-lhe	rebordar+V.ele.DAT.3.SG+IMPF+1+PL
rebordávamos-lhes	rebordar+V.ele.DAT.3.PL+IMPF+1+PL
rebordávamos-me	rebordar+V.eu.AD.1.SG+IMPF+1+PL
rebordávamos-te	rebordar+V.tu.AD.2.SG+IMPF+1+PL
rebordávamos-vos	rebordar+V.vós.AD.2.PL+IMPF+1+PL
rebordavam-se	rebordar+V.ele.REFL+IMPF+3+PL
rebordavam-te	rebordar+V.tu.AD.2.SG+IMPF+3+PL
rebordavam-vos	rebordar+V.vós.AD.2.PL+IMPF+3+PL
rebordava-nos	rebordar+nós.AD.1.PL+IMPF+1+SG
rebordava-nos	rebordar+nós.AD.1.PL+IMPF+2+SG
rebordava-nos	rebordar+nós.AD.1.PL+IMPF+3+SG
rebordava-o	rebordar+V.ele.ACC.3.M.SG+IMPF+1+SG
rebordava-o	rebordar+V.ele.ACC.3.M.SG+IMPF+3+SG
rebordava-os	rebordar+V.ele.ACC.3.M.PL+IMPF+1+SG
rebordava-os	rebordar+V.ele.ACC.3.M.PL+IMPF+3+SG
rebordava-se	rebordar+V.ele.REFL+IMPF+1+SG
rebordava-se	rebordar+V.ele.REFL+IMPF+3+SG
rebordavas-lhe	rebordar+V.ele.DAT.3.SG+IMPF+2+SG
rebordavas-lhes	rebordar+V.ele.DAT.3.PL+IMPF+2+SG
rebordavas-me	rebordar+V.eu.AD.1.SG+IMPF+2+SG
rebordavas-te	rebordar+V.tu.AD.2.SG+IMPF+2+SG
rebordavas-vos	rebordar+V.vós.AD.2.PL+IMPF+2+SG
rebordava-te	rebordar+V.tu.AD.2.SG+IMPF+1+SG
rebordava-te	rebordar+V.tu.AD.2.SG+IMPF+3+SG
rebordava-vos	rebordar+V.vós.AD.2.PL+IMPF+1+SG
rebordava-vos	rebordar+V.vós.AD.2.PL+IMPF+3+SG
rebordávei-la	rebordar+V.ele.ACC.3.F.SG+IMPF+2+PL
rebordávei-las	rebordar+V.ele.ACC.3.F.PL+IMPF+2+PL
rebordávei-lo	rebordar+V.ele.ACC.3.M.SG+IMPF+2+PL
rebordávei-los	rebordar+V.ele.ACC.3.M.PL+IMPF+2+PL
rebordávei-nos	rebordar+nós.AD.1.PL+IMPF+2+PL
rebordáveis-lhe	rebordar+V.ele.DAT.3.SG+IMPF+2+PL
rebordáveis-lhes	rebordar+V.ele.DAT.3.PL+IMPF+2+PL
rebordáveis-me	rebordar+V.eu.AD.1.SG+IMPF+2+PL
rebordáveis-te	rebordar+V.tu.AD.2.SG+IMPF+2+PL
rebordáveis-vos	rebordar+V.vós.AD.2.PL+IMPF+2+PL
reborda-vos	rebordar+V.vós.AD.2.PL+PRS+3+SG
reborde-a	rebordar+V.ele.ACC.3.F.SG+IMP+3+SG
reborde-as	rebordar+V.ele.ACC.3.F.PL+IMP+3+SG
rebordei-a	rebordar+V.ele.ACC.3.F.SG+PRF+1+SG
rebordei-as	rebordar+V.ele.ACC.3.F.PL+PRF+1+SG
rebordei-lhe	rebordar+V.ele.DAT.3.SG+PRF+1+SG
rebordei-lhes	rebordar+V.ele.DAT.3.PL+PRF+1+SG
rebordei-me	rebordar+V.eu.AD.1.SG+PRF+1+SG
rebordei-nos	rebordar+nós.AD.1.PL+PRF+1+SG
rebordei-o	rebordar+V.ele.ACC.3.M.SG+PRF+1+SG
rebordei-os	rebordar+V.ele.ACC.3.M.PL+PRF+1+SG
rebordei-te	rebordar+V.tu.AD.2.SG+PRF+1+SG
rebordei-vos	rebordar+V.vós.AD.2.PL+PRF+1+SG
reborde-lhe	rebordar+V.ele.DAT.3.SG+IMP+3+SG
reborde-lhes	rebordar+V.ele.DAT.3.PL+IMP+3+SG
reborde-me	rebordar+V.eu.AD.1.SG+IMP+3+SG
rebordem-lhe	rebordar+V.ele.DAT.3.SG+IMP+3+PL
rebordem-lhes	rebordar+V.ele.DAT.3.PL+IMP+3+PL
rebordem-me	rebordar+V.eu.AD.1.SG+IMP+3+PL
rebordem-na	rebordar+V.ele.ACC.3.F.SG+IMP+3+PL
rebordem-nas	rebordar+V.ele.ACC.3.F.PL+IMP+3+PL
rebordem-no	rebordar+V.ele.ACC.3.M.SG+IMP+3+PL
rebordem-nos	rebordar+V.ele.ACC.3.M.PL+IMP+3+PL
rebordem-nos	rebordar+V.nós.AD.1.PL+IMP+3+PL
rebordemo-la	rebordar+V.ele.ACC.3.F.SG+IMP+1+PL
rebordemo-las	rebordar+V.ele.ACC.3.F.PL+IMP+1+PL
rebordemo-lo	rebordar+V.ele.ACC.3.M.SG+IMP+1+PL
rebordemo-los	rebordar+V.ele.ACC.3.M.PL+IMP+1+PL
rebordemo-nos	rebordar+nós.AD.1.PL+IMP+1+PL
rebordemos-lhe	rebordar+V.ele.DAT.3.SG+IMP+1+PL
rebordemos-lhes	rebordar+V.ele.DAT.3.PL+IMP+1+PL
rebordemos-me	rebordar+V.eu.AD.1.SG+IMP+1+PL
rebordemos-te	rebordar+V.tu.AD.2.SG+IMP+1+PL
rebordemos-vos	rebordar+V.vós.AD.2.PL+IMP+1+PL
rebordem-se	rebordar+V.ele.REFL+IMP+3+PL
rebordem-te	rebordar+V.tu.AD.2.SG+IMP+3+PL
rebordem-vos	rebordar+V.vós.AD.2.PL+IMP+3+PL
reborde-nos	rebordar+nós.AD.1.PL+IMP+3+SG
reborde-o	rebordar+V.ele.ACC.3.M.SG+IMP+3+SG
reborde-os	rebordar+V.ele.ACC.3.M.PL+IMP+3+SG
reborde-se	rebordar+V.ele.REFL+IMP+3+SG
reborde-te	rebordar+V.tu.AD.2.SG+IMP+3+SG
reborde-vos	rebordar+V.vós.AD.2.PL+IMP+3+SG
rebordo-a	rebordar+V.ele.ACC.3.F.SG+PRS+1+SG
rebordo-as	rebordar+V.ele.ACC.3.F.PL+PRS+1+SG
rebordo-lhe	rebordar+V.ele.DAT.3.SG+PRS+1+SG
rebordo-lhes	rebordar+V.ele.DAT.3.PL+PRS+1+SG
rebordo-me	rebordar+V.eu.AD.1.SG+PRS+1+SG
rebordo-nos	rebordar+nós.AD.1.PL+PRS+1+SG
rebordo-o	rebordar+V.ele.ACC.3.M.SG+PRS+1+SG
rebordo-os	rebordar+V.ele.ACC.3.M.PL+PRS+1+SG
rebordo-te	rebordar+V.tu.AD.2.SG+PRS+1+SG
rebordou-a	rebordar+V.ele.ACC.3.F.SG+PRF+3+SG
rebordou-as	rebordar+V.ele.ACC.3.F.PL+PRF+3+SG
rebordou-lhe	rebordar+V.ele.DAT.3.SG+PRF+3+SG
rebordou-lhes	rebordar+V.ele.DAT.3.PL+PRF+3+SG
rebordou-me	rebordar+V.eu.AD.1.SG+PRF+3+SG
rebordou-nos	rebordar+nós.AD.1.PL+PRF+3+SG
rebordou-o	rebordar+V.ele.ACC.3.M.SG+PRF+3+SG
rebordou-os	rebordar+V.ele.ACC.3.M.PL+PRF+3+SG
rebordou-se	rebordar+V.ele.REFL+PRF+3+SG
rebordou-te	rebordar+V.tu.AD.2.SG+PRF+3+SG
rebordou-vos	rebordar+V.vós.AD.2.PL+PRF+3+SG
rebordo-vos	rebordar+V.vós.AD.2.PL+PRS+1+SG
rebota-a	rebotar+V.ele.ACC.3.F.SG+PRS+3+SG
rebota-as	rebotar+V.ele.ACC.3.F.PL+PRS+3+SG
rebotai-la	rebotar+V.ele.ACC.3.F.SG+PRS+2+PL
rebotai-las	rebotar+V.ele.ACC.3.F.PL+PRS+2+PL
rebotai-lo	rebotar+V.ele.ACC.3.M.SG+PRS+2+PL
rebotai-los	rebotar+V.ele.ACC.3.M.PL+PRS+2+PL
rebotai-nos	rebotar+nós.AD.1.PL+PRS+2+PL
rebotais-lhe	rebotar+V.ele.DAT.3.SG+PRS+2+PL
rebotais-lhes	rebotar+V.ele.DAT.3.PL+PRS+2+PL
rebotais-me	rebotar+V.eu.AD.1.SG+PRS+2+PL
rebotais-te	rebotar+V.tu.AD.2.SG+PRS+2+PL
rebotais-vos	rebotar+V.vós.AD.2.PL+PRS+2+PL
rebotá-la-ão	rebotar+V.ele.ACC.3.F.SG+FUT+3+PL
rebotá-la-á	rebotar+V.ele.ACC.3.F.SG+FUT+3+SG
rebotá-la-ás	rebotar+V.ele.ACC.3.F.SG+FUT+2+SG
rebotá-la-ei	rebotar+V.ele.ACC.3.F.SG+FUT+1+SG
rebotá-la-eis	rebotar+V.ele.ACC.3.F.SG+FUT+2+PL
rebotá-la-emos	rebotar+V.ele.ACC.3.F.SG+FUT+1+PL
rebotá-la-íamos	rebotar+V.ele.ACC.3.F.SG+COND+1+PL
rebotá-la-iam	rebotar+V.ele.ACC.3.F.SG+COND+3+PL
rebotá-la-ia	rebotar+V.ele.ACC.3.F.SG+COND+1+SG
rebotá-la-ia	rebotar+V.ele.ACC.3.F.SG+COND+3+SG
rebotá-la-ias	rebotar+V.ele.ACC.3.F.SG+COND+2+SG
rebotá-la-íeis	rebotar+V.ele.ACC.3.F.SG+COND+2+PL
rebotá-la	rebotar+V.ele.ACC.3.F.SG+INF+1+SG
rebotá-la	rebotar+V.ele.ACC.3.F.SG+INF+3+SG
rebota-la	rebotar+V.ele.ACC.3.F.SG+PRS+2+SG
rebotá-la	rebotar+V.ele.ACC.3.F.SG+SBJF+1+SG
rebotá-la	rebotar+V.ele.ACC.3.F.SG+SBJF+3+SG
rebotá-las-ão	rebotar+V.ele.ACC.3.F.PL+FUT+3+PL
rebotá-las-á	rebotar+V.ele.ACC.3.F.PL+FUT+3+SG
rebotá-las-ás	rebotar+V.ele.ACC.3.F.PL+FUT+2+SG
rebotá-las-ei	rebotar+V.ele.ACC.3.F.PL+FUT+1+SG
rebotá-las-eis	rebotar+V.ele.ACC.3.F.PL+FUT+2+PL
rebotá-las-emos	rebotar+V.ele.ACC.3.F.PL+FUT+1+PL
rebotá-las-íamos	rebotar+V.ele.ACC.3.F.PL+COND+1+PL
rebotá-las-iam	rebotar+V.ele.ACC.3.F.PL+COND+3+PL
rebotá-las-ia	rebotar+V.ele.ACC.3.F.PL+COND+1+SG
rebotá-las-ia	rebotar+V.ele.ACC.3.F.PL+COND+3+SG
rebotá-las-ias	rebotar+V.ele.ACC.3.F.PL+COND+2+SG
rebotá-las-íeis	rebotar+V.ele.ACC.3.F.PL+COND+2+PL
rebotá-las	rebotar+V.ele.ACC.3.F.PL+INF+1+SG
rebotá-las	rebotar+V.ele.ACC.3.F.PL+INF+3+SG
rebota-las	rebotar+V.ele.ACC.3.F.PL+PRS+2+SG
rebotá-las	rebotar+V.ele.ACC.3.F.PL+SBJF+1+SG
rebotá-las	rebotar+V.ele.ACC.3.F.PL+SBJF+3+SG
rebota-lhe	rebotar+V.ele.DAT.3.SG+PRS+3+SG
rebota-lhes	rebotar+V.ele.DAT.3.PL+PRS+3+SG
rebotá-lo-ão	rebotar+V.ele.ACC.3.M.SG+FUT+3+PL
rebotá-lo-á	rebotar+V.ele.ACC.3.M.SG+FUT+3+SG
rebotá-lo-ás	rebotar+V.ele.ACC.3.M.SG+FUT+2+SG
rebotá-lo-ei	rebotar+V.ele.ACC.3.M.SG+FUT+1+SG
rebotá-lo-eis	rebotar+V.ele.ACC.3.M.SG+FUT+2+PL
rebotá-lo-emos	rebotar+V.ele.ACC.3.M.SG+FUT+1+PL
rebotá-lo-íamos	rebotar+V.ele.ACC.3.M.SG+COND+1+PL
rebotá-lo-iam	rebotar+V.ele.ACC.3.M.SG+COND+3+PL
rebotá-lo-ia	rebotar+V.ele.ACC.3.M.SG+COND+1+SG
rebotá-lo-ia	rebotar+V.ele.ACC.3.M.SG+COND+3+SG
rebotá-lo-ias	rebotar+V.ele.ACC.3.M.SG+COND+2+SG
rebotá-lo-íeis	rebotar+V.ele.ACC.3.M.SG+COND+2+PL
rebotá-lo	rebotar+V.ele.ACC.3.M.SG+INF+1+SG
rebotá-lo	rebotar+V.ele.ACC.3.M.SG+INF+3+SG
rebota-lo	rebotar+V.ele.ACC.3.M.SG+PRS+2+SG
rebotá-lo	rebotar+V.ele.ACC.3.M.SG+SBJF+1+SG
rebotá-lo	rebotar+V.ele.ACC.3.M.SG+SBJF+3+SG
rebotá-los-ão	rebotar+V.ele.ACC.3.M.PL+FUT+3+PL
rebotá-los-á	rebotar+V.ele.ACC.3.M.PL+FUT+3+SG
rebotá-los-ás	rebotar+V.ele.ACC.3.M.PL+FUT+2+SG
rebotá-los-ei	rebotar+V.ele.ACC.3.M.PL+FUT+1+SG
rebotá-los-eis	rebotar+V.ele.ACC.3.M.PL+FUT+2+PL
rebotá-los-emos	rebotar+V.ele.ACC.3.M.PL+FUT+1+PL
rebotá-los-íamos	rebotar+V.ele.ACC.3.M.PL+COND+1+PL
rebotá-los-iam	rebotar+V.ele.ACC.3.M.PL+COND+3+PL
rebotá-los-ia	rebotar+V.ele.ACC.3.M.PL+COND+1+SG
rebotá-los-ia	rebotar+V.ele.ACC.3.M.PL+COND+3+SG
rebotá-los-ias	rebotar+V.ele.ACC.3.M.PL+COND+2+SG
rebotá-los-íeis	rebotar+V.ele.ACC.3.M.PL+COND+2+PL
rebotá-los	rebotar+V.ele.ACC.3.M.PL+INF+1+SG
rebotá-los	rebotar+V.ele.ACC.3.M.PL+INF+3+SG
rebota-los	rebotar+V.ele.ACC.3.M.PL+PRS+2+SG
rebotá-los	rebotar+V.ele.ACC.3.M.PL+SBJF+1+SG
rebotá-los	rebotar+V.ele.ACC.3.M.PL+SBJF+3+SG
rebota-me	rebotar+V.eu.AD.1.SG+PRS+3+SG
rebotam-lhe	rebotar+V.ele.DAT.3.SG+PRS+3+PL
rebotam-lhes	rebotar+V.ele.DAT.3.PL+PRS+3+PL
rebotam-me	rebotar+V.eu.AD.1.SG+PRS+3+PL
rebotam-na	rebotar+V.ele.ACC.3.F.SG+PRS+3+PL
rebotam-nas	rebotar+V.ele.ACC.3.F.PL+PRS+3+PL
rebotam-no	rebotar+V.ele.ACC.3.M.SG+PRS+3+PL
rebotam-nos	rebotar+V.ele.ACC.3.M.PL+PRS+3+PL
rebotam-nos	rebotar+V.nós.AD.1.PL+PRS+3+PL
rebotamo-la	rebotar+V.ele.ACC.3.F.SG+PRF+1+PL
rebotamo-la	rebotar+V.ele.ACC.3.F.SG+PRS+1+PL
rebotamo-las	rebotar+V.ele.ACC.3.F.PL+PRF+1+PL
rebotamo-las	rebotar+V.ele.ACC.3.F.PL+PRS+1+PL
rebotamo-lo	rebotar+V.ele.ACC.3.M.SG+PRF+1+PL
rebotamo-lo	rebotar+V.ele.ACC.3.M.SG+PRS+1+PL
rebotamo-los	rebotar+V.ele.ACC.3.M.PL+PRF+1+PL
rebotamo-los	rebotar+V.ele.ACC.3.M.PL+PRS+1+PL
rebotamo-nos	rebotar+nós.AD.1.PL+PRF+1+PL
rebotamo-nos	rebotar+nós.AD.1.PL+PRS+1+PL
rebotamos-lhe	rebotar+V.ele.DAT.3.SG+PRF+1+PL
rebotamos-lhe	rebotar+V.ele.DAT.3.SG+PRS+1+PL
rebotamos-lhes	rebotar+V.ele.DAT.3.PL+PRF+1+PL
rebotamos-lhes	rebotar+V.ele.DAT.3.PL+PRS+1+PL
rebotamos-me	rebotar+V.eu.AD.1.SG+PRF+1+PL
rebotamos-me	rebotar+V.eu.AD.1.SG+PRS+1+PL
rebotamos-te	rebotar+V.tu.AD.2.SG+PRF+1+PL
rebotamos-te	rebotar+V.tu.AD.2.SG+PRS+1+PL
rebotamos-vos	rebotar+V.vós.AD.2.PL+PRF+1+PL
rebotamos-vos	rebotar+V.vós.AD.2.PL+PRS+1+PL
rebotam-se	rebotar+V.ele.REFL+PRS+3+PL
rebotam-te	rebotar+V.tu.AD.2.SG+PRS+3+PL
rebotam-vos	rebotar+V.vós.AD.2.PL+PRS+3+PL
rebotando-a	rebotar+V.ele.ACC.3.F.SG+GRD
rebotando-as	rebotar+V.ele.ACC.3.F.PL+GRD
rebotando-lhe	rebotar+V.ele.DAT.3.SG+GRD
rebotando-lhes	rebotar+V.ele.DAT.3.PL+GRD
rebotando-me	rebotar+V.eu.AD.1.SG+GRD
rebotando-nos	rebotar+nós.AD.1.PL+GRD
rebotando-o	rebotar+V.ele.ACC.3.M.SG+GRD
rebotando-os	rebotar+V.ele.ACC.3.M.PL+GRD
rebotando-se	rebotar+V.ele.REFL+GRD
rebotando-te	rebotar+V.tu.AD.2.SG+GRD
rebotando-vos	rebotar+V.vós.AD.2.PL+GRD
rebota-nos	rebotar+nós.AD.1.PL+PRS+2+SG
rebota-nos	rebotar+nós.AD.1.PL+PRS+3+SG
rebota-o	rebotar+V.ele.ACC.3.M.SG+PRS+3+SG
rebota-os	rebotar+V.ele.ACC.3.M.PL+PRS+3+SG
rebotara-a	rebotar+V.ele.ACC.3.F.SG+PQP+1+SG
rebotara-a	rebotar+V.ele.ACC.3.F.SG+PQP+3+SG
rebotara-as	rebotar+V.ele.ACC.3.F.PL+PQP+1+SG
rebotara-as	rebotar+V.ele.ACC.3.F.PL+PQP+3+SG
rebotara-la	rebotar+V.ele.ACC.3.F.SG+PQP+2+SG
rebotara-las	rebotar+V.ele.ACC.3.F.PL+PQP+2+SG
rebotara-lhe	rebotar+V.ele.DAT.3.SG+PQP+1+SG
rebotara-lhe	rebotar+V.ele.DAT.3.SG+PQP+3+SG
rebotara-lhes	rebotar+V.ele.DAT.3.PL+PQP+1+SG
rebotara-lhes	rebotar+V.ele.DAT.3.PL+PQP+3+SG
rebotara-lo	rebotar+V.ele.ACC.3.M.SG+PQP+2+SG
rebotara-los	rebotar+V.ele.ACC.3.M.PL+PQP+2+SG
rebotara-me	rebotar+V.eu.AD.1.SG+PQP+1+SG
rebotara-me	rebotar+V.eu.AD.1.SG+PQP+3+SG
rebotaram-lhe	rebotar+V.ele.DAT.3.SG+PQP+3+PL
rebotaram-lhe	rebotar+V.ele.DAT.3.SG+PRF+3+PL
rebotaram-lhes	rebotar+V.ele.DAT.3.PL+PQP+3+PL
rebotaram-lhes	rebotar+V.ele.DAT.3.PL+PRF+3+PL
rebotaram-me	rebotar+V.eu.AD.1.SG+PQP+3+PL
rebotaram-me	rebotar+V.eu.AD.1.SG+PRF+3+PL
rebotaram-na	rebotar+V.ele.ACC.3.F.SG+PQP+3+PL
rebotaram-na	rebotar+V.ele.ACC.3.F.SG+PRF+3+PL
rebotaram-nas	rebotar+V.ele.ACC.3.F.PL+PQP+3+PL
rebotaram-nas	rebotar+V.ele.ACC.3.F.PL+PRF+3+PL
rebotaram-no	rebotar+V.ele.ACC.3.M.SG+PQP+3+PL
rebotaram-no	rebotar+V.ele.ACC.3.M.SG+PRF+3+PL
rebotaram-nos	rebotar+V.ele.ACC.3.M.PL+PQP+3+PL
rebotaram-nos	rebotar+V.ele.ACC.3.M.PL+PRF+3+PL
rebotaram-nos	rebotar+V.nós.AD.1.PL+PQP+3+PL
rebotaram-nos	rebotar+V.nós.AD.1.PL+PRF+3+PL
rebotáramo-la	rebotar+V.ele.ACC.3.F.SG+PQP+1+PL
rebotáramo-las	rebotar+V.ele.ACC.3.F.PL+PQP+1+PL
rebotáramo-lo	rebotar+V.ele.ACC.3.M.SG+PQP+1+PL
rebotáramo-los	rebotar+V.ele.ACC.3.M.PL+PQP+1+PL
rebotáramo-nos	rebotar+nós.AD.1.PL+PQP+1+PL
rebotáramos-lhe	rebotar+V.ele.DAT.3.SG+PQP+1+PL
rebotáramos-lhes	rebotar+V.ele.DAT.3.PL+PQP+1+PL
rebotáramos-me	rebotar+V.eu.AD.1.SG+PQP+1+PL
rebotáramos-te	rebotar+V.tu.AD.2.SG+PQP+1+PL
rebotáramos-vos	rebotar+V.vós.AD.2.PL+PQP+1+PL
rebotaram-se	rebotar+V.ele.REFL+PQP+3+PL
rebotaram-se	rebotar+V.ele.REFL+PRF+3+PL
rebotaram-te	rebotar+V.tu.AD.2.SG+PQP+3+PL
rebotaram-te	rebotar+V.tu.AD.2.SG+PRF+3+PL
rebotaram-vos	rebotar+V.vós.AD.2.PL+PQP+3+PL
rebotaram-vos	rebotar+V.vós.AD.2.PL+PRF+3+PL
rebotara-nos	rebotar+nós.AD.1.PL+PQP+1+SG
rebotara-nos	rebotar+nós.AD.1.PL+PQP+2+SG
rebotara-nos	rebotar+nós.AD.1.PL+PQP+3+SG
rebotara-o	rebotar+V.ele.ACC.3.M.SG+PQP+1+SG
rebotara-o	rebotar+V.ele.ACC.3.M.SG+PQP+3+SG
rebotara-os	rebotar+V.ele.ACC.3.M.PL+PQP+1+SG
rebotara-os	rebotar+V.ele.ACC.3.M.PL+PQP+3+SG
rebotara-se	rebotar+V.ele.REFL+PQP+1+SG
rebotara-se	rebotar+V.ele.REFL+PQP+3+SG
rebotaras-lhe	rebotar+V.ele.DAT.3.SG+PQP+2+SG
rebotaras-lhes	rebotar+V.ele.DAT.3.PL+PQP+2+SG
rebotaras-me	rebotar+V.eu.AD.1.SG+PQP+2+SG
rebotaras-te	rebotar+V.tu.AD.2.SG+PQP+2+SG
rebotaras-vos	rebotar+V.vós.AD.2.PL+PQP+2+SG
rebotara-te	rebotar+V.tu.AD.2.SG+PQP+1+SG
rebotara-te	rebotar+V.tu.AD.2.SG+PQP+3+SG
rebotara-vos	rebotar+V.vós.AD.2.PL+PQP+1+SG
rebotara-vos	rebotar+V.vós.AD.2.PL+PQP+3+SG
rebotarde-la	rebotar+V.ele.ACC.3.F.SG+INF+2+PL
rebotarde-la	rebotar+V.ele.ACC.3.F.SG+SBJF+2+PL
rebotarde-las	rebotar+V.ele.ACC.3.F.PL+INF+2+PL
rebotarde-las	rebotar+V.ele.ACC.3.F.PL+SBJF+2+PL
rebotarde-lo	rebotar+V.ele.ACC.3.M.SG+INF+2+PL
