reconvalescer-me	reconvalescer+V.eu.AD.1.SG+INF+1+SG
reconvalescer-me	reconvalescer+V.eu.AD.1.SG+INF+3+SG
reconvalescer-me	reconvalescer+V.eu.AD.1.SG+SBJF+1+SG
reconvalescer-me	reconvalescer+V.eu.AD.1.SG+SBJF+3+SG
reconvalescermo-la	reconvalescer+V.ele.ACC.3.F.SG+INF+1+PL
reconvalescermo-la	reconvalescer+V.ele.ACC.3.F.SG+SBJF+1+PL
reconvalescermo-las	reconvalescer+V.ele.ACC.3.F.PL+INF+1+PL
reconvalescermo-las	reconvalescer+V.ele.ACC.3.F.PL+SBJF+1+PL
reconvalescermo-lo	reconvalescer+V.ele.ACC.3.M.SG+INF+1+PL
reconvalescermo-lo	reconvalescer+V.ele.ACC.3.M.SG+SBJF+1+PL
reconvalescermo-los	reconvalescer+V.ele.ACC.3.M.PL+INF+1+PL
reconvalescermo-los	reconvalescer+V.ele.ACC.3.M.PL+SBJF+1+PL
reconvalescermo-nos	reconvalescer+nós.AD.1.PL+INF+1+PL
reconvalescermo-nos	reconvalescer+nós.AD.1.PL+SBJF+1+PL
reconvalescermos-lhe	reconvalescer+V.ele.DAT.3.SG+INF+1+PL
reconvalescermos-lhe	reconvalescer+V.ele.DAT.3.SG+SBJF+1+PL
reconvalescermos-lhes	reconvalescer+V.ele.DAT.3.PL+INF+1+PL
reconvalescermos-lhes	reconvalescer+V.ele.DAT.3.PL+SBJF+1+PL
reconvalescermos-me	reconvalescer+V.eu.AD.1.SG+INF+1+PL
reconvalescermos-me	reconvalescer+V.eu.AD.1.SG+SBJF+1+PL
reconvalescermos-te	reconvalescer+V.tu.AD.2.SG+INF+1+PL
reconvalescermos-te	reconvalescer+V.tu.AD.2.SG+SBJF+1+PL
reconvalescermos-vos	reconvalescer+V.vós.AD.2.PL+INF+1+PL
reconvalescermos-vos	reconvalescer+V.vós.AD.2.PL+SBJF+1+PL
reconvalescer-nos-ão	reconvalescer+nós.AD.1.PL+FUT+3+PL
reconvalescer-nos-á	reconvalescer+nós.AD.1.PL+FUT+3+SG
reconvalescer-nos-ás	reconvalescer+nós.AD.1.PL+FUT+2+SG
reconvalescer-nos-ei	reconvalescer+nós.AD.1.PL+FUT+1+SG
reconvalescer-nos-eis	reconvalescer+nós.AD.1.PL+FUT+2+PL
reconvalescer-nos-emos	reconvalescer+nós.AD.1.PL+FUT+1+PL
reconvalescer-nos-íamos	reconvalescer+nós.AD.1.PL+COND+1+PL
reconvalescer-nos-iam	reconvalescer+nós.AD.1.PL+COND+3+PL
reconvalescer-nos-ia	reconvalescer+nós.AD.1.PL+COND+1+SG
reconvalescer-nos-ia	reconvalescer+nós.AD.1.PL+COND+3+SG
reconvalescer-nos-ias	reconvalescer+nós.AD.1.PL+COND+2+SG
reconvalescer-nos-íeis	reconvalescer+nós.AD.1.PL+COND+2+PL
reconvalescer-nos	reconvalescer+nós.AD.1.PL+INF
reconvalescer-nos	reconvalescer+nós.AD.1.PL+INF+1+SG
reconvalescer-nos	reconvalescer+nós.AD.1.PL+INF+3+SG
reconvalescer-nos	reconvalescer+nós.AD.1.PL+SBJF+1+SG
reconvalescer-nos	reconvalescer+nós.AD.1.PL+SBJF+3+SG
reconvalescer-se-ão	reconvalescer+V.ele.REFL+FUT+3+PL
reconvalescer-se-á	reconvalescer+V.ele.REFL+FUT+3+SG
reconvalescer-se-iam	reconvalescer+V.ele.REFL+COND+3+PL
reconvalescer-se-ia	reconvalescer+V.ele.REFL+COND+3+SG
reconvalescer-se	reconvalescer+V.ele.REFL+INF
reconvalescer-se	reconvalescer+V.ele.REFL+INF+3+SG
reconvalescer-se	reconvalescer+V.ele.REFL+SBJF+3+SG
reconvalescer-te-ão	reconvalescer+V.tu.AD.2.SG+FUT+3+PL
reconvalescer-te-á	reconvalescer+V.tu.AD.2.SG+FUT+3+SG
reconvalescer-te-ás	reconvalescer+V.tu.AD.2.SG+FUT+2+SG
reconvalescer-te-ei	reconvalescer+V.tu.AD.2.SG+FUT+1+SG
reconvalescer-te-eis	reconvalescer+V.tu.AD.2.SG+FUT+2+PL
reconvalescer-te-emos	reconvalescer+V.tu.AD.2.SG+FUT+1+PL
reconvalescer-te-íamos	reconvalescer+V.tu.AD.2.SG+COND+1+PL
reconvalescer-te-iam	reconvalescer+V.tu.AD.2.SG+COND+3+PL
reconvalescer-te-ia	reconvalescer+V.tu.AD.2.SG+COND+1+SG
reconvalescer-te-ia	reconvalescer+V.tu.AD.2.SG+COND+3+SG
reconvalescer-te-ias	reconvalescer+V.tu.AD.2.SG+COND+2+SG
reconvalescer-te-íeis	reconvalescer+V.tu.AD.2.SG+COND+2+PL
reconvalescer-te	reconvalescer+V.tu.AD.2.SG+INF
reconvalescer-te	reconvalescer+V.tu.AD.2.SG+INF+1+SG
reconvalescer-te	reconvalescer+V.tu.AD.2.SG+INF+3+SG
reconvalescer-te	reconvalescer+V.tu.AD.2.SG+SBJF+1+SG
reconvalescer-te	reconvalescer+V.tu.AD.2.SG+SBJF+3+SG
reconvalescer-vos-ão	reconvalescer+V.vós.AD.2.PL+FUT+3+PL
reconvalescer-vos-á	reconvalescer+V.vós.AD.2.PL+FUT+3+SG
reconvalescer-vos-ás	reconvalescer+V.vós.AD.2.PL+FUT+2+SG
reconvalescer-vos-ei	reconvalescer+V.vós.AD.2.PL+FUT+1+SG
reconvalescer-vos-eis	reconvalescer+V.vós.AD.2.PL+FUT+2+PL
reconvalescer-vos-emos	reconvalescer+V.vós.AD.2.PL+FUT+1+PL
reconvalescer-vos-íamos	reconvalescer+V.vós.AD.2.PL+COND+1+PL
reconvalescer-vos-iam	reconvalescer+V.vós.AD.2.PL+COND+3+PL
reconvalescer-vos-ia	reconvalescer+V.vós.AD.2.PL+COND+1+SG
reconvalescer-vos-ia	reconvalescer+V.vós.AD.2.PL+COND+3+SG
reconvalescer-vos-ias	reconvalescer+V.vós.AD.2.PL+COND+2+SG
reconvalescer-vos-íeis	reconvalescer+V.vós.AD.2.PL+COND+2+PL
reconvalescer-vos	reconvalescer+V.vós.AD.2.PL+INF
reconvalescer-vos	reconvalescer+V.vós.AD.2.PL+INF+1+SG
reconvalescer-vos	reconvalescer+V.vós.AD.2.PL+INF+3+SG
reconvalescer-vos	reconvalescer+V.vós.AD.2.PL+SBJF+1+SG
reconvalescer-vos	reconvalescer+V.vós.AD.2.PL+SBJF+3+SG
reconvalesce-se	reconvalescer+V.ele.REFL+PRS+3+SG
reconvalesces-lhe	reconvalescer+V.ele.DAT.3.SG+PRS+2+SG
reconvalesces-lhes	reconvalescer+V.ele.DAT.3.PL+PRS+2+SG
reconvalesces-me	reconvalescer+V.eu.AD.1.SG+PRS+2+SG
reconvalesceste-a	reconvalescer+V.ele.ACC.3.F.SG+PRF+2+SG
reconvalesceste-as	reconvalescer+V.ele.ACC.3.F.PL+PRF+2+SG
reconvalesceste-la	reconvalescer+V.ele.ACC.3.F.SG+PRF+2+PL
reconvalesceste-las	reconvalescer+V.ele.ACC.3.F.PL+PRF+2+PL
reconvalesceste-lhe	reconvalescer+V.ele.DAT.3.SG+PRF+2+SG
reconvalesceste-lhes	reconvalescer+V.ele.DAT.3.PL+PRF+2+SG
reconvalesceste-lo	reconvalescer+V.ele.ACC.3.M.SG+PRF+2+PL
reconvalesceste-los	reconvalescer+V.ele.ACC.3.M.PL+PRF+2+PL
reconvalesceste-me	reconvalescer+V.eu.AD.1.SG+PRF+2+SG
reconvalesceste-nos	reconvalescer+nós.AD.1.PL+PRF+2+PL
reconvalesceste-nos	reconvalescer+nós.AD.1.PL+PRF+2+SG
reconvalesceste-o	reconvalescer+V.ele.ACC.3.M.SG+PRF+2+SG
reconvalesceste-os	reconvalescer+V.ele.ACC.3.M.PL+PRF+2+SG
reconvalesces-te	reconvalescer+V.tu.AD.2.SG+PRS+2+SG
reconvalescestes-lhe	reconvalescer+V.ele.DAT.3.SG+PRF+2+PL
reconvalescestes-lhes	reconvalescer+V.ele.DAT.3.PL+PRF+2+PL
reconvalescestes-me	reconvalescer+V.eu.AD.1.SG+PRF+2+PL
reconvalescestes-te	reconvalescer+V.tu.AD.2.SG+PRF+2+PL
reconvalescestes-vos	reconvalescer+V.vós.AD.2.PL+PRF+2+PL
reconvalesceste-te	reconvalescer+V.tu.AD.2.SG+PRF+2+SG
reconvalesceste-vos	reconvalescer+V.vós.AD.2.PL+PRF+2+SG
reconvalesces-vos	reconvalescer+V.vós.AD.2.PL+PRS+2+SG
reconvalesceu-a	reconvalescer+V.ele.ACC.3.F.SG+PRF+3+SG
reconvalesceu-as	reconvalescer+V.ele.ACC.3.F.PL+PRF+3+SG
reconvalesceu-lhe	reconvalescer+V.ele.DAT.3.SG+PRF+3+SG
reconvalesceu-lhes	reconvalescer+V.ele.DAT.3.PL+PRF+3+SG
reconvalesceu-me	reconvalescer+V.eu.AD.1.SG+PRF+3+SG
reconvalesceu-nos	reconvalescer+nós.AD.1.PL+PRF+3+SG
reconvalesceu-o	reconvalescer+V.ele.ACC.3.M.SG+PRF+3+SG
reconvalesceu-os	reconvalescer+V.ele.ACC.3.M.PL+PRF+3+SG
reconvalesceu-se	reconvalescer+V.ele.REFL+PRF+3+SG
reconvalesceu-te	reconvalescer+V.tu.AD.2.SG+PRF+3+SG
reconvalesceu-vos	reconvalescer+V.vós.AD.2.PL+PRF+3+SG
reconvalescia-a	reconvalescer+V.ele.ACC.3.F.SG+IMPF+1+SG
reconvalescia-a	reconvalescer+V.ele.ACC.3.F.SG+IMPF+3+SG
reconvalescia-as	reconvalescer+V.ele.ACC.3.F.PL+IMPF+1+SG
reconvalescia-as	reconvalescer+V.ele.ACC.3.F.PL+IMPF+3+SG
reconvalescia-la	reconvalescer+V.ele.ACC.3.F.SG+IMPF+2+SG
reconvalescia-las	reconvalescer+V.ele.ACC.3.F.PL+IMPF+2+SG
reconvalescia-lhe	reconvalescer+V.ele.DAT.3.SG+IMPF+1+SG
reconvalescia-lhe	reconvalescer+V.ele.DAT.3.SG+IMPF+3+SG
reconvalescia-lhes	reconvalescer+V.ele.DAT.3.PL+IMPF+1+SG
reconvalescia-lhes	reconvalescer+V.ele.DAT.3.PL+IMPF+3+SG
reconvalescia-lo	reconvalescer+V.ele.ACC.3.M.SG+IMPF+2+SG
reconvalescia-los	reconvalescer+V.ele.ACC.3.M.PL+IMPF+2+SG
reconvalescia-me	reconvalescer+V.eu.AD.1.SG+IMPF+1+SG
reconvalescia-me	reconvalescer+V.eu.AD.1.SG+IMPF+3+SG
reconvalesciam-lhe	reconvalescer+V.ele.DAT.3.SG+IMPF+3+PL
reconvalesciam-lhes	reconvalescer+V.ele.DAT.3.PL+IMPF+3+PL
reconvalesciam-me	reconvalescer+V.eu.AD.1.SG+IMPF+3+PL
reconvalesciam-na	reconvalescer+V.ele.ACC.3.F.SG+IMPF+3+PL
reconvalesciam-nas	reconvalescer+V.ele.ACC.3.F.PL+IMPF+3+PL
reconvalesciam-no	reconvalescer+V.ele.ACC.3.M.SG+IMPF+3+PL
reconvalesciam-nos	reconvalescer+V.ele.ACC.3.M.PL+IMPF+3+PL
reconvalesciam-nos	reconvalescer+V.nós.AD.1.PL+IMPF+3+PL
reconvalescíamo-la	reconvalescer+V.ele.ACC.3.F.SG+IMPF+1+PL
reconvalescíamo-las	reconvalescer+V.ele.ACC.3.F.PL+IMPF+1+PL
reconvalescíamo-lo	reconvalescer+V.ele.ACC.3.M.SG+IMPF+1+PL
reconvalescíamo-los	reconvalescer+V.ele.ACC.3.M.PL+IMPF+1+PL
reconvalescíamo-nos	reconvalescer+nós.AD.1.PL+IMPF+1+PL
reconvalescíamos-lhe	reconvalescer+V.ele.DAT.3.SG+IMPF+1+PL
reconvalescíamos-lhes	reconvalescer+V.ele.DAT.3.PL+IMPF+1+PL
reconvalescíamos-me	reconvalescer+V.eu.AD.1.SG+IMPF+1+PL
reconvalescíamos-te	reconvalescer+V.tu.AD.2.SG+IMPF+1+PL
reconvalescíamos-vos	reconvalescer+V.vós.AD.2.PL+IMPF+1+PL
reconvalesciam-se	reconvalescer+V.ele.REFL+IMPF+3+PL
reconvalesciam-te	reconvalescer+V.tu.AD.2.SG+IMPF+3+PL
reconvalesciam-vos	reconvalescer+V.vós.AD.2.PL+IMPF+3+PL
reconvalescia-nos	reconvalescer+nós.AD.1.PL+IMPF+1+SG
reconvalescia-nos	reconvalescer+nós.AD.1.PL+IMPF+2+SG
reconvalescia-nos	reconvalescer+nós.AD.1.PL+IMPF+3+SG
reconvalescia-o	reconvalescer+V.ele.ACC.3.M.SG+IMPF+1+SG
reconvalescia-o	reconvalescer+V.ele.ACC.3.M.SG+IMPF+3+SG
reconvalescia-os	reconvalescer+V.ele.ACC.3.M.PL+IMPF+1+SG
reconvalescia-os	reconvalescer+V.ele.ACC.3.M.PL+IMPF+3+SG
reconvalesci-a	reconvalescer+V.ele.ACC.3.F.SG+PRF+1+SG
reconvalescia-se	reconvalescer+V.ele.REFL+IMPF+3+SG
reconvalescias-lhe	reconvalescer+V.ele.DAT.3.SG+IMPF+2+SG
reconvalescias-lhes	reconvalescer+V.ele.DAT.3.PL+IMPF+2+SG
reconvalescias-me	reconvalescer+V.eu.AD.1.SG+IMPF+2+SG
reconvalesci-as	reconvalescer+V.ele.ACC.3.F.PL+PRF+1+SG
reconvalescias-te	reconvalescer+V.tu.AD.2.SG+IMPF+2+SG
reconvalescias-vos	reconvalescer+V.vós.AD.2.PL+IMPF+2+SG
reconvalescia-te	reconvalescer+V.tu.AD.2.SG+IMPF+1+SG
reconvalescia-te	reconvalescer+V.tu.AD.2.SG+IMPF+3+SG
reconvalescia-vos	reconvalescer+V.vós.AD.2.PL+IMPF+1+SG
reconvalescia-vos	reconvalescer+V.vós.AD.2.PL+IMPF+3+SG
reconvalescíei-la	reconvalescer+V.ele.ACC.3.F.SG+IMPF+2+PL
reconvalescíei-las	reconvalescer+V.ele.ACC.3.F.PL+IMPF+2+PL
reconvalescíei-lo	reconvalescer+V.ele.ACC.3.M.SG+IMPF+2+PL
reconvalescíei-los	reconvalescer+V.ele.ACC.3.M.PL+IMPF+2+PL
reconvalescíei-nos	reconvalescer+nós.AD.1.PL+IMPF+2+PL
reconvalescíeis-lhe	reconvalescer+V.ele.DAT.3.SG+IMPF+2+PL
reconvalescíeis-lhes	reconvalescer+V.ele.DAT.3.PL+IMPF+2+PL
reconvalescíeis-me	reconvalescer+V.eu.AD.1.SG+IMPF+2+PL
reconvalescíeis-te	reconvalescer+V.tu.AD.2.SG+IMPF+2+PL
reconvalescíeis-vos	reconvalescer+V.vós.AD.2.PL+IMPF+2+PL
reconvalesci-lhe	reconvalescer+V.ele.DAT.3.SG+PRF+1+SG
reconvalesci-lhes	reconvalescer+V.ele.DAT.3.PL+PRF+1+SG
reconvalesci-me	reconvalescer+V.eu.AD.1.SG+PRF+1+SG
reconvalesci-nos	reconvalescer+nós.AD.1.PL+PRF+1+SG
reconvalesci-o	reconvalescer+V.ele.ACC.3.M.SG+PRF+1+SG
reconvalesci-os	reconvalescer+V.ele.ACC.3.M.PL+PRF+1+SG
reconvalesci-te	reconvalescer+V.tu.AD.2.SG+PRF+1+SG
reconvalesci-vos	reconvalescer+V.vós.AD.2.PL+PRF+1+SG
reconvalesço-a	reconvalescer+V.ele.ACC.3.F.SG+PRS+1+SG
reconvalesço-as	reconvalescer+V.ele.ACC.3.F.PL+PRS+1+SG
reconvalesço-lhe	reconvalescer+V.ele.DAT.3.SG+PRS+1+SG
reconvalesço-lhes	reconvalescer+V.ele.DAT.3.PL+PRS+1+SG
reconvalesço-me	reconvalescer+V.eu.AD.1.SG+PRS+1+SG
reconvalesço-nos	reconvalescer+nós.AD.1.PL+PRS+1+SG
reconvalesço-o	reconvalescer+V.ele.ACC.3.M.SG+PRS+1+SG
reconvalesço-os	reconvalescer+V.ele.ACC.3.M.PL+PRS+1+SG
reconvalesço-te	reconvalescer+V.tu.AD.2.SG+PRS+1+SG
reconvalesço-vos	reconvalescer+V.vós.AD.2.PL+PRS+1+SG
reconveio-a	reconvir+V.ele.ACC.3.F.SG+PRF+3+SG
reconveio-as	reconvir+V.ele.ACC.3.F.PL+PRF+3+SG
reconveio-lhe	reconvir+V.ele.DAT.3.SG+PRF+3+SG
reconveio-lhes	reconvir+V.ele.DAT.3.PL+PRF+3+SG
reconveio-me	reconvir+V.eu.AD.1.SG+PRF+3+SG
reconveio-nos	reconvir+nós.AD.1.PL+PRF+3+SG
reconveio-o	reconvir+V.ele.ACC.3.M.SG+PRF+3+SG
reconveio-os	reconvir+V.ele.ACC.3.M.PL+PRF+3+SG
reconveio-se	reconvir+V.ele.REFL+PRF+3+SG
reconveio-te	reconvir+V.tu.AD.2.SG+PRF+3+SG
reconveio-vos	reconvir+V.vós.AD.2.PL+PRF+3+SG
reconvenha-a	reconvir+V.ele.ACC.3.F.SG+IMP+3+SG
reconvenha-as	reconvir+V.ele.ACC.3.F.PL+IMP+3+SG
reconvenha-lhe	reconvir+V.ele.DAT.3.SG+IMP+3+SG
reconvenha-lhes	reconvir+V.ele.DAT.3.PL+IMP+3+SG
reconvenha-me	reconvir+V.eu.AD.1.SG+IMP+3+SG
reconvenham-lhe	reconvir+V.ele.DAT.3.SG+IMP+3+PL
reconvenham-lhes	reconvir+V.ele.DAT.3.PL+IMP+3+PL
reconvenham-me	reconvir+V.eu.AD.1.SG+IMP+3+PL
reconvenham-na	reconvir+V.ele.ACC.3.F.SG+IMP+3+PL
reconvenham-nas	reconvir+V.ele.ACC.3.F.PL+IMP+3+PL
reconvenham-no	reconvir+V.ele.ACC.3.M.SG+IMP+3+PL
reconvenham-nos	reconvir+V.ele.ACC.3.M.PL+IMP+3+PL
reconvenham-nos	reconvir+V.nós.AD.1.PL+IMP+3+PL
reconvenhamo-la	reconvir+V.ele.ACC.3.F.SG+IMP+1+PL
reconvenhamo-las	reconvir+V.ele.ACC.3.F.PL+IMP+1+PL
reconvenhamo-lo	reconvir+V.ele.ACC.3.M.SG+IMP+1+PL
reconvenhamo-los	reconvir+V.ele.ACC.3.M.PL+IMP+1+PL
reconvenhamo-nos	reconvir+nós.AD.1.PL+IMP+1+PL
reconvenhamos-lhe	reconvir+V.ele.DAT.3.SG+IMP+1+PL
reconvenhamos-lhes	reconvir+V.ele.DAT.3.PL+IMP+1+PL
reconvenhamos-me	reconvir+V.eu.AD.1.SG+IMP+1+PL
reconvenhamos-te	reconvir+V.tu.AD.2.SG+IMP+1+PL
reconvenhamos-vos	reconvir+V.vós.AD.2.PL+IMP+1+PL
reconvenham-se	reconvir+V.ele.REFL+IMP+3+PL
reconvenham-te	reconvir+V.tu.AD.2.SG+IMP+3+PL
reconvenham-vos	reconvir+V.vós.AD.2.PL+IMP+3+PL
reconvenha-nos	reconvir+nós.AD.1.PL+IMP+3+SG
reconvenha-o	reconvir+V.ele.ACC.3.M.SG+IMP+3+SG
reconvenha-os	reconvir+V.ele.ACC.3.M.PL+IMP+3+SG
reconvenha-se	reconvir+V.ele.REFL+IMP+3+SG
reconvenha-te	reconvir+V.tu.AD.2.SG+IMP+3+SG
reconvenha-vos	reconvir+V.vós.AD.2.PL+IMP+3+SG
reconvié-la	reconvir+V.ele.ACC.3.F.SG+SBJF+1+SG
reconvié-la	reconvir+V.ele.ACC.3.F.SG+SBJF+3+SG
reconvié-las	reconvir+V.ele.ACC.3.F.PL+SBJF+1+SG
reconvié-las	reconvir+V.ele.ACC.3.F.PL+SBJF+3+SG
reconvié-lo	reconvir+V.ele.ACC.3.M.SG+SBJF+1+SG
reconvié-lo	reconvir+V.ele.ACC.3.M.SG+SBJF+3+SG
reconvié-los	reconvir+V.ele.ACC.3.M.PL+SBJF+1+SG
reconvié-los	reconvir+V.ele.ACC.3.M.PL+SBJF+3+SG
reconviemo-la	reconvir+V.ele.ACC.3.F.SG+PRF+1+PL
reconviemo-las	reconvir+V.ele.ACC.3.F.PL+PRF+1+PL
reconviemo-lo	reconvir+V.ele.ACC.3.M.SG+PRF+1+PL
reconviemo-los	reconvir+V.ele.ACC.3.M.PL+PRF+1+PL
reconviemo-nos	reconvir+nós.AD.1.PL+PRF+1+PL
reconviemos-lhe	reconvir+V.ele.DAT.3.SG+PRF+1+PL
reconviemos-lhes	reconvir+V.ele.DAT.3.PL+PRF+1+PL
reconviemos-me	reconvir+V.eu.AD.1.SG+PRF+1+PL
reconviemos-te	reconvir+V.tu.AD.2.SG+PRF+1+PL
reconviemos-vos	reconvir+V.vós.AD.2.PL+PRF+1+PL
reconviera-a	reconvir+V.ele.ACC.3.F.SG+PQP+1+SG
reconviera-a	reconvir+V.ele.ACC.3.F.SG+PQP+3+SG
reconviera-as	reconvir+V.ele.ACC.3.F.PL+PQP+1+SG
reconviera-as	reconvir+V.ele.ACC.3.F.PL+PQP+3+SG
reconviera-la	reconvir+V.ele.ACC.3.F.SG+PQP+2+SG
reconviera-las	reconvir+V.ele.ACC.3.F.PL+PQP+2+SG
reconviera-lhe	reconvir+V.ele.DAT.3.SG+PQP+1+SG
reconviera-lhe	reconvir+V.ele.DAT.3.SG+PQP+3+SG
reconviera-lhes	reconvir+V.ele.DAT.3.PL+PQP+1+SG
reconviera-lhes	reconvir+V.ele.DAT.3.PL+PQP+3+SG
reconviera-lo	reconvir+V.ele.ACC.3.M.SG+PQP+2+SG
reconviera-los	reconvir+V.ele.ACC.3.M.PL+PQP+2+SG
reconviera-me	reconvir+V.eu.AD.1.SG+PQP+1+SG
reconviera-me	reconvir+V.eu.AD.1.SG+PQP+3+SG
reconvieram-lhe	reconvir+V.ele.DAT.3.SG+PQP+3+PL
reconvieram-lhe	reconvir+V.ele.DAT.3.SG+PRF+3+PL
reconvieram-lhes	reconvir+V.ele.DAT.3.PL+PQP+3+PL
reconvieram-lhes	reconvir+V.ele.DAT.3.PL+PRF+3+PL
reconvieram-me	reconvir+V.eu.AD.1.SG+PQP+3+PL
reconvieram-me	reconvir+V.eu.AD.1.SG+PRF+3+PL
reconvieram-na	reconvir+V.ele.ACC.3.F.SG+PQP+3+PL
reconvieram-na	reconvir+V.ele.ACC.3.F.SG+PRF+3+PL
reconvieram-nas	reconvir+V.ele.ACC.3.F.PL+PQP+3+PL
reconvieram-nas	reconvir+V.ele.ACC.3.F.PL+PRF+3+PL
reconvieram-no	reconvir+V.ele.ACC.3.M.SG+PQP+3+PL
reconvieram-no	reconvir+V.ele.ACC.3.M.SG+PRF+3+PL
reconvieram-nos	reconvir+V.ele.ACC.3.M.PL+PQP+3+PL
reconvieram-nos	reconvir+V.ele.ACC.3.M.PL+PRF+3+PL
reconvieram-nos	reconvir+V.nós.AD.1.PL+PQP+3+PL
reconvieram-nos	reconvir+V.nós.AD.1.PL+PRF+3+PL
reconviéramo-la	reconvir+V.ele.ACC.3.F.SG+PQP+1+PL
reconviéramo-las	reconvir+V.ele.ACC.3.F.PL+PQP+1+PL
reconviéramo-lo	reconvir+V.ele.ACC.3.M.SG+PQP+1+PL
reconviéramo-los	reconvir+V.ele.ACC.3.M.PL+PQP+1+PL
reconviéramo-nos	reconvir+nós.AD.1.PL+PQP+1+PL
reconviéramos-lhe	reconvir+V.ele.DAT.3.SG+PQP+1+PL
reconviéramos-lhes	reconvir+V.ele.DAT.3.PL+PQP+1+PL
reconviéramos-me	reconvir+V.eu.AD.1.SG+PQP+1+PL
reconviéramos-te	reconvir+V.tu.AD.2.SG+PQP+1+PL
reconviéramos-vos	reconvir+V.vós.AD.2.PL+PQP+1+PL
reconvieram-se	reconvir+V.ele.REFL+PQP+3+PL
reconvieram-se	reconvir+V.ele.REFL+PRF+3+PL
reconvieram-te	reconvir+V.tu.AD.2.SG+PQP+3+PL
reconvieram-te	reconvir+V.tu.AD.2.SG+PRF+3+PL
reconvieram-vos	reconvir+V.vós.AD.2.PL+PQP+3+PL
reconvieram-vos	reconvir+V.vós.AD.2.PL+PRF+3+PL
reconviera-nos	reconvir+nós.AD.1.PL+PQP+1+SG
reconviera-nos	reconvir+nós.AD.1.PL+PQP+2+SG
reconviera-nos	reconvir+nós.AD.1.PL+PQP+3+SG
reconviera-o	reconvir+V.ele.ACC.3.M.SG+PQP+1+SG
reconviera-o	reconvir+V.ele.ACC.3.M.SG+PQP+3+SG
reconviera-os	reconvir+V.ele.ACC.3.M.PL+PQP+1+SG
reconviera-os	reconvir+V.ele.ACC.3.M.PL+PQP+3+SG
reconviera-se	reconvir+V.ele.REFL+PQP+3+SG
reconvieras-lhe	reconvir+V.ele.DAT.3.SG+PQP+2+SG
reconvieras-lhes	reconvir+V.ele.DAT.3.PL+PQP+2+SG
reconvieras-me	reconvir+V.eu.AD.1.SG+PQP+2+SG
reconvieras-te	reconvir+V.tu.AD.2.SG+PQP+2+SG
reconvieras-vos	reconvir+V.vós.AD.2.PL+PQP+2+SG
reconviera-te	reconvir+V.tu.AD.2.SG+PQP+1+SG
reconviera-te	reconvir+V.tu.AD.2.SG+PQP+3+SG
reconviera-vos	reconvir+V.vós.AD.2.PL+PQP+1+SG
reconviera-vos	reconvir+V.vós.AD.2.PL+PQP+3+SG
reconvierde-la	reconvir+V.ele.ACC.3.F.SG+SBJF+2+PL
reconvierde-las	reconvir+V.ele.ACC.3.F.PL+SBJF+2+PL
reconvierde-lo	reconvir+V.ele.ACC.3.M.SG+SBJF+2+PL
reconvierde-los	reconvir+V.ele.ACC.3.M.PL+SBJF+2+PL
reconvierde-nos	reconvir+nós.AD.1.PL+SBJF+2+PL
reconvierdes-lhe	reconvir+V.ele.DAT.3.SG+SBJF+2+PL
reconvierdes-lhes	reconvir+V.ele.DAT.3.PL+SBJF+2+PL
reconvierdes-me	reconvir+V.eu.AD.1.SG+SBJF+2+PL
reconvierdes-te	reconvir+V.tu.AD.2.SG+SBJF+2+PL
reconvierdes-vos	reconvir+V.vós.AD.2.PL+SBJF+2+PL
reconviérei-la	reconvir+V.ele.ACC.3.F.SG+PQP+2+PL
reconviérei-las	reconvir+V.ele.ACC.3.F.PL+PQP+2+PL
reconviérei-lo	reconvir+V.ele.ACC.3.M.SG+PQP+2+PL
reconviérei-los	reconvir+V.ele.ACC.3.M.PL+PQP+2+PL
reconviérei-nos	reconvir+nós.AD.1.PL+PQP+2+PL
reconviéreis-lhe	reconvir+V.ele.DAT.3.SG+PQP+2+PL
reconviéreis-lhes	reconvir+V.ele.DAT.3.PL+PQP+2+PL
reconviéreis-me	reconvir+V.eu.AD.1.SG+PQP+2+PL
reconviéreis-te	reconvir+V.tu.AD.2.SG+PQP+2+PL
reconviéreis-vos	reconvir+V.vós.AD.2.PL+PQP+2+PL
reconviere-la	reconvir+V.ele.ACC.3.F.SG+SBJF+2+SG
reconviere-las	reconvir+V.ele.ACC.3.F.PL+SBJF+2+SG
reconviere-lo	reconvir+V.ele.ACC.3.M.SG+SBJF+2+SG
reconviere-los	reconvir+V.ele.ACC.3.M.PL+SBJF+2+SG
reconvierem-lhe	reconvir+V.ele.DAT.3.SG+SBJF+3+PL
reconvierem-lhes	reconvir+V.ele.DAT.3.PL+SBJF+3+PL
reconvierem-me	reconvir+V.eu.AD.1.SG+SBJF+3+PL
reconvierem-na	reconvir+V.ele.ACC.3.F.SG+SBJF+3+PL
reconvierem-nas	reconvir+V.ele.ACC.3.F.PL+SBJF+3+PL
reconvierem-no	reconvir+V.ele.ACC.3.M.SG+SBJF+3+PL
reconvierem-nos	reconvir+V.ele.ACC.3.M.PL+SBJF+3+PL
reconvierem-nos	reconvir+V.nós.AD.1.PL+SBJF+3+PL
reconvierem-se	reconvir+V.ele.REFL+SBJF+3+PL
reconvierem-te	reconvir+V.tu.AD.2.SG+SBJF+3+PL
reconvierem-vos	reconvir+V.vós.AD.2.PL+SBJF+3+PL
reconviere-nos	reconvir+nós.AD.1.PL+SBJF+2+SG
reconvieres-lhe	reconvir+V.ele.DAT.3.SG+SBJF+2+SG
reconvieres-lhes	reconvir+V.ele.DAT.3.PL+SBJF+2+SG
reconvieres-me	reconvir+V.eu.AD.1.SG+SBJF+2+SG
reconvieres-te	reconvir+V.tu.AD.2.SG+SBJF+2+SG
reconvieres-vos	reconvir+V.vós.AD.2.PL+SBJF+2+SG
reconviermo-la	reconvir+V.ele.ACC.3.F.SG+SBJF+1+PL
reconviermo-las	reconvir+V.ele.ACC.3.F.PL+SBJF+1+PL
reconviermo-lo	reconvir+V.ele.ACC.3.M.SG+SBJF+1+PL
reconviermo-los	reconvir+V.ele.ACC.3.M.PL+SBJF+1+PL
reconviermo-nos	reconvir+nós.AD.1.PL+SBJF+1+PL
reconviermos-lhe	reconvir+V.ele.DAT.3.SG+SBJF+1+PL
reconviermos-lhes	reconvir+V.ele.DAT.3.PL+SBJF+1+PL
reconviermos-me	reconvir+V.eu.AD.1.SG+SBJF+1+PL
reconviermos-te	reconvir+V.tu.AD.2.SG+SBJF+1+PL
reconviermos-vos	reconvir+V.vós.AD.2.PL+SBJF+1+PL
reconvieste-a	reconvir+V.ele.ACC.3.F.SG+PRF+2+SG
reconvieste-as	reconvir+V.ele.ACC.3.F.PL+PRF+2+SG
reconvieste-la	reconvir+V.ele.ACC.3.F.SG+PRF+2+PL
reconvieste-las	reconvir+V.ele.ACC.3.F.PL+PRF+2+PL
reconvieste-lhe	reconvir+V.ele.DAT.3.SG+PRF+2+SG
reconvieste-lhes	reconvir+V.ele.DAT.3.PL+PRF+2+SG
reconvieste-lo	reconvir+V.ele.ACC.3.M.SG+PRF+2+PL
reconvieste-los	reconvir+V.ele.ACC.3.M.PL+PRF+2+PL
reconvieste-me	reconvir+V.eu.AD.1.SG+PRF+2+SG
reconvieste-nos	reconvir+nós.AD.1.PL+PRF+2+PL
reconvieste-nos	reconvir+nós.AD.1.PL+PRF+2+SG
reconvieste-o	reconvir+V.ele.ACC.3.M.SG+PRF+2+SG
reconvieste-os	reconvir+V.ele.ACC.3.M.PL+PRF+2+SG
reconviestes-lhe	reconvir+V.ele.DAT.3.SG+PRF+2+PL
reconviestes-lhes	reconvir+V.ele.DAT.3.PL+PRF+2+PL
reconviestes-me	reconvir+V.eu.AD.1.SG+PRF+2+PL
reconviestes-te	reconvir+V.tu.AD.2.SG+PRF+2+PL
reconviestes-vos	reconvir+V.vós.AD.2.PL+PRF+2+PL
reconvieste-te	reconvir+V.tu.AD.2.SG+PRF+2+SG
reconvieste-vos	reconvir+V.vós.AD.2.PL+PRF+2+SG
reconvi-la-ão	reconvir+V.ele.ACC.3.F.SG+FUT+3+PL
reconvi-la-á	reconvir+V.ele.ACC.3.F.SG+FUT+3+SG
reconvi-la-ás	reconvir+V.ele.ACC.3.F.SG+FUT+2+SG
reconvi-la-ei	reconvir+V.ele.ACC.3.F.SG+FUT+1+SG
reconvi-la-eis	reconvir+V.ele.ACC.3.F.SG+FUT+2+PL
reconvi-la-emos	reconvir+V.ele.ACC.3.F.SG+FUT+1+PL
reconvi-la-íamos	reconvir+V.ele.ACC.3.F.SG+COND+1+PL
reconvi-la-iam	reconvir+V.ele.ACC.3.F.SG+COND+3+PL
reconvi-la-ia	reconvir+V.ele.ACC.3.F.SG+COND+1+SG
reconvi-la-ia	reconvir+V.ele.ACC.3.F.SG+COND+3+SG
reconvi-la-ias	reconvir+V.ele.ACC.3.F.SG+COND+2+SG
reconvi-la-íeis	reconvir+V.ele.ACC.3.F.SG+COND+2+PL
reconvi-la	reconvir+V.ele.ACC.3.F.SG+INF+1+SG
reconvi-la	reconvir+V.ele.ACC.3.F.SG+INF+3+SG
reconvi-las-ão	reconvir+V.ele.ACC.3.F.PL+FUT+3+PL
reconvi-las-á	reconvir+V.ele.ACC.3.F.PL+FUT+3+SG
reconvi-las-ás	reconvir+V.ele.ACC.3.F.PL+FUT+2+SG
reconvi-las-ei	reconvir+V.ele.ACC.3.F.PL+FUT+1+SG
reconvi-las-eis	reconvir+V.ele.ACC.3.F.PL+FUT+2+PL
reconvi-las-emos	reconvir+V.ele.ACC.3.F.PL+FUT+1+PL
reconvi-las-íamos	reconvir+V.ele.ACC.3.F.PL+COND+1+PL
reconvi-las-iam	reconvir+V.ele.ACC.3.F.PL+COND+3+PL
reconvi-las-ia	reconvir+V.ele.ACC.3.F.PL+COND+1+SG
reconvi-las-ia	reconvir+V.ele.ACC.3.F.PL+COND+3+SG
reconvi-las-ias	reconvir+V.ele.ACC.3.F.PL+COND+2+SG
reconvi-las-íeis	reconvir+V.ele.ACC.3.F.PL+COND+2+PL
reconvi-las	reconvir+V.ele.ACC.3.F.PL+INF+1+SG
reconvi-las	reconvir+V.ele.ACC.3.F.PL+INF+3+SG
reconvi-lo-ão	reconvir+V.ele.ACC.3.M.SG+FUT+3+PL
reconvi-lo-á	reconvir+V.ele.ACC.3.M.SG+FUT+3+SG
reconvi-lo-ás	reconvir+V.ele.ACC.3.M.SG+FUT+2+SG
reconvi-lo-ei	reconvir+V.ele.ACC.3.M.SG+FUT+1+SG
reconvi-lo-eis	reconvir+V.ele.ACC.3.M.SG+FUT+2+PL
reconvi-lo-emos	reconvir+V.ele.ACC.3.M.SG+FUT+1+PL
reconvi-lo-íamos	reconvir+V.ele.ACC.3.M.SG+COND+1+PL
reconvi-lo-iam	reconvir+V.ele.ACC.3.M.SG+COND+3+PL
reconvi-lo-ia	reconvir+V.ele.ACC.3.M.SG+COND+1+SG
reconvi-lo-ia	reconvir+V.ele.ACC.3.M.SG+COND+3+SG
reconvi-lo-ias	reconvir+V.ele.ACC.3.M.SG+COND+2+SG
reconvi-lo-íeis	reconvir+V.ele.ACC.3.M.SG+COND+2+PL
reconvi-lo	reconvir+V.ele.ACC.3.M.SG+INF+1+SG
reconvi-lo	reconvir+V.ele.ACC.3.M.SG+INF+3+SG
reconvi-los-ão	reconvir+V.ele.ACC.3.M.PL+FUT+3+PL
reconvi-los-á	reconvir+V.ele.ACC.3.M.PL+FUT+3+SG
reconvi-los-ás	reconvir+V.ele.ACC.3.M.PL+FUT+2+SG
reconvi-los-ei	reconvir+V.ele.ACC.3.M.PL+FUT+1+SG
reconvi-los-eis	reconvir+V.ele.ACC.3.M.PL+FUT+2+PL
reconvi-los-emos	reconvir+V.ele.ACC.3.M.PL+FUT+1+PL
reconvi-los-íamos	reconvir+V.ele.ACC.3.M.PL+COND+1+PL
reconvi-los-iam	reconvir+V.ele.ACC.3.M.PL+COND+3+PL
reconvi-los-ia	reconvir+V.ele.ACC.3.M.PL+COND+1+SG
reconvi-los-ia	reconvir+V.ele.ACC.3.M.PL+COND+3+SG
reconvi-los-ias	reconvir+V.ele.ACC.3.M.PL+COND+2+SG
reconvi-los-íeis	reconvir+V.ele.ACC.3.M.PL+COND+2+PL
reconvi-los	reconvir+V.ele.ACC.3.M.PL+INF+1+SG
reconvi-los	reconvir+V.ele.ACC.3.M.PL+INF+3+SG
reconvim-lhe	reconvir+V.ele.DAT.3.SG+PRF+1+SG
reconvim-lhes	reconvir+V.ele.DAT.3.PL+PRF+1+SG
reconvim-me	reconvir+V.eu.AD.1.SG+PRF+1+SG
reconvim-na	reconvir+V.ele.ACC.3.F.SG+PRF+1+SG
reconvim-nas	reconvir+V.ele.ACC.3.F.PL+PRF+1+SG
reconvim-no	reconvir+V.ele.ACC.3.M.SG+PRF+1+SG
reconvim-nos	reconvir+V.ele.ACC.3.M.PL+PRF+1+SG
reconvim-nos	reconvir+V.nós.AD.1.PL+PRF+1+SG
reconvim-te	reconvir+V.tu.AD.2.SG+PRF+1+SG
reconvim-vos	reconvir+V.vós.AD.2.PL+PRF+1+SG
reconvindo-a	reconvir+V.ele.ACC.3.F.SG+GRD
reconvindo-a	reconvir+V.ele.ACC.3.F.SG+PTPASS
reconvindo-as	reconvir+V.ele.ACC.3.F.PL+GRD
reconvindo-as	reconvir+V.ele.ACC.3.F.PL+PTPASS
reconvindo-lhe	reconvir+V.ele.DAT.3.SG+GRD
reconvindo-lhe	reconvir+V.ele.DAT.3.SG+PTPASS
reconvindo-lhes	reconvir+V.ele.DAT.3.PL+GRD
reconvindo-lhes	reconvir+V.ele.DAT.3.PL+PTPASS
reconvindo-me	reconvir+V.eu.AD.1.SG+GRD
reconvindo-me	reconvir+V.eu.AD.1.SG+PTPASS
reconvindo-nos	reconvir+nós.AD.1.PL+GRD
reconvindo-nos	reconvir+nós.AD.1.PL+PTPASS
reconvindo-o	reconvir+V.ele.ACC.3.M.SG+GRD
reconvindo-o	reconvir+V.ele.ACC.3.M.SG+PTPASS
reconvindo-os	reconvir+V.ele.ACC.3.M.PL+GRD
reconvindo-os	reconvir+V.ele.ACC.3.M.PL+PTPASS
reconvindo-se	reconvir+V.ele.REFL+GRD
reconvindo-se	reconvir+V.ele.REFL+PTPASS
reconvindo-te	reconvir+V.tu.AD.2.SG+GRD
reconvindo-te	reconvir+V.tu.AD.2.SG+PTPASS
reconvindo-vos	reconvir+V.vós.AD.2.PL+GRD
reconvindo-vos	reconvir+V.vós.AD.2.PL+PTPASS
reconvinha-a	reconvir+V.ele.ACC.3.F.SG+IMPF+1+SG
reconvinha-a	reconvir+V.ele.ACC.3.F.SG+IMPF+3+SG
reconvinha-as	reconvir+V.ele.ACC.3.F.PL+IMPF+1+SG
reconvinha-as	reconvir+V.ele.ACC.3.F.PL+IMPF+3+SG
reconvinha-lhe	reconvir+V.ele.DAT.3.SG+IMPF+1+SG
reconvinha-lhe	reconvir+V.ele.DAT.3.SG+IMPF+3+SG
reconvinha-lhes	reconvir+V.ele.DAT.3.PL+IMPF+1+SG
reconvinha-lhes	reconvir+V.ele.DAT.3.PL+IMPF+3+SG
reconvinha-me	reconvir+V.eu.AD.1.SG+IMPF+1+SG
reconvinha-me	reconvir+V.eu.AD.1.SG+IMPF+3+SG
reconvinham-lhe	reconvir+V.ele.DAT.3.SG+IMPF+3+PL
reconvinham-lhes	reconvir+V.ele.DAT.3.PL+IMPF+3+PL
reconvinham-me	reconvir+V.eu.AD.1.SG+IMPF+3+PL
reconvinham-na	reconvir+V.ele.ACC.3.F.SG+IMPF+3+PL
reconvinham-nas	reconvir+V.ele.ACC.3.F.PL+IMPF+3+PL
reconvinham-no	reconvir+V.ele.ACC.3.M.SG+IMPF+3+PL
reconvinham-nos	reconvir+V.ele.ACC.3.M.PL+IMPF+3+PL
reconvinham-nos	reconvir+V.nós.AD.1.PL+IMPF+3+PL
reconvínhamo-la	reconvir+V.ele.ACC.3.F.SG+IMPF+1+PL
reconvínhamo-las	reconvir+V.ele.ACC.3.F.PL+IMPF+1+PL
reconvínhamo-lo	reconvir+V.ele.ACC.3.M.SG+IMPF+1+PL
reconvínhamo-los	reconvir+V.ele.ACC.3.M.PL+IMPF+1+PL
reconvínhamo-nos	reconvir+nós.AD.1.PL+IMPF+1+PL
reconvínhamos-lhe	reconvir+V.ele.DAT.3.SG+IMPF+1+PL
reconvínhamos-lhes	reconvir+V.ele.DAT.3.PL+IMPF+1+PL
reconvínhamos-me	reconvir+V.eu.AD.1.SG+IMPF+1+PL
reconvínhamos-te	reconvir+V.tu.AD.2.SG+IMPF+1+PL
reconvínhamos-vos	reconvir+V.vós.AD.2.PL+IMPF+1+PL
reconvinham-se	reconvir+V.ele.REFL+IMPF+3+PL
reconvinham-te	reconvir+V.tu.AD.2.SG+IMPF+3+PL
reconvinham-vos	reconvir+V.vós.AD.2.PL+IMPF+3+PL
reconvinha-nos	reconvir+nós.AD.1.PL+IMPF+1+SG
reconvinha-nos	reconvir+nós.AD.1.PL+IMPF+3+SG
reconvinha-o	reconvir+V.ele.ACC.3.M.SG+IMPF+1+SG
reconvinha-o	reconvir+V.ele.ACC.3.M.SG+IMPF+3+SG
reconvinha-os	reconvir+V.ele.ACC.3.M.PL+IMPF+1+SG
reconvinha-os	reconvir+V.ele.ACC.3.M.PL+IMPF+3+SG
reconvinha-se	reconvir+V.ele.REFL+IMPF+3+SG
reconvinhas-la	reconvir+V.ele.ACC.3.F.SG+IMPF+2+SG
reconvinhas-las	reconvir+V.ele.ACC.3.F.PL+IMPF+2+SG
reconvinhas-lhe	reconvir+V.ele.DAT.3.SG+IMPF+2+SG
reconvinhas-lhes	reconvir+V.ele.DAT.3.PL+IMPF+2+SG
reconvinhas-lo	reconvir+V.ele.ACC.3.M.SG+IMPF+2+SG
reconvinhas-los	reconvir+V.ele.ACC.3.M.PL+IMPF+2+SG
reconvinhas-me	reconvir+V.eu.AD.1.SG+IMPF+2+SG
reconvinhas-nos	reconvir+nós.AD.1.PL+IMPF+2+SG
reconvinhas-te	reconvir+V.tu.AD.2.SG+IMPF+2+SG
reconvinhas-vos	reconvir+V.vós.AD.2.PL+IMPF+2+SG
reconvinha-te	reconvir+V.tu.AD.2.SG+IMPF+1+SG
reconvinha-te	reconvir+V.tu.AD.2.SG+IMPF+3+SG
reconvinha-vos	reconvir+V.vós.AD.2.PL+IMPF+1+SG
reconvinha-vos	reconvir+V.vós.AD.2.PL+IMPF+3+SG
reconvínhei-la	reconvir+V.ele.ACC.3.F.SG+IMPF+2+PL
reconvínhei-las	reconvir+V.ele.ACC.3.F.PL+IMPF+2+PL
reconvínhei-lo	reconvir+V.ele.ACC.3.M.SG+IMPF+2+PL
reconvínhei-los	reconvir+V.ele.ACC.3.M.PL+IMPF+2+PL
reconvínhei-nos	reconvir+nós.AD.1.PL+IMPF+2+PL
reconvínheis-lhe	reconvir+V.ele.DAT.3.SG+IMPF+2+PL
reconvínheis-lhes	reconvir+V.ele.DAT.3.PL+IMPF+2+PL
reconvínheis-me	reconvir+V.eu.AD.1.SG+IMPF+2+PL
reconvínheis-te	reconvir+V.tu.AD.2.SG+IMPF+2+PL
reconvínheis-vos	reconvir+V.vós.AD.2.PL+IMPF+2+PL
reconvirde-la	reconvir+V.ele.ACC.3.F.SG+INF+2+PL
reconvirde-las	reconvir+V.ele.ACC.3.F.PL+INF+2+PL
reconvirde-lo	reconvir+V.ele.ACC.3.M.SG+INF+2+PL
reconvirde-los	reconvir+V.ele.ACC.3.M.PL+INF+2+PL
reconvirde-nos	reconvir+nós.AD.1.PL+INF+2+PL
reconvirdes-lhe	reconvir+V.ele.DAT.3.SG+INF+2+PL
reconvirdes-lhes	reconvir+V.ele.DAT.3.PL+INF+2+PL
reconvirdes-me	reconvir+V.eu.AD.1.SG+INF+2+PL
reconvirdes-te	reconvir+V.tu.AD.2.SG+INF+2+PL
reconvirdes-vos	reconvir+V.vós.AD.2.PL+INF+2+PL
reconvire-la	reconvir+V.ele.ACC.3.F.SG+INF+2+SG
reconvire-las	reconvir+V.ele.ACC.3.F.PL+INF+2+SG
reconvire-lo	reconvir+V.ele.ACC.3.M.SG+INF+2+SG
reconvire-los	reconvir+V.ele.ACC.3.M.PL+INF+2+SG
reconvirem-lhe	reconvir+V.ele.DAT.3.SG+INF+3+PL
reconvirem-lhes	reconvir+V.ele.DAT.3.PL+INF+3+PL
reconvirem-me	reconvir+V.eu.AD.1.SG+INF+3+PL
reconvirem-na	reconvir+V.ele.ACC.3.F.SG+INF+3+PL
reconvirem-nas	reconvir+V.ele.ACC.3.F.PL+INF+3+PL
reconvirem-no	reconvir+V.ele.ACC.3.M.SG+INF+3+PL
reconvirem-nos	reconvir+V.ele.ACC.3.M.PL+INF+3+PL
reconvirem-nos	reconvir+V.nós.AD.1.PL+INF+3+PL
reconvirem-se	reconvir+V.ele.REFL+INF+3+PL
reconvirem-te	reconvir+V.tu.AD.2.SG+INF+3+PL
reconvirem-vos	reconvir+V.vós.AD.2.PL+INF+3+PL
reconvire-nos	reconvir+nós.AD.1.PL+INF+2+SG
reconvires-lhe	reconvir+V.ele.DAT.3.SG+INF+2+SG
reconvires-lhes	reconvir+V.ele.DAT.3.PL+INF+2+SG
reconvires-me	reconvir+V.eu.AD.1.SG+INF+2+SG
reconvires-te	reconvir+V.tu.AD.2.SG+INF+2+SG
reconvires-vos	reconvir+V.vós.AD.2.PL+INF+2+SG
reconvir-lhe-ão	reconvir+V.ele.DAT.3.SG+FUT+3+PL
reconvir-lhe-á	reconvir+V.ele.DAT.3.SG+FUT+3+SG
reconvir-lhe-ás	reconvir+V.ele.DAT.3.SG+FUT+2+SG
reconvir-lhe-ei	reconvir+V.ele.DAT.3.SG+FUT+1+SG
reconvir-lhe-eis	reconvir+V.ele.DAT.3.SG+FUT+2+PL
reconvir-lhe-emos	reconvir+V.ele.DAT.3.SG+FUT+1+PL
reconvir-lhe-íamos	reconvir+V.ele.DAT.3.SG+COND+1+PL
reconvir-lhe-iam	reconvir+V.ele.DAT.3.SG+COND+3+PL
reconvir-lhe-ia	reconvir+V.ele.DAT.3.SG+COND+1+SG
reconvir-lhe-ia	reconvir+V.ele.DAT.3.SG+COND+3+SG
reconvir-lhe-ias	reconvir+V.ele.DAT.3.SG+COND+2+SG
reconvir-lhe-íeis	reconvir+V.ele.DAT.3.SG+COND+2+PL
reconvir-lhe	reconvir+V.ele.DAT.3.SG+INF
reconvir-lhe	reconvir+V.ele.DAT.3.SG+INF+1+SG
reconvir-lhe	reconvir+V.ele.DAT.3.SG+INF+3+SG
reconvir-lhes-ão	reconvir+V.ele.DAT.3.PL+FUT+3+PL
reconvir-lhes-á	reconvir+V.ele.DAT.3.PL+FUT+3+SG
reconvir-lhes-ás	reconvir+V.ele.DAT.3.PL+FUT+2+SG
reconvir-lhes-ei	reconvir+V.ele.DAT.3.PL+FUT+1+SG
reconvir-lhes-eis	reconvir+V.ele.DAT.3.PL+FUT+2+PL
reconvir-lhes-emos	reconvir+V.ele.DAT.3.PL+FUT+1+PL
reconvir-lhes-íamos	reconvir+V.ele.DAT.3.PL+COND+1+PL
reconvir-lhes-iam	reconvir+V.ele.DAT.3.PL+COND+3+PL
reconvir-lhes-ia	reconvir+V.ele.DAT.3.PL+COND+1+SG
reconvir-lhes-ia	reconvir+V.ele.DAT.3.PL+COND+3+SG
reconvir-lhes-ias	reconvir+V.ele.DAT.3.PL+COND+2+SG
reconvir-lhes-íeis	reconvir+V.ele.DAT.3.PL+COND+2+PL
reconvir-lhes	reconvir+V.ele.DAT.3.PL+INF
reconvir-lhes	reconvir+V.ele.DAT.3.PL+INF+1+SG
reconvir-lhes	reconvir+V.ele.DAT.3.PL+INF+3+SG
reconvir-me-ão	reconvir+V.eu.AD.1.SG+FUT+3+PL
reconvir-me-á	reconvir+V.eu.AD.1.SG+FUT+3+SG
reconvir-me-ás	reconvir+V.eu.AD.1.SG+FUT+2+SG
reconvir-me-ei	reconvir+V.eu.AD.1.SG+FUT+1+SG
reconvir-me-eis	reconvir+V.eu.AD.1.SG+FUT+2+PL
reconvir-me-emos	reconvir+V.eu.AD.1.SG+FUT+1+PL
reconvir-me-íamos	reconvir+V.eu.AD.1.SG+COND+1+PL
reconvir-me-iam	reconvir+V.eu.AD.1.SG+COND+3+PL
reconvir-me-ia	reconvir+V.eu.AD.1.SG+COND+1+SG
reconvir-me-ia	reconvir+V.eu.AD.1.SG+COND+3+SG
reconvir-me-ias	reconvir+V.eu.AD.1.SG+COND+2+SG
reconvir-me-íeis	reconvir+V.eu.AD.1.SG+COND+2+PL
reconvir-me	reconvir+V.eu.AD.1.SG+INF
reconvir-me	reconvir+V.eu.AD.1.SG+INF+1+SG
reconvir-me	reconvir+V.eu.AD.1.SG+INF+3+SG
reconvirmo-la	reconvir+V.ele.ACC.3.F.SG+INF+1+PL
reconvirmo-las	reconvir+V.ele.ACC.3.F.PL+INF+1+PL
reconvirmo-lo	reconvir+V.ele.ACC.3.M.SG+INF+1+PL
reconvirmo-los	reconvir+V.ele.ACC.3.M.PL+INF+1+PL
reconvirmo-nos	reconvir+nós.AD.1.PL+INF+1+PL
reconvirmos-lhe	reconvir+V.ele.DAT.3.SG+INF+1+PL
reconvirmos-lhes	reconvir+V.ele.DAT.3.PL+INF+1+PL
reconvirmos-me	reconvir+V.eu.AD.1.SG+INF+1+PL
reconvirmos-te	reconvir+V.tu.AD.2.SG+INF+1+PL
reconvirmos-vos	reconvir+V.vós.AD.2.PL+INF+1+PL
reconvir-nos-ão	reconvir+nós.AD.1.PL+FUT+3+PL
reconvir-nos-á	reconvir+nós.AD.1.PL+FUT+3+SG
reconvir-nos-ás	reconvir+nós.AD.1.PL+FUT+2+SG
reconvir-nos-ei	reconvir+nós.AD.1.PL+FUT+1+SG
reconvir-nos-eis	reconvir+nós.AD.1.PL+FUT+2+PL
reconvir-nos-emos	reconvir+nós.AD.1.PL+FUT+1+PL
reconvir-nos-íamos	reconvir+nós.AD.1.PL+COND+1+PL
reconvir-nos-iam	reconvir+nós.AD.1.PL+COND+3+PL
reconvir-nos-ia	reconvir+nós.AD.1.PL+COND+1+SG
reconvir-nos-ia	reconvir+nós.AD.1.PL+COND+3+SG
reconvir-nos-ias	reconvir+nós.AD.1.PL+COND+2+SG
reconvir-nos-íeis	reconvir+nós.AD.1.PL+COND+2+PL
reconvir-nos	reconvir+nós.AD.1.PL+INF
reconvir-nos	reconvir+nós.AD.1.PL+INF+1+SG
reconvir-nos	reconvir+nós.AD.1.PL+INF+3+SG
reconvir-se-ão	reconvir+V.ele.REFL+FUT+3+PL
reconvir-se-á	reconvir+V.ele.REFL+FUT+3+SG
reconvir-se-iam	reconvir+V.ele.REFL+COND+3+PL
reconvir-se-ia	reconvir+V.ele.REFL+COND+3+SG
reconvir-se	reconvir+V.ele.REFL+INF
reconvir-se	reconvir+V.ele.REFL+INF+3+SG
reconvir-te-ão	reconvir+V.tu.AD.2.SG+FUT+3+PL
reconvir-te-á	reconvir+V.tu.AD.2.SG+FUT+3+SG
reconvir-te-ás	reconvir+V.tu.AD.2.SG+FUT+2+SG
reconvir-te-ei	reconvir+V.tu.AD.2.SG+FUT+1+SG
reconvir-te-eis	reconvir+V.tu.AD.2.SG+FUT+2+PL
reconvir-te-emos	reconvir+V.tu.AD.2.SG+FUT+1+PL
reconvir-te-íamos	reconvir+V.tu.AD.2.SG+COND+1+PL
reconvir-te-iam	reconvir+V.tu.AD.2.SG+COND+3+PL
reconvir-te-ia	reconvir+V.tu.AD.2.SG+COND+1+SG
reconvir-te-ia	reconvir+V.tu.AD.2.SG+COND+3+SG
reconvir-te-ias	reconvir+V.tu.AD.2.SG+COND+2+SG
reconvir-te-íeis	reconvir+V.tu.AD.2.SG+COND+2+PL
reconvir-te	reconvir+V.tu.AD.2.SG+INF
reconvir-te	reconvir+V.tu.AD.2.SG+INF+1+SG
reconvir-te	reconvir+V.tu.AD.2.SG+INF+3+SG
reconvir-vos-ão	reconvir+V.vós.AD.2.PL+FUT+3+PL
reconvir-vos-á	reconvir+V.vós.AD.2.PL+FUT+3+SG
reconvir-vos-ás	reconvir+V.vós.AD.2.PL+FUT+2+SG
reconvir-vos-ei	reconvir+V.vós.AD.2.PL+FUT+1+SG
reconvir-vos-eis	reconvir+V.vós.AD.2.PL+FUT+2+PL
reconvir-vos-emos	reconvir+V.vós.AD.2.PL+FUT+1+PL
reconvir-vos-íamos	reconvir+V.vós.AD.2.PL+COND+1+PL
reconvir-vos-iam	reconvir+V.vós.AD.2.PL+COND+3+PL
reconvir-vos-ia	reconvir+V.vós.AD.2.PL+COND+1+SG
reconvir-vos-ia	reconvir+V.vós.AD.2.PL+COND+3+SG
reconvir-vos-ias	reconvir+V.vós.AD.2.PL+COND+2+SG
reconvir-vos-íeis	reconvir+V.vós.AD.2.PL+COND+2+PL
reconvir-vos	reconvir+V.vós.AD.2.PL+INF
reconvir-vos	reconvir+V.vós.AD.2.PL+INF+1+SG
reconvir-vos	reconvir+V.vós.AD.2.PL+INF+3+SG
reconvoca-a	reconvocar+V.ele.ACC.3.F.SG+PRS+3+SG
reconvoca-as	reconvocar+V.ele.ACC.3.F.PL+PRS+3+SG
reconvocai-la	reconvocar+V.ele.ACC.3.F.SG+PRS+2+PL
reconvocai-las	reconvocar+V.ele.ACC.3.F.PL+PRS+2+PL
reconvocai-lo	reconvocar+V.ele.ACC.3.M.SG+PRS+2+PL
reconvocai-los	reconvocar+V.ele.ACC.3.M.PL+PRS+2+PL
reconvocai-nos	reconvocar+nós.AD.1.PL+PRS+2+PL
reconvocais-lhe	reconvocar+V.ele.DAT.3.SG+PRS+2+PL
reconvocais-lhes	reconvocar+V.ele.DAT.3.PL+PRS+2+PL
reconvocais-me	reconvocar+V.eu.AD.1.SG+PRS+2+PL
reconvocais-te	reconvocar+V.tu.AD.2.SG+PRS+2+PL
reconvocais-vos	reconvocar+V.vós.AD.2.PL+PRS+2+PL
reconvocá-la-ão	reconvocar+V.ele.ACC.3.F.SG+FUT+3+PL
reconvocá-la-á	reconvocar+V.ele.ACC.3.F.SG+FUT+3+SG
reconvocá-la-ás	reconvocar+V.ele.ACC.3.F.SG+FUT+2+SG
reconvocá-la-ei	reconvocar+V.ele.ACC.3.F.SG+FUT+1+SG
reconvocá-la-eis	reconvocar+V.ele.ACC.3.F.SG+FUT+2+PL
reconvocá-la-emos	reconvocar+V.ele.ACC.3.F.SG+FUT+1+PL
reconvocá-la-íamos	reconvocar+V.ele.ACC.3.F.SG+COND+1+PL
reconvocá-la-iam	reconvocar+V.ele.ACC.3.F.SG+COND+3+PL
reconvocá-la-ia	reconvocar+V.ele.ACC.3.F.SG+COND+1+SG
reconvocá-la-ia	reconvocar+V.ele.ACC.3.F.SG+COND+3+SG
reconvocá-la-ias	reconvocar+V.ele.ACC.3.F.SG+COND+2+SG
reconvocá-la-íeis	reconvocar+V.ele.ACC.3.F.SG+COND+2+PL
reconvocá-la	reconvocar+V.ele.ACC.3.F.SG+INF+1+SG
reconvocá-la	reconvocar+V.ele.ACC.3.F.SG+INF+3+SG
reconvoca-la	reconvocar+V.ele.ACC.3.F.SG+PRS+2+SG
reconvocá-la	reconvocar+V.ele.ACC.3.F.SG+SBJF+1+SG
reconvocá-la	reconvocar+V.ele.ACC.3.F.SG+SBJF+3+SG
reconvocá-las-ão	reconvocar+V.ele.ACC.3.F.PL+FUT+3+PL
reconvocá-las-á	reconvocar+V.ele.ACC.3.F.PL+FUT+3+SG
reconvocá-las-ás	reconvocar+V.ele.ACC.3.F.PL+FUT+2+SG
reconvocá-las-ei	reconvocar+V.ele.ACC.3.F.PL+FUT+1+SG
reconvocá-las-eis	reconvocar+V.ele.ACC.3.F.PL+FUT+2+PL
reconvocá-las-emos	reconvocar+V.ele.ACC.3.F.PL+FUT+1+PL
reconvocá-las-íamos	reconvocar+V.ele.ACC.3.F.PL+COND+1+PL
reconvocá-las-iam	reconvocar+V.ele.ACC.3.F.PL+COND+3+PL
reconvocá-las-ia	reconvocar+V.ele.ACC.3.F.PL+COND+1+SG
reconvocá-las-ia	reconvocar+V.ele.ACC.3.F.PL+COND+3+SG
reconvocá-las-ias	reconvocar+V.ele.ACC.3.F.PL+COND+2+SG
reconvocá-las-íeis	reconvocar+V.ele.ACC.3.F.PL+COND+2+PL
reconvocá-las	reconvocar+V.ele.ACC.3.F.PL+INF+1+SG
reconvocá-las	reconvocar+V.ele.ACC.3.F.PL+INF+3+SG
reconvoca-las	reconvocar+V.ele.ACC.3.F.PL+PRS+2+SG
reconvocá-las	reconvocar+V.ele.ACC.3.F.PL+SBJF+1+SG
reconvocá-las	reconvocar+V.ele.ACC.3.F.PL+SBJF+3+SG
reconvoca-lhe	reconvocar+V.ele.DAT.3.SG+PRS+3+SG
reconvoca-lhes	reconvocar+V.ele.DAT.3.PL+PRS+3+SG
reconvocá-lo-ão	reconvocar+V.ele.ACC.3.M.SG+FUT+3+PL
reconvocá-lo-á	reconvocar+V.ele.ACC.3.M.SG+FUT+3+SG
reconvocá-lo-ás	reconvocar+V.ele.ACC.3.M.SG+FUT+2+SG
reconvocá-lo-ei	reconvocar+V.ele.ACC.3.M.SG+FUT+1+SG
reconvocá-lo-eis	reconvocar+V.ele.ACC.3.M.SG+FUT+2+PL
reconvocá-lo-emos	reconvocar+V.ele.ACC.3.M.SG+FUT+1+PL
reconvocá-lo-íamos	reconvocar+V.ele.ACC.3.M.SG+COND+1+PL
reconvocá-lo-iam	reconvocar+V.ele.ACC.3.M.SG+COND+3+PL
reconvocá-lo-ia	reconvocar+V.ele.ACC.3.M.SG+COND+1+SG
reconvocá-lo-ia	reconvocar+V.ele.ACC.3.M.SG+COND+3+SG
reconvocá-lo-ias	reconvocar+V.ele.ACC.3.M.SG+COND+2+SG
reconvocá-lo-íeis	reconvocar+V.ele.ACC.3.M.SG+COND+2+PL
reconvocá-lo	reconvocar+V.ele.ACC.3.M.SG+INF+1+SG
reconvocá-lo	reconvocar+V.ele.ACC.3.M.SG+INF+3+SG
reconvoca-lo	reconvocar+V.ele.ACC.3.M.SG+PRS+2+SG
reconvocá-lo	reconvocar+V.ele.ACC.3.M.SG+SBJF+1+SG
reconvocá-lo	reconvocar+V.ele.ACC.3.M.SG+SBJF+3+SG
reconvocá-los-ão	reconvocar+V.ele.ACC.3.M.PL+FUT+3+PL
reconvocá-los-á	reconvocar+V.ele.ACC.3.M.PL+FUT+3+SG
reconvocá-los-ás	reconvocar+V.ele.ACC.3.M.PL+FUT+2+SG
reconvocá-los-ei	reconvocar+V.ele.ACC.3.M.PL+FUT+1+SG
reconvocá-los-eis	reconvocar+V.ele.ACC.3.M.PL+FUT+2+PL
reconvocá-los-emos	reconvocar+V.ele.ACC.3.M.PL+FUT+1+PL
reconvocá-los-íamos	reconvocar+V.ele.ACC.3.M.PL+COND+1+PL
reconvocá-los-iam	reconvocar+V.ele.ACC.3.M.PL+COND+3+PL
reconvocá-los-ia	reconvocar+V.ele.ACC.3.M.PL+COND+1+SG
reconvocá-los-ia	reconvocar+V.ele.ACC.3.M.PL+COND+3+SG
reconvocá-los-ias	reconvocar+V.ele.ACC.3.M.PL+COND+2+SG
reconvocá-los-íeis	reconvocar+V.ele.ACC.3.M.PL+COND+2+PL
reconvocá-los	reconvocar+V.ele.ACC.3.M.PL+INF+1+SG
reconvocá-los	reconvocar+V.ele.ACC.3.M.PL+INF+3+SG
reconvoca-los	reconvocar+V.ele.ACC.3.M.PL+PRS+2+SG
reconvocá-los	reconvocar+V.ele.ACC.3.M.PL+SBJF+1+SG
reconvocá-los	reconvocar+V.ele.ACC.3.M.PL+SBJF+3+SG
reconvoca-me	reconvocar+V.eu.AD.1.SG+PRS+3+SG
reconvocam-lhe	reconvocar+V.ele.DAT.3.SG+PRS+3+PL
reconvocam-lhes	reconvocar+V.ele.DAT.3.PL+PRS+3+PL
reconvocam-me	reconvocar+V.eu.AD.1.SG+PRS+3+PL
reconvocam-na	reconvocar+V.ele.ACC.3.F.SG+PRS+3+PL
reconvocam-nas	reconvocar+V.ele.ACC.3.F.PL+PRS+3+PL
reconvocam-no	reconvocar+V.ele.ACC.3.M.SG+PRS+3+PL
reconvocam-nos	reconvocar+V.ele.ACC.3.M.PL+PRS+3+PL
reconvocam-nos	reconvocar+V.nós.AD.1.PL+PRS+3+PL
reconvocamo-la	reconvocar+V.ele.ACC.3.F.SG+PRF+1+PL
reconvocamo-la	reconvocar+V.ele.ACC.3.F.SG+PRS+1+PL
reconvocamo-las	reconvocar+V.ele.ACC.3.F.PL+PRF+1+PL
reconvocamo-las	reconvocar+V.ele.ACC.3.F.PL+PRS+1+PL
reconvocamo-lo	reconvocar+V.ele.ACC.3.M.SG+PRF+1+PL
reconvocamo-lo	reconvocar+V.ele.ACC.3.M.SG+PRS+1+PL
reconvocamo-los	reconvocar+V.ele.ACC.3.M.PL+PRF+1+PL
reconvocamo-los	reconvocar+V.ele.ACC.3.M.PL+PRS+1+PL
reconvocamo-nos	reconvocar+nós.AD.1.PL+PRF+1+PL
reconvocamo-nos	reconvocar+nós.AD.1.PL+PRS+1+PL
reconvocamos-lhe	reconvocar+V.ele.DAT.3.SG+PRF+1+PL
reconvocamos-lhe	reconvocar+V.ele.DAT.3.SG+PRS+1+PL
reconvocamos-lhes	reconvocar+V.ele.DAT.3.PL+PRF+1+PL
reconvocamos-lhes	reconvocar+V.ele.DAT.3.PL+PRS+1+PL
reconvocamos-me	reconvocar+V.eu.AD.1.SG+PRF+1+PL
reconvocamos-me	reconvocar+V.eu.AD.1.SG+PRS+1+PL
reconvocamos-te	reconvocar+V.tu.AD.2.SG+PRF+1+PL
reconvocamos-te	reconvocar+V.tu.AD.2.SG+PRS+1+PL
reconvocamos-vos	reconvocar+V.vós.AD.2.PL+PRF+1+PL
reconvocamos-vos	reconvocar+V.vós.AD.2.PL+PRS+1+PL
reconvocam-se	reconvocar+V.ele.REFL+PRS+3+PL
reconvocam-te	reconvocar+V.tu.AD.2.SG+PRS+3+PL
reconvocam-vos	reconvocar+V.vós.AD.2.PL+PRS+3+PL
reconvocando-a	reconvocar+V.ele.ACC.3.F.SG+GRD
reconvocando-as	reconvocar+V.ele.ACC.3.F.PL+GRD
reconvocando-lhe	reconvocar+V.ele.DAT.3.SG+GRD
reconvocando-lhes	reconvocar+V.ele.DAT.3.PL+GRD
reconvocando-me	reconvocar+V.eu.AD.1.SG+GRD
reconvocando-nos	reconvocar+nós.AD.1.PL+GRD
reconvocando-o	reconvocar+V.ele.ACC.3.M.SG+GRD
reconvocando-os	reconvocar+V.ele.ACC.3.M.PL+GRD
reconvocando-se	reconvocar+V.ele.REFL+GRD
reconvocando-te	reconvocar+V.tu.AD.2.SG+GRD
reconvocando-vos	reconvocar+V.vós.AD.2.PL+GRD
reconvoca-nos	reconvocar+nós.AD.1.PL+PRS+2+SG
reconvoca-nos	reconvocar+nós.AD.1.PL+PRS+3+SG
reconvoca-o	reconvocar+V.ele.ACC.3.M.SG+PRS+3+SG
reconvoca-os	reconvocar+V.ele.ACC.3.M.PL+PRS+3+SG
reconvocara-a	reconvocar+V.ele.ACC.3.F.SG+PQP+1+SG
reconvocara-a	reconvocar+V.ele.ACC.3.F.SG+PQP+3+SG
reconvocara-as	reconvocar+V.ele.ACC.3.F.PL+PQP+1+SG
reconvocara-as	reconvocar+V.ele.ACC.3.F.PL+PQP+3+SG
reconvocara-la	reconvocar+V.ele.ACC.3.F.SG+PQP+2+SG
reconvocara-las	reconvocar+V.ele.ACC.3.F.PL+PQP+2+SG
reconvocara-lhe	reconvocar+V.ele.DAT.3.SG+PQP+1+SG
reconvocara-lhe	reconvocar+V.ele.DAT.3.SG+PQP+3+SG
reconvocara-lhes	reconvocar+V.ele.DAT.3.PL+PQP+1+SG
reconvocara-lhes	reconvocar+V.ele.DAT.3.PL+PQP+3+SG
reconvocara-lo	reconvocar+V.ele.ACC.3.M.SG+PQP+2+SG
reconvocara-los	reconvocar+V.ele.ACC.3.M.PL+PQP+2+SG
reconvocara-me	reconvocar+V.eu.AD.1.SG+PQP+1+SG
reconvocara-me	reconvocar+V.eu.AD.1.SG+PQP+3+SG
reconvocaram-lhe	reconvocar+V.ele.DAT.3.SG+PQP+3+PL
reconvocaram-lhe	reconvocar+V.ele.DAT.3.SG+PRF+3+PL
reconvocaram-lhes	reconvocar+V.ele.DAT.3.PL+PQP+3+PL
reconvocaram-lhes	reconvocar+V.ele.DAT.3.PL+PRF+3+PL
reconvocaram-me	reconvocar+V.eu.AD.1.SG+PQP+3+PL
reconvocaram-me	reconvocar+V.eu.AD.1.SG+PRF+3+PL
reconvocaram-na	reconvocar+V.ele.ACC.3.F.SG+PQP+3+PL
reconvocaram-na	reconvocar+V.ele.ACC.3.F.SG+PRF+3+PL
reconvocaram-nas	reconvocar+V.ele.ACC.3.F.PL+PQP+3+PL
reconvocaram-nas	reconvocar+V.ele.ACC.3.F.PL+PRF+3+PL
reconvocaram-no	reconvocar+V.ele.ACC.3.M.SG+PQP+3+PL
reconvocaram-no	reconvocar+V.ele.ACC.3.M.SG+PRF+3+PL
reconvocaram-nos	reconvocar+V.ele.ACC.3.M.PL+PQP+3+PL
reconvocaram-nos	reconvocar+V.ele.ACC.3.M.PL+PRF+3+PL
reconvocaram-nos	reconvocar+V.nós.AD.1.PL+PQP+3+PL
reconvocaram-nos	reconvocar+V.nós.AD.1.PL+PRF+3+PL
reconvocáramo-la	reconvocar+V.ele.ACC.3.F.SG+PQP+1+PL
reconvocáramo-las	reconvocar+V.ele.ACC.3.F.PL+PQP+1+PL
reconvocáramo-lo	reconvocar+V.ele.ACC.3.M.SG+PQP+1+PL
reconvocáramo-los	reconvocar+V.ele.ACC.3.M.PL+PQP+1+PL
reconvocáramo-nos	reconvocar+nós.AD.1.PL+PQP+1+PL
reconvocáramos-lhe	reconvocar+V.ele.DAT.3.SG+PQP+1+PL
reconvocáramos-lhes	reconvocar+V.ele.DAT.3.PL+PQP+1+PL
reconvocáramos-me	reconvocar+V.eu.AD.1.SG+PQP+1+PL
reconvocáramos-te	reconvocar+V.tu.AD.2.SG+PQP+1+PL
reconvocáramos-vos	reconvocar+V.vós.AD.2.PL+PQP+1+PL
reconvocaram-se	reconvocar+V.ele.REFL+PQP+3+PL
reconvocaram-se	reconvocar+V.ele.REFL+PRF+3+PL
reconvocaram-te	reconvocar+V.tu.AD.2.SG+PQP+3+PL
reconvocaram-te	reconvocar+V.tu.AD.2.SG+PRF+3+PL
reconvocaram-vos	reconvocar+V.vós.AD.2.PL+PQP+3+PL
reconvocaram-vos	reconvocar+V.vós.AD.2.PL+PRF+3+PL
reconvocara-nos	reconvocar+nós.AD.1.PL+PQP+1+SG
reconvocara-nos	reconvocar+nós.AD.1.PL+PQP+2+SG
reconvocara-nos	reconvocar+nós.AD.1.PL+PQP+3+SG
reconvocara-o	reconvocar+V.ele.ACC.3.M.SG+PQP+1+SG
reconvocara-o	reconvocar+V.ele.ACC.3.M.SG+PQP+3+SG
reconvocara-os	reconvocar+V.ele.ACC.3.M.PL+PQP+1+SG
reconvocara-os	reconvocar+V.ele.ACC.3.M.PL+PQP+3+SG
reconvocara-se	reconvocar+V.ele.REFL+PQP+1+SG
reconvocara-se	reconvocar+V.ele.REFL+PQP+3+SG
reconvocaras-lhe	reconvocar+V.ele.DAT.3.SG+PQP+2+SG
reconvocaras-lhes	reconvocar+V.ele.DAT.3.PL+PQP+2+SG
reconvocaras-me	reconvocar+V.eu.AD.1.SG+PQP+2+SG
reconvocaras-te	reconvocar+V.tu.AD.2.SG+PQP+2+SG
reconvocaras-vos	reconvocar+V.vós.AD.2.PL+PQP+2+SG
reconvocara-te	reconvocar+V.tu.AD.2.SG+PQP+1+SG
reconvocara-te	reconvocar+V.tu.AD.2.SG+PQP+3+SG
reconvocara-vos	reconvocar+V.vós.AD.2.PL+PQP+1+SG
reconvocara-vos	reconvocar+V.vós.AD.2.PL+PQP+3+SG
reconvocarde-la	reconvocar+V.ele.ACC.3.F.SG+INF+2+PL
reconvocarde-la	reconvocar+V.ele.ACC.3.F.SG+SBJF+2+PL
reconvocarde-las	reconvocar+V.ele.ACC.3.F.PL+INF+2+PL
reconvocarde-las	reconvocar+V.ele.ACC.3.F.PL+SBJF+2+PL
reconvocarde-lo	reconvocar+V.ele.ACC.3.M.SG+INF+2+PL
reconvocarde-lo	reconvocar+V.ele.ACC.3.M.SG+SBJF+2+PL
reconvocarde-los	reconvocar+V.ele.ACC.3.M.PL+INF+2+PL
reconvocarde-los	reconvocar+V.ele.ACC.3.M.PL+SBJF+2+PL
reconvocarde-nos	reconvocar+nós.AD.1.PL+INF+2+PL
reconvocarde-nos	reconvocar+nós.AD.1.PL+SBJF+2+PL
reconvocardes-lhe	reconvocar+V.ele.DAT.3.SG+INF+2+PL
reconvocardes-lhe	reconvocar+V.ele.DAT.3.SG+SBJF+2+PL
reconvocardes-lhes	reconvocar+V.ele.DAT.3.PL+INF+2+PL
reconvocardes-lhes	reconvocar+V.ele.DAT.3.PL+SBJF+2+PL
reconvocardes-me	reconvocar+V.eu.AD.1.SG+INF+2+PL
reconvocardes-me	reconvocar+V.eu.AD.1.SG+SBJF+2+PL
reconvocardes-te	reconvocar+V.tu.AD.2.SG+INF+2+PL
reconvocardes-te	reconvocar+V.tu.AD.2.SG+SBJF+2+PL
reconvocardes-vos	reconvocar+V.vós.AD.2.PL+INF+2+PL
reconvocardes-vos	reconvocar+V.vós.AD.2.PL+SBJF+2+PL
reconvocárei-la	reconvocar+V.ele.ACC.3.F.SG+PQP+2+PL
reconvocárei-las	reconvocar+V.ele.ACC.3.F.PL+PQP+2+PL
reconvocárei-lo	reconvocar+V.ele.ACC.3.M.SG+PQP+2+PL
reconvocárei-los	reconvocar+V.ele.ACC.3.M.PL+PQP+2+PL
reconvocárei-nos	reconvocar+nós.AD.1.PL+PQP+2+PL
reconvocáreis-lhe	reconvocar+V.ele.DAT.3.SG+PQP+2+PL
reconvocáreis-lhes	reconvocar+V.ele.DAT.3.PL+PQP+2+PL
reconvocáreis-me	reconvocar+V.eu.AD.1.SG+PQP+2+PL
reconvocáreis-te	reconvocar+V.tu.AD.2.SG+PQP+2+PL
reconvocáreis-vos	reconvocar+V.vós.AD.2.PL+PQP+2+PL
reconvocare-la	reconvocar+V.ele.ACC.3.F.SG+INF+2+SG
reconvocare-la	reconvocar+V.ele.ACC.3.F.SG+SBJF+2+SG
reconvocare-las	reconvocar+V.ele.ACC.3.F.PL+INF+2+SG
reconvocare-las	reconvocar+V.ele.ACC.3.F.PL+SBJF+2+SG
reconvocare-lo	reconvocar+V.ele.ACC.3.M.SG+INF+2+SG
reconvocare-lo	reconvocar+V.ele.ACC.3.M.SG+SBJF+2+SG
reconvocare-los	reconvocar+V.ele.ACC.3.M.PL+INF+2+SG
reconvocare-los	reconvocar+V.ele.ACC.3.M.PL+SBJF+2+SG
reconvocarem-lhe	reconvocar+V.ele.DAT.3.SG+INF+3+PL
reconvocarem-lhe	reconvocar+V.ele.DAT.3.SG+SBJF+3+PL
reconvocarem-lhes	reconvocar+V.ele.DAT.3.PL+INF+3+PL
reconvocarem-lhes	reconvocar+V.ele.DAT.3.PL+SBJF+3+PL
reconvocarem-me	reconvocar+V.eu.AD.1.SG+INF+3+PL
reconvocarem-me	reconvocar+V.eu.AD.1.SG+SBJF+3+PL
reconvocarem-na	reconvocar+V.ele.ACC.3.F.SG+INF+3+PL
reconvocarem-na	reconvocar+V.ele.ACC.3.F.SG+SBJF+3+PL
reconvocarem-nas	reconvocar+V.ele.ACC.3.F.PL+INF+3+PL
reconvocarem-nas	reconvocar+V.ele.ACC.3.F.PL+SBJF+3+PL
reconvocarem-no	reconvocar+V.ele.ACC.3.M.SG+INF+3+PL
reconvocarem-no	reconvocar+V.ele.ACC.3.M.SG+SBJF+3+PL
reconvocarem-nos	reconvocar+V.ele.ACC.3.M.PL+INF+3+PL
reconvocarem-nos	reconvocar+V.ele.ACC.3.M.PL+SBJF+3+PL
reconvocarem-nos	reconvocar+V.nós.AD.1.PL+INF+3+PL
reconvocarem-nos	reconvocar+V.nós.AD.1.PL+SBJF+3+PL
reconvocarem-se	reconvocar+V.ele.REFL+INF+3+PL
reconvocarem-se	reconvocar+V.ele.REFL+SBJF+3+PL
reconvocarem-te	reconvocar+V.tu.AD.2.SG+INF+3+PL
reconvocarem-te	reconvocar+V.tu.AD.2.SG+SBJF+3+PL
reconvocarem-vos	reconvocar+V.vós.AD.2.PL+INF+3+PL
reconvocarem-vos	reconvocar+V.vós.AD.2.PL+SBJF+3+PL
reconvocare-nos	reconvocar+nós.AD.1.PL+INF+2+SG
reconvocare-nos	reconvocar+nós.AD.1.PL+SBJF+2+SG
reconvocares-lhe	reconvocar+V.ele.DAT.3.SG+INF+2+SG
reconvocares-lhe	reconvocar+V.ele.DAT.3.SG+SBJF+2+SG
reconvocares-lhes	reconvocar+V.ele.DAT.3.PL+INF+2+SG
reconvocares-lhes	reconvocar+V.ele.DAT.3.PL+SBJF+2+SG
reconvocares-me	reconvocar+V.eu.AD.1.SG+INF+2+SG
reconvocares-me	reconvocar+V.eu.AD.1.SG+SBJF+2+SG
reconvocares-te	reconvocar+V.tu.AD.2.SG+INF+2+SG
reconvocares-te	reconvocar+V.tu.AD.2.SG+SBJF+2+SG
reconvocares-vos	reconvocar+V.vós.AD.2.PL+INF+2+SG
reconvocares-vos	reconvocar+V.vós.AD.2.PL+SBJF+2+SG
reconvocar-lhe-ão	reconvocar+V.ele.DAT.3.SG+FUT+3+PL
reconvocar-lhe-á	reconvocar+V.ele.DAT.3.SG+FUT+3+SG
reconvocar-lhe-ás	reconvocar+V.ele.DAT.3.SG+FUT+2+SG
reconvocar-lhe-ei	reconvocar+V.ele.DAT.3.SG+FUT+1+SG
reconvocar-lhe-eis	reconvocar+V.ele.DAT.3.SG+FUT+2+PL
reconvocar-lhe-emos	reconvocar+V.ele.DAT.3.SG+FUT+1+PL
reconvocar-lhe-íamos	reconvocar+V.ele.DAT.3.SG+COND+1+PL
reconvocar-lhe-iam	reconvocar+V.ele.DAT.3.SG+COND+3+PL
reconvocar-lhe-ia	reconvocar+V.ele.DAT.3.SG+COND+1+SG
reconvocar-lhe-ia	reconvocar+V.ele.DAT.3.SG+COND+3+SG
reconvocar-lhe-ias	reconvocar+V.ele.DAT.3.SG+COND+2+SG
reconvocar-lhe-íeis	reconvocar+V.ele.DAT.3.SG+COND+2+PL
reconvocar-lhe	reconvocar+V.ele.DAT.3.SG+INF
reconvocar-lhe	reconvocar+V.ele.DAT.3.SG+INF+1+SG
reconvocar-lhe	reconvocar+V.ele.DAT.3.SG+INF+3+SG
reconvocar-lhe	reconvocar+V.ele.DAT.3.SG+SBJF+1+SG
reconvocar-lhe	reconvocar+V.ele.DAT.3.SG+SBJF+3+SG
reconvocar-lhes-ão	reconvocar+V.ele.DAT.3.PL+FUT+3+PL
reconvocar-lhes-á	reconvocar+V.ele.DAT.3.PL+FUT+3+SG
reconvocar-lhes-ás	reconvocar+V.ele.DAT.3.PL+FUT+2+SG
reconvocar-lhes-ei	reconvocar+V.ele.DAT.3.PL+FUT+1+SG
reconvocar-lhes-eis	reconvocar+V.ele.DAT.3.PL+FUT+2+PL
reconvocar-lhes-emos	reconvocar+V.ele.DAT.3.PL+FUT+1+PL
reconvocar-lhes-íamos	reconvocar+V.ele.DAT.3.PL+COND+1+PL
reconvocar-lhes-iam	reconvocar+V.ele.DAT.3.PL+COND+3+PL
reconvocar-lhes-ia	reconvocar+V.ele.DAT.3.PL+COND+1+SG
reconvocar-lhes-ia	reconvocar+V.ele.DAT.3.PL+COND+3+SG
reconvocar-lhes-ias	reconvocar+V.ele.DAT.3.PL+COND+2+SG
reconvocar-lhes-íeis	reconvocar+V.ele.DAT.3.PL+COND+2+PL
reconvocar-lhes	reconvocar+V.ele.DAT.3.PL+INF
reconvocar-lhes	reconvocar+V.ele.DAT.3.PL+INF+1+SG
reconvocar-lhes	reconvocar+V.ele.DAT.3.PL+INF+3+SG
reconvocar-lhes	reconvocar+V.ele.DAT.3.PL+SBJF+1+SG
reconvocar-lhes	reconvocar+V.ele.DAT.3.PL+SBJF+3+SG
reconvocar-me-ão	reconvocar+V.eu.AD.1.SG+FUT+3+PL
reconvocar-me-á	reconvocar+V.eu.AD.1.SG+FUT+3+SG
reconvocar-me-ás	reconvocar+V.eu.AD.1.SG+FUT+2+SG
reconvocar-me-ei	reconvocar+V.eu.AD.1.SG+FUT+1+SG
reconvocar-me-eis	reconvocar+V.eu.AD.1.SG+FUT+2+PL
reconvocar-me-emos	reconvocar+V.eu.AD.1.SG+FUT+1+PL
reconvocar-me-íamos	reconvocar+V.eu.AD.1.SG+COND+1+PL
reconvocar-me-iam	reconvocar+V.eu.AD.1.SG+COND+3+PL
reconvocar-me-ia	reconvocar+V.eu.AD.1.SG+COND+1+SG
reconvocar-me-ia	reconvocar+V.eu.AD.1.SG+COND+3+SG
reconvocar-me-ias	reconvocar+V.eu.AD.1.SG+COND+2+SG
reconvocar-me-íeis	reconvocar+V.eu.AD.1.SG+COND+2+PL
reconvocar-me	reconvocar+V.eu.AD.1.SG+INF
reconvocar-me	reconvocar+V.eu.AD.1.SG+INF+1+SG
reconvocar-me	reconvocar+V.eu.AD.1.SG+INF+3+SG
reconvocar-me	reconvocar+V.eu.AD.1.SG+SBJF+1+SG
reconvocar-me	reconvocar+V.eu.AD.1.SG+SBJF+3+SG
reconvocarmo-la	reconvocar+V.ele.ACC.3.F.SG+INF+1+PL
