recongraçar-lhe	recongraçar+V.ele.DAT.3.SG+INF
recongraçar-lhe	recongraçar+V.ele.DAT.3.SG+INF+1+SG
recongraçar-lhe	recongraçar+V.ele.DAT.3.SG+INF+3+SG
recongraçar-lhe	recongraçar+V.ele.DAT.3.SG+SBJF+1+SG
recongraçar-lhe	recongraçar+V.ele.DAT.3.SG+SBJF+3+SG
recongraçar-lhes-ão	recongraçar+V.ele.DAT.3.PL+FUT+3+PL
recongraçar-lhes-á	recongraçar+V.ele.DAT.3.PL+FUT+3+SG
recongraçar-lhes-ás	recongraçar+V.ele.DAT.3.PL+FUT+2+SG
recongraçar-lhes-ei	recongraçar+V.ele.DAT.3.PL+FUT+1+SG
recongraçar-lhes-eis	recongraçar+V.ele.DAT.3.PL+FUT+2+PL
recongraçar-lhes-emos	recongraçar+V.ele.DAT.3.PL+FUT+1+PL
recongraçar-lhes-íamos	recongraçar+V.ele.DAT.3.PL+COND+1+PL
recongraçar-lhes-iam	recongraçar+V.ele.DAT.3.PL+COND+3+PL
recongraçar-lhes-ia	recongraçar+V.ele.DAT.3.PL+COND+1+SG
recongraçar-lhes-ia	recongraçar+V.ele.DAT.3.PL+COND+3+SG
recongraçar-lhes-ias	recongraçar+V.ele.DAT.3.PL+COND+2+SG
recongraçar-lhes-íeis	recongraçar+V.ele.DAT.3.PL+COND+2+PL
recongraçar-lhes	recongraçar+V.ele.DAT.3.PL+INF
recongraçar-lhes	recongraçar+V.ele.DAT.3.PL+INF+1+SG
recongraçar-lhes	recongraçar+V.ele.DAT.3.PL+INF+3+SG
recongraçar-lhes	recongraçar+V.ele.DAT.3.PL+SBJF+1+SG
recongraçar-lhes	recongraçar+V.ele.DAT.3.PL+SBJF+3+SG
recongraçar-me-ão	recongraçar+V.eu.AD.1.SG+FUT+3+PL
recongraçar-me-á	recongraçar+V.eu.AD.1.SG+FUT+3+SG
recongraçar-me-ás	recongraçar+V.eu.AD.1.SG+FUT+2+SG
recongraçar-me-ei	recongraçar+V.eu.AD.1.SG+FUT+1+SG
recongraçar-me-eis	recongraçar+V.eu.AD.1.SG+FUT+2+PL
recongraçar-me-emos	recongraçar+V.eu.AD.1.SG+FUT+1+PL
recongraçar-me-íamos	recongraçar+V.eu.AD.1.SG+COND+1+PL
recongraçar-me-iam	recongraçar+V.eu.AD.1.SG+COND+3+PL
recongraçar-me-ia	recongraçar+V.eu.AD.1.SG+COND+1+SG
recongraçar-me-ia	recongraçar+V.eu.AD.1.SG+COND+3+SG
recongraçar-me-ias	recongraçar+V.eu.AD.1.SG+COND+2+SG
recongraçar-me-íeis	recongraçar+V.eu.AD.1.SG+COND+2+PL
recongraçar-me	recongraçar+V.eu.AD.1.SG+INF
recongraçar-me	recongraçar+V.eu.AD.1.SG+INF+1+SG
recongraçar-me	recongraçar+V.eu.AD.1.SG+INF+3+SG
recongraçar-me	recongraçar+V.eu.AD.1.SG+SBJF+1+SG
recongraçar-me	recongraçar+V.eu.AD.1.SG+SBJF+3+SG
recongraçarmo-la	recongraçar+V.ele.ACC.3.F.SG+INF+1+PL
recongraçarmo-la	recongraçar+V.ele.ACC.3.F.SG+SBJF+1+PL
recongraçarmo-las	recongraçar+V.ele.ACC.3.F.PL+INF+1+PL
recongraçarmo-las	recongraçar+V.ele.ACC.3.F.PL+SBJF+1+PL
recongraçarmo-lo	recongraçar+V.ele.ACC.3.M.SG+INF+1+PL
recongraçarmo-lo	recongraçar+V.ele.ACC.3.M.SG+SBJF+1+PL
recongraçarmo-los	recongraçar+V.ele.ACC.3.M.PL+INF+1+PL
recongraçarmo-los	recongraçar+V.ele.ACC.3.M.PL+SBJF+1+PL
recongraçarmo-nos	recongraçar+nós.AD.1.PL+INF+1+PL
recongraçarmo-nos	recongraçar+nós.AD.1.PL+SBJF+1+PL
recongraçarmos-lhe	recongraçar+V.ele.DAT.3.SG+INF+1+PL
recongraçarmos-lhe	recongraçar+V.ele.DAT.3.SG+SBJF+1+PL
recongraçarmos-lhes	recongraçar+V.ele.DAT.3.PL+INF+1+PL
recongraçarmos-lhes	recongraçar+V.ele.DAT.3.PL+SBJF+1+PL
recongraçarmos-me	recongraçar+V.eu.AD.1.SG+INF+1+PL
recongraçarmos-me	recongraçar+V.eu.AD.1.SG+SBJF+1+PL
recongraçarmos-te	recongraçar+V.tu.AD.2.SG+INF+1+PL
recongraçarmos-te	recongraçar+V.tu.AD.2.SG+SBJF+1+PL
recongraçarmos-vos	recongraçar+V.vós.AD.2.PL+INF+1+PL
recongraçarmos-vos	recongraçar+V.vós.AD.2.PL+SBJF+1+PL
recongraçar-nos-ão	recongraçar+nós.AD.1.PL+FUT+3+PL
recongraçar-nos-á	recongraçar+nós.AD.1.PL+FUT+3+SG
recongraçar-nos-ás	recongraçar+nós.AD.1.PL+FUT+2+SG
recongraçar-nos-ei	recongraçar+nós.AD.1.PL+FUT+1+SG
recongraçar-nos-eis	recongraçar+nós.AD.1.PL+FUT+2+PL
recongraçar-nos-emos	recongraçar+nós.AD.1.PL+FUT+1+PL
recongraçar-nos-íamos	recongraçar+nós.AD.1.PL+COND+1+PL
recongraçar-nos-iam	recongraçar+nós.AD.1.PL+COND+3+PL
recongraçar-nos-ia	recongraçar+nós.AD.1.PL+COND+1+SG
recongraçar-nos-ia	recongraçar+nós.AD.1.PL+COND+3+SG
recongraçar-nos-ias	recongraçar+nós.AD.1.PL+COND+2+SG
recongraçar-nos-íeis	recongraçar+nós.AD.1.PL+COND+2+PL
recongraçar-nos	recongraçar+nós.AD.1.PL+INF
recongraçar-nos	recongraçar+nós.AD.1.PL+INF+1+SG
recongraçar-nos	recongraçar+nós.AD.1.PL+INF+3+SG
recongraçar-nos	recongraçar+nós.AD.1.PL+SBJF+1+SG
recongraçar-nos	recongraçar+nós.AD.1.PL+SBJF+3+SG
recongraçar-se-ão	recongraçar+V.ele.REFL+FUT+3+PL
recongraçar-se-á	recongraçar+V.ele.REFL+FUT+3+SG
recongraçar-se-iam	recongraçar+V.ele.REFL+COND+3+PL
recongraçar-se-ia	recongraçar+V.ele.REFL+COND+3+SG
recongraçar-se	recongraçar+V.ele.REFL+INF
recongraçar-se	recongraçar+V.ele.REFL+INF+3+SG
recongraçar-se	recongraçar+V.ele.REFL+SBJF+3+SG
recongraçar-te-ão	recongraçar+V.tu.AD.2.SG+FUT+3+PL
recongraçar-te-á	recongraçar+V.tu.AD.2.SG+FUT+3+SG
recongraçar-te-ás	recongraçar+V.tu.AD.2.SG+FUT+2+SG
recongraçar-te-ei	recongraçar+V.tu.AD.2.SG+FUT+1+SG
recongraçar-te-eis	recongraçar+V.tu.AD.2.SG+FUT+2+PL
recongraçar-te-emos	recongraçar+V.tu.AD.2.SG+FUT+1+PL
recongraçar-te-íamos	recongraçar+V.tu.AD.2.SG+COND+1+PL
recongraçar-te-iam	recongraçar+V.tu.AD.2.SG+COND+3+PL
recongraçar-te-ia	recongraçar+V.tu.AD.2.SG+COND+1+SG
recongraçar-te-ia	recongraçar+V.tu.AD.2.SG+COND+3+SG
recongraçar-te-ias	recongraçar+V.tu.AD.2.SG+COND+2+SG
recongraçar-te-íeis	recongraçar+V.tu.AD.2.SG+COND+2+PL
recongraçar-te	recongraçar+V.tu.AD.2.SG+INF
recongraçar-te	recongraçar+V.tu.AD.2.SG+INF+1+SG
recongraçar-te	recongraçar+V.tu.AD.2.SG+INF+3+SG
recongraçar-te	recongraçar+V.tu.AD.2.SG+SBJF+1+SG
recongraçar-te	recongraçar+V.tu.AD.2.SG+SBJF+3+SG
recongraçar-vos-ão	recongraçar+V.vós.AD.2.PL+FUT+3+PL
recongraçar-vos-á	recongraçar+V.vós.AD.2.PL+FUT+3+SG
recongraçar-vos-ás	recongraçar+V.vós.AD.2.PL+FUT+2+SG
recongraçar-vos-ei	recongraçar+V.vós.AD.2.PL+FUT+1+SG
recongraçar-vos-eis	recongraçar+V.vós.AD.2.PL+FUT+2+PL
recongraçar-vos-emos	recongraçar+V.vós.AD.2.PL+FUT+1+PL
recongraçar-vos-íamos	recongraçar+V.vós.AD.2.PL+COND+1+PL
recongraçar-vos-iam	recongraçar+V.vós.AD.2.PL+COND+3+PL
recongraçar-vos-ia	recongraçar+V.vós.AD.2.PL+COND+1+SG
recongraçar-vos-ia	recongraçar+V.vós.AD.2.PL+COND+3+SG
recongraçar-vos-ias	recongraçar+V.vós.AD.2.PL+COND+2+SG
recongraçar-vos-íeis	recongraçar+V.vós.AD.2.PL+COND+2+PL
recongraçar-vos	recongraçar+V.vós.AD.2.PL+INF
recongraçar-vos	recongraçar+V.vós.AD.2.PL+INF+1+SG
recongraçar-vos	recongraçar+V.vós.AD.2.PL+INF+3+SG
recongraçar-vos	recongraçar+V.vós.AD.2.PL+SBJF+1+SG
recongraçar-vos	recongraçar+V.vós.AD.2.PL+SBJF+3+SG
recongraça-se	recongraçar+V.ele.REFL+PRS+3+SG
recongraças-lhe	recongraçar+V.ele.DAT.3.SG+PRS+2+SG
recongraças-lhes	recongraçar+V.ele.DAT.3.PL+PRS+2+SG
recongraças-me	recongraçar+V.eu.AD.1.SG+PRS+2+SG
recongraçaste-la	recongraçar+V.ele.ACC.3.F.SG+PRF+2+PL
recongraçaste-las	recongraçar+V.ele.ACC.3.F.PL+PRF+2+PL
recongraçaste-lo	recongraçar+V.ele.ACC.3.M.SG+PRF+2+PL
recongraçaste-los	recongraçar+V.ele.ACC.3.M.PL+PRF+2+PL
recongraçaste-nos	recongraçar+nós.AD.1.PL+PRF+2+PL
recongraças-te	recongraçar+V.tu.AD.2.SG+PRS+2+SG
recongraçastes-lhe	recongraçar+V.ele.DAT.3.SG+PRF+2+PL
recongraçastes-lhes	recongraçar+V.ele.DAT.3.PL+PRF+2+PL
recongraçastes-me	recongraçar+V.eu.AD.1.SG+PRF+2+PL
recongraçastes-te	recongraçar+V.tu.AD.2.SG+PRF+2+PL
recongraçastes-vos	recongraçar+V.vós.AD.2.PL+PRF+2+PL
recongraças-vos	recongraçar+V.vós.AD.2.PL+PRS+2+SG
recongraça-te	recongraçar+V.tu.AD.2.SG+PRS+3+SG
recongraçava-a	recongraçar+V.ele.ACC.3.F.SG+IMPF+1+SG
recongraçava-a	recongraçar+V.ele.ACC.3.F.SG+IMPF+3+SG
recongraçava-as	recongraçar+V.ele.ACC.3.F.PL+IMPF+1+SG
recongraçava-as	recongraçar+V.ele.ACC.3.F.PL+IMPF+3+SG
recongraçava-la	recongraçar+V.ele.ACC.3.F.SG+IMPF+2+SG
recongraçava-las	recongraçar+V.ele.ACC.3.F.PL+IMPF+2+SG
recongraçava-lhe	recongraçar+V.ele.DAT.3.SG+IMPF+1+SG
recongraçava-lhe	recongraçar+V.ele.DAT.3.SG+IMPF+3+SG
recongraçava-lhes	recongraçar+V.ele.DAT.3.PL+IMPF+1+SG
recongraçava-lhes	recongraçar+V.ele.DAT.3.PL+IMPF+3+SG
recongraçava-lo	recongraçar+V.ele.ACC.3.M.SG+IMPF+2+SG
recongraçava-los	recongraçar+V.ele.ACC.3.M.PL+IMPF+2+SG
recongraçava-me	recongraçar+V.eu.AD.1.SG+IMPF+1+SG
recongraçava-me	recongraçar+V.eu.AD.1.SG+IMPF+3+SG
recongraçavam-lhe	recongraçar+V.ele.DAT.3.SG+IMPF+3+PL
recongraçavam-lhes	recongraçar+V.ele.DAT.3.PL+IMPF+3+PL
recongraçavam-me	recongraçar+V.eu.AD.1.SG+IMPF+3+PL
recongraçavam-na	recongraçar+V.ele.ACC.3.F.SG+IMPF+3+PL
recongraçavam-nas	recongraçar+V.ele.ACC.3.F.PL+IMPF+3+PL
recongraçavam-no	recongraçar+V.ele.ACC.3.M.SG+IMPF+3+PL
recongraçavam-nos	recongraçar+nós.AD.1.PL+IMPF+3+PL
recongraçávamo-la	recongraçar+V.ele.ACC.3.F.SG+IMPF+1+PL
recongraçávamo-las	recongraçar+V.ele.ACC.3.F.PL+IMPF+1+PL
recongraçávamo-lo	recongraçar+V.ele.ACC.3.M.SG+IMPF+1+PL
recongraçávamo-los	recongraçar+V.ele.ACC.3.M.PL+IMPF+1+PL
recongraçávamo-nos	recongraçar+nós.AD.1.PL+IMPF+1+PL
recongraçávamos-lhe	recongraçar+V.ele.DAT.3.SG+IMPF+1+PL
recongraçávamos-lhes	recongraçar+V.ele.DAT.3.PL+IMPF+1+PL
recongraçávamos-me	recongraçar+V.eu.AD.1.SG+IMPF+1+PL
recongraçávamos-te	recongraçar+V.tu.AD.2.SG+IMPF+1+PL
recongraçávamos-vos	recongraçar+V.vós.AD.2.PL+IMPF+1+PL
recongraçavam-se	recongraçar+V.ele.REFL+IMPF+3+PL
recongraçavam-te	recongraçar+V.tu.AD.2.SG+IMPF+3+PL
recongraçavam-vos	recongraçar+V.vós.AD.2.PL+IMPF+3+PL
recongraçava-nos	recongraçar+nós.AD.1.PL+IMPF+1+SG
recongraçava-nos	recongraçar+nós.AD.1.PL+IMPF+2+SG
recongraçava-nos	recongraçar+nós.AD.1.PL+IMPF+3+SG
recongraçava-o	recongraçar+V.ele.ACC.3.M.SG+IMPF+1+SG
recongraçava-o	recongraçar+V.ele.ACC.3.M.SG+IMPF+3+SG
recongraçava-os	recongraçar+V.ele.ACC.3.M.PL+IMPF+1+SG
recongraçava-os	recongraçar+V.ele.ACC.3.M.PL+IMPF+3+SG
recongraçava-se	recongraçar+V.ele.REFL+IMPF+1+SG
recongraçava-se	recongraçar+V.ele.REFL+IMPF+3+SG
recongraçavas-lhe	recongraçar+V.ele.DAT.3.SG+IMPF+2+SG
recongraçavas-lhes	recongraçar+V.ele.DAT.3.PL+IMPF+2+SG
recongraçavas-me	recongraçar+V.eu.AD.1.SG+IMPF+2+SG
recongraçavas-te	recongraçar+V.tu.AD.2.SG+IMPF+2+SG
recongraçavas-vos	recongraçar+V.vós.AD.2.PL+IMPF+2+SG
recongraçava-te	recongraçar+V.tu.AD.2.SG+IMPF+1+SG
recongraçava-te	recongraçar+V.tu.AD.2.SG+IMPF+3+SG
recongraçava-vos	recongraçar+V.vós.AD.2.PL+IMPF+1+SG
recongraçava-vos	recongraçar+V.vós.AD.2.PL+IMPF+3+SG
recongraçávei-la	recongraçar+V.ele.ACC.3.F.SG+IMPF+2+PL
recongraçávei-las	recongraçar+V.ele.ACC.3.F.PL+IMPF+2+PL
recongraçávei-lo	recongraçar+V.ele.ACC.3.M.SG+IMPF+2+PL
recongraçávei-los	recongraçar+V.ele.ACC.3.M.PL+IMPF+2+PL
recongraçávei-nos	recongraçar+nós.AD.1.PL+IMPF+2+PL
recongraçáveis-lhe	recongraçar+V.ele.DAT.3.SG+IMPF+2+PL
recongraçáveis-lhes	recongraçar+V.ele.DAT.3.PL+IMPF+2+PL
recongraçáveis-me	recongraçar+V.eu.AD.1.SG+IMPF+2+PL
recongraçáveis-te	recongraçar+V.tu.AD.2.SG+IMPF+2+PL
recongraçáveis-vos	recongraçar+V.vós.AD.2.PL+IMPF+2+PL
recongraça-vos	recongraçar+V.vós.AD.2.PL+PRS+3+SG
recongrace-a	recongraçar+V.ele.ACC.3.F.SG+IMP+3+SG
recongrace-as	recongraçar+V.ele.ACC.3.F.PL+IMP+3+SG
recongracei-a	recongraçar+V.ele.ACC.3.F.SG+PRF+1+SG
recongracei-as	recongraçar+V.ele.ACC.3.F.PL+PRF+1+SG
recongracei-lhe	recongraçar+V.ele.DAT.3.SG+PRF+1+SG
recongracei-lhes	recongraçar+V.ele.DAT.3.PL+PRF+1+SG
recongracei-me	recongraçar+V.eu.AD.1.SG+PRF+1+SG
recongracei-nos	recongraçar+nós.AD.1.PL+PRF+1+SG
recongracei-o	recongraçar+V.ele.ACC.3.M.SG+PRF+1+SG
recongracei-os	recongraçar+V.ele.ACC.3.M.PL+PRF+1+SG
recongracei-te	recongraçar+V.tu.AD.2.SG+PRF+1+SG
recongracei-vos	recongraçar+V.vós.AD.2.PL+PRF+1+SG
recongrace-lhe	recongraçar+V.ele.DAT.3.SG+IMP+3+SG
recongrace-lhes	recongraçar+V.ele.DAT.3.PL+IMP+3+SG
recongrace-me	recongraçar+V.eu.AD.1.SG+IMP+3+SG
recongracem-lhe	recongraçar+V.ele.DAT.3.SG+IMP+3+PL
recongracem-lhes	recongraçar+V.ele.DAT.3.PL+IMP+3+PL
recongracem-me	recongraçar+V.eu.AD.1.SG+IMP+3+PL
recongracem-na	recongraçar+V.ele.ACC.3.F.SG+IMP+3+PL
recongracem-nas	recongraçar+V.ele.ACC.3.F.PL+IMP+3+PL
recongracem-no	recongraçar+V.ele.ACC.3.M.SG+IMP+3+PL
recongracem-nos	recongraçar+V.ele.ACC.3.M.PL+IMP+3+PL
recongracem-nos	recongraçar+V.nós.AD.1.PL+IMP+3+PL
recongracemo-la	recongraçar+V.ele.ACC.3.F.SG+IMP+1+PL
recongracemo-las	recongraçar+V.ele.ACC.3.F.PL+IMP+1+PL
recongracemo-lo	recongraçar+V.ele.ACC.3.M.SG+IMP+1+PL
recongracemo-los	recongraçar+V.ele.ACC.3.M.PL+IMP+1+PL
recongracemo-nos	recongraçar+nós.AD.1.PL+IMP+1+PL
recongracemos-lhe	recongraçar+V.ele.DAT.3.SG+IMP+1+PL
recongracemos-lhes	recongraçar+V.ele.DAT.3.PL+IMP+1+PL
recongracemos-me	recongraçar+V.eu.AD.1.SG+IMP+1+PL
recongracemos-te	recongraçar+V.tu.AD.2.SG+IMP+1+PL
recongracemos-vos	recongraçar+V.vós.AD.2.PL+IMP+1+PL
recongracem-se	recongraçar+V.ele.REFL+IMP+3+PL
recongracem-te	recongraçar+V.tu.AD.2.SG+IMP+3+PL
recongracem-vos	recongraçar+V.vós.AD.2.PL+IMP+3+PL
recongrace-nos	recongraçar+nós.AD.1.PL+IMP+3+SG
recongrace-o	recongraçar+V.ele.ACC.3.M.SG+IMP+3+SG
recongrace-os	recongraçar+V.ele.ACC.3.M.PL+IMP+3+SG
recongrace-se	recongraçar+V.ele.REFL+IMP+3+SG
recongrace-te	recongraçar+V.tu.AD.2.SG+IMP+3+SG
recongrace-vos	recongraçar+V.vós.AD.2.PL+IMP+3+SG
recongraço-a	recongraçar+V.ele.ACC.3.F.SG+PRS+1+SG
recongraço-as	recongraçar+V.ele.ACC.3.F.PL+PRS+1+SG
recongraço-lhe	recongraçar+V.ele.DAT.3.SG+PRS+1+SG
recongraço-lhes	recongraçar+V.ele.DAT.3.PL+PRS+1+SG
recongraço-me	recongraçar+V.eu.AD.1.SG+PRS+1+SG
recongraço-nos	recongraçar+nós.AD.1.PL+PRS+1+SG
recongraço-o	recongraçar+V.ele.ACC.3.M.SG+PRS+1+SG
recongraço-os	recongraçar+V.ele.ACC.3.M.PL+PRS+1+SG
recongraço-te	recongraçar+V.tu.AD.2.SG+PRS+1+SG
recongraçou-a	recongraçar+V.ele.ACC.3.F.SG+PRF+3+SG
recongraçou-as	recongraçar+V.ele.ACC.3.F.PL+PRF+3+SG
recongraçou-lhe	recongraçar+V.ele.DAT.3.SG+PRF+3+SG
recongraçou-lhes	recongraçar+V.ele.DAT.3.PL+PRF+3+SG
recongraçou-me	recongraçar+V.eu.AD.1.SG+PRF+3+SG
recongraçou-nos	recongraçar+nós.AD.1.PL+PRF+3+SG
recongraçou-o	recongraçar+V.ele.ACC.3.M.SG+PRF+3+SG
recongraçou-os	recongraçar+V.ele.ACC.3.M.PL+PRF+3+SG
recongraçou-se	recongraçar+V.ele.REFL+PRF+3+SG
recongraçou-te	recongraçar+V.tu.AD.2.SG+PRF+3+SG
recongraçou-vos	recongraçar+V.vós.AD.2.PL+PRF+3+SG
recongraço-vos	recongraçar+V.vós.AD.2.PL+PRS+1+SG
reconheça-a	reconhecer+V.ele.ACC.3.F.SG+IMP+3+SG
reconheça-as	reconhecer+V.ele.ACC.3.F.PL+IMP+3+SG
reconheça-lhe	reconhecer+V.ele.DAT.3.SG+IMP+3+SG
reconheça-lhes	reconhecer+V.ele.DAT.3.PL+IMP+3+SG
reconheça-me	reconhecer+V.eu.AD.1.SG+IMP+3+SG
reconheçam-lhe	reconhecer+V.ele.DAT.3.SG+IMP+3+PL
reconheçam-lhes	reconhecer+V.ele.DAT.3.PL+IMP+3+PL
reconheçam-me	reconhecer+V.eu.AD.1.SG+IMP+3+PL
reconheçam-na	reconhecer+V.ele.ACC.3.F.SG+IMP+3+PL
reconheçam-nas	reconhecer+V.ele.ACC.3.F.PL+IMP+3+PL
reconheçam-no	reconhecer+V.ele.ACC.3.M.SG+IMP+3+PL
reconheçam-nos	reconhecer+nós.AD.1.PL+IMP+3+PL
reconheçamo-la	reconhecer+V.ele.ACC.3.F.SG+IMP+1+PL
reconheçamo-las	reconhecer+V.ele.ACC.3.F.PL+IMP+1+PL
reconheçamo-lo	reconhecer+V.ele.ACC.3.M.SG+IMP+1+PL
reconheçamo-los	reconhecer+V.ele.ACC.3.M.PL+IMP+1+PL
reconheçamo-nos	reconhecer+nós.AD.1.PL+IMP+1+PL
reconheçamos-lhe	reconhecer+V.ele.DAT.3.SG+IMP+1+PL
reconheçamos-lhes	reconhecer+V.ele.DAT.3.PL+IMP+1+PL
reconheçamos-me	reconhecer+V.eu.AD.1.SG+IMP+1+PL
reconheçamos-te	reconhecer+V.tu.AD.2.SG+IMP+1+PL
reconheçamos-vos	reconhecer+V.vós.AD.2.PL+IMP+1+PL
reconheçam-se	reconhecer+V.ele.REFL+IMP+3+PL
reconheçam-te	reconhecer+V.tu.AD.2.SG+IMP+3+PL
reconheçam-vos	reconhecer+V.vós.AD.2.PL+IMP+3+PL
reconheça-nos	reconhecer+nós.AD.1.PL+IMP+3+SG
reconheça-o	reconhecer+V.ele.ACC.3.M.SG+IMP+3+SG
reconheça-os	reconhecer+V.ele.ACC.3.M.PL+IMP+3+SG
reconheça-se	reconhecer+V.ele.REFL+IMP+3+SG
reconheça-te	reconhecer+V.tu.AD.2.SG+IMP+3+SG
reconheça-vos	reconhecer+V.vós.AD.2.PL+IMP+3+SG
reconhecei-la	reconhecer+V.ele.ACC.3.F.SG+PRS+2+PL
reconhecei-las	reconhecer+V.ele.ACC.3.F.PL+PRS+2+PL
reconhecei-lo	reconhecer+V.ele.ACC.3.M.SG+PRS+2+PL
reconhecei-los	reconhecer+V.ele.ACC.3.M.PL+PRS+2+PL
reconhecei-nos	reconhecer+nós.AD.1.PL+PRS+2+PL
reconheceis-lhe	reconhecer+V.ele.DAT.3.SG+PRS+2+PL
reconheceis-lhes	reconhecer+V.ele.DAT.3.PL+PRS+2+PL
reconheceis-me	reconhecer+V.eu.AD.1.SG+PRS+2+PL
reconheceis-te	reconhecer+V.tu.AD.2.SG+PRS+2+PL
reconheceis-vos	reconhecer+V.vós.AD.2.PL+PRS+2+PL
reconhecê-la-ão	reconhecer+V.ele.ACC.3.F.SG+FUT+3+PL
reconhecê-la-á	reconhecer+V.ele.ACC.3.F.SG+FUT+3+SG
reconhecê-la-ás	reconhecer+V.ele.ACC.3.F.SG+FUT+2+SG
reconhecê-la-ei	reconhecer+V.ele.ACC.3.F.SG+FUT+1+SG
reconhecê-la-eis	reconhecer+V.ele.ACC.3.F.SG+FUT+2+PL
reconhecê-la-emos	reconhecer+V.ele.ACC.3.F.SG+FUT+1+PL
reconhecê-la-íamos	reconhecer+V.ele.ACC.3.F.SG+COND+1+PL
reconhecê-la-iam	reconhecer+V.ele.ACC.3.F.SG+COND+3+PL
reconhecê-la-ia	reconhecer+V.ele.ACC.3.F.SG+COND+1+SG
reconhecê-la-ia	reconhecer+V.ele.ACC.3.F.SG+COND+3+SG
reconhecê-la-ias	reconhecer+V.ele.ACC.3.F.SG+COND+2+SG
reconhecê-la-íeis	reconhecer+V.ele.ACC.3.F.SG+COND+2+PL
reconhecê-la	reconhecer+V.ele.ACC.3.F.SG+INF
reconhecê-la	reconhecer+V.ele.ACC.3.F.SG+INF+1+SG
reconhecê-la	reconhecer+V.ele.ACC.3.F.SG+INF+3+SG
reconhece-la	reconhecer+V.ele.ACC.3.F.SG+PRS+2+SG
reconhecê-la	reconhecer+V.ele.ACC.3.F.SG+SBJF+1+SG
reconhecê-la	reconhecer+V.ele.ACC.3.F.SG+SBJF+3+SG
reconhecê-las-ão	reconhecer+V.ele.ACC.3.F.PL+FUT+3+PL
reconhecê-las-á	reconhecer+V.ele.ACC.3.F.PL+FUT+3+SG
reconhecê-las-ás	reconhecer+V.ele.ACC.3.F.PL+FUT+2+SG
reconhecê-las-ei	reconhecer+V.ele.ACC.3.F.PL+FUT+1+SG
reconhecê-las-eis	reconhecer+V.ele.ACC.3.F.PL+FUT+2+PL
reconhecê-las-emos	reconhecer+V.ele.ACC.3.F.PL+FUT+1+PL
reconhecê-las-íamos	reconhecer+V.ele.ACC.3.F.PL+COND+1+PL
reconhecê-las-iam	reconhecer+V.ele.ACC.3.F.PL+COND+3+PL
reconhecê-las-ia	reconhecer+V.ele.ACC.3.F.PL+COND+1+SG
reconhecê-las-ia	reconhecer+V.ele.ACC.3.F.PL+COND+3+SG
reconhecê-las-ias	reconhecer+V.ele.ACC.3.F.PL+COND+2+SG
reconhecê-las-íeis	reconhecer+V.ele.ACC.3.F.PL+COND+2+PL
reconhecê-las	reconhecer+V.ele.ACC.3.F.PL+INF
reconhecê-las	reconhecer+V.ele.ACC.3.F.PL+INF+1+SG
reconhecê-las	reconhecer+V.ele.ACC.3.F.PL+INF+3+SG
reconhece-las	reconhecer+V.ele.ACC.3.F.PL+PRS+2+SG
reconhecê-las	reconhecer+V.ele.ACC.3.F.PL+SBJF+1+SG
reconhecê-las	reconhecer+V.ele.ACC.3.F.PL+SBJF+3+SG
reconhecê-lo-ão	reconhecer+V.ele.ACC.3.M.SG+FUT+3+PL
reconhecê-lo-á	reconhecer+V.ele.ACC.3.M.SG+FUT+3+SG
reconhecê-lo-ás	reconhecer+V.ele.ACC.3.M.SG+FUT+2+SG
reconhecê-lo-ei	reconhecer+V.ele.ACC.3.M.SG+FUT+1+SG
reconhecê-lo-eis	reconhecer+V.ele.ACC.3.M.SG+FUT+2+PL
reconhecê-lo-emos	reconhecer+V.ele.ACC.3.M.SG+FUT+1+PL
reconhecê-lo-íamos	reconhecer+V.ele.ACC.3.M.SG+COND+1+PL
reconhecê-lo-iam	reconhecer+V.ele.ACC.3.M.SG+COND+3+PL
reconhecê-lo-ia	reconhecer+V.ele.ACC.3.M.SG+COND+1+SG
reconhecê-lo-ia	reconhecer+V.ele.ACC.3.M.SG+COND+3+SG
reconhecê-lo-ias	reconhecer+V.ele.ACC.3.M.SG+COND+2+SG
reconhecê-lo-íeis	reconhecer+V.ele.ACC.3.M.SG+COND+2+PL
reconhecê-lo	reconhecer+V.ele.ACC.3.M.SG+INF
reconhecê-lo	reconhecer+V.ele.ACC.3.M.SG+INF+1+SG
reconhecê-lo	reconhecer+V.ele.ACC.3.M.SG+INF+3+SG
reconhece-lo	reconhecer+V.ele.ACC.3.M.SG+PRS+2+SG
reconhecê-lo	reconhecer+V.ele.ACC.3.M.SG+SBJF+1+SG
reconhecê-lo	reconhecer+V.ele.ACC.3.M.SG+SBJF+3+SG
reconhecê-los-ão	reconhecer+V.ele.ACC.3.M.PL+FUT+3+PL
reconhecê-los-á	reconhecer+V.ele.ACC.3.M.PL+FUT+3+SG
reconhecê-los-ás	reconhecer+V.ele.ACC.3.M.PL+FUT+2+SG
reconhecê-los-ei	reconhecer+V.ele.ACC.3.M.PL+FUT+1+SG
reconhecê-los-eis	reconhecer+V.ele.ACC.3.M.PL+FUT+2+PL
reconhecê-los-emos	reconhecer+V.ele.ACC.3.M.PL+FUT+1+PL
reconhecê-los-íamos	reconhecer+V.ele.ACC.3.M.PL+COND+1+PL
reconhecê-los-iam	reconhecer+V.ele.ACC.3.M.PL+COND+3+PL
reconhecê-los-ia	reconhecer+V.ele.ACC.3.M.PL+COND+1+SG
reconhecê-los-ia	reconhecer+V.ele.ACC.3.M.PL+COND+3+SG
reconhecê-los-ias	reconhecer+V.ele.ACC.3.M.PL+COND+2+SG
reconhecê-los-íeis	reconhecer+V.ele.ACC.3.M.PL+COND+2+PL
reconhecê-los	reconhecer+V.ele.ACC.3.M.PL+INF
reconhecê-los	reconhecer+V.ele.ACC.3.M.PL+INF+1+SG
reconhecê-los	reconhecer+V.ele.ACC.3.M.PL+INF+3+SG
reconhece-los	reconhecer+V.ele.ACC.3.M.PL+PRS+2+SG
reconhecê-los	reconhecer+V.ele.ACC.3.M.PL+SBJF+1+SG
reconhecê-los	reconhecer+V.ele.ACC.3.M.PL+SBJF+3+SG
reconhecem-lhe	reconhecer+V.ele.DAT.3.SG+PRS+3+PL
reconhecem-lhes	reconhecer+V.ele.DAT.3.PL+PRS+3+PL
reconhecem-me	reconhecer+V.eu.AD.1.SG+PRS+3+PL
reconhecem-na	reconhecer+V.ele.ACC.3.F.SG+PRS+3+PL
reconhecem-nas	reconhecer+V.ele.ACC.3.F.PL+PRS+3+PL
reconhecem-no	reconhecer+V.ele.ACC.3.M.SG+PRS+3+PL
reconhecem-nos	reconhecer+V.ele.ACC.3.M.PL+PRS+3+PL
reconhecem-nos	reconhecer+V.nós.AD.1.PL+PRS+3+PL
reconhecemo-la	reconhecer+V.ele.ACC.3.F.SG+PRF+1+PL
reconhecemo-la	reconhecer+V.ele.ACC.3.F.SG+PRS+1+PL
reconhecemo-las	reconhecer+V.ele.ACC.3.F.PL+PRF+1+PL
reconhecemo-las	reconhecer+V.ele.ACC.3.F.PL+PRS+1+PL
reconhecemo-lo	reconhecer+V.ele.ACC.3.M.SG+PRF+1+PL
reconhecemo-lo	reconhecer+V.ele.ACC.3.M.SG+PRS+1+PL
reconhecemo-los	reconhecer+V.ele.ACC.3.M.PL+PRF+1+PL
reconhecemo-los	reconhecer+V.ele.ACC.3.M.PL+PRS+1+PL
reconhecemo-nos	reconhecer+nós.AD.1.PL+PRF+1+PL
reconhecemo-nos	reconhecer+nós.AD.1.PL+PRS+1+PL
reconhecemos-lhe	reconhecer+V.ele.DAT.3.SG+PRF+1+PL
reconhecemos-lhe	reconhecer+V.ele.DAT.3.SG+PRS+1+PL
reconhecemos-lhes	reconhecer+V.ele.DAT.3.PL+PRF+1+PL
reconhecemos-lhes	reconhecer+V.ele.DAT.3.PL+PRS+1+PL
reconhecemos-me	reconhecer+V.eu.AD.1.SG+PRF+1+PL
reconhecemos-me	reconhecer+V.eu.AD.1.SG+PRS+1+PL
reconhecemos-te	reconhecer+V.tu.AD.2.SG+PRF+1+PL
reconhecemos-te	reconhecer+V.tu.AD.2.SG+PRS+1+PL
reconhecemos-vos	reconhecer+V.vós.AD.2.PL+PRF+1+PL
reconhecemos-vos	reconhecer+V.vós.AD.2.PL+PRS+1+PL
reconhecem-se	reconhecer+V.ele.REFL+PRS+3+PL
reconhecem-te	reconhecer+V.tu.AD.2.SG+PRS+3+PL
reconhecem-vos	reconhecer+V.vós.AD.2.PL+PRS+3+PL
reconhecendo-a	reconhecer+V.ele.ACC.3.F.SG+GRD
reconhecendo-as	reconhecer+V.ele.ACC.3.F.PL+GRD
reconhecendo-lhe	reconhecer+V.ele.DAT.3.SG+GRD
reconhecendo-lhes	reconhecer+V.ele.DAT.3.PL+GRD
reconhecendo-me	reconhecer+V.eu.AD.1.SG+GRD
reconhecendo-nos	reconhecer+nós.AD.1.PL+GRD
reconhecendo-o	reconhecer+V.ele.ACC.3.M.SG+GRD
reconhecendo-os	reconhecer+V.ele.ACC.3.M.PL+GRD
reconhecendo-se	reconhecer+V.ele.REFL+GRD
reconhecendo-te	reconhecer+V.tu.AD.2.SG+GRD
reconhecendo-vos	reconhecer+V.vós.AD.2.PL+GRD
reconhece-nos	reconhecer+nós.AD.1.PL+PRS+2+SG
reconhecera-a	reconhecer+V.ele.ACC.3.F.SG+PQP+1+SG
reconhecera-a	reconhecer+V.ele.ACC.3.F.SG+PQP+3+SG
reconhecera-as	reconhecer+V.ele.ACC.3.F.PL+PQP+1+SG
reconhecera-as	reconhecer+V.ele.ACC.3.F.PL+PQP+3+SG
reconhecera-la	reconhecer+V.ele.ACC.3.F.SG+PQP+2+SG
reconhecera-las	reconhecer+V.ele.ACC.3.F.PL+PQP+2+SG
reconhecera-lhe	reconhecer+V.ele.DAT.3.SG+PQP+1+SG
reconhecera-lhe	reconhecer+V.ele.DAT.3.SG+PQP+3+SG
reconhecera-lhes	reconhecer+V.ele.DAT.3.PL+PQP+1+SG
reconhecera-lhes	reconhecer+V.ele.DAT.3.PL+PQP+3+SG
reconhecera-lo	reconhecer+V.ele.ACC.3.M.SG+PQP+2+SG
reconhecera-los	reconhecer+V.ele.ACC.3.M.PL+PQP+2+SG
reconhecera-me	reconhecer+V.eu.AD.1.SG+PQP+1+SG
reconhecera-me	reconhecer+V.eu.AD.1.SG+PQP+3+SG
reconheceram-lhe	reconhecer+V.ele.DAT.3.SG+PQP+3+PL
reconheceram-lhe	reconhecer+V.ele.DAT.3.SG+PRF+3+PL
reconheceram-lhes	reconhecer+V.ele.DAT.3.PL+PQP+3+PL
reconheceram-lhes	reconhecer+V.ele.DAT.3.PL+PRF+3+PL
reconheceram-me	reconhecer+V.eu.AD.1.SG+PQP+3+PL
reconheceram-me	reconhecer+V.eu.AD.1.SG+PRF+3+PL
reconheceram-na	reconhecer+V.ele.ACC.3.F.SG+PQP+3+PL
reconheceram-na	reconhecer+V.ele.ACC.3.F.SG+PRF+3+PL
reconheceram-nas	reconhecer+V.ele.ACC.3.F.PL+PQP+3+PL
reconheceram-nas	reconhecer+V.ele.ACC.3.F.PL+PRF+3+PL
reconheceram-no	reconhecer+V.ele.ACC.3.M.SG+PQP+3+PL
reconheceram-no	reconhecer+V.ele.ACC.3.M.SG+PRF+3+PL
reconheceram-nos	reconhecer+V.ele.ACC.3.M.PL+PQP+3+PL
reconheceram-nos	reconhecer+V.ele.ACC.3.M.PL+PRF+3+PL
reconheceram-nos	reconhecer+V.nós.AD.1.PL+PQP+3+PL
reconheceram-nos	reconhecer+V.nós.AD.1.PL+PRF+3+PL
reconhecêramo-la	reconhecer+V.ele.ACC.3.F.SG+PQP+1+PL
reconhecêramo-las	reconhecer+V.ele.ACC.3.F.PL+PQP+1+PL
reconhecêramo-lo	reconhecer+V.ele.ACC.3.M.SG+PQP+1+PL
reconhecêramo-los	reconhecer+V.ele.ACC.3.M.PL+PQP+1+PL
reconhecêramo-nos	reconhecer+nós.AD.1.PL+PQP+1+PL
reconhecêramos-lhe	reconhecer+V.ele.DAT.3.SG+PQP+1+PL
reconhecêramos-lhes	reconhecer+V.ele.DAT.3.PL+PQP+1+PL
reconhecêramos-me	reconhecer+V.eu.AD.1.SG+PQP+1+PL
reconhecêramos-te	reconhecer+V.tu.AD.2.SG+PQP+1+PL
reconhecêramos-vos	reconhecer+V.vós.AD.2.PL+PQP+1+PL
reconheceram-se	reconhecer+V.ele.REFL+PQP+3+PL
reconheceram-se	reconhecer+V.ele.REFL+PRF+3+PL
reconheceram-te	reconhecer+V.tu.AD.2.SG+PQP+3+PL
reconheceram-te	reconhecer+V.tu.AD.2.SG+PRF+3+PL
reconheceram-vos	reconhecer+V.vós.AD.2.PL+PQP+3+PL
reconheceram-vos	reconhecer+V.vós.AD.2.PL+PRF+3+PL
reconhecera-nos	reconhecer+nós.AD.1.PL+PQP+1+SG
reconhecera-nos	reconhecer+nós.AD.1.PL+PQP+2+SG
reconhecera-nos	reconhecer+nós.AD.1.PL+PQP+3+SG
reconhecera-o	reconhecer+V.ele.ACC.3.M.SG+PQP+1+SG
reconhecera-o	reconhecer+V.ele.ACC.3.M.SG+PQP+3+SG
reconhecera-os	reconhecer+V.ele.ACC.3.M.PL+PQP+1+SG
reconhecera-os	reconhecer+V.ele.ACC.3.M.PL+PQP+3+SG
reconhecera-se	reconhecer+V.ele.REFL+PQP+3+SG
reconheceras-lhe	reconhecer+V.ele.DAT.3.SG+PQP+2+SG
reconheceras-lhes	reconhecer+V.ele.DAT.3.PL+PQP+2+SG
reconheceras-me	reconhecer+V.eu.AD.1.SG+PQP+2+SG
reconheceras-te	reconhecer+V.tu.AD.2.SG+PQP+2+SG
reconheceras-vos	reconhecer+V.vós.AD.2.PL+PQP+2+SG
reconhecera-te	reconhecer+V.tu.AD.2.SG+PQP+1+SG
reconhecera-te	reconhecer+V.tu.AD.2.SG+PQP+3+SG
reconhecera-vos	reconhecer+V.vós.AD.2.PL+PQP+1+SG
reconhecera-vos	reconhecer+V.vós.AD.2.PL+PQP+3+SG
reconhecerde-la	reconhecer+V.ele.ACC.3.F.SG+INF+2+PL
reconhecerde-la	reconhecer+V.ele.ACC.3.F.SG+SBJF+2+PL
reconhecerde-las	reconhecer+V.ele.ACC.3.F.PL+INF+2+PL
reconhecerde-las	reconhecer+V.ele.ACC.3.F.PL+SBJF+2+PL
reconhecerde-lo	reconhecer+V.ele.ACC.3.M.SG+INF+2+PL
reconhecerde-lo	reconhecer+V.ele.ACC.3.M.SG+SBJF+2+PL
reconhecerde-los	reconhecer+V.ele.ACC.3.M.PL+INF+2+PL
reconhecerde-los	reconhecer+V.ele.ACC.3.M.PL+SBJF+2+PL
reconhecerde-nos	reconhecer+nós.AD.1.PL+INF+2+PL
reconhecerde-nos	reconhecer+nós.AD.1.PL+SBJF+2+PL
reconhecerdes-lhe	reconhecer+V.ele.DAT.3.SG+INF+2+PL
reconhecerdes-lhe	reconhecer+V.ele.DAT.3.SG+SBJF+2+PL
reconhecerdes-lhes	reconhecer+V.ele.DAT.3.PL+INF+2+PL
reconhecerdes-lhes	reconhecer+V.ele.DAT.3.PL+SBJF+2+PL
reconhecerdes-me	reconhecer+V.eu.AD.1.SG+INF+2+PL
reconhecerdes-me	reconhecer+V.eu.AD.1.SG+SBJF+2+PL
reconhecerdes-te	reconhecer+V.tu.AD.2.SG+INF+2+PL
reconhecerdes-te	reconhecer+V.tu.AD.2.SG+SBJF+2+PL
reconhecerdes-vos	reconhecer+V.vós.AD.2.PL+INF+2+PL
reconhecerdes-vos	reconhecer+V.vós.AD.2.PL+SBJF+2+PL
reconhecêrei-la	reconhecer+V.ele.ACC.3.F.SG+PQP+2+PL
reconhecêrei-las	reconhecer+V.ele.ACC.3.F.PL+PQP+2+PL
reconhecêrei-lo	reconhecer+V.ele.ACC.3.M.SG+PQP+2+PL
reconhecêrei-los	reconhecer+V.ele.ACC.3.M.PL+PQP+2+PL
reconhecêrei-nos	reconhecer+nós.AD.1.PL+PQP+2+PL
reconhecêreis-lhe	reconhecer+V.ele.DAT.3.SG+PQP+2+PL
reconhecêreis-lhes	reconhecer+V.ele.DAT.3.PL+PQP+2+PL
reconhecêreis-me	reconhecer+V.eu.AD.1.SG+PQP+2+PL
reconhecêreis-te	reconhecer+V.tu.AD.2.SG+PQP+2+PL
reconhecêreis-vos	reconhecer+V.vós.AD.2.PL+PQP+2+PL
reconhecere-la	reconhecer+V.ele.ACC.3.F.SG+INF+2+SG
reconhecere-la	reconhecer+V.ele.ACC.3.F.SG+SBJF+2+SG
reconhecere-las	reconhecer+V.ele.ACC.3.F.PL+INF+2+SG
reconhecere-las	reconhecer+V.ele.ACC.3.F.PL+SBJF+2+SG
reconhecere-lo	reconhecer+V.ele.ACC.3.M.SG+INF+2+SG
reconhecere-lo	reconhecer+V.ele.ACC.3.M.SG+SBJF+2+SG
reconhecere-los	reconhecer+V.ele.ACC.3.M.PL+INF+2+SG
reconhecere-los	reconhecer+V.ele.ACC.3.M.PL+SBJF+2+SG
reconhecerem-lhe	reconhecer+V.ele.DAT.3.SG+INF+3+PL
reconhecerem-lhe	reconhecer+V.ele.DAT.3.SG+SBJF+3+PL
reconhecerem-lhes	reconhecer+V.ele.DAT.3.PL+INF+3+PL
reconhecerem-lhes	reconhecer+V.ele.DAT.3.PL+SBJF+3+PL
reconhecerem-me	reconhecer+V.eu.AD.1.SG+INF+3+PL
reconhecerem-me	reconhecer+V.eu.AD.1.SG+SBJF+3+PL
reconhecerem-na	reconhecer+V.ele.ACC.3.F.SG+INF+3+PL
reconhecerem-na	reconhecer+V.ele.ACC.3.F.SG+SBJF+3+PL
reconhecerem-nas	reconhecer+V.ele.ACC.3.F.PL+INF+3+PL
reconhecerem-nas	reconhecer+V.ele.ACC.3.F.PL+SBJF+3+PL
reconhecerem-no	reconhecer+V.ele.ACC.3.M.SG+INF+3+PL
reconhecerem-no	reconhecer+V.ele.ACC.3.M.SG+SBJF+3+PL
reconhecerem-nos	reconhecer+V.ele.ACC.3.M.PL+INF+3+PL
reconhecerem-nos	reconhecer+V.ele.ACC.3.M.PL+SBJF+3+PL
reconhecerem-nos	reconhecer+V.nós.AD.1.PL+INF+3+PL
reconhecerem-nos	reconhecer+V.nós.AD.1.PL+SBJF+3+PL
reconhecerem-se	reconhecer+V.ele.REFL+INF+3+PL
reconhecerem-se	reconhecer+V.ele.REFL+SBJF+3+PL
reconhecerem-te	reconhecer+V.tu.AD.2.SG+INF+3+PL
reconhecerem-te	reconhecer+V.tu.AD.2.SG+SBJF+3+PL
reconhecerem-vos	reconhecer+V.vós.AD.2.PL+INF+3+PL
reconhecerem-vos	reconhecer+V.vós.AD.2.PL+SBJF+3+PL
reconhecere-nos	reconhecer+nós.AD.1.PL+INF+2+SG
reconhecere-nos	reconhecer+nós.AD.1.PL+SBJF+2+SG
reconheceres-lhe	reconhecer+V.ele.DAT.3.SG+INF+2+SG
reconheceres-lhe	reconhecer+V.ele.DAT.3.SG+SBJF+2+SG
reconheceres-lhes	reconhecer+V.ele.DAT.3.PL+INF+2+SG
reconheceres-lhes	reconhecer+V.ele.DAT.3.PL+SBJF+2+SG
reconheceres-me	reconhecer+V.eu.AD.1.SG+INF+2+SG
reconheceres-me	reconhecer+V.eu.AD.1.SG+SBJF+2+SG
reconheceres-te	reconhecer+V.tu.AD.2.SG+INF+2+SG
reconheceres-te	reconhecer+V.tu.AD.2.SG+SBJF+2+SG
reconheceres-vos	reconhecer+V.vós.AD.2.PL+INF+2+SG
reconheceres-vos	reconhecer+V.vós.AD.2.PL+SBJF+2+SG
reconhecer-lhe-ão	reconhecer+V.ele.DAT.3.SG+FUT+3+PL
reconhecer-lhe-á	reconhecer+V.ele.DAT.3.SG+FUT+3+SG
reconhecer-lhe-ás	reconhecer+V.ele.DAT.3.SG+FUT+2+SG
reconhecer-lhe-ei	reconhecer+V.ele.DAT.3.SG+FUT+1+SG
reconhecer-lhe-eis	reconhecer+V.ele.DAT.3.SG+FUT+2+PL
reconhecer-lhe-emos	reconhecer+V.ele.DAT.3.SG+FUT+1+PL
reconhecer-lhe-íamos	reconhecer+V.ele.DAT.3.SG+COND+1+PL
reconhecer-lhe-iam	reconhecer+V.ele.DAT.3.SG+COND+3+PL
reconhecer-lhe-ia	reconhecer+V.ele.DAT.3.SG+COND+1+SG
reconhecer-lhe-ia	reconhecer+V.ele.DAT.3.SG+COND+3+SG
reconhecer-lhe-ias	reconhecer+V.ele.DAT.3.SG+COND+2+SG
reconhecer-lhe-íeis	reconhecer+V.ele.DAT.3.SG+COND+2+PL
reconhecer-lhe	reconhecer+V.ele.DAT.3.SG+INF
reconhecer-lhe	reconhecer+V.ele.DAT.3.SG+INF+1+SG
reconhecer-lhe	reconhecer+V.ele.DAT.3.SG+INF+3+SG
reconhecer-lhe	reconhecer+V.ele.DAT.3.SG+SBJF+1+SG
reconhecer-lhe	reconhecer+V.ele.DAT.3.SG+SBJF+3+SG
reconhecer-lhes-ão	reconhecer+V.ele.DAT.3.PL+FUT+3+PL
reconhecer-lhes-á	reconhecer+V.ele.DAT.3.PL+FUT+3+SG
reconhecer-lhes-ás	reconhecer+V.ele.DAT.3.PL+FUT+2+SG
reconhecer-lhes-ei	reconhecer+V.ele.DAT.3.PL+FUT+1+SG
reconhecer-lhes-eis	reconhecer+V.ele.DAT.3.PL+FUT+2+PL
reconhecer-lhes-emos	reconhecer+V.ele.DAT.3.PL+FUT+1+PL
reconhecer-lhes-íamos	reconhecer+V.ele.DAT.3.PL+COND+1+PL
reconhecer-lhes-iam	reconhecer+V.ele.DAT.3.PL+COND+3+PL
reconhecer-lhes-ia	reconhecer+V.ele.DAT.3.PL+COND+1+SG
reconhecer-lhes-ia	reconhecer+V.ele.DAT.3.PL+COND+3+SG
reconhecer-lhes-ias	reconhecer+V.ele.DAT.3.PL+COND+2+SG
reconhecer-lhes-íeis	reconhecer+V.ele.DAT.3.PL+COND+2+PL
reconhecer-lhes	reconhecer+V.ele.DAT.3.PL+INF
reconhecer-lhes	reconhecer+V.ele.DAT.3.PL+INF+1+SG
reconhecer-lhes	reconhecer+V.ele.DAT.3.PL+INF+3+SG
reconhecer-lhes	reconhecer+V.ele.DAT.3.PL+SBJF+1+SG
reconhecer-lhes	reconhecer+V.ele.DAT.3.PL+SBJF+3+SG
reconhecer-me-ão	reconhecer+V.eu.AD.1.SG+FUT+3+PL
reconhecer-me-á	reconhecer+V.eu.AD.1.SG+FUT+3+SG
reconhecer-me-ás	reconhecer+V.eu.AD.1.SG+FUT+2+SG
reconhecer-me-ei	reconhecer+V.eu.AD.1.SG+FUT+1+SG
reconhecer-me-eis	reconhecer+V.eu.AD.1.SG+FUT+2+PL
reconhecer-me-emos	reconhecer+V.eu.AD.1.SG+FUT+1+PL
reconhecer-me-íamos	reconhecer+V.eu.AD.1.SG+COND+1+PL
reconhecer-me-iam	reconhecer+V.eu.AD.1.SG+COND+3+PL
reconhecer-me-ia	reconhecer+V.eu.AD.1.SG+COND+1+SG
reconhecer-me-ia	reconhecer+V.eu.AD.1.SG+COND+3+SG
reconhecer-me-ias	reconhecer+V.eu.AD.1.SG+COND+2+SG
reconhecer-me-íeis	reconhecer+V.eu.AD.1.SG+COND+2+PL
reconhecer-me	reconhecer+V.eu.AD.1.SG+INF
reconhecer-me	reconhecer+V.eu.AD.1.SG+INF+1+SG
reconhecer-me	reconhecer+V.eu.AD.1.SG+INF+3+SG
reconhecer-me	reconhecer+V.eu.AD.1.SG+SBJF+1+SG
reconhecer-me	reconhecer+V.eu.AD.1.SG+SBJF+3+SG
reconhecermo-la	reconhecer+V.ele.ACC.3.F.SG+INF+1+PL
reconhecermo-la	reconhecer+V.ele.ACC.3.F.SG+SBJF+1+PL
reconhecermo-las	reconhecer+V.ele.ACC.3.F.PL+INF+1+PL
reconhecermo-las	reconhecer+V.ele.ACC.3.F.PL+SBJF+1+PL
reconhecermo-lo	reconhecer+V.ele.ACC.3.M.SG+INF+1+PL
reconhecermo-lo	reconhecer+V.ele.ACC.3.M.SG+SBJF+1+PL
reconhecermo-los	reconhecer+V.ele.ACC.3.M.PL+INF+1+PL
reconhecermo-los	reconhecer+V.ele.ACC.3.M.PL+SBJF+1+PL
reconhecermo-nos	reconhecer+nós.AD.1.PL+INF+1+PL
reconhecermo-nos	reconhecer+nós.AD.1.PL+SBJF+1+PL
reconhecermos-lhe	reconhecer+V.ele.DAT.3.SG+INF+1+PL
reconhecermos-lhe	reconhecer+V.ele.DAT.3.SG+SBJF+1+PL
reconhecermos-lhes	reconhecer+V.ele.DAT.3.PL+INF+1+PL
reconhecermos-lhes	reconhecer+V.ele.DAT.3.PL+SBJF+1+PL
reconhecermos-me	reconhecer+V.eu.AD.1.SG+INF+1+PL
reconhecermos-me	reconhecer+V.eu.AD.1.SG+SBJF+1+PL
reconhecermos-te	reconhecer+V.tu.AD.2.SG+INF+1+PL
reconhecermos-te	reconhecer+V.tu.AD.2.SG+SBJF+1+PL
reconhecermos-vos	reconhecer+V.vós.AD.2.PL+INF+1+PL
reconhecermos-vos	reconhecer+V.vós.AD.2.PL+SBJF+1+PL
reconhecer-nos-ão	reconhecer+nós.AD.1.PL+FUT+3+PL
reconhecer-nos-á	reconhecer+nós.AD.1.PL+FUT+3+SG
reconhecer-nos-ás	reconhecer+nós.AD.1.PL+FUT+2+SG
reconhecer-nos-ei	reconhecer+nós.AD.1.PL+FUT+1+SG
reconhecer-nos-eis	reconhecer+nós.AD.1.PL+FUT+2+PL
reconhecer-nos-emos	reconhecer+nós.AD.1.PL+FUT+1+PL
reconhecer-nos-íamos	reconhecer+nós.AD.1.PL+COND+1+PL
reconhecer-nos-iam	reconhecer+nós.AD.1.PL+COND+3+PL
reconhecer-nos-ia	reconhecer+nós.AD.1.PL+COND+1+SG
reconhecer-nos-ia	reconhecer+nós.AD.1.PL+COND+3+SG
reconhecer-nos-ias	reconhecer+nós.AD.1.PL+COND+2+SG
reconhecer-nos-íeis	reconhecer+nós.AD.1.PL+COND+2+PL
reconhecer-nos	reconhecer+nós.AD.1.PL+INF
reconhecer-nos	reconhecer+nós.AD.1.PL+INF+1+SG
reconhecer-nos	reconhecer+nós.AD.1.PL+INF+3+SG
reconhecer-nos	reconhecer+nós.AD.1.PL+SBJF+1+SG
reconhecer-nos	reconhecer+nós.AD.1.PL+SBJF+3+SG
reconhecer-se-ão	reconhecer+V.ele.REFL+FUT+3+PL
reconhecer-se-á	reconhecer+V.ele.REFL+FUT+3+SG
reconhecer-se-iam	reconhecer+V.ele.REFL+COND+3+PL
reconhecer-se-ia	reconhecer+V.ele.REFL+COND+3+SG
reconhecer-se	reconhecer+V.ele.REFL+INF
reconhecer-se	reconhecer+V.ele.REFL+INF+3+SG
reconhecer-se	reconhecer+V.ele.REFL+SBJF+3+SG
reconhecer-te-ão	reconhecer+V.tu.AD.2.SG+FUT+3+PL
reconhecer-te-á	reconhecer+V.tu.AD.2.SG+FUT+3+SG
reconhecer-te-ás	reconhecer+V.tu.AD.2.SG+FUT+2+SG
reconhecer-te-ei	reconhecer+V.tu.AD.2.SG+FUT+1+SG
reconhecer-te-eis	reconhecer+V.tu.AD.2.SG+FUT+2+PL
reconhecer-te-emos	reconhecer+V.tu.AD.2.SG+FUT+1+PL
reconhecer-te-íamos	reconhecer+V.tu.AD.2.SG+COND+1+PL
reconhecer-te-iam	reconhecer+V.tu.AD.2.SG+COND+3+PL
reconhecer-te-ia	reconhecer+V.tu.AD.2.SG+COND+1+SG
reconhecer-te-ia	reconhecer+V.tu.AD.2.SG+COND+3+SG
reconhecer-te-ias	reconhecer+V.tu.AD.2.SG+COND+2+SG
reconhecer-te-íeis	reconhecer+V.tu.AD.2.SG+COND+2+PL
reconhecer-te	reconhecer+V.tu.AD.2.SG+INF
reconhecer-te	reconhecer+V.tu.AD.2.SG+INF+1+SG
reconhecer-te	reconhecer+V.tu.AD.2.SG+INF+3+SG
reconhecer-te	reconhecer+V.tu.AD.2.SG+SBJF+1+SG
reconhecer-te	reconhecer+V.tu.AD.2.SG+SBJF+3+SG
reconhecer-vos-ão	reconhecer+V.vós.AD.2.PL+FUT+3+PL
reconhecer-vos-á	reconhecer+V.vós.AD.2.PL+FUT+3+SG
reconhecer-vos-ás	reconhecer+V.vós.AD.2.PL+FUT+2+SG
reconhecer-vos-ei	reconhecer+V.vós.AD.2.PL+FUT+1+SG
reconhecer-vos-eis	reconhecer+V.vós.AD.2.PL+FUT+2+PL
reconhecer-vos-emos	reconhecer+V.vós.AD.2.PL+FUT+1+PL
reconhecer-vos-íamos	reconhecer+V.vós.AD.2.PL+COND+1+PL
reconhecer-vos-iam	reconhecer+V.vós.AD.2.PL+COND+3+PL
reconhecer-vos-ia	reconhecer+V.vós.AD.2.PL+COND+1+SG
reconhecer-vos-ia	reconhecer+V.vós.AD.2.PL+COND+3+SG
reconhecer-vos-ias	reconhecer+V.vós.AD.2.PL+COND+2+SG
reconhecer-vos-íeis	reconhecer+V.vós.AD.2.PL+COND+2+PL
reconhecer-vos	reconhecer+V.vós.AD.2.PL+INF
reconhecer-vos	reconhecer+V.vós.AD.2.PL+INF+1+SG
reconhecer-vos	reconhecer+V.vós.AD.2.PL+INF+3+SG
reconhecer-vos	reconhecer+V.vós.AD.2.PL+SBJF+1+SG
reconhecer-vos	reconhecer+V.vós.AD.2.PL+SBJF+3+SG
reconhece-se	reconhecer+V.ele.REFL+PRS+3+SG
reconheces-lhe	reconhecer+V.ele.DAT.3.SG+PRS+2+SG
reconheces-lhes	reconhecer+V.ele.DAT.3.PL+PRS+2+SG
reconheces-me	reconhecer+V.eu.AD.1.SG+PRS+2+SG
reconheceste-a	reconhecer+V.ele.ACC.3.F.SG+PRF+2+SG
reconheceste-as	reconhecer+V.ele.ACC.3.F.PL+PRF+2+SG
reconheceste-la	reconhecer+V.ele.ACC.3.F.SG+PRF+2+PL
reconheceste-las	reconhecer+V.ele.ACC.3.F.PL+PRF+2+PL
reconheceste-lhe	reconhecer+V.ele.DAT.3.SG+PRF+2+SG
reconheceste-lhes	reconhecer+V.ele.DAT.3.PL+PRF+2+SG
reconheceste-lo	reconhecer+V.ele.ACC.3.M.SG+PRF+2+PL
reconheceste-los	reconhecer+V.ele.ACC.3.M.PL+PRF+2+PL
reconheceste-me	reconhecer+V.eu.AD.1.SG+PRF+2+SG
reconheceste-nos	reconhecer+nós.AD.1.PL+PRF+2+PL
reconheceste-nos	reconhecer+nós.AD.1.PL+PRF+2+SG
reconheceste-o	reconhecer+V.ele.ACC.3.M.SG+PRF+2+SG
reconheceste-os	reconhecer+V.ele.ACC.3.M.PL+PRF+2+SG
reconheces-te	reconhecer+V.tu.AD.2.SG+PRS+2+SG
reconhecestes-lhe	reconhecer+V.ele.DAT.3.SG+PRF+2+PL
reconhecestes-lhes	reconhecer+V.ele.DAT.3.PL+PRF+2+PL
reconhecestes-me	reconhecer+V.eu.AD.1.SG+PRF+2+PL
reconhecestes-te	reconhecer+V.tu.AD.2.SG+PRF+2+PL
reconhecestes-vos	reconhecer+V.vós.AD.2.PL+PRF+2+PL
reconheceste-te	reconhecer+V.tu.AD.2.SG+PRF+2+SG
reconheceste-vos	reconhecer+V.vós.AD.2.PL+PRF+2+SG
reconheces-vos	reconhecer+V.vós.AD.2.PL+PRS+2+SG
reconheceu-a	reconhecer+V.ele.ACC.3.F.SG+PRF+3+SG
reconheceu-as	reconhecer+V.ele.ACC.3.F.PL+PRF+3+SG
reconheceu-lhe	reconhecer+V.ele.DAT.3.SG+PRF+3+SG
reconheceu-lhes	reconhecer+V.ele.DAT.3.PL+PRF+3+SG
reconheceu-me	reconhecer+V.eu.AD.1.SG+PRF+3+SG
reconheceu-nos	reconhecer+nós.AD.1.PL+PRF+3+SG
reconheceu-o	reconhecer+V.ele.ACC.3.M.SG+PRF+3+SG
reconheceu-os	reconhecer+V.ele.ACC.3.M.PL+PRF+3+SG
reconheceu-se	reconhecer+V.ele.REFL+PRF+3+SG
reconheceu-te	reconhecer+V.tu.AD.2.SG+PRF+3+SG
reconheceu-vos	reconhecer+V.vós.AD.2.PL+PRF+3+SG
reconhecia-a	reconhecer+V.ele.ACC.3.F.SG+IMPF+1+SG
reconhecia-a	reconhecer+V.ele.ACC.3.F.SG+IMPF+3+SG
reconhecia-as	reconhecer+V.ele.ACC.3.F.PL+IMPF+1+SG
reconhecia-as	reconhecer+V.ele.ACC.3.F.PL+IMPF+3+SG
reconhecia-la	reconhecer+V.ele.ACC.3.F.SG+IMPF+2+SG
reconhecia-las	reconhecer+V.ele.ACC.3.F.PL+IMPF+2+SG
reconhecia-lhe	reconhecer+V.ele.DAT.3.SG+IMPF+1+SG
reconhecia-lhe	reconhecer+V.ele.DAT.3.SG+IMPF+3+SG
reconhecia-lhes	reconhecer+V.ele.DAT.3.PL+IMPF+1+SG
reconhecia-lhes	reconhecer+V.ele.DAT.3.PL+IMPF+3+SG
reconhecia-lo	reconhecer+V.ele.ACC.3.M.SG+IMPF+2+SG
reconhecia-los	reconhecer+V.ele.ACC.3.M.PL+IMPF+2+SG
reconhecia-me	reconhecer+V.eu.AD.1.SG+IMPF+1+SG
reconhecia-me	reconhecer+V.eu.AD.1.SG+IMPF+3+SG
reconheciam-lhe	reconhecer+V.ele.DAT.3.SG+IMPF+3+PL
reconheciam-lhes	reconhecer+V.ele.DAT.3.PL+IMPF+3+PL
reconheciam-me	reconhecer+V.eu.AD.1.SG+IMPF+3+PL
reconheciam-na	reconhecer+V.ele.ACC.3.F.SG+IMPF+3+PL
reconheciam-nas	reconhecer+V.ele.ACC.3.F.PL+IMPF+3+PL
reconheciam-no	reconhecer+V.ele.ACC.3.M.SG+IMPF+3+PL
reconheciam-nos	reconhecer+V.ele.ACC.3.M.PL+IMPF+3+PL
reconheciam-nos	reconhecer+V.nós.AD.1.PL+IMPF+3+PL
reconhecíamo-la	reconhecer+V.ele.ACC.3.F.SG+IMPF+1+PL
reconhecíamo-las	reconhecer+V.ele.ACC.3.F.PL+IMPF+1+PL
reconhecíamo-lo	reconhecer+V.ele.ACC.3.M.SG+IMPF+1+PL
reconhecíamo-los	reconhecer+V.ele.ACC.3.M.PL+IMPF+1+PL
reconhecíamo-nos	reconhecer+nós.AD.1.PL+IMPF+1+PL
reconhecíamos-lhe	reconhecer+V.ele.DAT.3.SG+IMPF+1+PL
reconhecíamos-lhes	reconhecer+V.ele.DAT.3.PL+IMPF+1+PL
reconhecíamos-me	reconhecer+V.eu.AD.1.SG+IMPF+1+PL
reconhecíamos-te	reconhecer+V.tu.AD.2.SG+IMPF+1+PL
reconhecíamos-vos	reconhecer+V.vós.AD.2.PL+IMPF+1+PL
reconheciam-se	reconhecer+V.ele.REFL+IMPF+3+PL
reconheciam-te	reconhecer+V.tu.AD.2.SG+IMPF+3+PL
reconheciam-vos	reconhecer+V.vós.AD.2.PL+IMPF+3+PL
reconhecia-nos	reconhecer+nós.AD.1.PL+IMPF+1+SG
reconhecia-nos	reconhecer+nós.AD.1.PL+IMPF+2+SG
reconhecia-nos	reconhecer+nós.AD.1.PL+IMPF+3+SG
reconhecia-o	reconhecer+V.ele.ACC.3.M.SG+IMPF+1+SG
reconhecia-o	reconhecer+V.ele.ACC.3.M.SG+IMPF+3+SG
reconhecia-os	reconhecer+V.ele.ACC.3.M.PL+IMPF+1+SG
reconhecia-os	reconhecer+V.ele.ACC.3.M.PL+IMPF+3+SG
reconheci-a	reconhecer+V.ele.ACC.3.F.SG+PRF+1+SG
reconhecia-se	reconhecer+V.ele.REFL+IMPF+3+SG
reconhecias-lhe	reconhecer+V.ele.DAT.3.SG+IMPF+2+SG
reconhecias-lhes	reconhecer+V.ele.DAT.3.PL+IMPF+2+SG
reconhecias-me	reconhecer+V.eu.AD.1.SG+IMPF+2+SG
reconheci-as	reconhecer+V.ele.ACC.3.F.PL+PRF+1+SG
reconhecias-te	reconhecer+V.tu.AD.2.SG+IMPF+2+SG
reconhecias-vos	reconhecer+V.vós.AD.2.PL+IMPF+2+SG
reconhecia-te	reconhecer+V.tu.AD.2.SG+IMPF+1+SG
reconhecia-te	reconhecer+V.tu.AD.2.SG+IMPF+3+SG
reconhecia-vos	reconhecer+V.vós.AD.2.PL+IMPF+1+SG
reconhecia-vos	reconhecer+V.vós.AD.2.PL+IMPF+3+SG
reconhecíei-la	reconhecer+V.ele.ACC.3.F.SG+IMPF+2+PL
reconhecíei-las	reconhecer+V.ele.ACC.3.F.PL+IMPF+2+PL
reconhecíei-lo	reconhecer+V.ele.ACC.3.M.SG+IMPF+2+PL
reconhecíei-los	reconhecer+V.ele.ACC.3.M.PL+IMPF+2+PL
reconhecíei-nos	reconhecer+nós.AD.1.PL+IMPF+2+PL
reconhecíeis-lhe	reconhecer+V.ele.DAT.3.SG+IMPF+2+PL
reconhecíeis-lhes	reconhecer+V.ele.DAT.3.PL+IMPF+2+PL
reconhecíeis-me	reconhecer+V.eu.AD.1.SG+IMPF+2+PL
reconhecíeis-te	reconhecer+V.tu.AD.2.SG+IMPF+2+PL
reconhecíeis-vos	reconhecer+V.vós.AD.2.PL+IMPF+2+PL
reconheci-lhe	reconhecer+V.ele.DAT.3.SG+PRF+1+SG
reconheci-lhes	reconhecer+V.ele.DAT.3.PL+PRF+1+SG
reconheci-me	reconhecer+V.eu.AD.1.SG+PRF+1+SG
reconheci-nos	reconhecer+nós.AD.1.PL+PRF+1+SG
reconheci-o	reconhecer+V.ele.ACC.3.M.SG+PRF+1+SG
reconheci-os	reconhecer+V.ele.ACC.3.M.PL+PRF+1+SG
reconheci-te	reconhecer+V.tu.AD.2.SG+PRF+1+SG
reconheci-vos	reconhecer+V.vós.AD.2.PL+PRF+1+SG
reconheço-a	reconhecer+V.ele.ACC.3.F.SG+PRS+1+SG
reconheço-as	reconhecer+V.ele.ACC.3.F.PL+PRS+1+SG
reconheço-lhe	reconhecer+V.ele.DAT.3.SG+PRS+1+SG
reconheço-lhes	reconhecer+V.ele.DAT.3.PL+PRS+1+SG
reconheço-me	reconhecer+V.eu.AD.1.SG+PRS+1+SG
reconheço-nos	reconhecer+nós.AD.1.PL+PRS+1+SG
reconheço-o	reconhecer+V.ele.ACC.3.M.SG+PRS+1+SG
reconheço-os	reconhecer+V.ele.ACC.3.M.PL+PRS+1+SG
reconheço-te	reconhecer+V.tu.AD.2.SG+PRS+1+SG
reconheço-vos	reconhecer+V.vós.AD.2.PL+PRS+1+SG
reconquista-a	reconquistar+V.ele.ACC.3.F.SG+PRS+3+SG
reconquista-as	reconquistar+V.ele.ACC.3.F.PL+PRS+3+SG
reconquistai-la	reconquistar+V.ele.ACC.3.F.SG+PRS+2+PL
reconquistai-las	reconquistar+V.ele.ACC.3.F.PL+PRS+2+PL
reconquistai-lo	reconquistar+V.ele.ACC.3.M.SG+PRS+2+PL
reconquistai-los	reconquistar+V.ele.ACC.3.M.PL+PRS+2+PL
reconquistai-nos	reconquistar+nós.AD.1.PL+PRS+2+PL
reconquistais-lhe	reconquistar+V.ele.DAT.3.SG+PRS+2+PL
reconquistais-lhes	reconquistar+V.ele.DAT.3.PL+PRS+2+PL
reconquistais-me	reconquistar+V.eu.AD.1.SG+PRS+2+PL
reconquistais-te	reconquistar+V.tu.AD.2.SG+PRS+2+PL
reconquistais-vos	reconquistar+V.vós.AD.2.PL+PRS+2+PL
reconquistá-la-ão	reconquistar+V.ele.ACC.3.F.SG+FUT+3+PL
reconquistá-la-á	reconquistar+V.ele.ACC.3.F.SG+FUT+3+SG
reconquistá-la-ás	reconquistar+V.ele.ACC.3.F.SG+FUT+2+SG
reconquistá-la-ei	reconquistar+V.ele.ACC.3.F.SG+FUT+1+SG
reconquistá-la-eis	reconquistar+V.ele.ACC.3.F.SG+FUT+2+PL
reconquistá-la-emos	reconquistar+V.ele.ACC.3.F.SG+FUT+1+PL
reconquistá-la-íamos	reconquistar+V.ele.ACC.3.F.SG+COND+1+PL
reconquistá-la-iam	reconquistar+V.ele.ACC.3.F.SG+COND+3+PL
reconquistá-la-ia	reconquistar+V.ele.ACC.3.F.SG+COND+1+SG
reconquistá-la-ia	reconquistar+V.ele.ACC.3.F.SG+COND+3+SG
reconquistá-la-ias	reconquistar+V.ele.ACC.3.F.SG+COND+2+SG
reconquistá-la-íeis	reconquistar+V.ele.ACC.3.F.SG+COND+2+PL
reconquistá-la	reconquistar+V.ele.ACC.3.F.SG+INF+1+SG
reconquistá-la	reconquistar+V.ele.ACC.3.F.SG+INF+3+SG
reconquista-la	reconquistar+V.ele.ACC.3.F.SG+PRS+2+SG
reconquistá-la	reconquistar+V.ele.ACC.3.F.SG+SBJF+1+SG
reconquistá-la	reconquistar+V.ele.ACC.3.F.SG+SBJF+3+SG
reconquistá-las-ão	reconquistar+V.ele.ACC.3.F.PL+FUT+3+PL
reconquistá-las-á	reconquistar+V.ele.ACC.3.F.PL+FUT+3+SG
reconquistá-las-ás	reconquistar+V.ele.ACC.3.F.PL+FUT+2+SG
reconquistá-las-ei	reconquistar+V.ele.ACC.3.F.PL+FUT+1+SG
reconquistá-las-eis	reconquistar+V.ele.ACC.3.F.PL+FUT+2+PL
reconquistá-las-emos	reconquistar+V.ele.ACC.3.F.PL+FUT+1+PL
reconquistá-las-íamos	reconquistar+V.ele.ACC.3.F.PL+COND+1+PL
reconquistá-las-iam	reconquistar+V.ele.ACC.3.F.PL+COND+3+PL
reconquistá-las-ia	reconquistar+V.ele.ACC.3.F.PL+COND+1+SG
reconquistá-las-ia	reconquistar+V.ele.ACC.3.F.PL+COND+3+SG
reconquistá-las-ias	reconquistar+V.ele.ACC.3.F.PL+COND+2+SG
reconquistá-las-íeis	reconquistar+V.ele.ACC.3.F.PL+COND+2+PL
reconquistá-las	reconquistar+V.ele.ACC.3.F.PL+INF+1+SG
reconquistá-las	reconquistar+V.ele.ACC.3.F.PL+INF+3+SG
reconquista-las	reconquistar+V.ele.ACC.3.F.PL+PRS+2+SG
reconquistá-las	reconquistar+V.ele.ACC.3.F.PL+SBJF+1+SG
reconquistá-las	reconquistar+V.ele.ACC.3.F.PL+SBJF+3+SG
reconquista-lhe	reconquistar+V.ele.DAT.3.SG+PRS+3+SG
reconquista-lhes	reconquistar+V.ele.DAT.3.PL+PRS+3+SG
reconquistá-lo-ão	reconquistar+V.ele.ACC.3.M.SG+FUT+3+PL
reconquistá-lo-á	reconquistar+V.ele.ACC.3.M.SG+FUT+3+SG
reconquistá-lo-ás	reconquistar+V.ele.ACC.3.M.SG+FUT+2+SG
reconquistá-lo-ei	reconquistar+V.ele.ACC.3.M.SG+FUT+1+SG
reconquistá-lo-eis	reconquistar+V.ele.ACC.3.M.SG+FUT+2+PL
reconquistá-lo-emos	reconquistar+V.ele.ACC.3.M.SG+FUT+1+PL
reconquistá-lo-íamos	reconquistar+V.ele.ACC.3.M.SG+COND+1+PL
reconquistá-lo-iam	reconquistar+V.ele.ACC.3.M.SG+COND+3+PL
reconquistá-lo-ia	reconquistar+V.ele.ACC.3.M.SG+COND+1+SG
reconquistá-lo-ia	reconquistar+V.ele.ACC.3.M.SG+COND+3+SG
reconquistá-lo-ias	reconquistar+V.ele.ACC.3.M.SG+COND+2+SG
reconquistá-lo-íeis	reconquistar+V.ele.ACC.3.M.SG+COND+2+PL
reconquistá-lo	reconquistar+V.ele.ACC.3.M.SG+INF+1+SG
reconquistá-lo	reconquistar+V.ele.ACC.3.M.SG+INF+3+SG
reconquista-lo	reconquistar+V.ele.ACC.3.M.SG+PRS+2+SG
reconquistá-lo	reconquistar+V.ele.ACC.3.M.SG+SBJF+1+SG
reconquistá-lo	reconquistar+V.ele.ACC.3.M.SG+SBJF+3+SG
reconquistá-los-ão	reconquistar+V.ele.ACC.3.M.PL+FUT+3+PL
reconquistá-los-á	reconquistar+V.ele.ACC.3.M.PL+FUT+3+SG
reconquistá-los-ás	reconquistar+V.ele.ACC.3.M.PL+FUT+2+SG
reconquistá-los-ei	reconquistar+V.ele.ACC.3.M.PL+FUT+1+SG
reconquistá-los-eis	reconquistar+V.ele.ACC.3.M.PL+FUT+2+PL
reconquistá-los-emos	reconquistar+V.ele.ACC.3.M.PL+FUT+1+PL
reconquistá-los-íamos	reconquistar+V.ele.ACC.3.M.PL+COND+1+PL
reconquistá-los-iam	reconquistar+V.ele.ACC.3.M.PL+COND+3+PL
reconquistá-los-ia	reconquistar+V.ele.ACC.3.M.PL+COND+1+SG
reconquistá-los-ia	reconquistar+V.ele.ACC.3.M.PL+COND+3+SG
reconquistá-los-ias	reconquistar+V.ele.ACC.3.M.PL+COND+2+SG
reconquistá-los-íeis	reconquistar+V.ele.ACC.3.M.PL+COND+2+PL
reconquistá-los	reconquistar+V.ele.ACC.3.M.PL+INF+1+SG
reconquistá-los	reconquistar+V.ele.ACC.3.M.PL+INF+3+SG
reconquista-los	reconquistar+V.ele.ACC.3.M.PL+PRS+2+SG
reconquistá-los	reconquistar+V.ele.ACC.3.M.PL+SBJF+1+SG
reconquistá-los	reconquistar+V.ele.ACC.3.M.PL+SBJF+3+SG
reconquista-me	reconquistar+V.eu.AD.1.SG+PRS+3+SG
reconquistam-lhe	reconquistar+V.ele.DAT.3.SG+PRS+3+PL
reconquistam-lhes	reconquistar+V.ele.DAT.3.PL+PRS+3+PL
reconquistam-me	reconquistar+V.eu.AD.1.SG+PRS+3+PL
reconquistam-na	reconquistar+V.ele.ACC.3.F.SG+PRS+3+PL
reconquistam-nas	reconquistar+V.ele.ACC.3.F.PL+PRS+3+PL
reconquistam-no	reconquistar+V.ele.ACC.3.M.SG+PRS+3+PL
reconquistam-nos	reconquistar+V.ele.ACC.3.M.PL+PRS+3+PL
reconquistam-nos	reconquistar+V.nós.AD.1.PL+PRS+3+PL
reconquistamo-la	reconquistar+V.ele.ACC.3.F.SG+PRF+1+PL
reconquistamo-la	reconquistar+V.ele.ACC.3.F.SG+PRS+1+PL
reconquistamo-las	reconquistar+V.ele.ACC.3.F.PL+PRF+1+PL
reconquistamo-las	reconquistar+V.ele.ACC.3.F.PL+PRS+1+PL
reconquistamo-lo	reconquistar+V.ele.ACC.3.M.SG+PRF+1+PL
reconquistamo-lo	reconquistar+V.ele.ACC.3.M.SG+PRS+1+PL
reconquistamo-los	reconquistar+V.ele.ACC.3.M.PL+PRF+1+PL
reconquistamo-los	reconquistar+V.ele.ACC.3.M.PL+PRS+1+PL
reconquistamo-nos	reconquistar+nós.AD.1.PL+PRF+1+PL
reconquistamo-nos	reconquistar+nós.AD.1.PL+PRS+1+PL
reconquistamos-lhe	reconquistar+V.ele.DAT.3.SG+PRF+1+PL
reconquistamos-lhe	reconquistar+V.ele.DAT.3.SG+PRS+1+PL
reconquistamos-lhes	reconquistar+V.ele.DAT.3.PL+PRF+1+PL
reconquistamos-lhes	reconquistar+V.ele.DAT.3.PL+PRS+1+PL
reconquistamos-me	reconquistar+V.eu.AD.1.SG+PRF+1+PL
reconquistamos-me	reconquistar+V.eu.AD.1.SG+PRS+1+PL
reconquistamos-te	reconquistar+V.tu.AD.2.SG+PRF+1+PL
reconquistamos-te	reconquistar+V.tu.AD.2.SG+PRS+1+PL
reconquistamos-vos	reconquistar+V.vós.AD.2.PL+PRF+1+PL
reconquistamos-vos	reconquistar+V.vós.AD.2.PL+PRS+1+PL
reconquistam-se	reconquistar+V.ele.REFL+PRS+3+PL
reconquistam-te	reconquistar+V.tu.AD.2.SG+PRS+3+PL
reconquistam-vos	reconquistar+V.vós.AD.2.PL+PRS+3+PL
reconquistando-a	reconquistar+V.ele.ACC.3.F.SG+GRD
reconquistando-as	reconquistar+V.ele.ACC.3.F.PL+GRD
reconquistando-lhe	reconquistar+V.ele.DAT.3.SG+GRD
reconquistando-lhes	reconquistar+V.ele.DAT.3.PL+GRD
reconquistando-me	reconquistar+V.eu.AD.1.SG+GRD
reconquistando-nos	reconquistar+nós.AD.1.PL+GRD
reconquistando-o	reconquistar+V.ele.ACC.3.M.SG+GRD
reconquistando-os	reconquistar+V.ele.ACC.3.M.PL+GRD
reconquistando-se	reconquistar+V.ele.REFL+GRD
reconquistando-te	reconquistar+V.tu.AD.2.SG+GRD
reconquistando-vos	reconquistar+V.vós.AD.2.PL+GRD
reconquista-nos	reconquistar+nós.AD.1.PL+PRS+2+SG
reconquista-nos	reconquistar+nós.AD.1.PL+PRS+3+SG
reconquista-o	reconquistar+V.ele.ACC.3.M.SG+PRS+3+SG
reconquista-os	reconquistar+V.ele.ACC.3.M.PL+PRS+3+SG
reconquistara-a	reconquistar+V.ele.ACC.3.F.SG+PQP+1+SG
reconquistara-a	reconquistar+V.ele.ACC.3.F.SG+PQP+3+SG
reconquistara-as	reconquistar+V.ele.ACC.3.F.PL+PQP+1+SG
reconquistara-as	reconquistar+V.ele.ACC.3.F.PL+PQP+3+SG
reconquistara-la	reconquistar+V.ele.ACC.3.F.SG+PQP+2+SG
reconquistara-las	reconquistar+V.ele.ACC.3.F.PL+PQP+2+SG
reconquistara-lhe	reconquistar+V.ele.DAT.3.SG+PQP+1+SG
reconquistara-lhe	reconquistar+V.ele.DAT.3.SG+PQP+3+SG
reconquistara-lhes	reconquistar+V.ele.DAT.3.PL+PQP+1+SG
reconquistara-lhes	reconquistar+V.ele.DAT.3.PL+PQP+3+SG
reconquistara-lo	reconquistar+V.ele.ACC.3.M.SG+PQP+2+SG
reconquistara-los	reconquistar+V.ele.ACC.3.M.PL+PQP+2+SG
reconquistara-me	reconquistar+V.eu.AD.1.SG+PQP+1+SG
reconquistara-me	reconquistar+V.eu.AD.1.SG+PQP+3+SG
reconquistaram-lhe	reconquistar+V.ele.DAT.3.SG+PQP+3+PL
reconquistaram-lhe	reconquistar+V.ele.DAT.3.SG+PRF+3+PL
reconquistaram-lhes	reconquistar+V.ele.DAT.3.PL+PQP+3+PL
reconquistaram-lhes	reconquistar+V.ele.DAT.3.PL+PRF+3+PL
reconquistaram-me	reconquistar+V.eu.AD.1.SG+PQP+3+PL
reconquistaram-me	reconquistar+V.eu.AD.1.SG+PRF+3+PL
reconquistaram-na	reconquistar+V.ele.ACC.3.F.SG+PQP+3+PL
reconquistaram-na	reconquistar+V.ele.ACC.3.F.SG+PRF+3+PL
reconquistaram-nas	reconquistar+V.ele.ACC.3.F.PL+PQP+3+PL
reconquistaram-nas	reconquistar+V.ele.ACC.3.F.PL+PRF+3+PL
reconquistaram-no	reconquistar+V.ele.ACC.3.M.SG+PQP+3+PL
reconquistaram-no	reconquistar+V.ele.ACC.3.M.SG+PRF+3+PL
reconquistaram-nos	reconquistar+V.ele.ACC.3.M.PL+PQP+3+PL
reconquistaram-nos	reconquistar+V.ele.ACC.3.M.PL+PRF+3+PL
reconquistaram-nos	reconquistar+V.nós.AD.1.PL+PQP+3+PL
reconquistaram-nos	reconquistar+V.nós.AD.1.PL+PRF+3+PL
reconquistáramo-la	reconquistar+V.ele.ACC.3.F.SG+PQP+1+PL
reconquistáramo-las	reconquistar+V.ele.ACC.3.F.PL+PQP+1+PL
reconquistáramo-lo	reconquistar+V.ele.ACC.3.M.SG+PQP+1+PL
reconquistáramo-los	reconquistar+V.ele.ACC.3.M.PL+PQP+1+PL
reconquistáramo-nos	reconquistar+nós.AD.1.PL+PQP+1+PL
reconquistáramos-lhe	reconquistar+V.ele.DAT.3.SG+PQP+1+PL
reconquistáramos-lhes	reconquistar+V.ele.DAT.3.PL+PQP+1+PL
reconquistáramos-me	reconquistar+V.eu.AD.1.SG+PQP+1+PL
reconquistáramos-te	reconquistar+V.tu.AD.2.SG+PQP+1+PL
reconquistáramos-vos	reconquistar+V.vós.AD.2.PL+PQP+1+PL
reconquistaram-se	reconquistar+V.ele.REFL+PQP+3+PL
reconquistaram-se	reconquistar+V.ele.REFL+PRF+3+PL
reconquistaram-te	reconquistar+V.tu.AD.2.SG+PQP+3+PL
reconquistaram-te	reconquistar+V.tu.AD.2.SG+PRF+3+PL
reconquistaram-vos	reconquistar+V.vós.AD.2.PL+PQP+3+PL
reconquistaram-vos	reconquistar+V.vós.AD.2.PL+PRF+3+PL
reconquistara-nos	reconquistar+nós.AD.1.PL+PQP+1+SG
reconquistara-nos	reconquistar+nós.AD.1.PL+PQP+2+SG
reconquistara-nos	reconquistar+nós.AD.1.PL+PQP+3+SG
reconquistara-o	reconquistar+V.ele.ACC.3.M.SG+PQP+1+SG
reconquistara-o	reconquistar+V.ele.ACC.3.M.SG+PQP+3+SG
reconquistara-os	reconquistar+V.ele.ACC.3.M.PL+PQP+1+SG
reconquistara-os	reconquistar+V.ele.ACC.3.M.PL+PQP+3+SG
reconquistara-se	reconquistar+V.ele.REFL+PQP+1+SG
reconquistara-se	reconquistar+V.ele.REFL+PQP+3+SG
reconquistaras-lhe	reconquistar+V.ele.DAT.3.SG+PQP+2+SG
reconquistaras-lhes	reconquistar+V.ele.DAT.3.PL+PQP+2+SG
reconquistaras-me	reconquistar+V.eu.AD.1.SG+PQP+2+SG
reconquistaras-te	reconquistar+V.tu.AD.2.SG+PQP+2+SG
reconquistaras-vos	reconquistar+V.vós.AD.2.PL+PQP+2+SG
reconquistara-te	reconquistar+V.tu.AD.2.SG+PQP+1+SG
reconquistara-te	reconquistar+V.tu.AD.2.SG+PQP+3+SG
reconquistara-vos	reconquistar+V.vós.AD.2.PL+PQP+1+SG
reconquistara-vos	reconquistar+V.vós.AD.2.PL+PQP+3+SG
reconquistarde-la	reconquistar+V.ele.ACC.3.F.SG+INF+2+PL
reconquistarde-la	reconquistar+V.ele.ACC.3.F.SG+SBJF+2+PL
reconquistarde-las	reconquistar+V.ele.ACC.3.F.PL+INF+2+PL
reconquistarde-las	reconquistar+V.ele.ACC.3.F.PL+SBJF+2+PL
reconquistarde-lo	reconquistar+V.ele.ACC.3.M.SG+INF+2+PL
reconquistarde-lo	reconquistar+V.ele.ACC.3.M.SG+SBJF+2+PL
reconquistarde-los	reconquistar+V.ele.ACC.3.M.PL+INF+2+PL
reconquistarde-los	reconquistar+V.ele.ACC.3.M.PL+SBJF+2+PL
