reemendares-lhe	reemendar+V.ele.DAT.3.SG+SBJF+2+SG
reemendares-lhes	reemendar+V.ele.DAT.3.PL+INF+2+SG
reemendares-lhes	reemendar+V.ele.DAT.3.PL+SBJF+2+SG
reemendares-me	reemendar+V.eu.AD.1.SG+INF+2+SG
reemendares-me	reemendar+V.eu.AD.1.SG+SBJF+2+SG
reemendares-te	reemendar+V.tu.AD.2.SG+INF+2+SG
reemendares-te	reemendar+V.tu.AD.2.SG+SBJF+2+SG
reemendares-vos	reemendar+V.vós.AD.2.PL+INF+2+SG
reemendares-vos	reemendar+V.vós.AD.2.PL+SBJF+2+SG
reemendar-lhe-ão	reemendar+V.ele.DAT.3.SG+FUT+3+PL
reemendar-lhe-á	reemendar+V.ele.DAT.3.SG+FUT+3+SG
reemendar-lhe-ás	reemendar+V.ele.DAT.3.SG+FUT+2+SG
reemendar-lhe-ei	reemendar+V.ele.DAT.3.SG+FUT+1+SG
reemendar-lhe-eis	reemendar+V.ele.DAT.3.SG+FUT+2+PL
reemendar-lhe-emos	reemendar+V.ele.DAT.3.SG+FUT+1+PL
reemendar-lhe-íamos	reemendar+V.ele.DAT.3.SG+COND+1+PL
reemendar-lhe-iam	reemendar+V.ele.DAT.3.SG+COND+3+PL
reemendar-lhe-ia	reemendar+V.ele.DAT.3.SG+COND+1+SG
reemendar-lhe-ia	reemendar+V.ele.DAT.3.SG+COND+3+SG
reemendar-lhe-ias	reemendar+V.ele.DAT.3.SG+COND+2+SG
reemendar-lhe-íeis	reemendar+V.ele.DAT.3.SG+COND+2+PL
reemendar-lhe	reemendar+V.ele.DAT.3.SG+INF
reemendar-lhe	reemendar+V.ele.DAT.3.SG+INF+1+SG
reemendar-lhe	reemendar+V.ele.DAT.3.SG+INF+3+SG
reemendar-lhe	reemendar+V.ele.DAT.3.SG+SBJF+1+SG
reemendar-lhe	reemendar+V.ele.DAT.3.SG+SBJF+3+SG
reemendar-lhes-ão	reemendar+V.ele.DAT.3.PL+FUT+3+PL
reemendar-lhes-á	reemendar+V.ele.DAT.3.PL+FUT+3+SG
reemendar-lhes-ás	reemendar+V.ele.DAT.3.PL+FUT+2+SG
reemendar-lhes-ei	reemendar+V.ele.DAT.3.PL+FUT+1+SG
reemendar-lhes-eis	reemendar+V.ele.DAT.3.PL+FUT+2+PL
reemendar-lhes-emos	reemendar+V.ele.DAT.3.PL+FUT+1+PL
reemendar-lhes-íamos	reemendar+V.ele.DAT.3.PL+COND+1+PL
reemendar-lhes-iam	reemendar+V.ele.DAT.3.PL+COND+3+PL
reemendar-lhes-ia	reemendar+V.ele.DAT.3.PL+COND+1+SG
reemendar-lhes-ia	reemendar+V.ele.DAT.3.PL+COND+3+SG
reemendar-lhes-ias	reemendar+V.ele.DAT.3.PL+COND+2+SG
reemendar-lhes-íeis	reemendar+V.ele.DAT.3.PL+COND+2+PL
reemendar-lhes	reemendar+V.ele.DAT.3.PL+INF
reemendar-lhes	reemendar+V.ele.DAT.3.PL+INF+1+SG
reemendar-lhes	reemendar+V.ele.DAT.3.PL+INF+3+SG
reemendar-lhes	reemendar+V.ele.DAT.3.PL+SBJF+1+SG
reemendar-lhes	reemendar+V.ele.DAT.3.PL+SBJF+3+SG
reemendar-me-ão	reemendar+V.eu.AD.1.SG+FUT+3+PL
reemendar-me-á	reemendar+V.eu.AD.1.SG+FUT+3+SG
reemendar-me-ás	reemendar+V.eu.AD.1.SG+FUT+2+SG
reemendar-me-ei	reemendar+V.eu.AD.1.SG+FUT+1+SG
reemendar-me-eis	reemendar+V.eu.AD.1.SG+FUT+2+PL
reemendar-me-emos	reemendar+V.eu.AD.1.SG+FUT+1+PL
reemendar-me-íamos	reemendar+V.eu.AD.1.SG+COND+1+PL
reemendar-me-iam	reemendar+V.eu.AD.1.SG+COND+3+PL
reemendar-me-ia	reemendar+V.eu.AD.1.SG+COND+1+SG
reemendar-me-ia	reemendar+V.eu.AD.1.SG+COND+3+SG
reemendar-me-ias	reemendar+V.eu.AD.1.SG+COND+2+SG
reemendar-me-íeis	reemendar+V.eu.AD.1.SG+COND+2+PL
reemendar-me	reemendar+V.eu.AD.1.SG+INF
reemendar-me	reemendar+V.eu.AD.1.SG+INF+1+SG
reemendar-me	reemendar+V.eu.AD.1.SG+INF+3+SG
reemendar-me	reemendar+V.eu.AD.1.SG+SBJF+1+SG
reemendar-me	reemendar+V.eu.AD.1.SG+SBJF+3+SG
reemendarmo-la	reemendar+V.ele.ACC.3.F.SG+INF+1+PL
reemendarmo-la	reemendar+V.ele.ACC.3.F.SG+SBJF+1+PL
reemendarmo-las	reemendar+V.ele.ACC.3.F.PL+INF+1+PL
reemendarmo-las	reemendar+V.ele.ACC.3.F.PL+SBJF+1+PL
reemendarmo-lo	reemendar+V.ele.ACC.3.M.SG+INF+1+PL
reemendarmo-lo	reemendar+V.ele.ACC.3.M.SG+SBJF+1+PL
reemendarmo-los	reemendar+V.ele.ACC.3.M.PL+INF+1+PL
reemendarmo-los	reemendar+V.ele.ACC.3.M.PL+SBJF+1+PL
reemendarmo-nos	reemendar+nós.AD.1.PL+INF+1+PL
reemendarmo-nos	reemendar+nós.AD.1.PL+SBJF+1+PL
reemendarmos-lhe	reemendar+V.ele.DAT.3.SG+INF+1+PL
reemendarmos-lhe	reemendar+V.ele.DAT.3.SG+SBJF+1+PL
reemendarmos-lhes	reemendar+V.ele.DAT.3.PL+INF+1+PL
reemendarmos-lhes	reemendar+V.ele.DAT.3.PL+SBJF+1+PL
reemendarmos-me	reemendar+V.eu.AD.1.SG+INF+1+PL
reemendarmos-me	reemendar+V.eu.AD.1.SG+SBJF+1+PL
reemendarmos-te	reemendar+V.tu.AD.2.SG+INF+1+PL
reemendarmos-te	reemendar+V.tu.AD.2.SG+SBJF+1+PL
reemendarmos-vos	reemendar+V.vós.AD.2.PL+INF+1+PL
reemendarmos-vos	reemendar+V.vós.AD.2.PL+SBJF+1+PL
reemendar-nos-ão	reemendar+nós.AD.1.PL+FUT+3+PL
reemendar-nos-á	reemendar+nós.AD.1.PL+FUT+3+SG
reemendar-nos-ás	reemendar+nós.AD.1.PL+FUT+2+SG
reemendar-nos-ei	reemendar+nós.AD.1.PL+FUT+1+SG
reemendar-nos-eis	reemendar+nós.AD.1.PL+FUT+2+PL
reemendar-nos-emos	reemendar+nós.AD.1.PL+FUT+1+PL
reemendar-nos-íamos	reemendar+nós.AD.1.PL+COND+1+PL
reemendar-nos-iam	reemendar+nós.AD.1.PL+COND+3+PL
reemendar-nos-ia	reemendar+nós.AD.1.PL+COND+1+SG
reemendar-nos-ia	reemendar+nós.AD.1.PL+COND+3+SG
reemendar-nos-ias	reemendar+nós.AD.1.PL+COND+2+SG
reemendar-nos-íeis	reemendar+nós.AD.1.PL+COND+2+PL
reemendar-nos	reemendar+nós.AD.1.PL+INF
reemendar-nos	reemendar+nós.AD.1.PL+INF+1+SG
reemendar-nos	reemendar+nós.AD.1.PL+INF+3+SG
reemendar-nos	reemendar+nós.AD.1.PL+SBJF+1+SG
reemendar-nos	reemendar+nós.AD.1.PL+SBJF+3+SG
reemendar-se-ão	reemendar+V.ele.REFL+FUT+3+PL
reemendar-se-á	reemendar+V.ele.REFL+FUT+3+SG
reemendar-se-iam	reemendar+V.ele.REFL+COND+3+PL
reemendar-se-ia	reemendar+V.ele.REFL+COND+3+SG
reemendar-se	reemendar+V.ele.REFL+INF
reemendar-se	reemendar+V.ele.REFL+INF+3+SG
reemendar-se	reemendar+V.ele.REFL+SBJF+3+SG
reemendar-te-ão	reemendar+V.tu.AD.2.SG+FUT+3+PL
reemendar-te-á	reemendar+V.tu.AD.2.SG+FUT+3+SG
reemendar-te-ás	reemendar+V.tu.AD.2.SG+FUT+2+SG
reemendar-te-ei	reemendar+V.tu.AD.2.SG+FUT+1+SG
reemendar-te-eis	reemendar+V.tu.AD.2.SG+FUT+2+PL
reemendar-te-emos	reemendar+V.tu.AD.2.SG+FUT+1+PL
reemendar-te-íamos	reemendar+V.tu.AD.2.SG+COND+1+PL
reemendar-te-iam	reemendar+V.tu.AD.2.SG+COND+3+PL
reemendar-te-ia	reemendar+V.tu.AD.2.SG+COND+1+SG
reemendar-te-ia	reemendar+V.tu.AD.2.SG+COND+3+SG
reemendar-te-ias	reemendar+V.tu.AD.2.SG+COND+2+SG
reemendar-te-íeis	reemendar+V.tu.AD.2.SG+COND+2+PL
reemendar-te	reemendar+V.tu.AD.2.SG+INF
reemendar-te	reemendar+V.tu.AD.2.SG+INF+1+SG
reemendar-te	reemendar+V.tu.AD.2.SG+INF+3+SG
reemendar-te	reemendar+V.tu.AD.2.SG+SBJF+1+SG
reemendar-te	reemendar+V.tu.AD.2.SG+SBJF+3+SG
reemendar-vos-ão	reemendar+V.vós.AD.2.PL+FUT+3+PL
reemendar-vos-á	reemendar+V.vós.AD.2.PL+FUT+3+SG
reemendar-vos-ás	reemendar+V.vós.AD.2.PL+FUT+2+SG
reemendar-vos-ei	reemendar+V.vós.AD.2.PL+FUT+1+SG
reemendar-vos-eis	reemendar+V.vós.AD.2.PL+FUT+2+PL
reemendar-vos-emos	reemendar+V.vós.AD.2.PL+FUT+1+PL
reemendar-vos-íamos	reemendar+V.vós.AD.2.PL+COND+1+PL
reemendar-vos-iam	reemendar+V.vós.AD.2.PL+COND+3+PL
reemendar-vos-ia	reemendar+V.vós.AD.2.PL+COND+1+SG
reemendar-vos-ia	reemendar+V.vós.AD.2.PL+COND+3+SG
reemendar-vos-ias	reemendar+V.vós.AD.2.PL+COND+2+SG
reemendar-vos-íeis	reemendar+V.vós.AD.2.PL+COND+2+PL
reemendar-vos	reemendar+V.vós.AD.2.PL+INF
reemendar-vos	reemendar+V.vós.AD.2.PL+INF+1+SG
reemendar-vos	reemendar+V.vós.AD.2.PL+INF+3+SG
reemendar-vos	reemendar+V.vós.AD.2.PL+SBJF+1+SG
reemendar-vos	reemendar+V.vós.AD.2.PL+SBJF+3+SG
reemenda-se	reemendar+V.ele.REFL+PRS+3+SG
reemendas-lhe	reemendar+V.ele.DAT.3.SG+PRS+2+SG
reemendas-lhes	reemendar+V.ele.DAT.3.PL+PRS+2+SG
reemendas-me	reemendar+V.eu.AD.1.SG+PRS+2+SG
reemendaste-a	reemendar+V.ele.ACC.3.F.SG+PRF+2+SG
reemendaste-as	reemendar+V.ele.ACC.3.F.PL+PRF+2+SG
reemendaste-la	reemendar+V.ele.ACC.3.F.SG+PRF+2+PL
reemendaste-las	reemendar+V.ele.ACC.3.F.PL+PRF+2+PL
reemendaste-lhe	reemendar+V.ele.DAT.3.SG+PRF+2+SG
reemendaste-lhes	reemendar+V.ele.DAT.3.PL+PRF+2+SG
reemendaste-lo	reemendar+V.ele.ACC.3.M.SG+PRF+2+PL
reemendaste-los	reemendar+V.ele.ACC.3.M.PL+PRF+2+PL
reemendaste-me	reemendar+V.eu.AD.1.SG+PRF+2+SG
reemendaste-nos	reemendar+nós.AD.1.PL+PRF+2+PL
reemendaste-nos	reemendar+nós.AD.1.PL+PRF+2+SG
reemendaste-o	reemendar+V.ele.ACC.3.M.SG+PRF+2+SG
reemendaste-os	reemendar+V.ele.ACC.3.M.PL+PRF+2+SG
reemendas-te	reemendar+V.tu.AD.2.SG+PRS+2+SG
reemendastes-lhe	reemendar+V.ele.DAT.3.SG+PRF+2+PL
reemendastes-lhes	reemendar+V.ele.DAT.3.PL+PRF+2+PL
reemendastes-me	reemendar+V.eu.AD.1.SG+PRF+2+PL
reemendastes-te	reemendar+V.tu.AD.2.SG+PRF+2+PL
reemendastes-vos	reemendar+V.vós.AD.2.PL+PRF+2+PL
reemendaste-te	reemendar+V.tu.AD.2.SG+PRF+2+SG
reemendaste-vos	reemendar+V.vós.AD.2.PL+PRF+2+SG
reemendas-vos	reemendar+V.vós.AD.2.PL+PRS+2+SG
reemenda-te	reemendar+V.tu.AD.2.SG+PRS+3+SG
reemendava-a	reemendar+V.ele.ACC.3.F.SG+IMPF+1+SG
reemendava-a	reemendar+V.ele.ACC.3.F.SG+IMPF+3+SG
reemendava-as	reemendar+V.ele.ACC.3.F.PL+IMPF+1+SG
reemendava-as	reemendar+V.ele.ACC.3.F.PL+IMPF+3+SG
reemendava-la	reemendar+V.ele.ACC.3.F.SG+IMPF+2+SG
reemendava-las	reemendar+V.ele.ACC.3.F.PL+IMPF+2+SG
reemendava-lhe	reemendar+V.ele.DAT.3.SG+IMPF+1+SG
reemendava-lhe	reemendar+V.ele.DAT.3.SG+IMPF+3+SG
reemendava-lhes	reemendar+V.ele.DAT.3.PL+IMPF+1+SG
reemendava-lhes	reemendar+V.ele.DAT.3.PL+IMPF+3+SG
reemendava-lo	reemendar+V.ele.ACC.3.M.SG+IMPF+2+SG
reemendava-los	reemendar+V.ele.ACC.3.M.PL+IMPF+2+SG
reemendava-me	reemendar+V.eu.AD.1.SG+IMPF+1+SG
reemendava-me	reemendar+V.eu.AD.1.SG+IMPF+3+SG
reemendavam-lhe	reemendar+V.ele.DAT.3.SG+IMPF+3+PL
reemendavam-lhes	reemendar+V.ele.DAT.3.PL+IMPF+3+PL
reemendavam-me	reemendar+V.eu.AD.1.SG+IMPF+3+PL
reemendavam-na	reemendar+V.ele.ACC.3.F.SG+IMPF+3+PL
reemendavam-nas	reemendar+V.ele.ACC.3.F.PL+IMPF+3+PL
reemendavam-no	reemendar+V.ele.ACC.3.M.SG+IMPF+3+PL
reemendavam-nos	reemendar+V.ele.ACC.3.M.PL+IMPF+3+PL
reemendavam-nos	reemendar+V.nós.AD.1.PL+IMPF+3+PL
reemendávamo-la	reemendar+V.ele.ACC.3.F.SG+IMPF+1+PL
reemendávamo-las	reemendar+V.ele.ACC.3.F.PL+IMPF+1+PL
reemendávamo-lo	reemendar+V.ele.ACC.3.M.SG+IMPF+1+PL
reemendávamo-los	reemendar+V.ele.ACC.3.M.PL+IMPF+1+PL
reemendávamo-nos	reemendar+nós.AD.1.PL+IMPF+1+PL
reemendávamos-lhe	reemendar+V.ele.DAT.3.SG+IMPF+1+PL
reemendávamos-lhes	reemendar+V.ele.DAT.3.PL+IMPF+1+PL
reemendávamos-me	reemendar+V.eu.AD.1.SG+IMPF+1+PL
reemendávamos-te	reemendar+V.tu.AD.2.SG+IMPF+1+PL
reemendávamos-vos	reemendar+V.vós.AD.2.PL+IMPF+1+PL
reemendavam-se	reemendar+V.ele.REFL+IMPF+3+PL
reemendavam-te	reemendar+V.tu.AD.2.SG+IMPF+3+PL
reemendavam-vos	reemendar+V.vós.AD.2.PL+IMPF+3+PL
reemendava-nos	reemendar+nós.AD.1.PL+IMPF+1+SG
reemendava-nos	reemendar+nós.AD.1.PL+IMPF+2+SG
reemendava-nos	reemendar+nós.AD.1.PL+IMPF+3+SG
reemendava-o	reemendar+V.ele.ACC.3.M.SG+IMPF+1+SG
reemendava-o	reemendar+V.ele.ACC.3.M.SG+IMPF+3+SG
reemendava-os	reemendar+V.ele.ACC.3.M.PL+IMPF+1+SG
reemendava-os	reemendar+V.ele.ACC.3.M.PL+IMPF+3+SG
reemendava-se	reemendar+V.ele.REFL+IMPF+1+SG
reemendava-se	reemendar+V.ele.REFL+IMPF+3+SG
reemendavas-lhe	reemendar+V.ele.DAT.3.SG+IMPF+2+SG
reemendavas-lhes	reemendar+V.ele.DAT.3.PL+IMPF+2+SG
reemendavas-me	reemendar+V.eu.AD.1.SG+IMPF+2+SG
reemendavas-te	reemendar+V.tu.AD.2.SG+IMPF+2+SG
reemendavas-vos	reemendar+V.vós.AD.2.PL+IMPF+2+SG
reemendava-te	reemendar+V.tu.AD.2.SG+IMPF+1+SG
reemendava-te	reemendar+V.tu.AD.2.SG+IMPF+3+SG
reemendava-vos	reemendar+V.vós.AD.2.PL+IMPF+1+SG
reemendava-vos	reemendar+V.vós.AD.2.PL+IMPF+3+SG
reemendávei-la	reemendar+V.ele.ACC.3.F.SG+IMPF+2+PL
reemendávei-las	reemendar+V.ele.ACC.3.F.PL+IMPF+2+PL
reemendávei-lo	reemendar+V.ele.ACC.3.M.SG+IMPF+2+PL
reemendávei-los	reemendar+V.ele.ACC.3.M.PL+IMPF+2+PL
reemendávei-nos	reemendar+nós.AD.1.PL+IMPF+2+PL
reemendáveis-lhe	reemendar+V.ele.DAT.3.SG+IMPF+2+PL
reemendáveis-lhes	reemendar+V.ele.DAT.3.PL+IMPF+2+PL
reemendáveis-me	reemendar+V.eu.AD.1.SG+IMPF+2+PL
reemendáveis-te	reemendar+V.tu.AD.2.SG+IMPF+2+PL
reemendáveis-vos	reemendar+V.vós.AD.2.PL+IMPF+2+PL
reemenda-vos	reemendar+V.vós.AD.2.PL+PRS+3+SG
reemende-a	reemendar+V.ele.ACC.3.F.SG+IMP+3+SG
reemende-as	reemendar+V.ele.ACC.3.F.PL+IMP+3+SG
reemendei-a	reemendar+V.ele.ACC.3.F.SG+PRF+1+SG
reemendei-as	reemendar+V.ele.ACC.3.F.PL+PRF+1+SG
reemendei-lhe	reemendar+V.ele.DAT.3.SG+PRF+1+SG
reemendei-lhes	reemendar+V.ele.DAT.3.PL+PRF+1+SG
reemendei-me	reemendar+V.eu.AD.1.SG+PRF+1+SG
reemendei-nos	reemendar+nós.AD.1.PL+PRF+1+SG
reemendei-o	reemendar+V.ele.ACC.3.M.SG+PRF+1+SG
reemendei-os	reemendar+V.ele.ACC.3.M.PL+PRF+1+SG
reemendei-te	reemendar+V.tu.AD.2.SG+PRF+1+SG
reemendei-vos	reemendar+V.vós.AD.2.PL+PRF+1+SG
reemende-lhe	reemendar+V.ele.DAT.3.SG+IMP+3+SG
reemende-lhes	reemendar+V.ele.DAT.3.PL+IMP+3+SG
reemende-me	reemendar+V.eu.AD.1.SG+IMP+3+SG
reemendem-lhe	reemendar+V.ele.DAT.3.SG+IMP+3+PL
reemendem-lhes	reemendar+V.ele.DAT.3.PL+IMP+3+PL
reemendem-me	reemendar+V.eu.AD.1.SG+IMP+3+PL
reemendem-na	reemendar+V.ele.ACC.3.F.SG+IMP+3+PL
reemendem-nas	reemendar+V.ele.ACC.3.F.PL+IMP+3+PL
reemendem-no	reemendar+V.ele.ACC.3.M.SG+IMP+3+PL
reemendem-nos	reemendar+V.ele.ACC.3.M.PL+IMP+3+PL
reemendem-nos	reemendar+V.nós.AD.1.PL+IMP+3+PL
reemendemo-la	reemendar+V.ele.ACC.3.F.SG+IMP+1+PL
reemendemo-las	reemendar+V.ele.ACC.3.F.PL+IMP+1+PL
reemendemo-lo	reemendar+V.ele.ACC.3.M.SG+IMP+1+PL
reemendemo-los	reemendar+V.ele.ACC.3.M.PL+IMP+1+PL
reemendemo-nos	reemendar+nós.AD.1.PL+IMP+1+PL
reemendemos-lhe	reemendar+V.ele.DAT.3.SG+IMP+1+PL
reemendemos-lhes	reemendar+V.ele.DAT.3.PL+IMP+1+PL
reemendemos-me	reemendar+V.eu.AD.1.SG+IMP+1+PL
reemendemos-te	reemendar+V.tu.AD.2.SG+IMP+1+PL
reemendemos-vos	reemendar+V.vós.AD.2.PL+IMP+1+PL
reemendem-se	reemendar+V.ele.REFL+IMP+3+PL
reemendem-te	reemendar+V.tu.AD.2.SG+IMP+3+PL
reemendem-vos	reemendar+V.vós.AD.2.PL+IMP+3+PL
reemende-nos	reemendar+nós.AD.1.PL+IMP+3+SG
reemende-o	reemendar+V.ele.ACC.3.M.SG+IMP+3+SG
reemende-os	reemendar+V.ele.ACC.3.M.PL+IMP+3+SG
reemende-se	reemendar+V.ele.REFL+IMP+3+SG
reemende-te	reemendar+V.tu.AD.2.SG+IMP+3+SG
reemende-vos	reemendar+V.vós.AD.2.PL+IMP+3+SG
reemendo-a	reemendar+V.ele.ACC.3.F.SG+PRS+1+SG
reemendo-as	reemendar+V.ele.ACC.3.F.PL+PRS+1+SG
reemendo-lhe	reemendar+V.ele.DAT.3.SG+PRS+1+SG
reemendo-lhes	reemendar+V.ele.DAT.3.PL+PRS+1+SG
reemendo-me	reemendar+V.eu.AD.1.SG+PRS+1+SG
reemendo-nos	reemendar+nós.AD.1.PL+PRS+1+SG
reemendo-o	reemendar+V.ele.ACC.3.M.SG+PRS+1+SG
reemendo-os	reemendar+V.ele.ACC.3.M.PL+PRS+1+SG
reemendo-te	reemendar+V.tu.AD.2.SG+PRS+1+SG
reemendou-a	reemendar+V.ele.ACC.3.F.SG+PRF+3+SG
reemendou-as	reemendar+V.ele.ACC.3.F.PL+PRF+3+SG
reemendou-lhe	reemendar+V.ele.DAT.3.SG+PRF+3+SG
reemendou-lhes	reemendar+V.ele.DAT.3.PL+PRF+3+SG
reemendou-me	reemendar+V.eu.AD.1.SG+PRF+3+SG
reemendou-nos	reemendar+nós.AD.1.PL+PRF+3+SG
reemendou-o	reemendar+V.ele.ACC.3.M.SG+PRF+3+SG
reemendou-os	reemendar+V.ele.ACC.3.M.PL+PRF+3+SG
reemendou-se	reemendar+V.ele.REFL+PRF+3+SG
reemendou-te	reemendar+V.tu.AD.2.SG+PRF+3+SG
reemendou-vos	reemendar+V.vós.AD.2.PL+PRF+3+SG
reemendo-vos	reemendar+V.vós.AD.2.PL+PRS+1+SG
reemita-a	reemitir+V.ele.ACC.3.F.SG+IMP+3+SG
reemita-as	reemitir+V.ele.ACC.3.F.PL+IMP+3+SG
reemita-lhe	reemitir+V.ele.DAT.3.SG+IMP+3+SG
reemita-lhes	reemitir+V.ele.DAT.3.PL+IMP+3+SG
reemita-me	reemitir+V.eu.AD.1.SG+IMP+3+SG
reemitam-lhe	reemitir+V.ele.DAT.3.SG+IMP+3+PL
reemitam-lhes	reemitir+V.ele.DAT.3.PL+IMP+3+PL
reemitam-me	reemitir+V.eu.AD.1.SG+IMP+3+PL
reemitam-na	reemitir+V.ele.ACC.3.F.SG+IMP+3+PL
reemitam-nas	reemitir+V.ele.ACC.3.F.PL+IMP+3+PL
reemitam-no	reemitir+V.ele.ACC.3.M.SG+IMP+3+PL
reemitam-nos	reemitir+V.ele.ACC.3.M.PL+IMP+3+PL
reemitam-nos	reemitir+V.nós.AD.1.PL+IMP+3+PL
reemitamo-la	reemitir+V.ele.ACC.3.F.SG+IMP+1+PL
reemitamo-las	reemitir+V.ele.ACC.3.F.PL+IMP+1+PL
reemitamo-lo	reemitir+V.ele.ACC.3.M.SG+IMP+1+PL
reemitamo-los	reemitir+V.ele.ACC.3.M.PL+IMP+1+PL
reemitamo-nos	reemitir+nós.AD.1.PL+IMP+1+PL
reemitamos-lhe	reemitir+V.ele.DAT.3.SG+IMP+1+PL
reemitamos-lhes	reemitir+V.ele.DAT.3.PL+IMP+1+PL
reemitamos-me	reemitir+V.eu.AD.1.SG+IMP+1+PL
reemitamos-te	reemitir+V.tu.AD.2.SG+IMP+1+PL
reemitamos-vos	reemitir+V.vós.AD.2.PL+IMP+1+PL
reemitam-se	reemitir+V.ele.REFL+IMP+3+PL
reemitam-te	reemitir+V.tu.AD.2.SG+IMP+3+PL
reemitam-vos	reemitir+V.vós.AD.2.PL+IMP+3+PL
reemita-nos	reemitir+nós.AD.1.PL+IMP+3+SG
reemita-o	reemitir+V.ele.ACC.3.M.SG+IMP+3+SG
reemita-os	reemitir+V.ele.ACC.3.M.PL+IMP+3+SG
reemita-se	reemitir+V.ele.REFL+IMP+3+SG
reemita-te	reemitir+V.tu.AD.2.SG+IMP+3+SG
reemita-vos	reemitir+V.vós.AD.2.PL+IMP+3+SG
reemitia-a	reemitir+V.ele.ACC.3.F.SG+IMPF+1+SG
reemitia-a	reemitir+V.ele.ACC.3.F.SG+IMPF+3+SG
reemitia-as	reemitir+V.ele.ACC.3.F.PL+IMPF+1+SG
reemitia-as	reemitir+V.ele.ACC.3.F.PL+IMPF+3+SG
reemitia-la	reemitir+V.ele.ACC.3.F.SG+IMPF+2+SG
reemitia-las	reemitir+V.ele.ACC.3.F.PL+IMPF+2+SG
reemitia-lhe	reemitir+V.ele.DAT.3.SG+IMPF+1+SG
reemitia-lhe	reemitir+V.ele.DAT.3.SG+IMPF+3+SG
reemitia-lhes	reemitir+V.ele.DAT.3.PL+IMPF+1+SG
reemitia-lhes	reemitir+V.ele.DAT.3.PL+IMPF+3+SG
reemitia-lo	reemitir+V.ele.ACC.3.M.SG+IMPF+2+SG
reemitia-los	reemitir+V.ele.ACC.3.M.PL+IMPF+2+SG
reemitia-me	reemitir+V.eu.AD.1.SG+IMPF+1+SG
reemitia-me	reemitir+V.eu.AD.1.SG+IMPF+3+SG
reemitiam-lhe	reemitir+V.ele.DAT.3.SG+IMPF+3+PL
reemitiam-lhes	reemitir+V.ele.DAT.3.PL+IMPF+3+PL
reemitiam-me	reemitir+V.eu.AD.1.SG+IMPF+3+PL
reemitiam-na	reemitir+V.ele.ACC.3.F.SG+IMPF+3+PL
reemitiam-nas	reemitir+V.ele.ACC.3.F.PL+IMPF+3+PL
reemitiam-no	reemitir+V.ele.ACC.3.M.SG+IMPF+3+PL
reemitiam-nos	reemitir+V.ele.ACC.3.M.PL+IMPF+3+PL
reemitiam-nos	reemitir+V.nós.AD.1.PL+IMPF+3+PL
reemitíamo-la	reemitir+V.ele.ACC.3.F.SG+IMPF+1+PL
reemitíamo-las	reemitir+V.ele.ACC.3.F.PL+IMPF+1+PL
reemitíamo-lo	reemitir+V.ele.ACC.3.M.SG+IMPF+1+PL
reemitíamo-los	reemitir+V.ele.ACC.3.M.PL+IMPF+1+PL
reemitíamo-nos	reemitir+nós.AD.1.PL+IMPF+1+PL
reemitíamos-lhe	reemitir+V.ele.DAT.3.SG+IMPF+1+PL
reemitíamos-lhes	reemitir+V.ele.DAT.3.PL+IMPF+1+PL
reemitíamos-me	reemitir+V.eu.AD.1.SG+IMPF+1+PL
reemitíamos-te	reemitir+V.tu.AD.2.SG+IMPF+1+PL
reemitíamos-vos	reemitir+V.vós.AD.2.PL+IMPF+1+PL
reemitiam-se	reemitir+V.ele.REFL+IMPF+3+PL
reemitiam-te	reemitir+V.tu.AD.2.SG+IMPF+3+PL
reemitiam-vos	reemitir+V.vós.AD.2.PL+IMPF+3+PL
reemitia-nos	reemitir+nós.AD.1.PL+IMPF+1+SG
reemitia-nos	reemitir+nós.AD.1.PL+IMPF+2+SG
reemitia-nos	reemitir+nós.AD.1.PL+IMPF+3+SG
reemitia-o	reemitir+V.ele.ACC.3.M.SG+IMPF+1+SG
reemitia-o	reemitir+V.ele.ACC.3.M.SG+IMPF+3+SG
reemitia-os	reemitir+V.ele.ACC.3.M.PL+IMPF+1+SG
reemitia-os	reemitir+V.ele.ACC.3.M.PL+IMPF+3+SG
reemiti-a	reemitir+V.ele.ACC.3.F.SG+PRF+1+SG
reemitia-se	reemitir+V.ele.REFL+IMPF+3+SG
reemitias-lhe	reemitir+V.ele.DAT.3.SG+IMPF+2+SG
reemitias-lhes	reemitir+V.ele.DAT.3.PL+IMPF+2+SG
reemitias-me	reemitir+V.eu.AD.1.SG+IMPF+2+SG
reemiti-as	reemitir+V.ele.ACC.3.F.PL+PRF+1+SG
reemitias-te	reemitir+V.tu.AD.2.SG+IMPF+2+SG
reemitias-vos	reemitir+V.vós.AD.2.PL+IMPF+2+SG
reemitia-te	reemitir+V.tu.AD.2.SG+IMPF+1+SG
reemitia-te	reemitir+V.tu.AD.2.SG+IMPF+3+SG
reemitia-vos	reemitir+V.vós.AD.2.PL+IMPF+1+SG
reemitia-vos	reemitir+V.vós.AD.2.PL+IMPF+3+SG
reemitíei-la	reemitir+V.ele.ACC.3.F.SG+IMPF+2+PL
reemitíei-las	reemitir+V.ele.ACC.3.F.PL+IMPF+2+PL
reemitíei-lo	reemitir+V.ele.ACC.3.M.SG+IMPF+2+PL
reemitíei-los	reemitir+V.ele.ACC.3.M.PL+IMPF+2+PL
reemitíei-nos	reemitir+nós.AD.1.PL+IMPF+2+PL
reemitíeis-lhe	reemitir+V.ele.DAT.3.SG+IMPF+2+PL
reemitíeis-lhes	reemitir+V.ele.DAT.3.PL+IMPF+2+PL
reemitíeis-me	reemitir+V.eu.AD.1.SG+IMPF+2+PL
reemitíeis-te	reemitir+V.tu.AD.2.SG+IMPF+2+PL
reemitíeis-vos	reemitir+V.vós.AD.2.PL+IMPF+2+PL
reemiti-la-ão	reemitir+V.ele.ACC.3.F.SG+FUT+3+PL
reemiti-la-á	reemitir+V.ele.ACC.3.F.SG+FUT+3+SG
reemiti-la-ás	reemitir+V.ele.ACC.3.F.SG+FUT+2+SG
reemiti-la-ei	reemitir+V.ele.ACC.3.F.SG+FUT+1+SG
reemiti-la-eis	reemitir+V.ele.ACC.3.F.SG+FUT+2+PL
reemiti-la-emos	reemitir+V.ele.ACC.3.F.SG+FUT+1+PL
reemiti-la-íamos	reemitir+V.ele.ACC.3.F.SG+COND+1+PL
reemiti-la-iam	reemitir+V.ele.ACC.3.F.SG+COND+3+PL
reemiti-la-ia	reemitir+V.ele.ACC.3.F.SG+COND+1+SG
reemiti-la-ia	reemitir+V.ele.ACC.3.F.SG+COND+3+SG
reemiti-la-ias	reemitir+V.ele.ACC.3.F.SG+COND+2+SG
reemiti-la-íeis	reemitir+V.ele.ACC.3.F.SG+COND+2+PL
reemiti-la	reemitir+V.ele.ACC.3.F.SG+INF+1+SG
reemiti-la	reemitir+V.ele.ACC.3.F.SG+INF+3+SG
reemiti-la	reemitir+V.ele.ACC.3.F.SG+SBJF+1+SG
reemiti-la	reemitir+V.ele.ACC.3.F.SG+SBJF+3+SG
reemiti-las-ão	reemitir+V.ele.ACC.3.F.PL+FUT+3+PL
reemiti-las-á	reemitir+V.ele.ACC.3.F.PL+FUT+3+SG
reemiti-las-ás	reemitir+V.ele.ACC.3.F.PL+FUT+2+SG
reemiti-las-ei	reemitir+V.ele.ACC.3.F.PL+FUT+1+SG
reemiti-las-eis	reemitir+V.ele.ACC.3.F.PL+FUT+2+PL
reemiti-las-emos	reemitir+V.ele.ACC.3.F.PL+FUT+1+PL
reemiti-las-íamos	reemitir+V.ele.ACC.3.F.PL+COND+1+PL
reemiti-las-iam	reemitir+V.ele.ACC.3.F.PL+COND+3+PL
reemiti-las-ia	reemitir+V.ele.ACC.3.F.PL+COND+1+SG
reemiti-las-ia	reemitir+V.ele.ACC.3.F.PL+COND+3+SG
reemiti-las-ias	reemitir+V.ele.ACC.3.F.PL+COND+2+SG
reemiti-las-íeis	reemitir+V.ele.ACC.3.F.PL+COND+2+PL
reemiti-las	reemitir+V.ele.ACC.3.F.PL+INF+1+SG
reemiti-las	reemitir+V.ele.ACC.3.F.PL+INF+3+SG
reemiti-las	reemitir+V.ele.ACC.3.F.PL+SBJF+1+SG
reemiti-las	reemitir+V.ele.ACC.3.F.PL+SBJF+3+SG
reemiti-lhe	reemitir+V.ele.DAT.3.SG+PRF+1+SG
reemiti-lhes	reemitir+V.ele.DAT.3.PL+PRF+1+SG
reemiti-lo-ão	reemitir+V.ele.ACC.3.M.SG+FUT+3+PL
reemiti-lo-á	reemitir+V.ele.ACC.3.M.SG+FUT+3+SG
reemiti-lo-ás	reemitir+V.ele.ACC.3.M.SG+FUT+2+SG
reemiti-lo-ei	reemitir+V.ele.ACC.3.M.SG+FUT+1+SG
reemiti-lo-eis	reemitir+V.ele.ACC.3.M.SG+FUT+2+PL
reemiti-lo-emos	reemitir+V.ele.ACC.3.M.SG+FUT+1+PL
reemiti-lo-íamos	reemitir+V.ele.ACC.3.M.SG+COND+1+PL
reemiti-lo-iam	reemitir+V.ele.ACC.3.M.SG+COND+3+PL
reemiti-lo-ia	reemitir+V.ele.ACC.3.M.SG+COND+1+SG
reemiti-lo-ia	reemitir+V.ele.ACC.3.M.SG+COND+3+SG
reemiti-lo-ias	reemitir+V.ele.ACC.3.M.SG+COND+2+SG
reemiti-lo-íeis	reemitir+V.ele.ACC.3.M.SG+COND+2+PL
reemiti-lo	reemitir+V.ele.ACC.3.M.SG+INF+1+SG
reemiti-lo	reemitir+V.ele.ACC.3.M.SG+INF+3+SG
reemiti-lo	reemitir+V.ele.ACC.3.M.SG+SBJF+1+SG
reemiti-lo	reemitir+V.ele.ACC.3.M.SG+SBJF+3+SG
reemiti-los-ão	reemitir+V.ele.ACC.3.M.PL+FUT+3+PL
reemiti-los-á	reemitir+V.ele.ACC.3.M.PL+FUT+3+SG
reemiti-los-ás	reemitir+V.ele.ACC.3.M.PL+FUT+2+SG
reemiti-los-ei	reemitir+V.ele.ACC.3.M.PL+FUT+1+SG
reemiti-los-eis	reemitir+V.ele.ACC.3.M.PL+FUT+2+PL
reemiti-los-emos	reemitir+V.ele.ACC.3.M.PL+FUT+1+PL
reemiti-los-íamos	reemitir+V.ele.ACC.3.M.PL+COND+1+PL
reemiti-los-iam	reemitir+V.ele.ACC.3.M.PL+COND+3+PL
reemiti-los-ia	reemitir+V.ele.ACC.3.M.PL+COND+1+SG
reemiti-los-ia	reemitir+V.ele.ACC.3.M.PL+COND+3+SG
reemiti-los-ias	reemitir+V.ele.ACC.3.M.PL+COND+2+SG
reemiti-los-íeis	reemitir+V.ele.ACC.3.M.PL+COND+2+PL
reemiti-los	reemitir+V.ele.ACC.3.M.PL+INF+1+SG
reemiti-los	reemitir+V.ele.ACC.3.M.PL+INF+3+SG
reemiti-los	reemitir+V.ele.ACC.3.M.PL+SBJF+1+SG
reemiti-los	reemitir+V.ele.ACC.3.M.PL+SBJF+3+SG
reemiti-me	reemitir+V.eu.AD.1.SG+PRF+1+SG
reemitimo-la	reemitir+V.ele.ACC.3.F.SG+PRF+1+PL
reemitimo-las	reemitir+V.ele.ACC.3.F.PL+PRF+1+PL
reemitimo-lo	reemitir+V.ele.ACC.3.M.SG+PRF+1+PL
reemitimo-los	reemitir+V.ele.ACC.3.M.PL+PRF+1+PL
reemitimo-nos	reemitir+nós.AD.1.PL+PRF+1+PL
reemitimos-lhe	reemitir+V.ele.DAT.3.SG+PRF+1+PL
reemitimos-lhes	reemitir+V.ele.DAT.3.PL+PRF+1+PL
reemitimos-me	reemitir+V.eu.AD.1.SG+PRF+1+PL
reemitimos-te	reemitir+V.tu.AD.2.SG+PRF+1+PL
reemitimos-vos	reemitir+V.vós.AD.2.PL+PRF+1+PL
reemitindo-a	reemitir+V.ele.ACC.3.F.SG+GRD
reemitindo-as	reemitir+V.ele.ACC.3.F.PL+GRD
reemitindo-lhe	reemitir+V.ele.DAT.3.SG+GRD
reemitindo-lhes	reemitir+V.ele.DAT.3.PL+GRD
reemitindo-me	reemitir+V.eu.AD.1.SG+GRD
reemitindo-nos	reemitir+nós.AD.1.PL+GRD
reemitindo-o	reemitir+V.ele.ACC.3.M.SG+GRD
reemitindo-os	reemitir+V.ele.ACC.3.M.PL+GRD
reemitindo-se	reemitir+V.ele.REFL+GRD
reemitindo-te	reemitir+V.tu.AD.2.SG+GRD
reemitindo-vos	reemitir+V.vós.AD.2.PL+GRD
reemiti-nos	reemitir+nós.AD.1.PL+PRF+1+SG
reemiti-o	reemitir+V.ele.ACC.3.M.SG+PRF+1+SG
reemiti-os	reemitir+V.ele.ACC.3.M.PL+PRF+1+SG
reemitiram-lhe	reemitir+V.ele.DAT.3.SG+PRF+3+PL
reemitiram-lhes	reemitir+V.ele.DAT.3.PL+PRF+3+PL
reemitiram-me	reemitir+V.eu.AD.1.SG+PRF+3+PL
reemitiram-na	reemitir+V.ele.ACC.3.F.SG+PRF+3+PL
reemitiram-nas	reemitir+V.ele.ACC.3.F.PL+PRF+3+PL
reemitiram-no	reemitir+V.ele.ACC.3.M.SG+PRF+3+PL
reemitiram-nos	reemitir+V.ele.ACC.3.M.PL+PRF+3+PL
reemitiram-nos	reemitir+V.nós.AD.1.PL+PRF+3+PL
reemitiram-se	reemitir+V.ele.REFL+PRF+3+PL
reemitiram-te	reemitir+V.tu.AD.2.SG+PRF+3+PL
reemitiram-vos	reemitir+V.vós.AD.2.PL+PRF+3+PL
reemitirde-la	reemitir+V.ele.ACC.3.F.SG+INF+2+PL
reemitirde-la	reemitir+V.ele.ACC.3.F.SG+SBJF+2+PL
reemitirde-las	reemitir+V.ele.ACC.3.F.PL+INF+2+PL
reemitirde-las	reemitir+V.ele.ACC.3.F.PL+SBJF+2+PL
reemitirde-lo	reemitir+V.ele.ACC.3.M.SG+INF+2+PL
reemitirde-lo	reemitir+V.ele.ACC.3.M.SG+SBJF+2+PL
reemitirde-los	reemitir+V.ele.ACC.3.M.PL+INF+2+PL
reemitirde-los	reemitir+V.ele.ACC.3.M.PL+SBJF+2+PL
reemitirde-nos	reemitir+nós.AD.1.PL+INF+2+PL
reemitirde-nos	reemitir+nós.AD.1.PL+SBJF+2+PL
reemitirdes-lhe	reemitir+V.ele.DAT.3.SG+INF+2+PL
reemitirdes-lhe	reemitir+V.ele.DAT.3.SG+SBJF+2+PL
reemitirdes-lhes	reemitir+V.ele.DAT.3.PL+INF+2+PL
reemitirdes-lhes	reemitir+V.ele.DAT.3.PL+SBJF+2+PL
reemitirdes-me	reemitir+V.eu.AD.1.SG+INF+2+PL
reemitirdes-me	reemitir+V.eu.AD.1.SG+SBJF+2+PL
reemitirdes-te	reemitir+V.tu.AD.2.SG+INF+2+PL
reemitirdes-te	reemitir+V.tu.AD.2.SG+SBJF+2+PL
reemitirdes-vos	reemitir+V.vós.AD.2.PL+INF+2+PL
reemitirdes-vos	reemitir+V.vós.AD.2.PL+SBJF+2+PL
reemitire-la	reemitir+V.ele.ACC.3.F.SG+INF+2+SG
reemitire-la	reemitir+V.ele.ACC.3.F.SG+SBJF+2+SG
reemitire-las	reemitir+V.ele.ACC.3.F.PL+INF+2+SG
reemitire-las	reemitir+V.ele.ACC.3.F.PL+SBJF+2+SG
reemitire-lo	reemitir+V.ele.ACC.3.M.SG+INF+2+SG
reemitire-lo	reemitir+V.ele.ACC.3.M.SG+SBJF+2+SG
reemitire-los	reemitir+V.ele.ACC.3.M.PL+INF+2+SG
reemitire-los	reemitir+V.ele.ACC.3.M.PL+SBJF+2+SG
reemitirem-lhe	reemitir+V.ele.DAT.3.SG+INF+3+PL
reemitirem-lhe	reemitir+V.ele.DAT.3.SG+SBJF+3+PL
reemitirem-lhes	reemitir+V.ele.DAT.3.PL+INF+3+PL
reemitirem-lhes	reemitir+V.ele.DAT.3.PL+SBJF+3+PL
reemitirem-me	reemitir+V.eu.AD.1.SG+INF+3+PL
reemitirem-me	reemitir+V.eu.AD.1.SG+SBJF+3+PL
reemitirem-na	reemitir+V.ele.ACC.3.F.SG+INF+3+PL
reemitirem-na	reemitir+V.ele.ACC.3.F.SG+SBJF+3+PL
reemitirem-nas	reemitir+V.ele.ACC.3.F.PL+INF+3+PL
reemitirem-nas	reemitir+V.ele.ACC.3.F.PL+SBJF+3+PL
reemitirem-no	reemitir+V.ele.ACC.3.M.SG+INF+3+PL
reemitirem-no	reemitir+V.ele.ACC.3.M.SG+SBJF+3+PL
reemitirem-nos	reemitir+V.ele.ACC.3.M.PL+INF+3+PL
reemitirem-nos	reemitir+V.ele.ACC.3.M.PL+SBJF+3+PL
reemitirem-nos	reemitir+V.nós.AD.1.PL+INF+3+PL
reemitirem-nos	reemitir+V.nós.AD.1.PL+SBJF+3+PL
reemitirem-se	reemitir+V.ele.REFL+INF+3+PL
reemitirem-se	reemitir+V.ele.REFL+SBJF+3+PL
reemitirem-te	reemitir+V.tu.AD.2.SG+INF+3+PL
reemitirem-te	reemitir+V.tu.AD.2.SG+SBJF+3+PL
reemitirem-vos	reemitir+V.vós.AD.2.PL+INF+3+PL
reemitirem-vos	reemitir+V.vós.AD.2.PL+SBJF+3+PL
reemitire-nos	reemitir+nós.AD.1.PL+INF+2+SG
reemitire-nos	reemitir+nós.AD.1.PL+SBJF+2+SG
reemitires-lhe	reemitir+V.ele.DAT.3.SG+INF+2+SG
reemitires-lhe	reemitir+V.ele.DAT.3.SG+SBJF+2+SG
reemitires-lhes	reemitir+V.ele.DAT.3.PL+INF+2+SG
reemitires-lhes	reemitir+V.ele.DAT.3.PL+SBJF+2+SG
reemitires-me	reemitir+V.eu.AD.1.SG+INF+2+SG
reemitires-me	reemitir+V.eu.AD.1.SG+SBJF+2+SG
reemitires-te	reemitir+V.tu.AD.2.SG+INF+2+SG
reemitires-te	reemitir+V.tu.AD.2.SG+SBJF+2+SG
reemitires-vos	reemitir+V.vós.AD.2.PL+INF+2+SG
reemitires-vos	reemitir+V.vós.AD.2.PL+SBJF+2+SG
reemitir-lhe-ão	reemitir+V.ele.DAT.3.SG+FUT+3+PL
reemitir-lhe-á	reemitir+V.ele.DAT.3.SG+FUT+3+SG
reemitir-lhe-ás	reemitir+V.ele.DAT.3.SG+FUT+2+SG
reemitir-lhe-ei	reemitir+V.ele.DAT.3.SG+FUT+1+SG
reemitir-lhe-eis	reemitir+V.ele.DAT.3.SG+FUT+2+PL
reemitir-lhe-emos	reemitir+V.ele.DAT.3.SG+FUT+1+PL
reemitir-lhe-íamos	reemitir+V.ele.DAT.3.SG+COND+1+PL
reemitir-lhe-iam	reemitir+V.ele.DAT.3.SG+COND+3+PL
reemitir-lhe-ia	reemitir+V.ele.DAT.3.SG+COND+1+SG
reemitir-lhe-ia	reemitir+V.ele.DAT.3.SG+COND+3+SG
reemitir-lhe-ias	reemitir+V.ele.DAT.3.SG+COND+2+SG
reemitir-lhe-íeis	reemitir+V.ele.DAT.3.SG+COND+2+PL
reemitir-lhe	reemitir+V.ele.DAT.3.SG+INF
reemitir-lhe	reemitir+V.ele.DAT.3.SG+INF+1+SG
reemitir-lhe	reemitir+V.ele.DAT.3.SG+INF+3+SG
reemitir-lhe	reemitir+V.ele.DAT.3.SG+SBJF+1+SG
reemitir-lhe	reemitir+V.ele.DAT.3.SG+SBJF+3+SG
reemitir-lhes-ão	reemitir+V.ele.DAT.3.PL+FUT+3+PL
reemitir-lhes-á	reemitir+V.ele.DAT.3.PL+FUT+3+SG
reemitir-lhes-ás	reemitir+V.ele.DAT.3.PL+FUT+2+SG
reemitir-lhes-ei	reemitir+V.ele.DAT.3.PL+FUT+1+SG
reemitir-lhes-eis	reemitir+V.ele.DAT.3.PL+FUT+2+PL
reemitir-lhes-emos	reemitir+V.ele.DAT.3.PL+FUT+1+PL
reemitir-lhes-íamos	reemitir+V.ele.DAT.3.PL+COND+1+PL
reemitir-lhes-iam	reemitir+V.ele.DAT.3.PL+COND+3+PL
reemitir-lhes-ia	reemitir+V.ele.DAT.3.PL+COND+1+SG
reemitir-lhes-ia	reemitir+V.ele.DAT.3.PL+COND+3+SG
reemitir-lhes-ias	reemitir+V.ele.DAT.3.PL+COND+2+SG
reemitir-lhes-íeis	reemitir+V.ele.DAT.3.PL+COND+2+PL
reemitir-lhes	reemitir+V.ele.DAT.3.PL+INF
reemitir-lhes	reemitir+V.ele.DAT.3.PL+INF+1+SG
reemitir-lhes	reemitir+V.ele.DAT.3.PL+INF+3+SG
reemitir-lhes	reemitir+V.ele.DAT.3.PL+SBJF+1+SG
reemitir-lhes	reemitir+V.ele.DAT.3.PL+SBJF+3+SG
reemitir-me-ão	reemitir+V.eu.AD.1.SG+FUT+3+PL
reemitir-me-á	reemitir+V.eu.AD.1.SG+FUT+3+SG
reemitir-me-ás	reemitir+V.eu.AD.1.SG+FUT+2+SG
reemitir-me-ei	reemitir+V.eu.AD.1.SG+FUT+1+SG
reemitir-me-eis	reemitir+V.eu.AD.1.SG+FUT+2+PL
reemitir-me-emos	reemitir+V.eu.AD.1.SG+FUT+1+PL
reemitir-me-íamos	reemitir+V.eu.AD.1.SG+COND+1+PL
reemitir-me-iam	reemitir+V.eu.AD.1.SG+COND+3+PL
reemitir-me-ia	reemitir+V.eu.AD.1.SG+COND+1+SG
reemitir-me-ia	reemitir+V.eu.AD.1.SG+COND+3+SG
reemitir-me-ias	reemitir+V.eu.AD.1.SG+COND+2+SG
reemitir-me-íeis	reemitir+V.eu.AD.1.SG+COND+2+PL
reemitir-me	reemitir+V.eu.AD.1.SG+INF
reemitir-me	reemitir+V.eu.AD.1.SG+INF+1+SG
reemitir-me	reemitir+V.eu.AD.1.SG+INF+3+SG
reemitir-me	reemitir+V.eu.AD.1.SG+SBJF+1+SG
reemitir-me	reemitir+V.eu.AD.1.SG+SBJF+3+SG
reemitirmo-la	reemitir+V.ele.ACC.3.F.SG+INF+1+PL
reemitirmo-la	reemitir+V.ele.ACC.3.F.SG+SBJF+1+PL
reemitirmo-las	reemitir+V.ele.ACC.3.F.PL+INF+1+PL
reemitirmo-las	reemitir+V.ele.ACC.3.F.PL+SBJF+1+PL
reemitirmo-lo	reemitir+V.ele.ACC.3.M.SG+INF+1+PL
reemitirmo-lo	reemitir+V.ele.ACC.3.M.SG+SBJF+1+PL
reemitirmo-los	reemitir+V.ele.ACC.3.M.PL+INF+1+PL
reemitirmo-los	reemitir+V.ele.ACC.3.M.PL+SBJF+1+PL
reemitirmo-nos	reemitir+nós.AD.1.PL+INF+1+PL
reemitirmo-nos	reemitir+nós.AD.1.PL+SBJF+1+PL
reemitirmos-lhe	reemitir+V.ele.DAT.3.SG+INF+1+PL
reemitirmos-lhe	reemitir+V.ele.DAT.3.SG+SBJF+1+PL
reemitirmos-lhes	reemitir+V.ele.DAT.3.PL+INF+1+PL
reemitirmos-lhes	reemitir+V.ele.DAT.3.PL+SBJF+1+PL
reemitirmos-me	reemitir+V.eu.AD.1.SG+INF+1+PL
reemitirmos-me	reemitir+V.eu.AD.1.SG+SBJF+1+PL
reemitirmos-te	reemitir+V.tu.AD.2.SG+INF+1+PL
reemitirmos-te	reemitir+V.tu.AD.2.SG+SBJF+1+PL
reemitirmos-vos	reemitir+V.vós.AD.2.PL+INF+1+PL
reemitirmos-vos	reemitir+V.vós.AD.2.PL+SBJF+1+PL
reemitir-nos-ão	reemitir+nós.AD.1.PL+FUT+3+PL
reemitir-nos-á	reemitir+nós.AD.1.PL+FUT+3+SG
reemitir-nos-ás	reemitir+nós.AD.1.PL+FUT+2+SG
reemitir-nos-ei	reemitir+nós.AD.1.PL+FUT+1+SG
reemitir-nos-eis	reemitir+nós.AD.1.PL+FUT+2+PL
reemitir-nos-emos	reemitir+nós.AD.1.PL+FUT+1+PL
reemitir-nos-íamos	reemitir+nós.AD.1.PL+COND+1+PL
reemitir-nos-iam	reemitir+nós.AD.1.PL+COND+3+PL
reemitir-nos-ia	reemitir+nós.AD.1.PL+COND+1+SG
reemitir-nos-ia	reemitir+nós.AD.1.PL+COND+3+SG
reemitir-nos-ias	reemitir+nós.AD.1.PL+COND+2+SG
reemitir-nos-íeis	reemitir+nós.AD.1.PL+COND+2+PL
reemitir-nos	reemitir+nós.AD.1.PL+INF
reemitir-nos	reemitir+nós.AD.1.PL+INF+1+SG
reemitir-nos	reemitir+nós.AD.1.PL+INF+3+SG
reemitir-nos	reemitir+nós.AD.1.PL+SBJF+1+SG
reemitir-nos	reemitir+nós.AD.1.PL+SBJF+3+SG
reemitir-se-ão	reemitir+V.ele.REFL+FUT+3+PL
reemitir-se-á	reemitir+V.ele.REFL+FUT+3+SG
reemitir-se-iam	reemitir+V.ele.REFL+COND+3+PL
reemitir-se-ia	reemitir+V.ele.REFL+COND+3+SG
reemitir-se	reemitir+V.ele.REFL+INF
reemitir-se	reemitir+V.ele.REFL+INF+3+SG
reemitir-se	reemitir+V.ele.REFL+SBJF+3+SG
reemitir-te-ão	reemitir+V.tu.AD.2.SG+FUT+3+PL
reemitir-te-á	reemitir+V.tu.AD.2.SG+FUT+3+SG
reemitir-te-ás	reemitir+V.tu.AD.2.SG+FUT+2+SG
reemitir-te-ei	reemitir+V.tu.AD.2.SG+FUT+1+SG
reemitir-te-eis	reemitir+V.tu.AD.2.SG+FUT+2+PL
reemitir-te-emos	reemitir+V.tu.AD.2.SG+FUT+1+PL
reemitir-te-íamos	reemitir+V.tu.AD.2.SG+COND+1+PL
reemitir-te-iam	reemitir+V.tu.AD.2.SG+COND+3+PL
reemitir-te-ia	reemitir+V.tu.AD.2.SG+COND+1+SG
reemitir-te-ia	reemitir+V.tu.AD.2.SG+COND+3+SG
reemitir-te-ias	reemitir+V.tu.AD.2.SG+COND+2+SG
reemitir-te-íeis	reemitir+V.tu.AD.2.SG+COND+2+PL
reemitir-te	reemitir+V.tu.AD.2.SG+INF
reemitir-te	reemitir+V.tu.AD.2.SG+INF+1+SG
reemitir-te	reemitir+V.tu.AD.2.SG+INF+3+SG
reemitir-te	reemitir+V.tu.AD.2.SG+SBJF+1+SG
reemitir-te	reemitir+V.tu.AD.2.SG+SBJF+3+SG
reemitir-vos-ão	reemitir+V.vós.AD.2.PL+FUT+3+PL
reemitir-vos-á	reemitir+V.vós.AD.2.PL+FUT+3+SG
reemitir-vos-ás	reemitir+V.vós.AD.2.PL+FUT+2+SG
reemitir-vos-ei	reemitir+V.vós.AD.2.PL+FUT+1+SG
reemitir-vos-eis	reemitir+V.vós.AD.2.PL+FUT+2+PL
reemitir-vos-emos	reemitir+V.vós.AD.2.PL+FUT+1+PL
reemitir-vos-íamos	reemitir+V.vós.AD.2.PL+COND+1+PL
reemitir-vos-iam	reemitir+V.vós.AD.2.PL+COND+3+PL
reemitir-vos-ia	reemitir+V.vós.AD.2.PL+COND+1+SG
reemitir-vos-ia	reemitir+V.vós.AD.2.PL+COND+3+SG
reemitir-vos-ias	reemitir+V.vós.AD.2.PL+COND+2+SG
reemitir-vos-íeis	reemitir+V.vós.AD.2.PL+COND+2+PL
reemitir-vos	reemitir+V.vós.AD.2.PL+INF
reemitir-vos	reemitir+V.vós.AD.2.PL+INF+1+SG
reemitir-vos	reemitir+V.vós.AD.2.PL+INF+3+SG
reemitir-vos	reemitir+V.vós.AD.2.PL+SBJF+1+SG
reemitir-vos	reemitir+V.vós.AD.2.PL+SBJF+3+SG
reemitiste-a	reemitir+V.ele.ACC.3.F.SG+PRF+2+SG
reemitiste-as	reemitir+V.ele.ACC.3.F.PL+PRF+2+SG
reemitiste-la	reemitir+V.ele.ACC.3.F.SG+PRF+2+PL
reemitiste-las	reemitir+V.ele.ACC.3.F.PL+PRF+2+PL
reemitiste-lhe	reemitir+V.ele.DAT.3.SG+PRF+2+SG
reemitiste-lhes	reemitir+V.ele.DAT.3.PL+PRF+2+SG
reemitiste-lo	reemitir+V.ele.ACC.3.M.SG+PRF+2+PL
reemitiste-los	reemitir+V.ele.ACC.3.M.PL+PRF+2+PL
reemitiste-me	reemitir+V.eu.AD.1.SG+PRF+2+SG
reemitiste-nos	reemitir+nós.AD.1.PL+PRF+2+PL
reemitiste-nos	reemitir+nós.AD.1.PL+PRF+2+SG
reemitiste-o	reemitir+V.ele.ACC.3.M.SG+PRF+2+SG
reemitiste-os	reemitir+V.ele.ACC.3.M.PL+PRF+2+SG
reemitistes-lhe	reemitir+V.ele.DAT.3.SG+PRF+2+PL
reemitistes-lhes	reemitir+V.ele.DAT.3.PL+PRF+2+PL
reemitistes-me	reemitir+V.eu.AD.1.SG+PRF+2+PL
reemitistes-te	reemitir+V.tu.AD.2.SG+PRF+2+PL
reemitistes-vos	reemitir+V.vós.AD.2.PL+PRF+2+PL
reemitiste-te	reemitir+V.tu.AD.2.SG+PRF+2+SG
reemitiste-vos	reemitir+V.vós.AD.2.PL+PRF+2+SG
reemiti-te	reemitir+V.tu.AD.2.SG+PRF+1+SG
reemitiu-a	reemitir+V.ele.ACC.3.F.SG+PRF+3+SG
reemitiu-as	reemitir+V.ele.ACC.3.F.PL+PRF+3+SG
reemitiu-lhe	reemitir+V.ele.DAT.3.SG+PRF+3+SG
reemitiu-lhes	reemitir+V.ele.DAT.3.PL+PRF+3+SG
reemitiu-me	reemitir+V.eu.AD.1.SG+PRF+3+SG
reemitiu-nos	reemitir+nós.AD.1.PL+PRF+3+SG
reemitiu-o	reemitir+V.ele.ACC.3.M.SG+PRF+3+SG
reemitiu-os	reemitir+V.ele.ACC.3.M.PL+PRF+3+SG
reemitiu-se	reemitir+V.ele.REFL+PRF+3+SG
reemitiu-te	reemitir+V.tu.AD.2.SG+PRF+3+SG
reemitiu-vos	reemitir+V.vós.AD.2.PL+PRF+3+SG
reemiti-vos	reemitir+V.vós.AD.2.PL+PRF+1+SG
reem-lhe	rer+V.ele.DAT.3.SG+PRS+3+PL
reem-lhes	rer+V.ele.DAT.3.PL+PRS+3+PL
reem-me	rer+V.eu.AD.1.SG+PRS+3+PL
reem-na	rer+V.ele.ACC.3.F.SG+PRS+3+PL
reem-nas	rer+V.ele.ACC.3.F.PL+PRS+3+PL
reem-no	rer+V.ele.ACC.3.M.SG+PRS+3+PL
reem-nos	rer+V.ele.ACC.3.M.PL+PRS+3+PL
reem-nos	rer+V.nós.AD.1.PL+PRS+3+PL
reempossa-a	reempossar+V.ele.ACC.3.F.SG+PRS+3+SG
reempossa-as	reempossar+V.ele.ACC.3.F.PL+PRS+3+SG
reempossai-la	reempossar+V.ele.ACC.3.F.SG+PRS+2+PL
reempossai-las	reempossar+V.ele.ACC.3.F.PL+PRS+2+PL
reempossai-lo	reempossar+V.ele.ACC.3.M.SG+PRS+2+PL
reempossai-los	reempossar+V.ele.ACC.3.M.PL+PRS+2+PL
reempossai-nos	reempossar+nós.AD.1.PL+PRS+2+PL
reempossais-lhe	reempossar+V.ele.DAT.3.SG+PRS+2+PL
reempossais-lhes	reempossar+V.ele.DAT.3.PL+PRS+2+PL
reempossais-me	reempossar+V.eu.AD.1.SG+PRS+2+PL
reempossais-te	reempossar+V.tu.AD.2.SG+PRS+2+PL
reempossais-vos	reempossar+V.vós.AD.2.PL+PRS+2+PL
reempossá-la-ão	reempossar+V.ele.ACC.3.F.SG+FUT+3+PL
reempossá-la-á	reempossar+V.ele.ACC.3.F.SG+FUT+3+SG
reempossá-la-ás	reempossar+V.ele.ACC.3.F.SG+FUT+2+SG
reempossá-la-ei	reempossar+V.ele.ACC.3.F.SG+FUT+1+SG
reempossá-la-eis	reempossar+V.ele.ACC.3.F.SG+FUT+2+PL
reempossá-la-emos	reempossar+V.ele.ACC.3.F.SG+FUT+1+PL
reempossá-la-íamos	reempossar+V.ele.ACC.3.F.SG+COND+1+PL
reempossá-la-iam	reempossar+V.ele.ACC.3.F.SG+COND+3+PL
reempossá-la-ia	reempossar+V.ele.ACC.3.F.SG+COND+1+SG
reempossá-la-ia	reempossar+V.ele.ACC.3.F.SG+COND+3+SG
reempossá-la-ias	reempossar+V.ele.ACC.3.F.SG+COND+2+SG
reempossá-la-íeis	reempossar+V.ele.ACC.3.F.SG+COND+2+PL
reempossá-la	reempossar+V.ele.ACC.3.F.SG+INF+1+SG
reempossá-la	reempossar+V.ele.ACC.3.F.SG+INF+3+SG
reempossa-la	reempossar+V.ele.ACC.3.F.SG+PRS+2+SG
reempossá-la	reempossar+V.ele.ACC.3.F.SG+SBJF+1+SG
reempossá-la	reempossar+V.ele.ACC.3.F.SG+SBJF+3+SG
reempossá-las-ão	reempossar+V.ele.ACC.3.F.PL+FUT+3+PL
reempossá-las-á	reempossar+V.ele.ACC.3.F.PL+FUT+3+SG
reempossá-las-ás	reempossar+V.ele.ACC.3.F.PL+FUT+2+SG
reempossá-las-ei	reempossar+V.ele.ACC.3.F.PL+FUT+1+SG
reempossá-las-eis	reempossar+V.ele.ACC.3.F.PL+FUT+2+PL
reempossá-las-emos	reempossar+V.ele.ACC.3.F.PL+FUT+1+PL
reempossá-las-íamos	reempossar+V.ele.ACC.3.F.PL+COND+1+PL
reempossá-las-iam	reempossar+V.ele.ACC.3.F.PL+COND+3+PL
reempossá-las-ia	reempossar+V.ele.ACC.3.F.PL+COND+1+SG
reempossá-las-ia	reempossar+V.ele.ACC.3.F.PL+COND+3+SG
reempossá-las-ias	reempossar+V.ele.ACC.3.F.PL+COND+2+SG
reempossá-las-íeis	reempossar+V.ele.ACC.3.F.PL+COND+2+PL
reempossá-las	reempossar+V.ele.ACC.3.F.PL+INF+1+SG
reempossá-las	reempossar+V.ele.ACC.3.F.PL+INF+3+SG
reempossa-las	reempossar+V.ele.ACC.3.F.PL+PRS+2+SG
reempossá-las	reempossar+V.ele.ACC.3.F.PL+SBJF+1+SG
reempossá-las	reempossar+V.ele.ACC.3.F.PL+SBJF+3+SG
reempossa-lhe	reempossar+V.ele.DAT.3.SG+PRS+3+SG
reempossa-lhes	reempossar+V.ele.DAT.3.PL+PRS+3+SG
reempossá-lo-ão	reempossar+V.ele.ACC.3.M.SG+FUT+3+PL
reempossá-lo-á	reempossar+V.ele.ACC.3.M.SG+FUT+3+SG
reempossá-lo-ás	reempossar+V.ele.ACC.3.M.SG+FUT+2+SG
reempossá-lo-ei	reempossar+V.ele.ACC.3.M.SG+FUT+1+SG
reempossá-lo-eis	reempossar+V.ele.ACC.3.M.SG+FUT+2+PL
reempossá-lo-emos	reempossar+V.ele.ACC.3.M.SG+FUT+1+PL
reempossá-lo-íamos	reempossar+V.ele.ACC.3.M.SG+COND+1+PL
reempossá-lo-iam	reempossar+V.ele.ACC.3.M.SG+COND+3+PL
reempossá-lo-ia	reempossar+V.ele.ACC.3.M.SG+COND+1+SG
reempossá-lo-ia	reempossar+V.ele.ACC.3.M.SG+COND+3+SG
reempossá-lo-ias	reempossar+V.ele.ACC.3.M.SG+COND+2+SG
reempossá-lo-íeis	reempossar+V.ele.ACC.3.M.SG+COND+2+PL
reempossá-lo	reempossar+V.ele.ACC.3.M.SG+INF+1+SG
reempossá-lo	reempossar+V.ele.ACC.3.M.SG+INF+3+SG
reempossa-lo	reempossar+V.ele.ACC.3.M.SG+PRS+2+SG
reempossá-lo	reempossar+V.ele.ACC.3.M.SG+SBJF+1+SG
reempossá-lo	reempossar+V.ele.ACC.3.M.SG+SBJF+3+SG
reempossá-los-ão	reempossar+V.ele.ACC.3.M.PL+FUT+3+PL
reempossá-los-á	reempossar+V.ele.ACC.3.M.PL+FUT+3+SG
reempossá-los-ás	reempossar+V.ele.ACC.3.M.PL+FUT+2+SG
reempossá-los-ei	reempossar+V.ele.ACC.3.M.PL+FUT+1+SG
reempossá-los-eis	reempossar+V.ele.ACC.3.M.PL+FUT+2+PL
reempossá-los-emos	reempossar+V.ele.ACC.3.M.PL+FUT+1+PL
reempossá-los-íamos	reempossar+V.ele.ACC.3.M.PL+COND+1+PL
reempossá-los-iam	reempossar+V.ele.ACC.3.M.PL+COND+3+PL
reempossá-los-ia	reempossar+V.ele.ACC.3.M.PL+COND+1+SG
reempossá-los-ia	reempossar+V.ele.ACC.3.M.PL+COND+3+SG
reempossá-los-ias	reempossar+V.ele.ACC.3.M.PL+COND+2+SG
reempossá-los-íeis	reempossar+V.ele.ACC.3.M.PL+COND+2+PL
reempossá-los	reempossar+V.ele.ACC.3.M.PL+INF+1+SG
reempossá-los	reempossar+V.ele.ACC.3.M.PL+INF+3+SG
reempossa-los	reempossar+V.ele.ACC.3.M.PL+PRS+2+SG
reempossá-los	reempossar+V.ele.ACC.3.M.PL+SBJF+1+SG
reempossá-los	reempossar+V.ele.ACC.3.M.PL+SBJF+3+SG
reempossa-me	reempossar+V.eu.AD.1.SG+PRS+3+SG
reempossam-lhe	reempossar+V.ele.DAT.3.SG+PRS+3+PL
reempossam-lhes	reempossar+V.ele.DAT.3.PL+PRS+3+PL
reempossam-me	reempossar+V.eu.AD.1.SG+PRS+3+PL
reempossam-na	reempossar+V.ele.ACC.3.F.SG+PRS+3+PL
reempossam-nas	reempossar+V.ele.ACC.3.F.PL+PRS+3+PL
reempossam-no	reempossar+V.ele.ACC.3.M.SG+PRS+3+PL
reempossam-nos	reempossar+V.ele.ACC.3.M.PL+PRS+3+PL
reempossam-nos	reempossar+V.nós.AD.1.PL+PRS+3+PL
reempossamo-la	reempossar+V.ele.ACC.3.F.SG+PRF+1+PL
reempossamo-la	reempossar+V.ele.ACC.3.F.SG+PRS+1+PL
reempossamo-las	reempossar+V.ele.ACC.3.F.PL+PRF+1+PL
reempossamo-las	reempossar+V.ele.ACC.3.F.PL+PRS+1+PL
reempossamo-lo	reempossar+V.ele.ACC.3.M.SG+PRF+1+PL
reempossamo-lo	reempossar+V.ele.ACC.3.M.SG+PRS+1+PL
reempossamo-los	reempossar+V.ele.ACC.3.M.PL+PRF+1+PL
reempossamo-los	reempossar+V.ele.ACC.3.M.PL+PRS+1+PL
reempossamo-nos	reempossar+nós.AD.1.PL+PRF+1+PL
reempossamo-nos	reempossar+nós.AD.1.PL+PRS+1+PL
reempossamos-lhe	reempossar+V.ele.DAT.3.SG+PRF+1+PL
reempossamos-lhe	reempossar+V.ele.DAT.3.SG+PRS+1+PL
reempossamos-lhes	reempossar+V.ele.DAT.3.PL+PRF+1+PL
reempossamos-lhes	reempossar+V.ele.DAT.3.PL+PRS+1+PL
reempossamos-me	reempossar+V.eu.AD.1.SG+PRF+1+PL
reempossamos-me	reempossar+V.eu.AD.1.SG+PRS+1+PL
reempossamos-te	reempossar+V.tu.AD.2.SG+PRF+1+PL
reempossamos-te	reempossar+V.tu.AD.2.SG+PRS+1+PL
reempossamos-vos	reempossar+V.vós.AD.2.PL+PRF+1+PL
reempossamos-vos	reempossar+V.vós.AD.2.PL+PRS+1+PL
reempossam-se	reempossar+V.ele.REFL+PRS+3+PL
reempossam-te	reempossar+V.tu.AD.2.SG+PRS+3+PL
reempossam-vos	reempossar+V.vós.AD.2.PL+PRS+3+PL
reempossando-a	reempossar+V.ele.ACC.3.F.SG+GRD
reempossando-as	reempossar+V.ele.ACC.3.F.PL+GRD
reempossando-lhe	reempossar+V.ele.DAT.3.SG+GRD
reempossando-lhes	reempossar+V.ele.DAT.3.PL+GRD
reempossando-me	reempossar+V.eu.AD.1.SG+GRD
reempossando-nos	reempossar+nós.AD.1.PL+GRD
reempossando-o	reempossar+V.ele.ACC.3.M.SG+GRD
reempossando-os	reempossar+V.ele.ACC.3.M.PL+GRD
reempossando-se	reempossar+V.ele.REFL+GRD
reempossando-te	reempossar+V.tu.AD.2.SG+GRD
reempossando-vos	reempossar+V.vós.AD.2.PL+GRD
reempossa-nos	reempossar+nós.AD.1.PL+PRS+2+SG
reempossa-nos	reempossar+nós.AD.1.PL+PRS+3+SG
reempossa-o	reempossar+V.ele.ACC.3.M.SG+PRS+3+SG
reempossa-os	reempossar+V.ele.ACC.3.M.PL+PRS+3+SG
reempossara-a	reempossar+V.ele.ACC.3.F.SG+PQP+1+SG
reempossara-a	reempossar+V.ele.ACC.3.F.SG+PQP+3+SG
reempossara-as	reempossar+V.ele.ACC.3.F.PL+PQP+1+SG
reempossara-as	reempossar+V.ele.ACC.3.F.PL+PQP+3+SG
reempossara-la	reempossar+V.ele.ACC.3.F.SG+PQP+2+SG
reempossara-las	reempossar+V.ele.ACC.3.F.PL+PQP+2+SG
reempossara-lhe	reempossar+V.ele.DAT.3.SG+PQP+1+SG
reempossara-lhe	reempossar+V.ele.DAT.3.SG+PQP+3+SG
reempossara-lhes	reempossar+V.ele.DAT.3.PL+PQP+1+SG
reempossara-lhes	reempossar+V.ele.DAT.3.PL+PQP+3+SG
reempossara-lo	reempossar+V.ele.ACC.3.M.SG+PQP+2+SG
reempossara-los	reempossar+V.ele.ACC.3.M.PL+PQP+2+SG
reempossara-me	reempossar+V.eu.AD.1.SG+PQP+1+SG
reempossara-me	reempossar+V.eu.AD.1.SG+PQP+3+SG
reempossaram-lhe	reempossar+V.ele.DAT.3.SG+PQP+3+PL
reempossaram-lhe	reempossar+V.ele.DAT.3.SG+PRF+3+PL
reempossaram-lhes	reempossar+V.ele.DAT.3.PL+PQP+3+PL
reempossaram-lhes	reempossar+V.ele.DAT.3.PL+PRF+3+PL
reempossaram-me	reempossar+V.eu.AD.1.SG+PQP+3+PL
reempossaram-me	reempossar+V.eu.AD.1.SG+PRF+3+PL
reempossaram-na	reempossar+V.ele.ACC.3.F.SG+PQP+3+PL
reempossaram-na	reempossar+V.ele.ACC.3.F.SG+PRF+3+PL
reempossaram-nas	reempossar+V.ele.ACC.3.F.PL+PQP+3+PL
reempossaram-nas	reempossar+V.ele.ACC.3.F.PL+PRF+3+PL
reempossaram-no	reempossar+V.ele.ACC.3.M.SG+PQP+3+PL
reempossaram-no	reempossar+V.ele.ACC.3.M.SG+PRF+3+PL
reempossaram-nos	reempossar+V.ele.ACC.3.M.PL+PQP+3+PL
reempossaram-nos	reempossar+V.ele.ACC.3.M.PL+PRF+3+PL
reempossaram-nos	reempossar+V.nós.AD.1.PL+PQP+3+PL
reempossaram-nos	reempossar+V.nós.AD.1.PL+PRF+3+PL
reempossáramo-la	reempossar+V.ele.ACC.3.F.SG+PQP+1+PL
reempossáramo-las	reempossar+V.ele.ACC.3.F.PL+PQP+1+PL
reempossáramo-lo	reempossar+V.ele.ACC.3.M.SG+PQP+1+PL
reempossáramo-los	reempossar+V.ele.ACC.3.M.PL+PQP+1+PL
reempossáramo-nos	reempossar+nós.AD.1.PL+PQP+1+PL
reempossáramos-lhe	reempossar+V.ele.DAT.3.SG+PQP+1+PL
reempossáramos-lhes	reempossar+V.ele.DAT.3.PL+PQP+1+PL
reempossáramos-me	reempossar+V.eu.AD.1.SG+PQP+1+PL
reempossáramos-te	reempossar+V.tu.AD.2.SG+PQP+1+PL
reempossáramos-vos	reempossar+V.vós.AD.2.PL+PQP+1+PL
reempossaram-se	reempossar+V.ele.REFL+PQP+3+PL
reempossaram-se	reempossar+V.ele.REFL+PRF+3+PL
reempossaram-te	reempossar+V.tu.AD.2.SG+PQP+3+PL
reempossaram-te	reempossar+V.tu.AD.2.SG+PRF+3+PL
reempossaram-vos	reempossar+V.vós.AD.2.PL+PQP+3+PL
reempossaram-vos	reempossar+V.vós.AD.2.PL+PRF+3+PL
reempossara-nos	reempossar+nós.AD.1.PL+PQP+1+SG
reempossara-nos	reempossar+nós.AD.1.PL+PQP+2+SG
reempossara-nos	reempossar+nós.AD.1.PL+PQP+3+SG
reempossara-o	reempossar+V.ele.ACC.3.M.SG+PQP+1+SG
reempossara-o	reempossar+V.ele.ACC.3.M.SG+PQP+3+SG
reempossara-os	reempossar+V.ele.ACC.3.M.PL+PQP+1+SG
reempossara-os	reempossar+V.ele.ACC.3.M.PL+PQP+3+SG
reempossara-se	reempossar+V.ele.REFL+PQP+1+SG
reempossara-se	reempossar+V.ele.REFL+PQP+3+SG
reempossaras-lhe	reempossar+V.ele.DAT.3.SG+PQP+2+SG
reempossaras-lhes	reempossar+V.ele.DAT.3.PL+PQP+2+SG
reempossaras-me	reempossar+V.eu.AD.1.SG+PQP+2+SG
reempossaras-te	reempossar+V.tu.AD.2.SG+PQP+2+SG
reempossaras-vos	reempossar+V.vós.AD.2.PL+PQP+2+SG
reempossara-te	reempossar+V.tu.AD.2.SG+PQP+1+SG
reempossara-te	reempossar+V.tu.AD.2.SG+PQP+3+SG
reempossara-vos	reempossar+V.vós.AD.2.PL+PQP+1+SG
reempossara-vos	reempossar+V.vós.AD.2.PL+PQP+3+SG
reempossarde-la	reempossar+V.ele.ACC.3.F.SG+INF+2+PL
reempossarde-la	reempossar+V.ele.ACC.3.F.SG+SBJF+2+PL
reempossarde-las	reempossar+V.ele.ACC.3.F.PL+INF+2+PL
reempossarde-las	reempossar+V.ele.ACC.3.F.PL+SBJF+2+PL
reempossarde-lo	reempossar+V.ele.ACC.3.M.SG+INF+2+PL
reempossarde-lo	reempossar+V.ele.ACC.3.M.SG+SBJF+2+PL
reempossarde-los	reempossar+V.ele.ACC.3.M.PL+INF+2+PL
reempossarde-los	reempossar+V.ele.ACC.3.M.PL+SBJF+2+PL
reempossarde-nos	reempossar+nós.AD.1.PL+INF+2+PL
reempossarde-nos	reempossar+nós.AD.1.PL+SBJF+2+PL
reempossardes-lhe	reempossar+V.ele.DAT.3.SG+INF+2+PL
reempossardes-lhe	reempossar+V.ele.DAT.3.SG+SBJF+2+PL
reempossardes-lhes	reempossar+V.ele.DAT.3.PL+INF+2+PL
reempossardes-lhes	reempossar+V.ele.DAT.3.PL+SBJF+2+PL
reempossardes-me	reempossar+V.eu.AD.1.SG+INF+2+PL
reempossardes-me	reempossar+V.eu.AD.1.SG+SBJF+2+PL
reempossardes-te	reempossar+V.tu.AD.2.SG+INF+2+PL
reempossardes-te	reempossar+V.tu.AD.2.SG+SBJF+2+PL
reempossardes-vos	reempossar+V.vós.AD.2.PL+INF+2+PL
reempossardes-vos	reempossar+V.vós.AD.2.PL+SBJF+2+PL
reempossárei-la	reempossar+V.ele.ACC.3.F.SG+PQP+2+PL
reempossárei-las	reempossar+V.ele.ACC.3.F.PL+PQP+2+PL
reempossárei-lo	reempossar+V.ele.ACC.3.M.SG+PQP+2+PL
reempossárei-los	reempossar+V.ele.ACC.3.M.PL+PQP+2+PL
reempossárei-nos	reempossar+nós.AD.1.PL+PQP+2+PL
reempossáreis-lhe	reempossar+V.ele.DAT.3.SG+PQP+2+PL
reempossáreis-lhes	reempossar+V.ele.DAT.3.PL+PQP+2+PL
reempossáreis-me	reempossar+V.eu.AD.1.SG+PQP+2+PL
reempossáreis-te	reempossar+V.tu.AD.2.SG+PQP+2+PL
reempossáreis-vos	reempossar+V.vós.AD.2.PL+PQP+2+PL
reempossare-la	reempossar+V.ele.ACC.3.F.SG+INF+2+SG
reempossare-la	reempossar+V.ele.ACC.3.F.SG+SBJF+2+SG
reempossare-las	reempossar+V.ele.ACC.3.F.PL+INF+2+SG
reempossare-las	reempossar+V.ele.ACC.3.F.PL+SBJF+2+SG
reempossare-lo	reempossar+V.ele.ACC.3.M.SG+INF+2+SG
reempossare-lo	reempossar+V.ele.ACC.3.M.SG+SBJF+2+SG
reempossare-los	reempossar+V.ele.ACC.3.M.PL+INF+2+SG
reempossare-los	reempossar+V.ele.ACC.3.M.PL+SBJF+2+SG
reempossarem-lhe	reempossar+V.ele.DAT.3.SG+INF+3+PL
reempossarem-lhe	reempossar+V.ele.DAT.3.SG+SBJF+3+PL
reempossarem-lhes	reempossar+V.ele.DAT.3.PL+INF+3+PL
reempossarem-lhes	reempossar+V.ele.DAT.3.PL+SBJF+3+PL
reempossarem-me	reempossar+V.eu.AD.1.SG+INF+3+PL
reempossarem-me	reempossar+V.eu.AD.1.SG+SBJF+3+PL
reempossarem-na	reempossar+V.ele.ACC.3.F.SG+INF+3+PL
reempossarem-na	reempossar+V.ele.ACC.3.F.SG+SBJF+3+PL
reempossarem-nas	reempossar+V.ele.ACC.3.F.PL+INF+3+PL
reempossarem-nas	reempossar+V.ele.ACC.3.F.PL+SBJF+3+PL
reempossarem-no	reempossar+V.ele.ACC.3.M.SG+INF+3+PL
reempossarem-no	reempossar+V.ele.ACC.3.M.SG+SBJF+3+PL
reempossarem-nos	reempossar+V.ele.ACC.3.M.PL+INF+3+PL
reempossarem-nos	reempossar+V.ele.ACC.3.M.PL+SBJF+3+PL
reempossarem-nos	reempossar+V.nós.AD.1.PL+INF+3+PL
reempossarem-nos	reempossar+V.nós.AD.1.PL+SBJF+3+PL
reempossarem-se	reempossar+V.ele.REFL+INF+3+PL
reempossarem-se	reempossar+V.ele.REFL+SBJF+3+PL
reempossarem-te	reempossar+V.tu.AD.2.SG+INF+3+PL
reempossarem-te	reempossar+V.tu.AD.2.SG+SBJF+3+PL
reempossarem-vos	reempossar+V.vós.AD.2.PL+INF+3+PL
reempossarem-vos	reempossar+V.vós.AD.2.PL+SBJF+3+PL
reempossare-nos	reempossar+nós.AD.1.PL+INF+2+SG
reempossare-nos	reempossar+nós.AD.1.PL+SBJF+2+SG
reempossares-lhe	reempossar+V.ele.DAT.3.SG+INF+2+SG
reempossares-lhe	reempossar+V.ele.DAT.3.SG+SBJF+2+SG
reempossares-lhes	reempossar+V.ele.DAT.3.PL+INF+2+SG
reempossares-lhes	reempossar+V.ele.DAT.3.PL+SBJF+2+SG
reempossares-me	reempossar+V.eu.AD.1.SG+INF+2+SG
reempossares-me	reempossar+V.eu.AD.1.SG+SBJF+2+SG
reempossares-te	reempossar+V.tu.AD.2.SG+INF+2+SG
reempossares-te	reempossar+V.tu.AD.2.SG+SBJF+2+SG
reempossares-vos	reempossar+V.vós.AD.2.PL+INF+2+SG
reempossares-vos	reempossar+V.vós.AD.2.PL+SBJF+2+SG
reempossar-lhe-ão	reempossar+V.ele.DAT.3.SG+FUT+3+PL
reempossar-lhe-á	reempossar+V.ele.DAT.3.SG+FUT+3+SG
reempossar-lhe-ás	reempossar+V.ele.DAT.3.SG+FUT+2+SG
reempossar-lhe-ei	reempossar+V.ele.DAT.3.SG+FUT+1+SG
reempossar-lhe-eis	reempossar+V.ele.DAT.3.SG+FUT+2+PL
reempossar-lhe-emos	reempossar+V.ele.DAT.3.SG+FUT+1+PL
reempossar-lhe-íamos	reempossar+V.ele.DAT.3.SG+COND+1+PL
reempossar-lhe-iam	reempossar+V.ele.DAT.3.SG+COND+3+PL
reempossar-lhe-ia	reempossar+V.ele.DAT.3.SG+COND+1+SG
reempossar-lhe-ia	reempossar+V.ele.DAT.3.SG+COND+3+SG
reempossar-lhe-ias	reempossar+V.ele.DAT.3.SG+COND+2+SG
reempossar-lhe-íeis	reempossar+V.ele.DAT.3.SG+COND+2+PL
reempossar-lhe	reempossar+V.ele.DAT.3.SG+INF
