remessar-lhes-ão	remessar+V.ele.DAT.3.PL+FUT+3+PL
remessar-lhes-á	remessar+V.ele.DAT.3.PL+FUT+3+SG
remessar-lhes-ás	remessar+V.ele.DAT.3.PL+FUT+2+SG
remessar-lhes-ei	remessar+V.ele.DAT.3.PL+FUT+1+SG
remessar-lhes-eis	remessar+V.ele.DAT.3.PL+FUT+2+PL
remessar-lhes-emos	remessar+V.ele.DAT.3.PL+FUT+1+PL
remessar-lhes-íamos	remessar+V.ele.DAT.3.PL+COND+1+PL
remessar-lhes-iam	remessar+V.ele.DAT.3.PL+COND+3+PL
remessar-lhes-ia	remessar+V.ele.DAT.3.PL+COND+1+SG
remessar-lhes-ia	remessar+V.ele.DAT.3.PL+COND+3+SG
remessar-lhes-ias	remessar+V.ele.DAT.3.PL+COND+2+SG
remessar-lhes-íeis	remessar+V.ele.DAT.3.PL+COND+2+PL
remessar-lhes	remessar+V.ele.DAT.3.PL+INF
remessar-lhes	remessar+V.ele.DAT.3.PL+INF+1+SG
remessar-lhes	remessar+V.ele.DAT.3.PL+INF+3+SG
remessar-lhes	remessar+V.ele.DAT.3.PL+SBJF+1+SG
remessar-lhes	remessar+V.ele.DAT.3.PL+SBJF+3+SG
remessar-me-ão	remessar+V.eu.AD.1.SG+FUT+3+PL
remessar-me-á	remessar+V.eu.AD.1.SG+FUT+3+SG
remessar-me-ás	remessar+V.eu.AD.1.SG+FUT+2+SG
remessar-me-ei	remessar+V.eu.AD.1.SG+FUT+1+SG
remessar-me-eis	remessar+V.eu.AD.1.SG+FUT+2+PL
remessar-me-emos	remessar+V.eu.AD.1.SG+FUT+1+PL
remessar-me-íamos	remessar+V.eu.AD.1.SG+COND+1+PL
remessar-me-iam	remessar+V.eu.AD.1.SG+COND+3+PL
remessar-me-ia	remessar+V.eu.AD.1.SG+COND+1+SG
remessar-me-ia	remessar+V.eu.AD.1.SG+COND+3+SG
remessar-me-ias	remessar+V.eu.AD.1.SG+COND+2+SG
remessar-me-íeis	remessar+V.eu.AD.1.SG+COND+2+PL
remessar-me	remessar+V.eu.AD.1.SG+INF
remessar-me	remessar+V.eu.AD.1.SG+INF+1+SG
remessar-me	remessar+V.eu.AD.1.SG+INF+3+SG
remessar-me	remessar+V.eu.AD.1.SG+SBJF+1+SG
remessar-me	remessar+V.eu.AD.1.SG+SBJF+3+SG
remessarmo-la	remessar+V.ele.ACC.3.F.SG+INF+1+PL
remessarmo-la	remessar+V.ele.ACC.3.F.SG+SBJF+1+PL
remessarmo-las	remessar+V.ele.ACC.3.F.PL+INF+1+PL
remessarmo-las	remessar+V.ele.ACC.3.F.PL+SBJF+1+PL
remessarmo-lo	remessar+V.ele.ACC.3.M.SG+INF+1+PL
remessarmo-lo	remessar+V.ele.ACC.3.M.SG+SBJF+1+PL
remessarmo-los	remessar+V.ele.ACC.3.M.PL+INF+1+PL
remessarmo-los	remessar+V.ele.ACC.3.M.PL+SBJF+1+PL
remessarmo-nos	remessar+nós.AD.1.PL+INF+1+PL
remessarmo-nos	remessar+nós.AD.1.PL+SBJF+1+PL
remessarmos-lhe	remessar+V.ele.DAT.3.SG+INF+1+PL
remessarmos-lhe	remessar+V.ele.DAT.3.SG+SBJF+1+PL
remessarmos-lhes	remessar+V.ele.DAT.3.PL+INF+1+PL
remessarmos-lhes	remessar+V.ele.DAT.3.PL+SBJF+1+PL
remessarmos-me	remessar+V.eu.AD.1.SG+INF+1+PL
remessarmos-me	remessar+V.eu.AD.1.SG+SBJF+1+PL
remessarmos-te	remessar+V.tu.AD.2.SG+INF+1+PL
remessarmos-te	remessar+V.tu.AD.2.SG+SBJF+1+PL
remessarmos-vos	remessar+V.vós.AD.2.PL+INF+1+PL
remessarmos-vos	remessar+V.vós.AD.2.PL+SBJF+1+PL
remessar-nos-ão	remessar+nós.AD.1.PL+FUT+3+PL
remessar-nos-á	remessar+nós.AD.1.PL+FUT+3+SG
remessar-nos-ás	remessar+nós.AD.1.PL+FUT+2+SG
remessar-nos-ei	remessar+nós.AD.1.PL+FUT+1+SG
remessar-nos-eis	remessar+nós.AD.1.PL+FUT+2+PL
remessar-nos-emos	remessar+nós.AD.1.PL+FUT+1+PL
remessar-nos-íamos	remessar+nós.AD.1.PL+COND+1+PL
remessar-nos-iam	remessar+nós.AD.1.PL+COND+3+PL
remessar-nos-ia	remessar+nós.AD.1.PL+COND+1+SG
remessar-nos-ia	remessar+nós.AD.1.PL+COND+3+SG
remessar-nos-ias	remessar+nós.AD.1.PL+COND+2+SG
remessar-nos-íeis	remessar+nós.AD.1.PL+COND+2+PL
remessar-nos	remessar+nós.AD.1.PL+INF
remessar-nos	remessar+nós.AD.1.PL+INF+1+SG
remessar-nos	remessar+nós.AD.1.PL+INF+3+SG
remessar-nos	remessar+nós.AD.1.PL+SBJF+1+SG
remessar-nos	remessar+nós.AD.1.PL+SBJF+3+SG
remessar-se-ão	remessar+V.ele.REFL+FUT+3+PL
remessar-se-á	remessar+V.ele.REFL+FUT+3+SG
remessar-se-iam	remessar+V.ele.REFL+COND+3+PL
remessar-se-ia	remessar+V.ele.REFL+COND+3+SG
remessar-se	remessar+V.ele.REFL+INF
remessar-se	remessar+V.ele.REFL+INF+3+SG
remessar-se	remessar+V.ele.REFL+SBJF+3+SG
remessar-te-ão	remessar+V.tu.AD.2.SG+FUT+3+PL
remessar-te-á	remessar+V.tu.AD.2.SG+FUT+3+SG
remessar-te-ás	remessar+V.tu.AD.2.SG+FUT+2+SG
remessar-te-ei	remessar+V.tu.AD.2.SG+FUT+1+SG
remessar-te-eis	remessar+V.tu.AD.2.SG+FUT+2+PL
remessar-te-emos	remessar+V.tu.AD.2.SG+FUT+1+PL
remessar-te-íamos	remessar+V.tu.AD.2.SG+COND+1+PL
remessar-te-iam	remessar+V.tu.AD.2.SG+COND+3+PL
remessar-te-ia	remessar+V.tu.AD.2.SG+COND+1+SG
remessar-te-ia	remessar+V.tu.AD.2.SG+COND+3+SG
remessar-te-ias	remessar+V.tu.AD.2.SG+COND+2+SG
remessar-te-íeis	remessar+V.tu.AD.2.SG+COND+2+PL
remessar-te	remessar+V.tu.AD.2.SG+INF
remessar-te	remessar+V.tu.AD.2.SG+INF+1+SG
remessar-te	remessar+V.tu.AD.2.SG+INF+3+SG
remessar-te	remessar+V.tu.AD.2.SG+SBJF+1+SG
remessar-te	remessar+V.tu.AD.2.SG+SBJF+3+SG
remessar-vos-ão	remessar+V.vós.AD.2.PL+FUT+3+PL
remessar-vos-á	remessar+V.vós.AD.2.PL+FUT+3+SG
remessar-vos-ás	remessar+V.vós.AD.2.PL+FUT+2+SG
remessar-vos-ei	remessar+V.vós.AD.2.PL+FUT+1+SG
remessar-vos-eis	remessar+V.vós.AD.2.PL+FUT+2+PL
remessar-vos-emos	remessar+V.vós.AD.2.PL+FUT+1+PL
remessar-vos-íamos	remessar+V.vós.AD.2.PL+COND+1+PL
remessar-vos-iam	remessar+V.vós.AD.2.PL+COND+3+PL
remessar-vos-ia	remessar+V.vós.AD.2.PL+COND+1+SG
remessar-vos-ia	remessar+V.vós.AD.2.PL+COND+3+SG
remessar-vos-ias	remessar+V.vós.AD.2.PL+COND+2+SG
remessar-vos-íeis	remessar+V.vós.AD.2.PL+COND+2+PL
remessar-vos	remessar+V.vós.AD.2.PL+INF
remessar-vos	remessar+V.vós.AD.2.PL+INF+1+SG
remessar-vos	remessar+V.vós.AD.2.PL+INF+3+SG
remessar-vos	remessar+V.vós.AD.2.PL+SBJF+1+SG
remessar-vos	remessar+V.vós.AD.2.PL+SBJF+3+SG
remessa-se	remessar+V.ele.REFL+PRS+3+SG
remessas-lhe	remessar+V.ele.DAT.3.SG+PRS+2+SG
remessas-lhes	remessar+V.ele.DAT.3.PL+PRS+2+SG
remessas-me	remessar+V.eu.AD.1.SG+PRS+2+SG
remessaste-a	remessar+V.ele.ACC.3.F.SG+PRF+2+SG
remessaste-as	remessar+V.ele.ACC.3.F.PL+PRF+2+SG
remessaste-la	remessar+V.ele.ACC.3.F.SG+PRF+2+PL
remessaste-las	remessar+V.ele.ACC.3.F.PL+PRF+2+PL
remessaste-lhe	remessar+V.ele.DAT.3.SG+PRF+2+SG
remessaste-lhes	remessar+V.ele.DAT.3.PL+PRF+2+SG
remessaste-lo	remessar+V.ele.ACC.3.M.SG+PRF+2+PL
remessaste-los	remessar+V.ele.ACC.3.M.PL+PRF+2+PL
remessaste-me	remessar+V.eu.AD.1.SG+PRF+2+SG
remessaste-nos	remessar+nós.AD.1.PL+PRF+2+PL
remessaste-nos	remessar+nós.AD.1.PL+PRF+2+SG
remessaste-o	remessar+V.ele.ACC.3.M.SG+PRF+2+SG
remessaste-os	remessar+V.ele.ACC.3.M.PL+PRF+2+SG
remessas-te	remessar+V.tu.AD.2.SG+PRS+2+SG
remessastes-lhe	remessar+V.ele.DAT.3.SG+PRF+2+PL
remessastes-lhes	remessar+V.ele.DAT.3.PL+PRF+2+PL
remessastes-me	remessar+V.eu.AD.1.SG+PRF+2+PL
remessastes-te	remessar+V.tu.AD.2.SG+PRF+2+PL
remessastes-vos	remessar+V.vós.AD.2.PL+PRF+2+PL
remessaste-te	remessar+V.tu.AD.2.SG+PRF+2+SG
remessaste-vos	remessar+V.vós.AD.2.PL+PRF+2+SG
remessas-vos	remessar+V.vós.AD.2.PL+PRS+2+SG
remessa-te	remessar+V.tu.AD.2.SG+PRS+3+SG
remessava-a	remessar+V.ele.ACC.3.F.SG+IMPF+1+SG
remessava-a	remessar+V.ele.ACC.3.F.SG+IMPF+3+SG
remessava-as	remessar+V.ele.ACC.3.F.PL+IMPF+1+SG
remessava-as	remessar+V.ele.ACC.3.F.PL+IMPF+3+SG
remessava-la	remessar+V.ele.ACC.3.F.SG+IMPF+2+SG
remessava-las	remessar+V.ele.ACC.3.F.PL+IMPF+2+SG
remessava-lhe	remessar+V.ele.DAT.3.SG+IMPF+1+SG
remessava-lhe	remessar+V.ele.DAT.3.SG+IMPF+3+SG
remessava-lhes	remessar+V.ele.DAT.3.PL+IMPF+1+SG
remessava-lhes	remessar+V.ele.DAT.3.PL+IMPF+3+SG
remessava-lo	remessar+V.ele.ACC.3.M.SG+IMPF+2+SG
remessava-los	remessar+V.ele.ACC.3.M.PL+IMPF+2+SG
remessava-me	remessar+V.eu.AD.1.SG+IMPF+1+SG
remessava-me	remessar+V.eu.AD.1.SG+IMPF+3+SG
remessavam-lhe	remessar+V.ele.DAT.3.SG+IMPF+3+PL
remessavam-lhes	remessar+V.ele.DAT.3.PL+IMPF+3+PL
remessavam-me	remessar+V.eu.AD.1.SG+IMPF+3+PL
remessavam-na	remessar+V.ele.ACC.3.F.SG+IMPF+3+PL
remessavam-nas	remessar+V.ele.ACC.3.F.PL+IMPF+3+PL
remessavam-no	remessar+V.ele.ACC.3.M.SG+IMPF+3+PL
remessavam-nos	remessar+V.ele.ACC.3.M.PL+IMPF+3+PL
remessavam-nos	remessar+V.nós.AD.1.PL+IMPF+3+PL
remessávamo-la	remessar+V.ele.ACC.3.F.SG+IMPF+1+PL
remessávamo-las	remessar+V.ele.ACC.3.F.PL+IMPF+1+PL
remessávamo-lo	remessar+V.ele.ACC.3.M.SG+IMPF+1+PL
remessávamo-los	remessar+V.ele.ACC.3.M.PL+IMPF+1+PL
remessávamo-nos	remessar+nós.AD.1.PL+IMPF+1+PL
remessávamos-lhe	remessar+V.ele.DAT.3.SG+IMPF+1+PL
remessávamos-lhes	remessar+V.ele.DAT.3.PL+IMPF+1+PL
remessávamos-me	remessar+V.eu.AD.1.SG+IMPF+1+PL
remessávamos-te	remessar+V.tu.AD.2.SG+IMPF+1+PL
remessávamos-vos	remessar+V.vós.AD.2.PL+IMPF+1+PL
remessavam-se	remessar+V.ele.REFL+IMPF+3+PL
remessavam-te	remessar+V.tu.AD.2.SG+IMPF+3+PL
remessavam-vos	remessar+V.vós.AD.2.PL+IMPF+3+PL
remessava-nos	remessar+nós.AD.1.PL+IMPF+1+SG
remessava-nos	remessar+nós.AD.1.PL+IMPF+2+SG
remessava-nos	remessar+nós.AD.1.PL+IMPF+3+SG
remessava-o	remessar+V.ele.ACC.3.M.SG+IMPF+1+SG
remessava-o	remessar+V.ele.ACC.3.M.SG+IMPF+3+SG
remessava-os	remessar+V.ele.ACC.3.M.PL+IMPF+1+SG
remessava-os	remessar+V.ele.ACC.3.M.PL+IMPF+3+SG
remessava-se	remessar+V.ele.REFL+IMPF+1+SG
remessava-se	remessar+V.ele.REFL+IMPF+3+SG
remessavas-lhe	remessar+V.ele.DAT.3.SG+IMPF+2+SG
remessavas-lhes	remessar+V.ele.DAT.3.PL+IMPF+2+SG
remessavas-me	remessar+V.eu.AD.1.SG+IMPF+2+SG
remessavas-te	remessar+V.tu.AD.2.SG+IMPF+2+SG
remessavas-vos	remessar+V.vós.AD.2.PL+IMPF+2+SG
remessava-te	remessar+V.tu.AD.2.SG+IMPF+1+SG
remessava-te	remessar+V.tu.AD.2.SG+IMPF+3+SG
remessava-vos	remessar+V.vós.AD.2.PL+IMPF+1+SG
remessava-vos	remessar+V.vós.AD.2.PL+IMPF+3+SG
remessávei-la	remessar+V.ele.ACC.3.F.SG+IMPF+2+PL
remessávei-las	remessar+V.ele.ACC.3.F.PL+IMPF+2+PL
remessávei-lo	remessar+V.ele.ACC.3.M.SG+IMPF+2+PL
remessávei-los	remessar+V.ele.ACC.3.M.PL+IMPF+2+PL
remessávei-nos	remessar+nós.AD.1.PL+IMPF+2+PL
remessáveis-lhe	remessar+V.ele.DAT.3.SG+IMPF+2+PL
remessáveis-lhes	remessar+V.ele.DAT.3.PL+IMPF+2+PL
remessáveis-me	remessar+V.eu.AD.1.SG+IMPF+2+PL
remessáveis-te	remessar+V.tu.AD.2.SG+IMPF+2+PL
remessáveis-vos	remessar+V.vós.AD.2.PL+IMPF+2+PL
remessa-vos	remessar+V.vós.AD.2.PL+PRS+3+SG
remesse-a	remessar+V.ele.ACC.3.F.SG+IMP+3+SG
remesse-as	remessar+V.ele.ACC.3.F.PL+IMP+3+SG
remessei-a	remessar+V.ele.ACC.3.F.SG+PRF+1+SG
remessei-as	remessar+V.ele.ACC.3.F.PL+PRF+1+SG
remessei-lhe	remessar+V.ele.DAT.3.SG+PRF+1+SG
remessei-lhes	remessar+V.ele.DAT.3.PL+PRF+1+SG
remessei-me	remessar+V.eu.AD.1.SG+PRF+1+SG
remessei-nos	remessar+nós.AD.1.PL+PRF+1+SG
remessei-o	remessar+V.ele.ACC.3.M.SG+PRF+1+SG
remessei-os	remessar+V.ele.ACC.3.M.PL+PRF+1+SG
remessei-te	remessar+V.tu.AD.2.SG+PRF+1+SG
remessei-vos	remessar+V.vós.AD.2.PL+PRF+1+SG
remesse-lhe	remessar+V.ele.DAT.3.SG+IMP+3+SG
remesse-lhes	remessar+V.ele.DAT.3.PL+IMP+3+SG
remesse-me	remessar+V.eu.AD.1.SG+IMP+3+SG
remessem-lhe	remessar+V.ele.DAT.3.SG+IMP+3+PL
remessem-lhes	remessar+V.ele.DAT.3.PL+IMP+3+PL
remessem-me	remessar+V.eu.AD.1.SG+IMP+3+PL
remessem-na	remessar+V.ele.ACC.3.F.SG+IMP+3+PL
remessem-nas	remessar+V.ele.ACC.3.F.PL+IMP+3+PL
remessem-no	remessar+V.ele.ACC.3.M.SG+IMP+3+PL
remessem-nos	remessar+V.ele.ACC.3.M.PL+IMP+3+PL
remessem-nos	remessar+V.nós.AD.1.PL+IMP+3+PL
remessemo-la	remessar+V.ele.ACC.3.F.SG+IMP+1+PL
remessemo-las	remessar+V.ele.ACC.3.F.PL+IMP+1+PL
remessemo-lo	remessar+V.ele.ACC.3.M.SG+IMP+1+PL
remessemo-los	remessar+V.ele.ACC.3.M.PL+IMP+1+PL
remessemo-nos	remessar+nós.AD.1.PL+IMP+1+PL
remessemos-lhe	remessar+V.ele.DAT.3.SG+IMP+1+PL
remessemos-lhes	remessar+V.ele.DAT.3.PL+IMP+1+PL
remessemos-me	remessar+V.eu.AD.1.SG+IMP+1+PL
remessemos-te	remessar+V.tu.AD.2.SG+IMP+1+PL
remessemos-vos	remessar+V.vós.AD.2.PL+IMP+1+PL
remessem-se	remessar+V.ele.REFL+IMP+3+PL
remessem-te	remessar+V.tu.AD.2.SG+IMP+3+PL
remessem-vos	remessar+V.vós.AD.2.PL+IMP+3+PL
remesse-nos	remessar+nós.AD.1.PL+IMP+3+SG
remesse-o	remessar+V.ele.ACC.3.M.SG+IMP+3+SG
remesse-os	remessar+V.ele.ACC.3.M.PL+IMP+3+SG
remesse-se	remessar+V.ele.REFL+IMP+3+SG
remesse-te	remessar+V.tu.AD.2.SG+IMP+3+SG
remesse-vos	remessar+V.vós.AD.2.PL+IMP+3+SG
remesso-a	remessar+V.ele.ACC.3.F.SG+PRS+1+SG
remesso-as	remessar+V.ele.ACC.3.F.PL+PRS+1+SG
remesso-lhe	remessar+V.ele.DAT.3.SG+PRS+1+SG
remesso-lhes	remessar+V.ele.DAT.3.PL+PRS+1+SG
remesso-me	remessar+V.eu.AD.1.SG+PRS+1+SG
remesso-nos	remessar+nós.AD.1.PL+PRS+1+SG
remesso-o	remessar+V.ele.ACC.3.M.SG+PRS+1+SG
remesso-os	remessar+V.ele.ACC.3.M.PL+PRS+1+SG
remesso-te	remessar+V.tu.AD.2.SG+PRS+1+SG
remessou-a	remessar+V.ele.ACC.3.F.SG+PRF+3+SG
remessou-as	remessar+V.ele.ACC.3.F.PL+PRF+3+SG
remessou-lhe	remessar+V.ele.DAT.3.SG+PRF+3+SG
remessou-lhes	remessar+V.ele.DAT.3.PL+PRF+3+SG
remessou-me	remessar+V.eu.AD.1.SG+PRF+3+SG
remessou-nos	remessar+nós.AD.1.PL+PRF+3+SG
remessou-o	remessar+V.ele.ACC.3.M.SG+PRF+3+SG
remessou-os	remessar+V.ele.ACC.3.M.PL+PRF+3+SG
remessou-se	remessar+V.ele.REFL+PRF+3+SG
remessou-te	remessar+V.tu.AD.2.SG+PRF+3+SG
remessou-vos	remessar+V.vós.AD.2.PL+PRF+3+SG
remesso-vos	remessar+V.vós.AD.2.PL+PRS+1+SG
remeta-a	remeter+V.ele.ACC.3.F.SG+IMP+3+SG
remeta-as	remeter+V.ele.ACC.3.F.PL+IMP+3+SG
remeta-lhe	remeter+V.ele.DAT.3.SG+IMP+3+SG
remeta-lhes	remeter+V.ele.DAT.3.PL+IMP+3+SG
remeta-me	remeter+V.eu.AD.1.SG+IMP+3+SG
remetam-lhe	remeter+V.ele.DAT.3.SG+IMP+3+PL
remetam-lhes	remeter+V.ele.DAT.3.PL+IMP+3+PL
remetam-me	remeter+V.eu.AD.1.SG+IMP+3+PL
remetam-na	remeter+V.ele.ACC.3.F.SG+IMP+3+PL
remetam-nas	remeter+V.ele.ACC.3.F.PL+IMP+3+PL
remetam-no	remeter+V.ele.ACC.3.M.SG+IMP+3+PL
remetam-nos	remeter+V.ele.ACC.3.M.PL+IMP+3+PL
remetam-nos	remeter+V.nós.AD.1.PL+IMP+3+PL
remetamo-la	remeter+V.ele.ACC.3.F.SG+IMP+1+PL
remetamo-las	remeter+V.ele.ACC.3.F.PL+IMP+1+PL
remetamo-lo	remeter+V.ele.ACC.3.M.SG+IMP+1+PL
remetamo-los	remeter+V.ele.ACC.3.M.PL+IMP+1+PL
remetamo-nos	remeter+nós.AD.1.PL+IMP+1+PL
remetamos-lhe	remeter+V.ele.DAT.3.SG+IMP+1+PL
remetamos-lhes	remeter+V.ele.DAT.3.PL+IMP+1+PL
remetamos-me	remeter+V.eu.AD.1.SG+IMP+1+PL
remetamos-te	remeter+V.tu.AD.2.SG+IMP+1+PL
remetamos-vos	remeter+V.vós.AD.2.PL+IMP+1+PL
remetam-se	remeter+V.ele.REFL+IMP+3+PL
remetam-te	remeter+V.tu.AD.2.SG+IMP+3+PL
remetam-vos	remeter+V.vós.AD.2.PL+IMP+3+PL
remeta-nos	remeter+nós.AD.1.PL+IMP+3+SG
remeta-o	remeter+V.ele.ACC.3.M.SG+IMP+3+SG
remeta-os	remeter+V.ele.ACC.3.M.PL+IMP+3+SG
remeta-se	remeter+V.ele.REFL+IMP+3+SG
remeta-te	remeter+V.tu.AD.2.SG+IMP+3+SG
remeta-vos	remeter+V.vós.AD.2.PL+IMP+3+SG
remete-a	remeter+V.ele.ACC.3.F.SG+PRS+3+SG
remete-as	remeter+V.ele.ACC.3.F.PL+PRS+3+SG
remetei-la	remeter+V.ele.ACC.3.F.SG+PRS+2+PL
remetei-las	remeter+V.ele.ACC.3.F.PL+PRS+2+PL
remetei-lo	remeter+V.ele.ACC.3.M.SG+PRS+2+PL
remetei-los	remeter+V.ele.ACC.3.M.PL+PRS+2+PL
remetei-nos	remeter+nós.AD.1.PL+PRS+2+PL
remeteis-lhe	remeter+V.ele.DAT.3.SG+PRS+2+PL
remeteis-lhes	remeter+V.ele.DAT.3.PL+PRS+2+PL
remeteis-me	remeter+V.eu.AD.1.SG+PRS+2+PL
remeteis-te	remeter+V.tu.AD.2.SG+PRS+2+PL
remeteis-vos	remeter+V.vós.AD.2.PL+PRS+2+PL
remetê-la-ão	remeter+V.ele.ACC.3.F.SG+FUT+3+PL
remetê-la-á	remeter+V.ele.ACC.3.F.SG+FUT+3+SG
remetê-la-ás	remeter+V.ele.ACC.3.F.SG+FUT+2+SG
remetê-la-ei	remeter+V.ele.ACC.3.F.SG+FUT+1+SG
remetê-la-eis	remeter+V.ele.ACC.3.F.SG+FUT+2+PL
remetê-la-emos	remeter+V.ele.ACC.3.F.SG+FUT+1+PL
remetê-la-íamos	remeter+V.ele.ACC.3.F.SG+COND+1+PL
remetê-la-iam	remeter+V.ele.ACC.3.F.SG+COND+3+PL
remetê-la-ia	remeter+V.ele.ACC.3.F.SG+COND+1+SG
remetê-la-ia	remeter+V.ele.ACC.3.F.SG+COND+3+SG
remetê-la-ias	remeter+V.ele.ACC.3.F.SG+COND+2+SG
remetê-la-íeis	remeter+V.ele.ACC.3.F.SG+COND+2+PL
remetê-la	remeter+V.ele.ACC.3.F.SG+INF
remetê-la	remeter+V.ele.ACC.3.F.SG+INF+1+SG
remetê-la	remeter+V.ele.ACC.3.F.SG+INF+3+SG
remete-la	remeter+V.ele.ACC.3.F.SG+PRS+2+SG
remetê-la	remeter+V.ele.ACC.3.F.SG+SBJF+1+SG
remetê-la	remeter+V.ele.ACC.3.F.SG+SBJF+3+SG
remetê-las-ão	remeter+V.ele.ACC.3.F.PL+FUT+3+PL
remetê-las-á	remeter+V.ele.ACC.3.F.PL+FUT+3+SG
remetê-las-ás	remeter+V.ele.ACC.3.F.PL+FUT+2+SG
remetê-las-ei	remeter+V.ele.ACC.3.F.PL+FUT+1+SG
remetê-las-eis	remeter+V.ele.ACC.3.F.PL+FUT+2+PL
remetê-las-emos	remeter+V.ele.ACC.3.F.PL+FUT+1+PL
remetê-las-íamos	remeter+V.ele.ACC.3.F.PL+COND+1+PL
remetê-las-iam	remeter+V.ele.ACC.3.F.PL+COND+3+PL
remetê-las-ia	remeter+V.ele.ACC.3.F.PL+COND+1+SG
remetê-las-ia	remeter+V.ele.ACC.3.F.PL+COND+3+SG
remetê-las-ias	remeter+V.ele.ACC.3.F.PL+COND+2+SG
remetê-las-íeis	remeter+V.ele.ACC.3.F.PL+COND+2+PL
remetê-las	remeter+V.ele.ACC.3.F.PL+INF
remetê-las	remeter+V.ele.ACC.3.F.PL+INF+1+SG
remetê-las	remeter+V.ele.ACC.3.F.PL+INF+3+SG
remete-las	remeter+V.ele.ACC.3.F.PL+PRS+2+SG
remetê-las	remeter+V.ele.ACC.3.F.PL+SBJF+1+SG
remetê-las	remeter+V.ele.ACC.3.F.PL+SBJF+3+SG
remete-lhe	remeter+V.ele.DAT.3.SG+PRS+3+SG
remete-lhes	remeter+V.ele.DAT.3.PL+PRS+3+SG
remetê-lo-ão	remeter+V.ele.ACC.3.M.SG+FUT+3+PL
remetê-lo-á	remeter+V.ele.ACC.3.M.SG+FUT+3+SG
remetê-lo-ás	remeter+V.ele.ACC.3.M.SG+FUT+2+SG
remetê-lo-ei	remeter+V.ele.ACC.3.M.SG+FUT+1+SG
remetê-lo-eis	remeter+V.ele.ACC.3.M.SG+FUT+2+PL
remetê-lo-emos	remeter+V.ele.ACC.3.M.SG+FUT+1+PL
remetê-lo-íamos	remeter+V.ele.ACC.3.M.SG+COND+1+PL
remetê-lo-iam	remeter+V.ele.ACC.3.M.SG+COND+3+PL
remetê-lo-ia	remeter+V.ele.ACC.3.M.SG+COND+1+SG
remetê-lo-ia	remeter+V.ele.ACC.3.M.SG+COND+3+SG
remetê-lo-ias	remeter+V.ele.ACC.3.M.SG+COND+2+SG
remetê-lo-íeis	remeter+V.ele.ACC.3.M.SG+COND+2+PL
remetê-lo	remeter+V.ele.ACC.3.M.SG+INF
remetê-lo	remeter+V.ele.ACC.3.M.SG+INF+1+SG
remetê-lo	remeter+V.ele.ACC.3.M.SG+INF+3+SG
remete-lo	remeter+V.ele.ACC.3.M.SG+PRS+2+SG
remetê-lo	remeter+V.ele.ACC.3.M.SG+SBJF+1+SG
remetê-lo	remeter+V.ele.ACC.3.M.SG+SBJF+3+SG
remetê-los-ão	remeter+V.ele.ACC.3.M.PL+FUT+3+PL
remetê-los-á	remeter+V.ele.ACC.3.M.PL+FUT+3+SG
remetê-los-ás	remeter+V.ele.ACC.3.M.PL+FUT+2+SG
remetê-los-ei	remeter+V.ele.ACC.3.M.PL+FUT+1+SG
remetê-los-eis	remeter+V.ele.ACC.3.M.PL+FUT+2+PL
remetê-los-emos	remeter+V.ele.ACC.3.M.PL+FUT+1+PL
remetê-los-íamos	remeter+V.ele.ACC.3.M.PL+COND+1+PL
remetê-los-iam	remeter+V.ele.ACC.3.M.PL+COND+3+PL
remetê-los-ia	remeter+V.ele.ACC.3.M.PL+COND+1+SG
remetê-los-ia	remeter+V.ele.ACC.3.M.PL+COND+3+SG
remetê-los-ias	remeter+V.ele.ACC.3.M.PL+COND+2+SG
remetê-los-íeis	remeter+V.ele.ACC.3.M.PL+COND+2+PL
remetê-los	remeter+V.ele.ACC.3.M.PL+INF
remetê-los	remeter+V.ele.ACC.3.M.PL+INF+1+SG
remetê-los	remeter+V.ele.ACC.3.M.PL+INF+3+SG
remete-los	remeter+V.ele.ACC.3.M.PL+PRS+2+SG
remetê-los	remeter+V.ele.ACC.3.M.PL+SBJF+1+SG
remetê-los	remeter+V.ele.ACC.3.M.PL+SBJF+3+SG
remete-me	remeter+V.eu.AD.1.SG+PRS+3+SG
remetem-lhe	remeter+V.ele.DAT.3.SG+PRS+3+PL
remetem-lhes	remeter+V.ele.DAT.3.PL+PRS+3+PL
remetem-me	remeter+V.eu.AD.1.SG+PRS+3+PL
remetem-na	remeter+V.ele.ACC.3.F.SG+PRS+3+PL
remetem-nas	remeter+V.ele.ACC.3.F.PL+PRS+3+PL
remetem-no	remeter+V.ele.ACC.3.M.SG+PRS+3+PL
remetem-nos	remeter+V.ele.ACC.3.M.PL+PRS+3+PL
remetem-nos	remeter+V.nós.AD.1.PL+PRS+3+PL
remetemo-la	remeter+V.ele.ACC.3.F.SG+PRF+1+PL
remetemo-la	remeter+V.ele.ACC.3.F.SG+PRS+1+PL
remetemo-las	remeter+V.ele.ACC.3.F.PL+PRF+1+PL
remetemo-las	remeter+V.ele.ACC.3.F.PL+PRS+1+PL
remetemo-lo	remeter+V.ele.ACC.3.M.SG+PRF+1+PL
remetemo-lo	remeter+V.ele.ACC.3.M.SG+PRS+1+PL
remetemo-los	remeter+V.ele.ACC.3.M.PL+PRF+1+PL
remetemo-los	remeter+V.ele.ACC.3.M.PL+PRS+1+PL
remetemo-nos	remeter+nós.AD.1.PL+PRF+1+PL
remetemo-nos	remeter+nós.AD.1.PL+PRS+1+PL
remetemos-lhe	remeter+V.ele.DAT.3.SG+PRF+1+PL
remetemos-lhe	remeter+V.ele.DAT.3.SG+PRS+1+PL
remetemos-lhes	remeter+V.ele.DAT.3.PL+PRF+1+PL
remetemos-lhes	remeter+V.ele.DAT.3.PL+PRS+1+PL
remetemos-me	remeter+V.eu.AD.1.SG+PRF+1+PL
remetemos-me	remeter+V.eu.AD.1.SG+PRS+1+PL
remetemos-te	remeter+V.tu.AD.2.SG+PRF+1+PL
remetemos-te	remeter+V.tu.AD.2.SG+PRS+1+PL
remetemos-vos	remeter+V.vós.AD.2.PL+PRF+1+PL
remetemos-vos	remeter+V.vós.AD.2.PL+PRS+1+PL
remetem-se	remeter+V.ele.REFL+PRS+3+PL
remetem-te	remeter+V.tu.AD.2.SG+PRS+3+PL
remetem-vos	remeter+V.vós.AD.2.PL+PRS+3+PL
remetendo-a	remeter+V.ele.ACC.3.F.SG+GRD
remetendo-as	remeter+V.ele.ACC.3.F.PL+GRD
remetendo-lhe	remeter+V.ele.DAT.3.SG+GRD
remetendo-lhes	remeter+V.ele.DAT.3.PL+GRD
remetendo-me	remeter+V.eu.AD.1.SG+GRD
remetendo-nos	remeter+nós.AD.1.PL+GRD
remetendo-o	remeter+V.ele.ACC.3.M.SG+GRD
remetendo-os	remeter+V.ele.ACC.3.M.PL+GRD
remetendo-se	remeter+V.ele.REFL+GRD
remetendo-te	remeter+V.tu.AD.2.SG+GRD
remetendo-vos	remeter+V.vós.AD.2.PL+GRD
remete-nos	remeter+nós.AD.1.PL+PRS+2+SG
remete-nos	remeter+nós.AD.1.PL+PRS+3+SG
remete-o	remeter+V.ele.ACC.3.M.SG+PRS+3+SG
remete-os	remeter+V.ele.ACC.3.M.PL+PRS+3+SG
remetera-a	remeter+V.ele.ACC.3.F.SG+PQP+1+SG
remetera-a	remeter+V.ele.ACC.3.F.SG+PQP+3+SG
remetera-as	remeter+V.ele.ACC.3.F.PL+PQP+1+SG
remetera-as	remeter+V.ele.ACC.3.F.PL+PQP+3+SG
remetera-la	remeter+V.ele.ACC.3.F.SG+PQP+2+SG
remetera-las	remeter+V.ele.ACC.3.F.PL+PQP+2+SG
remetera-lhe	remeter+V.ele.DAT.3.SG+PQP+1+SG
remetera-lhe	remeter+V.ele.DAT.3.SG+PQP+3+SG
remetera-lhes	remeter+V.ele.DAT.3.PL+PQP+1+SG
remetera-lhes	remeter+V.ele.DAT.3.PL+PQP+3+SG
remetera-lo	remeter+V.ele.ACC.3.M.SG+PQP+2+SG
remetera-los	remeter+V.ele.ACC.3.M.PL+PQP+2+SG
remetera-me	remeter+V.eu.AD.1.SG+PQP+1+SG
remetera-me	remeter+V.eu.AD.1.SG+PQP+3+SG
remeteram-lhe	remeter+V.ele.DAT.3.SG+PQP+3+PL
remeteram-lhe	remeter+V.ele.DAT.3.SG+PRF+3+PL
remeteram-lhes	remeter+V.ele.DAT.3.PL+PQP+3+PL
remeteram-lhes	remeter+V.ele.DAT.3.PL+PRF+3+PL
remeteram-me	remeter+V.eu.AD.1.SG+PQP+3+PL
remeteram-me	remeter+V.eu.AD.1.SG+PRF+3+PL
remeteram-na	remeter+V.ele.ACC.3.F.SG+PQP+3+PL
remeteram-na	remeter+V.ele.ACC.3.F.SG+PRF+3+PL
remeteram-nas	remeter+V.ele.ACC.3.F.PL+PQP+3+PL
remeteram-nas	remeter+V.ele.ACC.3.F.PL+PRF+3+PL
remeteram-no	remeter+V.ele.ACC.3.M.SG+PQP+3+PL
remeteram-no	remeter+V.ele.ACC.3.M.SG+PRF+3+PL
remeteram-nos	remeter+V.ele.ACC.3.M.PL+PQP+3+PL
remeteram-nos	remeter+V.ele.ACC.3.M.PL+PRF+3+PL
remeteram-nos	remeter+V.nós.AD.1.PL+PQP+3+PL
remeteram-nos	remeter+V.nós.AD.1.PL+PRF+3+PL
remetêramo-la	remeter+V.ele.ACC.3.F.SG+PQP+1+PL
remetêramo-las	remeter+V.ele.ACC.3.F.PL+PQP+1+PL
remetêramo-lo	remeter+V.ele.ACC.3.M.SG+PQP+1+PL
remetêramo-los	remeter+V.ele.ACC.3.M.PL+PQP+1+PL
remetêramo-nos	remeter+nós.AD.1.PL+PQP+1+PL
remetêramos-lhe	remeter+V.ele.DAT.3.SG+PQP+1+PL
remetêramos-lhes	remeter+V.ele.DAT.3.PL+PQP+1+PL
remetêramos-me	remeter+V.eu.AD.1.SG+PQP+1+PL
remetêramos-te	remeter+V.tu.AD.2.SG+PQP+1+PL
remetêramos-vos	remeter+V.vós.AD.2.PL+PQP+1+PL
remeteram-se	remeter+V.ele.REFL+PQP+3+PL
remeteram-se	remeter+V.ele.REFL+PRF+3+PL
remeteram-te	remeter+V.tu.AD.2.SG+PQP+3+PL
remeteram-te	remeter+V.tu.AD.2.SG+PRF+3+PL
remeteram-vos	remeter+V.vós.AD.2.PL+PQP+3+PL
remeteram-vos	remeter+V.vós.AD.2.PL+PRF+3+PL
remetera-nos	remeter+nós.AD.1.PL+PQP+1+SG
remetera-nos	remeter+nós.AD.1.PL+PQP+2+SG
remetera-nos	remeter+nós.AD.1.PL+PQP+3+SG
remetera-o	remeter+V.ele.ACC.3.M.SG+PQP+1+SG
remetera-o	remeter+V.ele.ACC.3.M.SG+PQP+3+SG
remetera-os	remeter+V.ele.ACC.3.M.PL+PQP+1+SG
remetera-os	remeter+V.ele.ACC.3.M.PL+PQP+3+SG
remetera-se	remeter+V.ele.REFL+PQP+3+SG
remeteras-lhe	remeter+V.ele.DAT.3.SG+PQP+2+SG
remeteras-lhes	remeter+V.ele.DAT.3.PL+PQP+2+SG
remeteras-me	remeter+V.eu.AD.1.SG+PQP+2+SG
remeteras-te	remeter+V.tu.AD.2.SG+PQP+2+SG
remeteras-vos	remeter+V.vós.AD.2.PL+PQP+2+SG
remetera-te	remeter+V.tu.AD.2.SG+PQP+1+SG
remetera-te	remeter+V.tu.AD.2.SG+PQP+3+SG
remetera-vos	remeter+V.vós.AD.2.PL+PQP+1+SG
remetera-vos	remeter+V.vós.AD.2.PL+PQP+3+SG
remeterde-la	remeter+V.ele.ACC.3.F.SG+INF+2+PL
remeterde-la	remeter+V.ele.ACC.3.F.SG+SBJF+2+PL
remeterde-las	remeter+V.ele.ACC.3.F.PL+INF+2+PL
remeterde-las	remeter+V.ele.ACC.3.F.PL+SBJF+2+PL
remeterde-lo	remeter+V.ele.ACC.3.M.SG+INF+2+PL
remeterde-lo	remeter+V.ele.ACC.3.M.SG+SBJF+2+PL
remeterde-los	remeter+V.ele.ACC.3.M.PL+INF+2+PL
remeterde-los	remeter+V.ele.ACC.3.M.PL+SBJF+2+PL
remeterde-nos	remeter+nós.AD.1.PL+INF+2+PL
remeterde-nos	remeter+nós.AD.1.PL+SBJF+2+PL
remeterdes-lhe	remeter+V.ele.DAT.3.SG+INF+2+PL
remeterdes-lhe	remeter+V.ele.DAT.3.SG+SBJF+2+PL
remeterdes-lhes	remeter+V.ele.DAT.3.PL+INF+2+PL
remeterdes-lhes	remeter+V.ele.DAT.3.PL+SBJF+2+PL
remeterdes-me	remeter+V.eu.AD.1.SG+INF+2+PL
remeterdes-me	remeter+V.eu.AD.1.SG+SBJF+2+PL
remeterdes-te	remeter+V.tu.AD.2.SG+INF+2+PL
remeterdes-te	remeter+V.tu.AD.2.SG+SBJF+2+PL
remeterdes-vos	remeter+V.vós.AD.2.PL+INF+2+PL
remeterdes-vos	remeter+V.vós.AD.2.PL+SBJF+2+PL
remetêrei-la	remeter+V.ele.ACC.3.F.SG+PQP+2+PL
remetêrei-las	remeter+V.ele.ACC.3.F.PL+PQP+2+PL
remetêrei-lo	remeter+V.ele.ACC.3.M.SG+PQP+2+PL
remetêrei-los	remeter+V.ele.ACC.3.M.PL+PQP+2+PL
remetêrei-nos	remeter+nós.AD.1.PL+PQP+2+PL
remetêreis-lhe	remeter+V.ele.DAT.3.SG+PQP+2+PL
remetêreis-lhes	remeter+V.ele.DAT.3.PL+PQP+2+PL
remetêreis-me	remeter+V.eu.AD.1.SG+PQP+2+PL
remetêreis-te	remeter+V.tu.AD.2.SG+PQP+2+PL
remetêreis-vos	remeter+V.vós.AD.2.PL+PQP+2+PL
remetere-la	remeter+V.ele.ACC.3.F.SG+INF+2+SG
remetere-la	remeter+V.ele.ACC.3.F.SG+SBJF+2+SG
remetere-las	remeter+V.ele.ACC.3.F.PL+INF+2+SG
remetere-las	remeter+V.ele.ACC.3.F.PL+SBJF+2+SG
remetere-lo	remeter+V.ele.ACC.3.M.SG+INF+2+SG
remetere-lo	remeter+V.ele.ACC.3.M.SG+SBJF+2+SG
remetere-los	remeter+V.ele.ACC.3.M.PL+INF+2+SG
remetere-los	remeter+V.ele.ACC.3.M.PL+SBJF+2+SG
reme-te	remar+V.tu.AD.2.SG+IMP+3+SG
remeterem-lhe	remeter+V.ele.DAT.3.SG+INF+3+PL
remeterem-lhe	remeter+V.ele.DAT.3.SG+SBJF+3+PL
remeterem-lhes	remeter+V.ele.DAT.3.PL+INF+3+PL
remeterem-lhes	remeter+V.ele.DAT.3.PL+SBJF+3+PL
remeterem-me	remeter+V.eu.AD.1.SG+INF+3+PL
remeterem-me	remeter+V.eu.AD.1.SG+SBJF+3+PL
remeterem-na	remeter+V.ele.ACC.3.F.SG+INF+3+PL
remeterem-na	remeter+V.ele.ACC.3.F.SG+SBJF+3+PL
remeterem-nas	remeter+V.ele.ACC.3.F.PL+INF+3+PL
remeterem-nas	remeter+V.ele.ACC.3.F.PL+SBJF+3+PL
remeterem-no	remeter+V.ele.ACC.3.M.SG+INF+3+PL
remeterem-no	remeter+V.ele.ACC.3.M.SG+SBJF+3+PL
remeterem-nos	remeter+V.ele.ACC.3.M.PL+INF+3+PL
remeterem-nos	remeter+V.ele.ACC.3.M.PL+SBJF+3+PL
remeterem-nos	remeter+V.nós.AD.1.PL+INF+3+PL
remeterem-nos	remeter+V.nós.AD.1.PL+SBJF+3+PL
remeterem-se	remeter+V.ele.REFL+INF+3+PL
remeterem-se	remeter+V.ele.REFL+SBJF+3+PL
remeterem-te	remeter+V.tu.AD.2.SG+INF+3+PL
remeterem-te	remeter+V.tu.AD.2.SG+SBJF+3+PL
remeterem-vos	remeter+V.vós.AD.2.PL+INF+3+PL
remeterem-vos	remeter+V.vós.AD.2.PL+SBJF+3+PL
remetere-nos	remeter+nós.AD.1.PL+INF+2+SG
remetere-nos	remeter+nós.AD.1.PL+SBJF+2+SG
remeteres-lhe	remeter+V.ele.DAT.3.SG+INF+2+SG
remeteres-lhe	remeter+V.ele.DAT.3.SG+SBJF+2+SG
remeteres-lhes	remeter+V.ele.DAT.3.PL+INF+2+SG
remeteres-lhes	remeter+V.ele.DAT.3.PL+SBJF+2+SG
remeteres-me	remeter+V.eu.AD.1.SG+INF+2+SG
remeteres-me	remeter+V.eu.AD.1.SG+SBJF+2+SG
remeteres-te	remeter+V.tu.AD.2.SG+INF+2+SG
remeteres-te	remeter+V.tu.AD.2.SG+SBJF+2+SG
remeteres-vos	remeter+V.vós.AD.2.PL+INF+2+SG
remeteres-vos	remeter+V.vós.AD.2.PL+SBJF+2+SG
remeter-lhe-ão	remeter+V.ele.DAT.3.SG+FUT+3+PL
remeter-lhe-á	remeter+V.ele.DAT.3.SG+FUT+3+SG
remeter-lhe-ás	remeter+V.ele.DAT.3.SG+FUT+2+SG
remeter-lhe-ei	remeter+V.ele.DAT.3.SG+FUT+1+SG
remeter-lhe-eis	remeter+V.ele.DAT.3.SG+FUT+2+PL
remeter-lhe-emos	remeter+V.ele.DAT.3.SG+FUT+1+PL
remeter-lhe-íamos	remeter+V.ele.DAT.3.SG+COND+1+PL
remeter-lhe-iam	remeter+V.ele.DAT.3.SG+COND+3+PL
remeter-lhe-ia	remeter+V.ele.DAT.3.SG+COND+1+SG
remeter-lhe-ia	remeter+V.ele.DAT.3.SG+COND+3+SG
remeter-lhe-ias	remeter+V.ele.DAT.3.SG+COND+2+SG
remeter-lhe-íeis	remeter+V.ele.DAT.3.SG+COND+2+PL
remeter-lhe	remeter+V.ele.DAT.3.SG+INF
remeter-lhe	remeter+V.ele.DAT.3.SG+INF+1+SG
remeter-lhe	remeter+V.ele.DAT.3.SG+INF+3+SG
remeter-lhe	remeter+V.ele.DAT.3.SG+SBJF+1+SG
remeter-lhe	remeter+V.ele.DAT.3.SG+SBJF+3+SG
remeter-lhes-ão	remeter+V.ele.DAT.3.PL+FUT+3+PL
remeter-lhes-á	remeter+V.ele.DAT.3.PL+FUT+3+SG
remeter-lhes-ás	remeter+V.ele.DAT.3.PL+FUT+2+SG
remeter-lhes-ei	remeter+V.ele.DAT.3.PL+FUT+1+SG
remeter-lhes-eis	remeter+V.ele.DAT.3.PL+FUT+2+PL
remeter-lhes-emos	remeter+V.ele.DAT.3.PL+FUT+1+PL
remeter-lhes-íamos	remeter+V.ele.DAT.3.PL+COND+1+PL
remeter-lhes-iam	remeter+V.ele.DAT.3.PL+COND+3+PL
remeter-lhes-ia	remeter+V.ele.DAT.3.PL+COND+1+SG
remeter-lhes-ia	remeter+V.ele.DAT.3.PL+COND+3+SG
remeter-lhes-ias	remeter+V.ele.DAT.3.PL+COND+2+SG
remeter-lhes-íeis	remeter+V.ele.DAT.3.PL+COND+2+PL
remeter-lhes	remeter+V.ele.DAT.3.PL+INF
remeter-lhes	remeter+V.ele.DAT.3.PL+INF+1+SG
remeter-lhes	remeter+V.ele.DAT.3.PL+INF+3+SG
remeter-lhes	remeter+V.ele.DAT.3.PL+SBJF+1+SG
remeter-lhes	remeter+V.ele.DAT.3.PL+SBJF+3+SG
remeter-me-ão	remeter+V.eu.AD.1.SG+FUT+3+PL
remeter-me-á	remeter+V.eu.AD.1.SG+FUT+3+SG
remeter-me-ás	remeter+V.eu.AD.1.SG+FUT+2+SG
remeter-me-ei	remeter+V.eu.AD.1.SG+FUT+1+SG
remeter-me-eis	remeter+V.eu.AD.1.SG+FUT+2+PL
remeter-me-emos	remeter+V.eu.AD.1.SG+FUT+1+PL
remeter-me-íamos	remeter+V.eu.AD.1.SG+COND+1+PL
remeter-me-iam	remeter+V.eu.AD.1.SG+COND+3+PL
remeter-me-ia	remeter+V.eu.AD.1.SG+COND+1+SG
remeter-me-ia	remeter+V.eu.AD.1.SG+COND+3+SG
remeter-me-ias	remeter+V.eu.AD.1.SG+COND+2+SG
remeter-me-íeis	remeter+V.eu.AD.1.SG+COND+2+PL
remeter-me	remeter+V.eu.AD.1.SG+INF
remeter-me	remeter+V.eu.AD.1.SG+INF+1+SG
remeter-me	remeter+V.eu.AD.1.SG+INF+3+SG
remeter-me	remeter+V.eu.AD.1.SG+SBJF+1+SG
remeter-me	remeter+V.eu.AD.1.SG+SBJF+3+SG
remetermo-la	remeter+V.ele.ACC.3.F.SG+INF+1+PL
remetermo-la	remeter+V.ele.ACC.3.F.SG+SBJF+1+PL
remetermo-las	remeter+V.ele.ACC.3.F.PL+INF+1+PL
remetermo-las	remeter+V.ele.ACC.3.F.PL+SBJF+1+PL
remetermo-lo	remeter+V.ele.ACC.3.M.SG+INF+1+PL
remetermo-lo	remeter+V.ele.ACC.3.M.SG+SBJF+1+PL
remetermo-los	remeter+V.ele.ACC.3.M.PL+INF+1+PL
remetermo-los	remeter+V.ele.ACC.3.M.PL+SBJF+1+PL
remetermo-nos	remeter+nós.AD.1.PL+INF+1+PL
remetermo-nos	remeter+nós.AD.1.PL+SBJF+1+PL
remetermos-lhe	remeter+V.ele.DAT.3.SG+INF+1+PL
remetermos-lhe	remeter+V.ele.DAT.3.SG+SBJF+1+PL
remetermos-lhes	remeter+V.ele.DAT.3.PL+INF+1+PL
remetermos-lhes	remeter+V.ele.DAT.3.PL+SBJF+1+PL
remetermos-me	remeter+V.eu.AD.1.SG+INF+1+PL
remetermos-me	remeter+V.eu.AD.1.SG+SBJF+1+PL
remetermos-te	remeter+V.tu.AD.2.SG+INF+1+PL
remetermos-te	remeter+V.tu.AD.2.SG+SBJF+1+PL
remetermos-vos	remeter+V.vós.AD.2.PL+INF+1+PL
remetermos-vos	remeter+V.vós.AD.2.PL+SBJF+1+PL
remeter-nos-ão	remeter+nós.AD.1.PL+FUT+3+PL
remeter-nos-á	remeter+nós.AD.1.PL+FUT+3+SG
remeter-nos-ás	remeter+nós.AD.1.PL+FUT+2+SG
remeter-nos-ei	remeter+nós.AD.1.PL+FUT+1+SG
remeter-nos-eis	remeter+nós.AD.1.PL+FUT+2+PL
remeter-nos-emos	remeter+nós.AD.1.PL+FUT+1+PL
remeter-nos-íamos	remeter+nós.AD.1.PL+COND+1+PL
remeter-nos-iam	remeter+nós.AD.1.PL+COND+3+PL
remeter-nos-ia	remeter+nós.AD.1.PL+COND+1+SG
remeter-nos-ia	remeter+nós.AD.1.PL+COND+3+SG
remeter-nos-ias	remeter+nós.AD.1.PL+COND+2+SG
remeter-nos-íeis	remeter+nós.AD.1.PL+COND+2+PL
remeter-nos	remeter+nós.AD.1.PL+INF
remeter-nos	remeter+nós.AD.1.PL+INF+1+SG
remeter-nos	remeter+nós.AD.1.PL+INF+3+SG
remeter-nos	remeter+nós.AD.1.PL+SBJF+1+SG
remeter-nos	remeter+nós.AD.1.PL+SBJF+3+SG
remeter-se-ão	remeter+V.ele.REFL+FUT+3+PL
remeter-se-á	remeter+V.ele.REFL+FUT+3+SG
remeter-se-iam	remeter+V.ele.REFL+COND+3+PL
remeter-se-ia	remeter+V.ele.REFL+COND+3+SG
remeter-se	remeter+V.ele.REFL+INF
remeter-se	remeter+V.ele.REFL+INF+3+SG
remeter-se	remeter+V.ele.REFL+SBJF+3+SG
remeter-te-ão	remeter+V.tu.AD.2.SG+FUT+3+PL
remeter-te-á	remeter+V.tu.AD.2.SG+FUT+3+SG
remeter-te-ás	remeter+V.tu.AD.2.SG+FUT+2+SG
remeter-te-ei	remeter+V.tu.AD.2.SG+FUT+1+SG
remeter-te-eis	remeter+V.tu.AD.2.SG+FUT+2+PL
remeter-te-emos	remeter+V.tu.AD.2.SG+FUT+1+PL
remeter-te-íamos	remeter+V.tu.AD.2.SG+COND+1+PL
remeter-te-iam	remeter+V.tu.AD.2.SG+COND+3+PL
remeter-te-ia	remeter+V.tu.AD.2.SG+COND+1+SG
remeter-te-ia	remeter+V.tu.AD.2.SG+COND+3+SG
remeter-te-ias	remeter+V.tu.AD.2.SG+COND+2+SG
remeter-te-íeis	remeter+V.tu.AD.2.SG+COND+2+PL
remeter-te	remeter+V.tu.AD.2.SG+INF
remeter-te	remeter+V.tu.AD.2.SG+INF+1+SG
remeter-te	remeter+V.tu.AD.2.SG+INF+3+SG
remeter-te	remeter+V.tu.AD.2.SG+SBJF+1+SG
remeter-te	remeter+V.tu.AD.2.SG+SBJF+3+SG
remeter-vos-ão	remeter+V.vós.AD.2.PL+FUT+3+PL
remeter-vos-á	remeter+V.vós.AD.2.PL+FUT+3+SG
remeter-vos-ás	remeter+V.vós.AD.2.PL+FUT+2+SG
remeter-vos-ei	remeter+V.vós.AD.2.PL+FUT+1+SG
remeter-vos-eis	remeter+V.vós.AD.2.PL+FUT+2+PL
remeter-vos-emos	remeter+V.vós.AD.2.PL+FUT+1+PL
remeter-vos-íamos	remeter+V.vós.AD.2.PL+COND+1+PL
remeter-vos-iam	remeter+V.vós.AD.2.PL+COND+3+PL
remeter-vos-ia	remeter+V.vós.AD.2.PL+COND+1+SG
remeter-vos-ia	remeter+V.vós.AD.2.PL+COND+3+SG
remeter-vos-ias	remeter+V.vós.AD.2.PL+COND+2+SG
remeter-vos-íeis	remeter+V.vós.AD.2.PL+COND+2+PL
remeter-vos	remeter+V.vós.AD.2.PL+INF
remeter-vos	remeter+V.vós.AD.2.PL+INF+1+SG
remeter-vos	remeter+V.vós.AD.2.PL+INF+3+SG
remeter-vos	remeter+V.vós.AD.2.PL+SBJF+1+SG
remeter-vos	remeter+V.vós.AD.2.PL+SBJF+3+SG
remete-se	remeter+V.ele.REFL+PRS+3+SG
remetes-lhe	remeter+V.ele.DAT.3.SG+PRS+2+SG
remetes-lhes	remeter+V.ele.DAT.3.PL+PRS+2+SG
remetes-me	remeter+V.eu.AD.1.SG+PRS+2+SG
remeteste-a	remeter+V.ele.ACC.3.F.SG+PRF+2+SG
remeteste-as	remeter+V.ele.ACC.3.F.PL+PRF+2+SG
remeteste-la	remeter+V.ele.ACC.3.F.SG+PRF+2+PL
remeteste-las	remeter+V.ele.ACC.3.F.PL+PRF+2+PL
remeteste-lhe	remeter+V.ele.DAT.3.SG+PRF+2+SG
remeteste-lhes	remeter+V.ele.DAT.3.PL+PRF+2+SG
remeteste-lo	remeter+V.ele.ACC.3.M.SG+PRF+2+PL
remeteste-los	remeter+V.ele.ACC.3.M.PL+PRF+2+PL
remeteste-me	remeter+V.eu.AD.1.SG+PRF+2+SG
remeteste-nos	remeter+nós.AD.1.PL+PRF+2+PL
remeteste-nos	remeter+nós.AD.1.PL+PRF+2+SG
remeteste-o	remeter+V.ele.ACC.3.M.SG+PRF+2+SG
remeteste-os	remeter+V.ele.ACC.3.M.PL+PRF+2+SG
remetes-te	remeter+V.tu.AD.2.SG+PRS+2+SG
remetestes-lhe	remeter+V.ele.DAT.3.SG+PRF+2+PL
remetestes-lhes	remeter+V.ele.DAT.3.PL+PRF+2+PL
remetestes-me	remeter+V.eu.AD.1.SG+PRF+2+PL
remetestes-te	remeter+V.tu.AD.2.SG+PRF+2+PL
remetestes-vos	remeter+V.vós.AD.2.PL+PRF+2+PL
remeteste-te	remeter+V.tu.AD.2.SG+PRF+2+SG
remeteste-vos	remeter+V.vós.AD.2.PL+PRF+2+SG
remetes-vos	remeter+V.vós.AD.2.PL+PRS+2+SG
remete-te	remeter+V.tu.AD.2.SG+PRS+3+SG
remeteu-a	remeter+V.ele.ACC.3.F.SG+PRF+3+SG
remeteu-as	remeter+V.ele.ACC.3.F.PL+PRF+3+SG
remeteu-lhe	remeter+V.ele.DAT.3.SG+PRF+3+SG
remeteu-lhes	remeter+V.ele.DAT.3.PL+PRF+3+SG
remeteu-me	remeter+V.eu.AD.1.SG+PRF+3+SG
remeteu-nos	remeter+nós.AD.1.PL+PRF+3+SG
remeteu-o	remeter+V.ele.ACC.3.M.SG+PRF+3+SG
remeteu-os	remeter+V.ele.ACC.3.M.PL+PRF+3+SG
remeteu-se	remeter+V.ele.REFL+PRF+3+SG
remeteu-te	remeter+V.tu.AD.2.SG+PRF+3+SG
remeteu-vos	remeter+V.vós.AD.2.PL+PRF+3+SG
remete-vos	remeter+V.vós.AD.2.PL+PRS+3+SG
remetia-a	remeter+V.ele.ACC.3.F.SG+IMPF+1+SG
remetia-a	remeter+V.ele.ACC.3.F.SG+IMPF+3+SG
remetia-as	remeter+V.ele.ACC.3.F.PL+IMPF+1+SG
remetia-as	remeter+V.ele.ACC.3.F.PL+IMPF+3+SG
remetia-la	remeter+V.ele.ACC.3.F.SG+IMPF+2+SG
remetia-las	remeter+V.ele.ACC.3.F.PL+IMPF+2+SG
remetia-lhe	remeter+V.ele.DAT.3.SG+IMPF+1+SG
remetia-lhe	remeter+V.ele.DAT.3.SG+IMPF+3+SG
remetia-lhes	remeter+V.ele.DAT.3.PL+IMPF+1+SG
remetia-lhes	remeter+V.ele.DAT.3.PL+IMPF+3+SG
remetia-lo	remeter+V.ele.ACC.3.M.SG+IMPF+2+SG
remetia-los	remeter+V.ele.ACC.3.M.PL+IMPF+2+SG
remetia-me	remeter+V.eu.AD.1.SG+IMPF+1+SG
remetia-me	remeter+V.eu.AD.1.SG+IMPF+3+SG
remetiam-lhe	remeter+V.ele.DAT.3.SG+IMPF+3+PL
remetiam-lhes	remeter+V.ele.DAT.3.PL+IMPF+3+PL
remetiam-me	remeter+V.eu.AD.1.SG+IMPF+3+PL
remetiam-na	remeter+V.ele.ACC.3.F.SG+IMPF+3+PL
remetiam-nas	remeter+V.ele.ACC.3.F.PL+IMPF+3+PL
remetiam-no	remeter+V.ele.ACC.3.M.SG+IMPF+3+PL
remetiam-nos	remeter+V.ele.ACC.3.M.PL+IMPF+3+PL
remetiam-nos	remeter+V.nós.AD.1.PL+IMPF+3+PL
remetíamo-la	remeter+V.ele.ACC.3.F.SG+IMPF+1+PL
remetíamo-las	remeter+V.ele.ACC.3.F.PL+IMPF+1+PL
remetíamo-lo	remeter+V.ele.ACC.3.M.SG+IMPF+1+PL
remetíamo-los	remeter+V.ele.ACC.3.M.PL+IMPF+1+PL
remetíamo-nos	remeter+nós.AD.1.PL+IMPF+1+PL
remetíamos-lhe	remeter+V.ele.DAT.3.SG+IMPF+1+PL
remetíamos-lhes	remeter+V.ele.DAT.3.PL+IMPF+1+PL
remetíamos-me	remeter+V.eu.AD.1.SG+IMPF+1+PL
remetíamos-te	remeter+V.tu.AD.2.SG+IMPF+1+PL
remetíamos-vos	remeter+V.vós.AD.2.PL+IMPF+1+PL
remetiam-se	remeter+V.ele.REFL+IMPF+3+PL
remetiam-te	remeter+V.tu.AD.2.SG+IMPF+3+PL
remetiam-vos	remeter+V.vós.AD.2.PL+IMPF+3+PL
remetia-nos	remeter+nós.AD.1.PL+IMPF+1+SG
remetia-nos	remeter+nós.AD.1.PL+IMPF+2+SG
remetia-nos	remeter+nós.AD.1.PL+IMPF+3+SG
remetia-o	remeter+V.ele.ACC.3.M.SG+IMPF+1+SG
remetia-o	remeter+V.ele.ACC.3.M.SG+IMPF+3+SG
remetia-os	remeter+V.ele.ACC.3.M.PL+IMPF+1+SG
remetia-os	remeter+V.ele.ACC.3.M.PL+IMPF+3+SG
remeti-a	remeter+V.ele.ACC.3.F.SG+PRF+1+SG
remetia-se	remeter+V.ele.REFL+IMPF+3+SG
remetias-lhe	remeter+V.ele.DAT.3.SG+IMPF+2+SG
remetias-lhes	remeter+V.ele.DAT.3.PL+IMPF+2+SG
remetias-me	remeter+V.eu.AD.1.SG+IMPF+2+SG
remeti-as	remeter+V.ele.ACC.3.F.PL+PRF+1+SG
remetias-te	remeter+V.tu.AD.2.SG+IMPF+2+SG
remetias-vos	remeter+V.vós.AD.2.PL+IMPF+2+SG
remetia-te	remeter+V.tu.AD.2.SG+IMPF+1+SG
remetia-te	remeter+V.tu.AD.2.SG+IMPF+3+SG
remetia-vos	remeter+V.vós.AD.2.PL+IMPF+1+SG
remetia-vos	remeter+V.vós.AD.2.PL+IMPF+3+SG
remetíei-la	remeter+V.ele.ACC.3.F.SG+IMPF+2+PL
remetíei-las	remeter+V.ele.ACC.3.F.PL+IMPF+2+PL
remetíei-lo	remeter+V.ele.ACC.3.M.SG+IMPF+2+PL
remetíei-los	remeter+V.ele.ACC.3.M.PL+IMPF+2+PL
remetíei-nos	remeter+nós.AD.1.PL+IMPF+2+PL
remetíeis-lhe	remeter+V.ele.DAT.3.SG+IMPF+2+PL
remetíeis-lhes	remeter+V.ele.DAT.3.PL+IMPF+2+PL
remetíeis-me	remeter+V.eu.AD.1.SG+IMPF+2+PL
remetíeis-te	remeter+V.tu.AD.2.SG+IMPF+2+PL
remetíeis-vos	remeter+V.vós.AD.2.PL+IMPF+2+PL
remeti-lhe	remeter+V.ele.DAT.3.SG+PRF+1+SG
remeti-lhes	remeter+V.ele.DAT.3.PL+PRF+1+SG
remeti-me	remeter+V.eu.AD.1.SG+PRF+1+SG
remeti-nos	remeter+nós.AD.1.PL+PRF+1+SG
remeti-o	remeter+V.ele.ACC.3.M.SG+PRF+1+SG
remeti-os	remeter+V.ele.ACC.3.M.PL+PRF+1+SG
remeti-te	remeter+V.tu.AD.2.SG+PRF+1+SG
remeti-vos	remeter+V.vós.AD.2.PL+PRF+1+SG
remeto-a	remeter+V.ele.ACC.3.F.SG+PRS+1+SG
remeto-as	remeter+V.ele.ACC.3.F.PL+PRS+1+SG
remeto-lhe	remeter+V.ele.DAT.3.SG+PRS+1+SG
remeto-lhes	remeter+V.ele.DAT.3.PL+PRS+1+SG
remeto-me	remeter+V.eu.AD.1.SG+PRS+1+SG
remeto-nos	remeter+nós.AD.1.PL+PRS+1+SG
remeto-o	remeter+V.ele.ACC.3.M.SG+PRS+1+SG
remeto-os	remeter+V.ele.ACC.3.M.PL+PRS+1+SG
remeto-te	remeter+V.tu.AD.2.SG+PRS+1+SG
remeto-vos	remeter+V.vós.AD.2.PL+PRS+1+SG
reme-vos	remar+V.vós.AD.2.PL+IMP+3+SG
remexa-a	remexer+V.ele.ACC.3.F.SG+IMP+3+SG
remexa-as	remexer+V.ele.ACC.3.F.PL+IMP+3+SG
remexa-lhe	remexer+V.ele.DAT.3.SG+IMP+3+SG
remexa-lhes	remexer+V.ele.DAT.3.PL+IMP+3+SG
remexa-me	remexer+V.eu.AD.1.SG+IMP+3+SG
remexam-lhe	remexer+V.ele.DAT.3.SG+IMP+3+PL
remexam-lhes	remexer+V.ele.DAT.3.PL+IMP+3+PL
remexam-me	remexer+V.eu.AD.1.SG+IMP+3+PL
remexam-na	remexer+V.ele.ACC.3.F.SG+IMP+3+PL
remexam-nas	remexer+V.ele.ACC.3.F.PL+IMP+3+PL
remexam-no	remexer+V.ele.ACC.3.M.SG+IMP+3+PL
remexam-nos	remexer+V.ele.ACC.3.M.PL+IMP+3+PL
remexam-nos	remexer+V.nós.AD.1.PL+IMP+3+PL
remexamo-la	remexer+V.ele.ACC.3.F.SG+IMP+1+PL
remexamo-las	remexer+V.ele.ACC.3.F.PL+IMP+1+PL
remexamo-lo	remexer+V.ele.ACC.3.M.SG+IMP+1+PL
remexamo-los	remexer+V.ele.ACC.3.M.PL+IMP+1+PL
remexamo-nos	remexer+nós.AD.1.PL+IMP+1+PL
remexamos-lhe	remexer+V.ele.DAT.3.SG+IMP+1+PL
remexamos-lhes	remexer+V.ele.DAT.3.PL+IMP+1+PL
remexamos-me	remexer+V.eu.AD.1.SG+IMP+1+PL
remexamos-te	remexer+V.tu.AD.2.SG+IMP+1+PL
remexamos-vos	remexer+V.vós.AD.2.PL+IMP+1+PL
remexam-se	remexer+V.ele.REFL+IMP+3+PL
remexam-te	remexer+V.tu.AD.2.SG+IMP+3+PL
remexam-vos	remexer+V.vós.AD.2.PL+IMP+3+PL
remexa-nos	remexer+nós.AD.1.PL+IMP+3+SG
remexa-o	remexer+V.ele.ACC.3.M.SG+IMP+3+SG
remexa-os	remexer+V.ele.ACC.3.M.PL+IMP+3+SG
remexa-se	remexer+V.ele.REFL+IMP+3+SG
remexa-te	remexer+V.tu.AD.2.SG+IMP+3+SG
remexa-vos	remexer+V.vós.AD.2.PL+IMP+3+SG
remexe-a	remexer+V.ele.ACC.3.F.SG+PRS+3+SG
remexe-as	remexer+V.ele.ACC.3.F.PL+PRS+3+SG
remexei-la	remexer+V.ele.ACC.3.F.SG+PRS+2+PL
remexei-las	remexer+V.ele.ACC.3.F.PL+PRS+2+PL
remexei-lo	remexer+V.ele.ACC.3.M.SG+PRS+2+PL
remexei-los	remexer+V.ele.ACC.3.M.PL+PRS+2+PL
remexei-nos	remexer+nós.AD.1.PL+PRS+2+PL
remexeis-lhe	remexer+V.ele.DAT.3.SG+PRS+2+PL
remexeis-lhes	remexer+V.ele.DAT.3.PL+PRS+2+PL
remexeis-me	remexer+V.eu.AD.1.SG+PRS+2+PL
remexeis-te	remexer+V.tu.AD.2.SG+PRS+2+PL
remexeis-vos	remexer+V.vós.AD.2.PL+PRS+2+PL
remexê-la-ão	remexer+V.ele.ACC.3.F.SG+FUT+3+PL
remexê-la-á	remexer+V.ele.ACC.3.F.SG+FUT+3+SG
remexê-la-ás	remexer+V.ele.ACC.3.F.SG+FUT+2+SG
remexê-la-ei	remexer+V.ele.ACC.3.F.SG+FUT+1+SG
remexê-la-eis	remexer+V.ele.ACC.3.F.SG+FUT+2+PL
remexê-la-emos	remexer+V.ele.ACC.3.F.SG+FUT+1+PL
remexê-la-íamos	remexer+V.ele.ACC.3.F.SG+COND+1+PL
remexê-la-iam	remexer+V.ele.ACC.3.F.SG+COND+3+PL
remexê-la-ia	remexer+V.ele.ACC.3.F.SG+COND+1+SG
remexê-la-ia	remexer+V.ele.ACC.3.F.SG+COND+3+SG
remexê-la-ias	remexer+V.ele.ACC.3.F.SG+COND+2+SG
remexê-la-íeis	remexer+V.ele.ACC.3.F.SG+COND+2+PL
remexê-la	remexer+V.ele.ACC.3.F.SG+INF
remexê-la	remexer+V.ele.ACC.3.F.SG+INF+1+SG
remexê-la	remexer+V.ele.ACC.3.F.SG+INF+3+SG
remexe-la	remexer+V.ele.ACC.3.F.SG+PRS+2+SG
remexê-la	remexer+V.ele.ACC.3.F.SG+SBJF+1+SG
remexê-la	remexer+V.ele.ACC.3.F.SG+SBJF+3+SG
remexê-las-ão	remexer+V.ele.ACC.3.F.PL+FUT+3+PL
remexê-las-á	remexer+V.ele.ACC.3.F.PL+FUT+3+SG
remexê-las-ás	remexer+V.ele.ACC.3.F.PL+FUT+2+SG
remexê-las-ei	remexer+V.ele.ACC.3.F.PL+FUT+1+SG
remexê-las-eis	remexer+V.ele.ACC.3.F.PL+FUT+2+PL
remexê-las-emos	remexer+V.ele.ACC.3.F.PL+FUT+1+PL
remexê-las-íamos	remexer+V.ele.ACC.3.F.PL+COND+1+PL
remexê-las-iam	remexer+V.ele.ACC.3.F.PL+COND+3+PL
remexê-las-ia	remexer+V.ele.ACC.3.F.PL+COND+1+SG
remexê-las-ia	remexer+V.ele.ACC.3.F.PL+COND+3+SG
remexê-las-ias	remexer+V.ele.ACC.3.F.PL+COND+2+SG
remexê-las-íeis	remexer+V.ele.ACC.3.F.PL+COND+2+PL
remexê-las	remexer+V.ele.ACC.3.F.PL+INF
remexê-las	remexer+V.ele.ACC.3.F.PL+INF+1+SG
remexê-las	remexer+V.ele.ACC.3.F.PL+INF+3+SG
remexe-las	remexer+V.ele.ACC.3.F.PL+PRS+2+SG
remexê-las	remexer+V.ele.ACC.3.F.PL+SBJF+1+SG
remexê-las	remexer+V.ele.ACC.3.F.PL+SBJF+3+SG
remexe-lhe	remexer+V.ele.DAT.3.SG+PRS+3+SG
remexe-lhes	remexer+V.ele.DAT.3.PL+PRS+3+SG
remexê-lo-ão	remexer+V.ele.ACC.3.M.SG+FUT+3+PL
remexê-lo-á	remexer+V.ele.ACC.3.M.SG+FUT+3+SG
remexê-lo-ás	remexer+V.ele.ACC.3.M.SG+FUT+2+SG
remexê-lo-ei	remexer+V.ele.ACC.3.M.SG+FUT+1+SG
remexê-lo-eis	remexer+V.ele.ACC.3.M.SG+FUT+2+PL
remexê-lo-emos	remexer+V.ele.ACC.3.M.SG+FUT+1+PL
remexê-lo-íamos	remexer+V.ele.ACC.3.M.SG+COND+1+PL
remexê-lo-iam	remexer+V.ele.ACC.3.M.SG+COND+3+PL
remexê-lo-ia	remexer+V.ele.ACC.3.M.SG+COND+1+SG
remexê-lo-ia	remexer+V.ele.ACC.3.M.SG+COND+3+SG
remexê-lo-ias	remexer+V.ele.ACC.3.M.SG+COND+2+SG
remexê-lo-íeis	remexer+V.ele.ACC.3.M.SG+COND+2+PL
remexê-lo	remexer+V.ele.ACC.3.M.SG+INF
remexê-lo	remexer+V.ele.ACC.3.M.SG+INF+1+SG
remexê-lo	remexer+V.ele.ACC.3.M.SG+INF+3+SG
remexe-lo	remexer+V.ele.ACC.3.M.SG+PRS+2+SG
remexê-lo	remexer+V.ele.ACC.3.M.SG+SBJF+1+SG
remexê-lo	remexer+V.ele.ACC.3.M.SG+SBJF+3+SG
remexê-los-ão	remexer+V.ele.ACC.3.M.PL+FUT+3+PL
remexê-los-á	remexer+V.ele.ACC.3.M.PL+FUT+3+SG
remexê-los-ás	remexer+V.ele.ACC.3.M.PL+FUT+2+SG
remexê-los-ei	remexer+V.ele.ACC.3.M.PL+FUT+1+SG
remexê-los-eis	remexer+V.ele.ACC.3.M.PL+FUT+2+PL
remexê-los-emos	remexer+V.ele.ACC.3.M.PL+FUT+1+PL
remexê-los-íamos	remexer+V.ele.ACC.3.M.PL+COND+1+PL
remexê-los-iam	remexer+V.ele.ACC.3.M.PL+COND+3+PL
remexê-los-ia	remexer+V.ele.ACC.3.M.PL+COND+1+SG
remexê-los-ia	remexer+V.ele.ACC.3.M.PL+COND+3+SG
remexê-los-ias	remexer+V.ele.ACC.3.M.PL+COND+2+SG
remexê-los-íeis	remexer+V.ele.ACC.3.M.PL+COND+2+PL
remexê-los	remexer+V.ele.ACC.3.M.PL+INF
remexê-los	remexer+V.ele.ACC.3.M.PL+INF+1+SG
remexê-los	remexer+V.ele.ACC.3.M.PL+INF+3+SG
remexe-los	remexer+V.ele.ACC.3.M.PL+PRS+2+SG
remexê-los	remexer+V.ele.ACC.3.M.PL+SBJF+1+SG
remexê-los	remexer+V.ele.ACC.3.M.PL+SBJF+3+SG
remexe-me	remexer+V.eu.AD.1.SG+PRS+3+SG
remexem-lhe	remexer+V.ele.DAT.3.SG+PRS+3+PL
remexem-lhes	remexer+V.ele.DAT.3.PL+PRS+3+PL
remexem-me	remexer+V.eu.AD.1.SG+PRS+3+PL
remexem-na	remexer+V.ele.ACC.3.F.SG+PRS+3+PL
remexem-nas	remexer+V.ele.ACC.3.F.PL+PRS+3+PL
remexem-no	remexer+V.ele.ACC.3.M.SG+PRS+3+PL
remexem-nos	remexer+V.ele.ACC.3.M.PL+PRS+3+PL
remexem-nos	remexer+V.nós.AD.1.PL+PRS+3+PL
remexemo-la	remexer+V.ele.ACC.3.F.SG+PRF+1+PL
remexemo-la	remexer+V.ele.ACC.3.F.SG+PRS+1+PL
remexemo-las	remexer+V.ele.ACC.3.F.PL+PRF+1+PL
remexemo-las	remexer+V.ele.ACC.3.F.PL+PRS+1+PL
remexemo-lo	remexer+V.ele.ACC.3.M.SG+PRF+1+PL
remexemo-lo	remexer+V.ele.ACC.3.M.SG+PRS+1+PL
remexemo-los	remexer+V.ele.ACC.3.M.PL+PRF+1+PL
remexemo-los	remexer+V.ele.ACC.3.M.PL+PRS+1+PL
remexemo-nos	remexer+nós.AD.1.PL+PRF+1+PL
remexemo-nos	remexer+nós.AD.1.PL+PRS+1+PL
remexemos-lhe	remexer+V.ele.DAT.3.SG+PRF+1+PL
remexemos-lhe	remexer+V.ele.DAT.3.SG+PRS+1+PL
remexemos-lhes	remexer+V.ele.DAT.3.PL+PRF+1+PL
remexemos-lhes	remexer+V.ele.DAT.3.PL+PRS+1+PL
remexemos-me	remexer+V.eu.AD.1.SG+PRF+1+PL
remexemos-me	remexer+V.eu.AD.1.SG+PRS+1+PL
remexemos-te	remexer+V.tu.AD.2.SG+PRF+1+PL
remexemos-te	remexer+V.tu.AD.2.SG+PRS+1+PL
remexemos-vos	remexer+V.vós.AD.2.PL+PRF+1+PL
remexemos-vos	remexer+V.vós.AD.2.PL+PRS+1+PL
remexem-se	remexer+V.ele.REFL+PRS+3+PL
remexem-te	remexer+V.tu.AD.2.SG+PRS+3+PL
remexem-vos	remexer+V.vós.AD.2.PL+PRS+3+PL
remexendo-a	remexer+V.ele.ACC.3.F.SG+GRD
remexendo-as	remexer+V.ele.ACC.3.F.PL+GRD
remexendo-lhe	remexer+V.ele.DAT.3.SG+GRD
remexendo-lhes	remexer+V.ele.DAT.3.PL+GRD
remexendo-me	remexer+V.eu.AD.1.SG+GRD
remexendo-nos	remexer+nós.AD.1.PL+GRD
remexendo-o	remexer+V.ele.ACC.3.M.SG+GRD
remexendo-os	remexer+V.ele.ACC.3.M.PL+GRD
remexendo-se	remexer+V.ele.REFL+GRD
remexendo-te	remexer+V.tu.AD.2.SG+GRD
remexendo-vos	remexer+V.vós.AD.2.PL+GRD
remexe-nos	remexer+nós.AD.1.PL+PRS+2+SG
remexe-nos	remexer+nós.AD.1.PL+PRS+3+SG
remexe-o	remexer+V.ele.ACC.3.M.SG+PRS+3+SG
remexe-os	remexer+V.ele.ACC.3.M.PL+PRS+3+SG
remexera-a	remexer+V.ele.ACC.3.F.SG+PQP+1+SG
remexera-a	remexer+V.ele.ACC.3.F.SG+PQP+3+SG
remexera-as	remexer+V.ele.ACC.3.F.PL+PQP+1+SG
remexera-as	remexer+V.ele.ACC.3.F.PL+PQP+3+SG
remexera-la	remexer+V.ele.ACC.3.F.SG+PQP+2+SG
remexera-las	remexer+V.ele.ACC.3.F.PL+PQP+2+SG
remexera-lhe	remexer+V.ele.DAT.3.SG+PQP+1+SG
remexera-lhe	remexer+V.ele.DAT.3.SG+PQP+3+SG
remexera-lhes	remexer+V.ele.DAT.3.PL+PQP+1+SG
remexera-lhes	remexer+V.ele.DAT.3.PL+PQP+3+SG
remexera-lo	remexer+V.ele.ACC.3.M.SG+PQP+2+SG
remexera-los	remexer+V.ele.ACC.3.M.PL+PQP+2+SG
remexera-me	remexer+V.eu.AD.1.SG+PQP+1+SG
remexera-me	remexer+V.eu.AD.1.SG+PQP+3+SG
remexeram-lhe	remexer+V.ele.DAT.3.SG+PQP+3+PL
remexeram-lhe	remexer+V.ele.DAT.3.SG+PRF+3+PL
remexeram-lhes	remexer+V.ele.DAT.3.PL+PQP+3+PL
