sapejava-lhes	sapejar+V.ele.DAT.3.PL+IMPF+1+SG
sapejava-lhes	sapejar+V.ele.DAT.3.PL+IMPF+3+SG
sapejava-lo	sapejar+V.ele.ACC.3.M.SG+IMPF+2+SG
sapejava-los	sapejar+V.ele.ACC.3.M.PL+IMPF+2+SG
sapejava-me	sapejar+V.eu.AD.1.SG+IMPF+1+SG
sapejava-me	sapejar+V.eu.AD.1.SG+IMPF+3+SG
sapejavam-lhe	sapejar+V.ele.DAT.3.SG+IMPF+3+PL
sapejavam-lhes	sapejar+V.ele.DAT.3.PL+IMPF+3+PL
sapejavam-me	sapejar+V.eu.AD.1.SG+IMPF+3+PL
sapejavam-na	sapejar+V.ele.ACC.3.F.SG+IMPF+3+PL
sapejavam-nas	sapejar+V.ele.ACC.3.F.PL+IMPF+3+PL
sapejavam-no	sapejar+V.ele.ACC.3.M.SG+IMPF+3+PL
sapejavam-nos	sapejar+V.ele.ACC.3.M.PL+IMPF+3+PL
sapejavam-nos	sapejar+V.nós.AD.1.PL+IMPF+3+PL
sapejávamo-la	sapejar+V.ele.ACC.3.F.SG+IMPF+1+PL
sapejávamo-las	sapejar+V.ele.ACC.3.F.PL+IMPF+1+PL
sapejávamo-lo	sapejar+V.ele.ACC.3.M.SG+IMPF+1+PL
sapejávamo-los	sapejar+V.ele.ACC.3.M.PL+IMPF+1+PL
sapejávamo-nos	sapejar+nós.AD.1.PL+IMPF+1+PL
sapejávamos-lhe	sapejar+V.ele.DAT.3.SG+IMPF+1+PL
sapejávamos-lhes	sapejar+V.ele.DAT.3.PL+IMPF+1+PL
sapejávamos-me	sapejar+V.eu.AD.1.SG+IMPF+1+PL
sapejávamos-te	sapejar+V.tu.AD.2.SG+IMPF+1+PL
sapejávamos-vos	sapejar+V.vós.AD.2.PL+IMPF+1+PL
sapejavam-se	sapejar+V.ele.REFL+IMPF+3+PL
sapejavam-te	sapejar+V.tu.AD.2.SG+IMPF+3+PL
sapejavam-vos	sapejar+V.vós.AD.2.PL+IMPF+3+PL
sapejava-nos	sapejar+nós.AD.1.PL+IMPF+1+SG
sapejava-nos	sapejar+nós.AD.1.PL+IMPF+2+SG
sapejava-nos	sapejar+nós.AD.1.PL+IMPF+3+SG
sapejava-o	sapejar+V.ele.ACC.3.M.SG+IMPF+1+SG
sapejava-o	sapejar+V.ele.ACC.3.M.SG+IMPF+3+SG
sapejava-os	sapejar+V.ele.ACC.3.M.PL+IMPF+1+SG
sapejava-os	sapejar+V.ele.ACC.3.M.PL+IMPF+3+SG
sapejava-se	sapejar+V.ele.REFL+IMPF+1+SG
sapejava-se	sapejar+V.ele.REFL+IMPF+3+SG
sapejavas-lhe	sapejar+V.ele.DAT.3.SG+IMPF+2+SG
sapejavas-lhes	sapejar+V.ele.DAT.3.PL+IMPF+2+SG
sapejavas-me	sapejar+V.eu.AD.1.SG+IMPF+2+SG
sapejavas-te	sapejar+V.tu.AD.2.SG+IMPF+2+SG
sapejavas-vos	sapejar+V.vós.AD.2.PL+IMPF+2+SG
sapejava-te	sapejar+V.tu.AD.2.SG+IMPF+1+SG
sapejava-te	sapejar+V.tu.AD.2.SG+IMPF+3+SG
sapejava-vos	sapejar+V.vós.AD.2.PL+IMPF+1+SG
sapejava-vos	sapejar+V.vós.AD.2.PL+IMPF+3+SG
sapejávei-la	sapejar+V.ele.ACC.3.F.SG+IMPF+2+PL
sapejávei-las	sapejar+V.ele.ACC.3.F.PL+IMPF+2+PL
sapejávei-lo	sapejar+V.ele.ACC.3.M.SG+IMPF+2+PL
sapejávei-los	sapejar+V.ele.ACC.3.M.PL+IMPF+2+PL
sapejávei-nos	sapejar+nós.AD.1.PL+IMPF+2+PL
sapejáveis-lhe	sapejar+V.ele.DAT.3.SG+IMPF+2+PL
sapejáveis-lhes	sapejar+V.ele.DAT.3.PL+IMPF+2+PL
sapejáveis-me	sapejar+V.eu.AD.1.SG+IMPF+2+PL
sapejáveis-te	sapejar+V.tu.AD.2.SG+IMPF+2+PL
sapejáveis-vos	sapejar+V.vós.AD.2.PL+IMPF+2+PL
sapeja-vos	sapejar+V.vós.AD.2.PL+PRS+3+SG
sapeje-a	sapejar+V.ele.ACC.3.F.SG+IMP+3+SG
sapeje-as	sapejar+V.ele.ACC.3.F.PL+IMP+3+SG
sapejei-a	sapejar+V.ele.ACC.3.F.SG+PRF+1+SG
sapejei-as	sapejar+V.ele.ACC.3.F.PL+PRF+1+SG
sapejei-lhe	sapejar+V.ele.DAT.3.SG+PRF+1+SG
sapejei-lhes	sapejar+V.ele.DAT.3.PL+PRF+1+SG
sapejei-me	sapejar+V.eu.AD.1.SG+PRF+1+SG
sapejei-nos	sapejar+nós.AD.1.PL+PRF+1+SG
sapejei-o	sapejar+V.ele.ACC.3.M.SG+PRF+1+SG
sapejei-os	sapejar+V.ele.ACC.3.M.PL+PRF+1+SG
sapejei-te	sapejar+V.tu.AD.2.SG+PRF+1+SG
sapejei-vos	sapejar+V.vós.AD.2.PL+PRF+1+SG
sapeje-lhe	sapejar+V.ele.DAT.3.SG+IMP+3+SG
sapeje-lhes	sapejar+V.ele.DAT.3.PL+IMP+3+SG
sapeje-me	sapejar+V.eu.AD.1.SG+IMP+3+SG
sapejem-lhe	sapejar+V.ele.DAT.3.SG+IMP+3+PL
sapejem-lhes	sapejar+V.ele.DAT.3.PL+IMP+3+PL
sapejem-me	sapejar+V.eu.AD.1.SG+IMP+3+PL
sapejem-na	sapejar+V.ele.ACC.3.F.SG+IMP+3+PL
sapejem-nas	sapejar+V.ele.ACC.3.F.PL+IMP+3+PL
sapejem-no	sapejar+V.ele.ACC.3.M.SG+IMP+3+PL
sapejem-nos	sapejar+V.ele.ACC.3.M.PL+IMP+3+PL
sapejem-nos	sapejar+V.nós.AD.1.PL+IMP+3+PL
sapejemo-la	sapejar+V.ele.ACC.3.F.SG+IMP+1+PL
sapejemo-las	sapejar+V.ele.ACC.3.F.PL+IMP+1+PL
sapejemo-lo	sapejar+V.ele.ACC.3.M.SG+IMP+1+PL
sapejemo-los	sapejar+V.ele.ACC.3.M.PL+IMP+1+PL
sapejemo-nos	sapejar+nós.AD.1.PL+IMP+1+PL
sapejemos-lhe	sapejar+V.ele.DAT.3.SG+IMP+1+PL
sapejemos-lhes	sapejar+V.ele.DAT.3.PL+IMP+1+PL
sapejemos-me	sapejar+V.eu.AD.1.SG+IMP+1+PL
sapejemos-te	sapejar+V.tu.AD.2.SG+IMP+1+PL
sapejemos-vos	sapejar+V.vós.AD.2.PL+IMP+1+PL
sapejem-se	sapejar+V.ele.REFL+IMP+3+PL
sapejem-te	sapejar+V.tu.AD.2.SG+IMP+3+PL
sapejem-vos	sapejar+V.vós.AD.2.PL+IMP+3+PL
sapeje-nos	sapejar+nós.AD.1.PL+IMP+3+SG
sapeje-o	sapejar+V.ele.ACC.3.M.SG+IMP+3+SG
sapeje-os	sapejar+V.ele.ACC.3.M.PL+IMP+3+SG
sapeje-se	sapejar+V.ele.REFL+IMP+3+SG
sapeje-te	sapejar+V.tu.AD.2.SG+IMP+3+SG
sapeje-vos	sapejar+V.vós.AD.2.PL+IMP+3+SG
sapejo-a	sapejar+V.ele.ACC.3.F.SG+PRS+1+SG
sapejo-as	sapejar+V.ele.ACC.3.F.PL+PRS+1+SG
sapejo-lhe	sapejar+V.ele.DAT.3.SG+PRS+1+SG
sapejo-lhes	sapejar+V.ele.DAT.3.PL+PRS+1+SG
sapejo-me	sapejar+V.eu.AD.1.SG+PRS+1+SG
sapejo-nos	sapejar+nós.AD.1.PL+PRS+1+SG
sapejo-o	sapejar+V.ele.ACC.3.M.SG+PRS+1+SG
sapejo-os	sapejar+V.ele.ACC.3.M.PL+PRS+1+SG
sapejo-te	sapejar+V.tu.AD.2.SG+PRS+1+SG
sapejou-a	sapejar+V.ele.ACC.3.F.SG+PRF+3+SG
sapejou-as	sapejar+V.ele.ACC.3.F.PL+PRF+3+SG
sapejou-lhe	sapejar+V.ele.DAT.3.SG+PRF+3+SG
sapejou-lhes	sapejar+V.ele.DAT.3.PL+PRF+3+SG
sapejou-me	sapejar+V.eu.AD.1.SG+PRF+3+SG
sapejou-nos	sapejar+nós.AD.1.PL+PRF+3+SG
sapejou-o	sapejar+V.ele.ACC.3.M.SG+PRF+3+SG
sapejou-os	sapejar+V.ele.ACC.3.M.PL+PRF+3+SG
sapejou-se	sapejar+V.ele.REFL+PRF+3+SG
sapejou-te	sapejar+V.tu.AD.2.SG+PRF+3+SG
sapejou-vos	sapejar+V.vós.AD.2.PL+PRF+3+SG
sapejo-vos	sapejar+V.vós.AD.2.PL+PRS+1+SG
sape-lhe	sapar+V.ele.DAT.3.SG+IMP+3+SG
sape-lhes	sapar+V.ele.DAT.3.PL+IMP+3+SG
sape-me	sapar+V.eu.AD.1.SG+IMP+3+SG
sapem-lhe	sapar+V.ele.DAT.3.SG+IMP+3+PL
sapem-lhes	sapar+V.ele.DAT.3.PL+IMP+3+PL
sapem-me	sapar+V.eu.AD.1.SG+IMP+3+PL
sapem-na	sapar+V.ele.ACC.3.F.SG+IMP+3+PL
sapem-nas	sapar+V.ele.ACC.3.F.PL+IMP+3+PL
sapem-no	sapar+V.ele.ACC.3.M.SG+IMP+3+PL
sapem-nos	sapar+V.ele.ACC.3.M.PL+IMP+3+PL
sapem-nos	sapar+V.nós.AD.1.PL+IMP+3+PL
sapemo-la	sapar+V.ele.ACC.3.F.SG+IMP+1+PL
sapemo-las	sapar+V.ele.ACC.3.F.PL+IMP+1+PL
sapemo-lo	sapar+V.ele.ACC.3.M.SG+IMP+1+PL
sapemo-los	sapar+V.ele.ACC.3.M.PL+IMP+1+PL
sapemo-nos	sapar+nós.AD.1.PL+IMP+1+PL
sapemos-lhe	sapar+V.ele.DAT.3.SG+IMP+1+PL
sapemos-lhes	sapar+V.ele.DAT.3.PL+IMP+1+PL
sapemos-me	sapar+V.eu.AD.1.SG+IMP+1+PL
sapemos-te	sapar+V.tu.AD.2.SG+IMP+1+PL
sapemos-vos	sapar+V.vós.AD.2.PL+IMP+1+PL
sapem-se	sapar+V.ele.REFL+IMP+3+PL
sapem-te	sapar+V.tu.AD.2.SG+IMP+3+PL
sapem-vos	sapar+V.vós.AD.2.PL+IMP+3+PL
sape-nos	sapar+nós.AD.1.PL+IMP+3+SG
sape-o	sapar+V.ele.ACC.3.M.SG+IMP+3+SG
sape-os	sapar+V.ele.ACC.3.M.PL+IMP+3+SG
sapeou-a	sapear+V.ele.ACC.3.F.SG+PRF+3+SG
sapeou-as	sapear+V.ele.ACC.3.F.PL+PRF+3+SG
sapeou-lhe	sapear+V.ele.DAT.3.SG+PRF+3+SG
sapeou-lhes	sapear+V.ele.DAT.3.PL+PRF+3+SG
sapeou-me	sapear+V.eu.AD.1.SG+PRF+3+SG
sapeou-nos	sapear+nós.AD.1.PL+PRF+3+SG
sapeou-o	sapear+V.ele.ACC.3.M.SG+PRF+3+SG
sapeou-os	sapear+V.ele.ACC.3.M.PL+PRF+3+SG
sapeou-se	sapear+V.ele.REFL+PRF+3+SG
sapeou-te	sapear+V.tu.AD.2.SG+PRF+3+SG
sapeou-vos	sapear+V.vós.AD.2.PL+PRF+3+SG
sapeque-a	sapecar+V.ele.ACC.3.F.SG+IMP+3+SG
sapeque-as	sapecar+V.ele.ACC.3.F.PL+IMP+3+SG
sapequei-a	sapecar+V.ele.ACC.3.F.SG+PRF+1+SG
sapequei-as	sapecar+V.ele.ACC.3.F.PL+PRF+1+SG
sapequei-lhe	sapecar+V.ele.DAT.3.SG+PRF+1+SG
sapequei-lhes	sapecar+V.ele.DAT.3.PL+PRF+1+SG
sapequei-me	sapecar+V.eu.AD.1.SG+PRF+1+SG
sapequei-nos	sapecar+nós.AD.1.PL+PRF+1+SG
sapequei-o	sapecar+V.ele.ACC.3.M.SG+PRF+1+SG
sapequei-os	sapecar+V.ele.ACC.3.M.PL+PRF+1+SG
sapequei-te	sapecar+V.tu.AD.2.SG+PRF+1+SG
sapequei-vos	sapecar+V.vós.AD.2.PL+PRF+1+SG
sapeque-lhe	sapecar+V.ele.DAT.3.SG+IMP+3+SG
sapeque-lhes	sapecar+V.ele.DAT.3.PL+IMP+3+SG
sapeque-me	sapecar+V.eu.AD.1.SG+IMP+3+SG
sapequem-lhe	sapecar+V.ele.DAT.3.SG+IMP+3+PL
sapequem-lhes	sapecar+V.ele.DAT.3.PL+IMP+3+PL
sapequem-me	sapecar+V.eu.AD.1.SG+IMP+3+PL
sapequem-na	sapecar+V.ele.ACC.3.F.SG+IMP+3+PL
sapequem-nas	sapecar+V.ele.ACC.3.F.PL+IMP+3+PL
sapequem-no	sapecar+V.ele.ACC.3.M.SG+IMP+3+PL
sapequem-nos	sapecar+V.ele.ACC.3.M.PL+IMP+3+PL
sapequem-nos	sapecar+V.nós.AD.1.PL+IMP+3+PL
sapequemo-la	sapecar+V.ele.ACC.3.F.SG+IMP+1+PL
sapequemo-las	sapecar+V.ele.ACC.3.F.PL+IMP+1+PL
sapequemo-lo	sapecar+V.ele.ACC.3.M.SG+IMP+1+PL
sapequemo-los	sapecar+V.ele.ACC.3.M.PL+IMP+1+PL
sapequemo-nos	sapecar+nós.AD.1.PL+IMP+1+PL
sapequemos-lhe	sapecar+V.ele.DAT.3.SG+IMP+1+PL
sapequemos-lhes	sapecar+V.ele.DAT.3.PL+IMP+1+PL
sapequemos-me	sapecar+V.eu.AD.1.SG+IMP+1+PL
sapequemos-te	sapecar+V.tu.AD.2.SG+IMP+1+PL
sapequemos-vos	sapecar+V.vós.AD.2.PL+IMP+1+PL
sapequem-se	sapecar+V.ele.REFL+IMP+3+PL
sapequem-te	sapecar+V.tu.AD.2.SG+IMP+3+PL
sapequem-vos	sapecar+V.vós.AD.2.PL+IMP+3+PL
sapeque-nos	sapecar+nós.AD.1.PL+IMP+3+SG
sapeque-o	sapecar+V.ele.ACC.3.M.SG+IMP+3+SG
sapeque-os	sapecar+V.ele.ACC.3.M.PL+IMP+3+SG
sapeque-se	sapecar+V.ele.REFL+IMP+3+SG
sapeque-te	sapecar+V.tu.AD.2.SG+IMP+3+SG
sapeque-vos	sapecar+V.vós.AD.2.PL+IMP+3+SG
sape-se	sapar+V.ele.REFL+IMP+3+SG
sape-te	sapar+V.tu.AD.2.SG+IMP+3+SG
sape-vos	sapar+V.vós.AD.2.PL+IMP+3+SG
sapo-a	sapar+V.ele.ACC.3.F.SG+PRS+1+SG
sapo-as	sapar+V.ele.ACC.3.F.PL+PRS+1+SG
sapo-lhe	sapar+V.ele.DAT.3.SG+PRS+1+SG
sapo-lhes	sapar+V.ele.DAT.3.PL+PRS+1+SG
sapo-me	sapar+V.eu.AD.1.SG+PRS+1+SG
saponifica-a	saponificar+V.ele.ACC.3.F.SG+PRS+3+SG
saponifica-as	saponificar+V.ele.ACC.3.F.PL+PRS+3+SG
saponificai-la	saponificar+V.ele.ACC.3.F.SG+PRS+2+PL
saponificai-las	saponificar+V.ele.ACC.3.F.PL+PRS+2+PL
saponificai-lo	saponificar+V.ele.ACC.3.M.SG+PRS+2+PL
saponificai-los	saponificar+V.ele.ACC.3.M.PL+PRS+2+PL
saponificai-nos	saponificar+nós.AD.1.PL+PRS+2+PL
saponificais-lhe	saponificar+V.ele.DAT.3.SG+PRS+2+PL
saponificais-lhes	saponificar+V.ele.DAT.3.PL+PRS+2+PL
saponificais-me	saponificar+V.eu.AD.1.SG+PRS+2+PL
saponificais-te	saponificar+V.tu.AD.2.SG+PRS+2+PL
saponificais-vos	saponificar+V.vós.AD.2.PL+PRS+2+PL
saponificá-la-ão	saponificar+V.ele.ACC.3.F.SG+FUT+3+PL
saponificá-la-á	saponificar+V.ele.ACC.3.F.SG+FUT+3+SG
saponificá-la-ás	saponificar+V.ele.ACC.3.F.SG+FUT+2+SG
saponificá-la-ei	saponificar+V.ele.ACC.3.F.SG+FUT+1+SG
saponificá-la-eis	saponificar+V.ele.ACC.3.F.SG+FUT+2+PL
saponificá-la-emos	saponificar+V.ele.ACC.3.F.SG+FUT+1+PL
saponificá-la-íamos	saponificar+V.ele.ACC.3.F.SG+COND+1+PL
saponificá-la-iam	saponificar+V.ele.ACC.3.F.SG+COND+3+PL
saponificá-la-ia	saponificar+V.ele.ACC.3.F.SG+COND+1+SG
saponificá-la-ia	saponificar+V.ele.ACC.3.F.SG+COND+3+SG
saponificá-la-ias	saponificar+V.ele.ACC.3.F.SG+COND+2+SG
saponificá-la-íeis	saponificar+V.ele.ACC.3.F.SG+COND+2+PL
saponificá-las-ão	saponificar+V.ele.ACC.3.F.PL+FUT+3+PL
saponificá-la	saponificar+V.ele.ACC.3.F.SG+INF+1+SG
saponificá-la	saponificar+V.ele.ACC.3.F.SG+INF+3+SG
saponifica-la	saponificar+V.ele.ACC.3.F.SG+PRS+2+SG
saponificá-la	saponificar+V.ele.ACC.3.F.SG+SBJF+1+SG
saponificá-la	saponificar+V.ele.ACC.3.F.SG+SBJF+3+SG
saponificá-las-á	saponificar+V.ele.ACC.3.F.PL+FUT+3+SG
saponificá-las-ás	saponificar+V.ele.ACC.3.F.PL+FUT+2+SG
saponificá-las-ei	saponificar+V.ele.ACC.3.F.PL+FUT+1+SG
saponificá-las-eis	saponificar+V.ele.ACC.3.F.PL+FUT+2+PL
saponificá-las-emos	saponificar+V.ele.ACC.3.F.PL+FUT+1+PL
saponificá-las-íamos	saponificar+V.ele.ACC.3.F.PL+COND+1+PL
saponificá-las-iam	saponificar+V.ele.ACC.3.F.PL+COND+3+PL
saponificá-las-ia	saponificar+V.ele.ACC.3.F.PL+COND+1+SG
saponificá-las-ia	saponificar+V.ele.ACC.3.F.PL+COND+3+SG
saponificá-las-ias	saponificar+V.ele.ACC.3.F.PL+COND+2+SG
saponificá-las-íeis	saponificar+V.ele.ACC.3.F.PL+COND+2+PL
saponificá-las	saponificar+V.ele.ACC.3.F.PL+INF+1+SG
saponificá-las	saponificar+V.ele.ACC.3.F.PL+INF+3+SG
saponifica-las	saponificar+V.ele.ACC.3.F.PL+PRS+2+SG
saponificá-las	saponificar+V.ele.ACC.3.F.PL+SBJF+1+SG
saponificá-las	saponificar+V.ele.ACC.3.F.PL+SBJF+3+SG
saponifica-lhe	saponificar+V.ele.DAT.3.SG+PRS+3+SG
saponifica-lhes	saponificar+V.ele.DAT.3.PL+PRS+3+SG
saponificá-lo-ão	saponificar+V.ele.ACC.3.M.SG+FUT+3+PL
saponificá-lo-á	saponificar+V.ele.ACC.3.M.SG+FUT+3+SG
saponificá-lo-ás	saponificar+V.ele.ACC.3.M.SG+FUT+2+SG
saponificá-lo-ei	saponificar+V.ele.ACC.3.M.SG+FUT+1+SG
saponificá-lo-eis	saponificar+V.ele.ACC.3.M.SG+FUT+2+PL
saponificá-lo-emos	saponificar+V.ele.ACC.3.M.SG+FUT+1+PL
saponificá-lo-íamos	saponificar+V.ele.ACC.3.M.SG+COND+1+PL
saponificá-lo-iam	saponificar+V.ele.ACC.3.M.SG+COND+3+PL
saponificá-lo-ia	saponificar+V.ele.ACC.3.M.SG+COND+1+SG
saponificá-lo-ia	saponificar+V.ele.ACC.3.M.SG+COND+3+SG
saponificá-lo-ias	saponificar+V.ele.ACC.3.M.SG+COND+2+SG
saponificá-lo-íeis	saponificar+V.ele.ACC.3.M.SG+COND+2+PL
saponificá-los-ão	saponificar+V.ele.ACC.3.M.PL+FUT+3+PL
saponificá-lo	saponificar+V.ele.ACC.3.M.SG+INF+1+SG
saponificá-lo	saponificar+V.ele.ACC.3.M.SG+INF+3+SG
saponifica-lo	saponificar+V.ele.ACC.3.M.SG+PRS+2+SG
saponificá-lo	saponificar+V.ele.ACC.3.M.SG+SBJF+1+SG
saponificá-lo	saponificar+V.ele.ACC.3.M.SG+SBJF+3+SG
saponificá-los-á	saponificar+V.ele.ACC.3.M.PL+FUT+3+SG
saponificá-los-ás	saponificar+V.ele.ACC.3.M.PL+FUT+2+SG
saponificá-los-ei	saponificar+V.ele.ACC.3.M.PL+FUT+1+SG
saponificá-los-eis	saponificar+V.ele.ACC.3.M.PL+FUT+2+PL
saponificá-los-emos	saponificar+V.ele.ACC.3.M.PL+FUT+1+PL
saponificá-los-íamos	saponificar+V.ele.ACC.3.M.PL+COND+1+PL
saponificá-los-iam	saponificar+V.ele.ACC.3.M.PL+COND+3+PL
saponificá-los-ia	saponificar+V.ele.ACC.3.M.PL+COND+1+SG
saponificá-los-ia	saponificar+V.ele.ACC.3.M.PL+COND+3+SG
saponificá-los-ias	saponificar+V.ele.ACC.3.M.PL+COND+2+SG
saponificá-los-íeis	saponificar+V.ele.ACC.3.M.PL+COND+2+PL
saponificá-los	saponificar+V.ele.ACC.3.M.PL+INF+1+SG
saponificá-los	saponificar+V.ele.ACC.3.M.PL+INF+3+SG
saponifica-los	saponificar+V.ele.ACC.3.M.PL+PRS+2+SG
saponificá-los	saponificar+V.ele.ACC.3.M.PL+SBJF+1+SG
saponificá-los	saponificar+V.ele.ACC.3.M.PL+SBJF+3+SG
saponifica-me	saponificar+V.eu.AD.1.SG+PRS+3+SG
saponificam-lhe	saponificar+V.ele.DAT.3.SG+PRS+3+PL
saponificam-lhes	saponificar+V.ele.DAT.3.PL+PRS+3+PL
saponificam-me	saponificar+V.eu.AD.1.SG+PRS+3+PL
saponificam-na	saponificar+V.ele.ACC.3.F.SG+PRS+3+PL
saponificam-nas	saponificar+V.ele.ACC.3.F.PL+PRS+3+PL
saponificam-no	saponificar+V.ele.ACC.3.M.SG+PRS+3+PL
saponificam-nos	saponificar+V.ele.ACC.3.M.PL+PRS+3+PL
saponificam-nos	saponificar+V.nós.AD.1.PL+PRS+3+PL
saponificamo-la	saponificar+V.ele.ACC.3.F.SG+PRF+1+PL
saponificamo-la	saponificar+V.ele.ACC.3.F.SG+PRS+1+PL
saponificamo-las	saponificar+V.ele.ACC.3.F.PL+PRF+1+PL
saponificamo-las	saponificar+V.ele.ACC.3.F.PL+PRS+1+PL
saponificamo-lo	saponificar+V.ele.ACC.3.M.SG+PRF+1+PL
saponificamo-lo	saponificar+V.ele.ACC.3.M.SG+PRS+1+PL
saponificamo-los	saponificar+V.ele.ACC.3.M.PL+PRF+1+PL
saponificamo-los	saponificar+V.ele.ACC.3.M.PL+PRS+1+PL
saponificamo-nos	saponificar+nós.AD.1.PL+PRF+1+PL
saponificamo-nos	saponificar+nós.AD.1.PL+PRS+1+PL
saponificamos-lhe	saponificar+V.ele.DAT.3.SG+PRF+1+PL
saponificamos-lhe	saponificar+V.ele.DAT.3.SG+PRS+1+PL
saponificamos-lhes	saponificar+V.ele.DAT.3.PL+PRF+1+PL
saponificamos-lhes	saponificar+V.ele.DAT.3.PL+PRS+1+PL
saponificamos-me	saponificar+V.eu.AD.1.SG+PRF+1+PL
saponificamos-me	saponificar+V.eu.AD.1.SG+PRS+1+PL
saponificamos-te	saponificar+V.tu.AD.2.SG+PRF+1+PL
saponificamos-te	saponificar+V.tu.AD.2.SG+PRS+1+PL
saponificamos-vos	saponificar+V.vós.AD.2.PL+PRF+1+PL
saponificamos-vos	saponificar+V.vós.AD.2.PL+PRS+1+PL
saponificam-se	saponificar+V.ele.REFL+PRS+3+PL
saponificam-te	saponificar+V.tu.AD.2.SG+PRS+3+PL
saponificam-vos	saponificar+V.vós.AD.2.PL+PRS+3+PL
saponificando-a	saponificar+V.ele.ACC.3.F.SG+GRD
saponificando-as	saponificar+V.ele.ACC.3.F.PL+GRD
saponificando-lhe	saponificar+V.ele.DAT.3.SG+GRD
saponificando-lhes	saponificar+V.ele.DAT.3.PL+GRD
saponificando-me	saponificar+V.eu.AD.1.SG+GRD
saponificando-nos	saponificar+nós.AD.1.PL+GRD
saponificando-o	saponificar+V.ele.ACC.3.M.SG+GRD
saponificando-os	saponificar+V.ele.ACC.3.M.PL+GRD
saponificando-se	saponificar+V.ele.REFL+GRD
saponificando-te	saponificar+V.tu.AD.2.SG+GRD
saponificando-vos	saponificar+V.vós.AD.2.PL+GRD
saponifica-nos	saponificar+nós.AD.1.PL+PRS+2+SG
saponifica-nos	saponificar+nós.AD.1.PL+PRS+3+SG
saponifica-o	saponificar+V.ele.ACC.3.M.SG+PRS+3+SG
saponifica-os	saponificar+V.ele.ACC.3.M.PL+PRS+3+SG
saponificara-a	saponificar+V.ele.ACC.3.F.SG+PQP+1+SG
saponificara-a	saponificar+V.ele.ACC.3.F.SG+PQP+3+SG
saponificara-as	saponificar+V.ele.ACC.3.F.PL+PQP+1+SG
saponificara-as	saponificar+V.ele.ACC.3.F.PL+PQP+3+SG
saponificara-la	saponificar+V.ele.ACC.3.F.SG+PQP+2+SG
saponificara-las	saponificar+V.ele.ACC.3.F.PL+PQP+2+SG
saponificara-lhe	saponificar+V.ele.DAT.3.SG+PQP+1+SG
saponificara-lhe	saponificar+V.ele.DAT.3.SG+PQP+3+SG
saponificara-lhes	saponificar+V.ele.DAT.3.PL+PQP+1+SG
saponificara-lhes	saponificar+V.ele.DAT.3.PL+PQP+3+SG
saponificara-lo	saponificar+V.ele.ACC.3.M.SG+PQP+2+SG
saponificara-los	saponificar+V.ele.ACC.3.M.PL+PQP+2+SG
saponificara-me	saponificar+V.eu.AD.1.SG+PQP+1+SG
saponificara-me	saponificar+V.eu.AD.1.SG+PQP+3+SG
saponificaram-lhe	saponificar+V.ele.DAT.3.SG+PQP+3+PL
saponificaram-lhe	saponificar+V.ele.DAT.3.SG+PRF+3+PL
saponificaram-lhes	saponificar+V.ele.DAT.3.PL+PQP+3+PL
saponificaram-lhes	saponificar+V.ele.DAT.3.PL+PRF+3+PL
saponificaram-me	saponificar+V.eu.AD.1.SG+PQP+3+PL
saponificaram-me	saponificar+V.eu.AD.1.SG+PRF+3+PL
saponificaram-na	saponificar+V.ele.ACC.3.F.SG+PQP+3+PL
saponificaram-na	saponificar+V.ele.ACC.3.F.SG+PRF+3+PL
saponificaram-nas	saponificar+V.ele.ACC.3.F.PL+PQP+3+PL
saponificaram-nas	saponificar+V.ele.ACC.3.F.PL+PRF+3+PL
saponificaram-no	saponificar+V.ele.ACC.3.M.SG+PQP+3+PL
saponificaram-no	saponificar+V.ele.ACC.3.M.SG+PRF+3+PL
saponificaram-nos	saponificar+V.ele.ACC.3.M.PL+PQP+3+PL
saponificaram-nos	saponificar+V.ele.ACC.3.M.PL+PRF+3+PL
saponificaram-nos	saponificar+V.nós.AD.1.PL+PQP+3+PL
saponificaram-nos	saponificar+V.nós.AD.1.PL+PRF+3+PL
saponificáramo-la	saponificar+V.ele.ACC.3.F.SG+PQP+1+PL
saponificáramo-las	saponificar+V.ele.ACC.3.F.PL+PQP+1+PL
saponificáramo-lo	saponificar+V.ele.ACC.3.M.SG+PQP+1+PL
saponificáramo-los	saponificar+V.ele.ACC.3.M.PL+PQP+1+PL
saponificáramo-nos	saponificar+nós.AD.1.PL+PQP+1+PL
saponificáramos-lhe	saponificar+V.ele.DAT.3.SG+PQP+1+PL
saponificáramos-lhes	saponificar+V.ele.DAT.3.PL+PQP+1+PL
saponificáramos-me	saponificar+V.eu.AD.1.SG+PQP+1+PL
saponificáramos-te	saponificar+V.tu.AD.2.SG+PQP+1+PL
saponificáramos-vos	saponificar+V.vós.AD.2.PL+PQP+1+PL
saponificaram-se	saponificar+V.ele.REFL+PQP+3+PL
saponificaram-se	saponificar+V.ele.REFL+PRF+3+PL
saponificaram-te	saponificar+V.tu.AD.2.SG+PQP+3+PL
saponificaram-te	saponificar+V.tu.AD.2.SG+PRF+3+PL
saponificaram-vos	saponificar+V.vós.AD.2.PL+PQP+3+PL
saponificaram-vos	saponificar+V.vós.AD.2.PL+PRF+3+PL
saponificara-nos	saponificar+nós.AD.1.PL+PQP+1+SG
saponificara-nos	saponificar+nós.AD.1.PL+PQP+2+SG
saponificara-nos	saponificar+nós.AD.1.PL+PQP+3+SG
saponificara-o	saponificar+V.ele.ACC.3.M.SG+PQP+1+SG
saponificara-o	saponificar+V.ele.ACC.3.M.SG+PQP+3+SG
saponificara-os	saponificar+V.ele.ACC.3.M.PL+PQP+1+SG
saponificara-os	saponificar+V.ele.ACC.3.M.PL+PQP+3+SG
saponificara-se	saponificar+V.ele.REFL+PQP+1+SG
saponificara-se	saponificar+V.ele.REFL+PQP+3+SG
saponificaras-lhe	saponificar+V.ele.DAT.3.SG+PQP+2+SG
saponificaras-lhes	saponificar+V.ele.DAT.3.PL+PQP+2+SG
saponificaras-me	saponificar+V.eu.AD.1.SG+PQP+2+SG
saponificaras-te	saponificar+V.tu.AD.2.SG+PQP+2+SG
saponificaras-vos	saponificar+V.vós.AD.2.PL+PQP+2+SG
saponificara-te	saponificar+V.tu.AD.2.SG+PQP+1+SG
saponificara-te	saponificar+V.tu.AD.2.SG+PQP+3+SG
saponificara-vos	saponificar+V.vós.AD.2.PL+PQP+1+SG
saponificara-vos	saponificar+V.vós.AD.2.PL+PQP+3+SG
saponificarde-la	saponificar+V.ele.ACC.3.F.SG+INF+2+PL
saponificarde-la	saponificar+V.ele.ACC.3.F.SG+SBJF+2+PL
saponificarde-las	saponificar+V.ele.ACC.3.F.PL+INF+2+PL
saponificarde-las	saponificar+V.ele.ACC.3.F.PL+SBJF+2+PL
saponificarde-lo	saponificar+V.ele.ACC.3.M.SG+INF+2+PL
saponificarde-lo	saponificar+V.ele.ACC.3.M.SG+SBJF+2+PL
saponificarde-los	saponificar+V.ele.ACC.3.M.PL+INF+2+PL
saponificarde-los	saponificar+V.ele.ACC.3.M.PL+SBJF+2+PL
saponificarde-nos	saponificar+nós.AD.1.PL+INF+2+PL
saponificarde-nos	saponificar+nós.AD.1.PL+SBJF+2+PL
saponificardes-lhe	saponificar+V.ele.DAT.3.SG+INF+2+PL
saponificardes-lhe	saponificar+V.ele.DAT.3.SG+SBJF+2+PL
saponificardes-lhes	saponificar+V.ele.DAT.3.PL+INF+2+PL
saponificardes-lhes	saponificar+V.ele.DAT.3.PL+SBJF+2+PL
saponificardes-me	saponificar+V.eu.AD.1.SG+INF+2+PL
saponificardes-me	saponificar+V.eu.AD.1.SG+SBJF+2+PL
saponificardes-te	saponificar+V.tu.AD.2.SG+INF+2+PL
saponificardes-te	saponificar+V.tu.AD.2.SG+SBJF+2+PL
saponificardes-vos	saponificar+V.vós.AD.2.PL+INF+2+PL
saponificardes-vos	saponificar+V.vós.AD.2.PL+SBJF+2+PL
saponificárei-la	saponificar+V.ele.ACC.3.F.SG+PQP+2+PL
saponificárei-las	saponificar+V.ele.ACC.3.F.PL+PQP+2+PL
saponificárei-lo	saponificar+V.ele.ACC.3.M.SG+PQP+2+PL
saponificárei-los	saponificar+V.ele.ACC.3.M.PL+PQP+2+PL
saponificárei-nos	saponificar+nós.AD.1.PL+PQP+2+PL
saponificáreis-lhe	saponificar+V.ele.DAT.3.SG+PQP+2+PL
saponificáreis-lhes	saponificar+V.ele.DAT.3.PL+PQP+2+PL
saponificáreis-me	saponificar+V.eu.AD.1.SG+PQP+2+PL
saponificáreis-te	saponificar+V.tu.AD.2.SG+PQP+2+PL
saponificáreis-vos	saponificar+V.vós.AD.2.PL+PQP+2+PL
saponificare-la	saponificar+V.ele.ACC.3.F.SG+INF+2+SG
saponificare-la	saponificar+V.ele.ACC.3.F.SG+SBJF+2+SG
saponificare-las	saponificar+V.ele.ACC.3.F.PL+INF+2+SG
saponificare-las	saponificar+V.ele.ACC.3.F.PL+SBJF+2+SG
saponificare-lo	saponificar+V.ele.ACC.3.M.SG+INF+2+SG
saponificare-lo	saponificar+V.ele.ACC.3.M.SG+SBJF+2+SG
saponificare-los	saponificar+V.ele.ACC.3.M.PL+INF+2+SG
saponificare-los	saponificar+V.ele.ACC.3.M.PL+SBJF+2+SG
saponificarem-lhe	saponificar+V.ele.DAT.3.SG+INF+3+PL
saponificarem-lhe	saponificar+V.ele.DAT.3.SG+SBJF+3+PL
saponificarem-lhes	saponificar+V.ele.DAT.3.PL+INF+3+PL
saponificarem-lhes	saponificar+V.ele.DAT.3.PL+SBJF+3+PL
saponificarem-me	saponificar+V.eu.AD.1.SG+INF+3+PL
saponificarem-me	saponificar+V.eu.AD.1.SG+SBJF+3+PL
saponificarem-na	saponificar+V.ele.ACC.3.F.SG+INF+3+PL
saponificarem-na	saponificar+V.ele.ACC.3.F.SG+SBJF+3+PL
saponificarem-nas	saponificar+V.ele.ACC.3.F.PL+INF+3+PL
saponificarem-nas	saponificar+V.ele.ACC.3.F.PL+SBJF+3+PL
saponificarem-no	saponificar+V.ele.ACC.3.M.SG+INF+3+PL
saponificarem-no	saponificar+V.ele.ACC.3.M.SG+SBJF+3+PL
saponificarem-nos	saponificar+V.ele.ACC.3.M.PL+INF+3+PL
saponificarem-nos	saponificar+V.ele.ACC.3.M.PL+SBJF+3+PL
saponificarem-nos	saponificar+V.nós.AD.1.PL+INF+3+PL
saponificarem-nos	saponificar+V.nós.AD.1.PL+SBJF+3+PL
saponificarem-se	saponificar+V.ele.REFL+INF+3+PL
saponificarem-se	saponificar+V.ele.REFL+SBJF+3+PL
saponificarem-te	saponificar+V.tu.AD.2.SG+INF+3+PL
saponificarem-te	saponificar+V.tu.AD.2.SG+SBJF+3+PL
saponificarem-vos	saponificar+V.vós.AD.2.PL+INF+3+PL
saponificarem-vos	saponificar+V.vós.AD.2.PL+SBJF+3+PL
saponificare-nos	saponificar+nós.AD.1.PL+INF+2+SG
saponificare-nos	saponificar+nós.AD.1.PL+SBJF+2+SG
saponificares-lhe	saponificar+V.ele.DAT.3.SG+INF+2+SG
saponificares-lhe	saponificar+V.ele.DAT.3.SG+SBJF+2+SG
saponificares-lhes	saponificar+V.ele.DAT.3.PL+INF+2+SG
saponificares-lhes	saponificar+V.ele.DAT.3.PL+SBJF+2+SG
saponificares-me	saponificar+V.eu.AD.1.SG+INF+2+SG
saponificares-me	saponificar+V.eu.AD.1.SG+SBJF+2+SG
saponificares-te	saponificar+V.tu.AD.2.SG+INF+2+SG
saponificares-te	saponificar+V.tu.AD.2.SG+SBJF+2+SG
saponificares-vos	saponificar+V.vós.AD.2.PL+INF+2+SG
saponificares-vos	saponificar+V.vós.AD.2.PL+SBJF+2+SG
saponificar-lhe-ão	saponificar+V.ele.DAT.3.SG+FUT+3+PL
saponificar-lhe-á	saponificar+V.ele.DAT.3.SG+FUT+3+SG
saponificar-lhe-ás	saponificar+V.ele.DAT.3.SG+FUT+2+SG
saponificar-lhe-ei	saponificar+V.ele.DAT.3.SG+FUT+1+SG
saponificar-lhe-eis	saponificar+V.ele.DAT.3.SG+FUT+2+PL
saponificar-lhe-emos	saponificar+V.ele.DAT.3.SG+FUT+1+PL
saponificar-lhe-íamos	saponificar+V.ele.DAT.3.SG+COND+1+PL
saponificar-lhe-iam	saponificar+V.ele.DAT.3.SG+COND+3+PL
saponificar-lhe-ia	saponificar+V.ele.DAT.3.SG+COND+1+SG
saponificar-lhe-ia	saponificar+V.ele.DAT.3.SG+COND+3+SG
saponificar-lhe-ias	saponificar+V.ele.DAT.3.SG+COND+2+SG
saponificar-lhe-íeis	saponificar+V.ele.DAT.3.SG+COND+2+PL
saponificar-lhes-ão	saponificar+V.ele.DAT.3.PL+FUT+3+PL
saponificar-lhe	saponificar+V.ele.DAT.3.SG+INF
saponificar-lhe	saponificar+V.ele.DAT.3.SG+INF+1+SG
saponificar-lhe	saponificar+V.ele.DAT.3.SG+INF+3+SG
saponificar-lhe	saponificar+V.ele.DAT.3.SG+SBJF+1+SG
saponificar-lhe	saponificar+V.ele.DAT.3.SG+SBJF+3+SG
saponificar-lhes-á	saponificar+V.ele.DAT.3.PL+FUT+3+SG
saponificar-lhes-ás	saponificar+V.ele.DAT.3.PL+FUT+2+SG
saponificar-lhes-ei	saponificar+V.ele.DAT.3.PL+FUT+1+SG
saponificar-lhes-eis	saponificar+V.ele.DAT.3.PL+FUT+2+PL
saponificar-lhes-emos	saponificar+V.ele.DAT.3.PL+FUT+1+PL
saponificar-lhes-íamos	saponificar+V.ele.DAT.3.PL+COND+1+PL
saponificar-lhes-iam	saponificar+V.ele.DAT.3.PL+COND+3+PL
saponificar-lhes-ia	saponificar+V.ele.DAT.3.PL+COND+1+SG
saponificar-lhes-ia	saponificar+V.ele.DAT.3.PL+COND+3+SG
saponificar-lhes-ias	saponificar+V.ele.DAT.3.PL+COND+2+SG
saponificar-lhes-íeis	saponificar+V.ele.DAT.3.PL+COND+2+PL
saponificar-lhes	saponificar+V.ele.DAT.3.PL+INF
saponificar-lhes	saponificar+V.ele.DAT.3.PL+INF+1+SG
saponificar-lhes	saponificar+V.ele.DAT.3.PL+INF+3+SG
saponificar-lhes	saponificar+V.ele.DAT.3.PL+SBJF+1+SG
saponificar-lhes	saponificar+V.ele.DAT.3.PL+SBJF+3+SG
saponificar-me-ão	saponificar+V.eu.AD.1.SG+FUT+3+PL
saponificar-me-á	saponificar+V.eu.AD.1.SG+FUT+3+SG
saponificar-me-ás	saponificar+V.eu.AD.1.SG+FUT+2+SG
saponificar-me-ei	saponificar+V.eu.AD.1.SG+FUT+1+SG
saponificar-me-eis	saponificar+V.eu.AD.1.SG+FUT+2+PL
saponificar-me-emos	saponificar+V.eu.AD.1.SG+FUT+1+PL
saponificar-me-íamos	saponificar+V.eu.AD.1.SG+COND+1+PL
saponificar-me-iam	saponificar+V.eu.AD.1.SG+COND+3+PL
saponificar-me-ia	saponificar+V.eu.AD.1.SG+COND+1+SG
saponificar-me-ia	saponificar+V.eu.AD.1.SG+COND+3+SG
saponificar-me-ias	saponificar+V.eu.AD.1.SG+COND+2+SG
saponificar-me-íeis	saponificar+V.eu.AD.1.SG+COND+2+PL
saponificar-me	saponificar+V.eu.AD.1.SG+INF
saponificar-me	saponificar+V.eu.AD.1.SG+INF+1+SG
saponificar-me	saponificar+V.eu.AD.1.SG+INF+3+SG
saponificar-me	saponificar+V.eu.AD.1.SG+SBJF+1+SG
saponificar-me	saponificar+V.eu.AD.1.SG+SBJF+3+SG
saponificarmo-la	saponificar+V.ele.ACC.3.F.SG+INF+1+PL
saponificarmo-la	saponificar+V.ele.ACC.3.F.SG+SBJF+1+PL
saponificarmo-las	saponificar+V.ele.ACC.3.F.PL+INF+1+PL
saponificarmo-las	saponificar+V.ele.ACC.3.F.PL+SBJF+1+PL
saponificarmo-lo	saponificar+V.ele.ACC.3.M.SG+INF+1+PL
saponificarmo-lo	saponificar+V.ele.ACC.3.M.SG+SBJF+1+PL
saponificarmo-los	saponificar+V.ele.ACC.3.M.PL+INF+1+PL
saponificarmo-los	saponificar+V.ele.ACC.3.M.PL+SBJF+1+PL
saponificarmo-nos	saponificar+nós.AD.1.PL+INF+1+PL
saponificarmo-nos	saponificar+nós.AD.1.PL+SBJF+1+PL
saponificarmos-lhe	saponificar+V.ele.DAT.3.SG+INF+1+PL
saponificarmos-lhe	saponificar+V.ele.DAT.3.SG+SBJF+1+PL
saponificarmos-lhes	saponificar+V.ele.DAT.3.PL+INF+1+PL
saponificarmos-lhes	saponificar+V.ele.DAT.3.PL+SBJF+1+PL
saponificarmos-me	saponificar+V.eu.AD.1.SG+INF+1+PL
saponificarmos-me	saponificar+V.eu.AD.1.SG+SBJF+1+PL
saponificarmos-te	saponificar+V.tu.AD.2.SG+INF+1+PL
saponificarmos-te	saponificar+V.tu.AD.2.SG+SBJF+1+PL
saponificarmos-vos	saponificar+V.vós.AD.2.PL+INF+1+PL
saponificarmos-vos	saponificar+V.vós.AD.2.PL+SBJF+1+PL
saponificar-nos-ão	saponificar+nós.AD.1.PL+FUT+3+PL
saponificar-nos-á	saponificar+nós.AD.1.PL+FUT+3+SG
saponificar-nos-ás	saponificar+nós.AD.1.PL+FUT+2+SG
saponificar-nos-ei	saponificar+nós.AD.1.PL+FUT+1+SG
saponificar-nos-eis	saponificar+nós.AD.1.PL+FUT+2+PL
saponificar-nos-emos	saponificar+nós.AD.1.PL+FUT+1+PL
saponificar-nos-íamos	saponificar+nós.AD.1.PL+COND+1+PL
saponificar-nos-iam	saponificar+nós.AD.1.PL+COND+3+PL
saponificar-nos-ia	saponificar+nós.AD.1.PL+COND+1+SG
saponificar-nos-ia	saponificar+nós.AD.1.PL+COND+3+SG
saponificar-nos-ias	saponificar+nós.AD.1.PL+COND+2+SG
saponificar-nos-íeis	saponificar+nós.AD.1.PL+COND+2+PL
saponificar-nos	saponificar+nós.AD.1.PL+INF
saponificar-nos	saponificar+nós.AD.1.PL+INF+1+SG
saponificar-nos	saponificar+nós.AD.1.PL+INF+3+SG
saponificar-nos	saponificar+nós.AD.1.PL+SBJF+1+SG
saponificar-nos	saponificar+nós.AD.1.PL+SBJF+3+SG
saponificar-se-ão	saponificar+V.ele.REFL+FUT+3+PL
saponificar-se-á	saponificar+V.ele.REFL+FUT+3+SG
saponificar-se-iam	saponificar+V.ele.REFL+COND+3+PL
saponificar-se-ia	saponificar+V.ele.REFL+COND+3+SG
saponificar-se	saponificar+V.ele.REFL+INF
saponificar-se	saponificar+V.ele.REFL+INF+3+SG
saponificar-se	saponificar+V.ele.REFL+SBJF+3+SG
saponificar-te-ão	saponificar+V.tu.AD.2.SG+FUT+3+PL
saponificar-te-á	saponificar+V.tu.AD.2.SG+FUT+3+SG
saponificar-te-ás	saponificar+V.tu.AD.2.SG+FUT+2+SG
saponificar-te-ei	saponificar+V.tu.AD.2.SG+FUT+1+SG
saponificar-te-eis	saponificar+V.tu.AD.2.SG+FUT+2+PL
saponificar-te-emos	saponificar+V.tu.AD.2.SG+FUT+1+PL
saponificar-te-íamos	saponificar+V.tu.AD.2.SG+COND+1+PL
saponificar-te-iam	saponificar+V.tu.AD.2.SG+COND+3+PL
saponificar-te-ia	saponificar+V.tu.AD.2.SG+COND+1+SG
saponificar-te-ia	saponificar+V.tu.AD.2.SG+COND+3+SG
saponificar-te-ias	saponificar+V.tu.AD.2.SG+COND+2+SG
saponificar-te-íeis	saponificar+V.tu.AD.2.SG+COND+2+PL
saponificar-te	saponificar+V.tu.AD.2.SG+INF
saponificar-te	saponificar+V.tu.AD.2.SG+INF+1+SG
saponificar-te	saponificar+V.tu.AD.2.SG+INF+3+SG
saponificar-te	saponificar+V.tu.AD.2.SG+SBJF+1+SG
saponificar-te	saponificar+V.tu.AD.2.SG+SBJF+3+SG
saponificar-vos-ão	saponificar+V.vós.AD.2.PL+FUT+3+PL
saponificar-vos-á	saponificar+V.vós.AD.2.PL+FUT+3+SG
saponificar-vos-ás	saponificar+V.vós.AD.2.PL+FUT+2+SG
saponificar-vos-ei	saponificar+V.vós.AD.2.PL+FUT+1+SG
saponificar-vos-eis	saponificar+V.vós.AD.2.PL+FUT+2+PL
saponificar-vos-emos	saponificar+V.vós.AD.2.PL+FUT+1+PL
saponificar-vos-íamos	saponificar+V.vós.AD.2.PL+COND+1+PL
saponificar-vos-iam	saponificar+V.vós.AD.2.PL+COND+3+PL
saponificar-vos-ia	saponificar+V.vós.AD.2.PL+COND+1+SG
saponificar-vos-ia	saponificar+V.vós.AD.2.PL+COND+3+SG
saponificar-vos-ias	saponificar+V.vós.AD.2.PL+COND+2+SG
saponificar-vos-íeis	saponificar+V.vós.AD.2.PL+COND+2+PL
saponificar-vos	saponificar+V.vós.AD.2.PL+INF
saponificar-vos	saponificar+V.vós.AD.2.PL+INF+1+SG
saponificar-vos	saponificar+V.vós.AD.2.PL+INF+3+SG
saponificar-vos	saponificar+V.vós.AD.2.PL+SBJF+1+SG
saponificar-vos	saponificar+V.vós.AD.2.PL+SBJF+3+SG
saponifica-se	saponificar+V.ele.REFL+PRS+3+SG
saponificas-lhe	saponificar+V.ele.DAT.3.SG+PRS+2+SG
saponificas-lhes	saponificar+V.ele.DAT.3.PL+PRS+2+SG
saponificas-me	saponificar+V.eu.AD.1.SG+PRS+2+SG
saponificaste-la	saponificar+V.ele.ACC.3.F.SG+PRF+2+PL
saponificaste-las	saponificar+V.ele.ACC.3.F.PL+PRF+2+PL
saponificaste-lo	saponificar+V.ele.ACC.3.M.SG+PRF+2+PL
saponificaste-los	saponificar+V.ele.ACC.3.M.PL+PRF+2+PL
saponificaste-nos	saponificar+nós.AD.1.PL+PRF+2+PL
saponificas-te	saponificar+V.tu.AD.2.SG+PRS+2+SG
saponificastes-lhe	saponificar+V.ele.DAT.3.SG+PRF+2+PL
saponificastes-lhes	saponificar+V.ele.DAT.3.PL+PRF+2+PL
saponificastes-me	saponificar+V.eu.AD.1.SG+PRF+2+PL
saponificastes-te	saponificar+V.tu.AD.2.SG+PRF+2+PL
saponificastes-vos	saponificar+V.vós.AD.2.PL+PRF+2+PL
saponificas-vos	saponificar+V.vós.AD.2.PL+PRS+2+SG
saponifica-te	saponificar+V.tu.AD.2.SG+PRS+3+SG
saponificava-a	saponificar+V.ele.ACC.3.F.SG+IMPF+1+SG
saponificava-a	saponificar+V.ele.ACC.3.F.SG+IMPF+3+SG
saponificava-as	saponificar+V.ele.ACC.3.F.PL+IMPF+1+SG
saponificava-as	saponificar+V.ele.ACC.3.F.PL+IMPF+3+SG
saponificava-la	saponificar+V.ele.ACC.3.F.SG+IMPF+2+SG
saponificava-las	saponificar+V.ele.ACC.3.F.PL+IMPF+2+SG
saponificava-lhe	saponificar+V.ele.DAT.3.SG+IMPF+1+SG
saponificava-lhe	saponificar+V.ele.DAT.3.SG+IMPF+3+SG
saponificava-lhes	saponificar+V.ele.DAT.3.PL+IMPF+1+SG
saponificava-lhes	saponificar+V.ele.DAT.3.PL+IMPF+3+SG
saponificava-lo	saponificar+V.ele.ACC.3.M.SG+IMPF+2+SG
saponificava-los	saponificar+V.ele.ACC.3.M.PL+IMPF+2+SG
saponificava-me	saponificar+V.eu.AD.1.SG+IMPF+1+SG
saponificava-me	saponificar+V.eu.AD.1.SG+IMPF+3+SG
saponificavam-lhe	saponificar+V.ele.DAT.3.SG+IMPF+3+PL
saponificavam-lhes	saponificar+V.ele.DAT.3.PL+IMPF+3+PL
saponificavam-me	saponificar+V.eu.AD.1.SG+IMPF+3+PL
saponificavam-na	saponificar+V.ele.ACC.3.F.SG+IMPF+3+PL
saponificavam-nas	saponificar+V.ele.ACC.3.F.PL+IMPF+3+PL
saponificavam-no	saponificar+V.ele.ACC.3.M.SG+IMPF+3+PL
saponificavam-nos	saponificar+V.ele.ACC.3.M.PL+IMPF+3+PL
saponificavam-nos	saponificar+V.nós.AD.1.PL+IMPF+3+PL
saponificávamo-la	saponificar+V.ele.ACC.3.F.SG+IMPF+1+PL
saponificávamo-las	saponificar+V.ele.ACC.3.F.PL+IMPF+1+PL
saponificávamo-lo	saponificar+V.ele.ACC.3.M.SG+IMPF+1+PL
saponificávamo-los	saponificar+V.ele.ACC.3.M.PL+IMPF+1+PL
saponificávamo-nos	saponificar+nós.AD.1.PL+IMPF+1+PL
saponificávamos-lhe	saponificar+V.ele.DAT.3.SG+IMPF+1+PL
saponificávamos-lhes	saponificar+V.ele.DAT.3.PL+IMPF+1+PL
saponificávamos-me	saponificar+V.eu.AD.1.SG+IMPF+1+PL
saponificávamos-te	saponificar+V.tu.AD.2.SG+IMPF+1+PL
saponificávamos-vos	saponificar+V.vós.AD.2.PL+IMPF+1+PL
saponificavam-se	saponificar+V.ele.REFL+IMPF+3+PL
saponificavam-te	saponificar+V.tu.AD.2.SG+IMPF+3+PL
saponificavam-vos	saponificar+V.vós.AD.2.PL+IMPF+3+PL
saponificava-nos	saponificar+nós.AD.1.PL+IMPF+1+SG
saponificava-nos	saponificar+nós.AD.1.PL+IMPF+2+SG
saponificava-nos	saponificar+nós.AD.1.PL+IMPF+3+SG
saponificava-o	saponificar+V.ele.ACC.3.M.SG+IMPF+1+SG
saponificava-o	saponificar+V.ele.ACC.3.M.SG+IMPF+3+SG
saponificava-os	saponificar+V.ele.ACC.3.M.PL+IMPF+1+SG
saponificava-os	saponificar+V.ele.ACC.3.M.PL+IMPF+3+SG
saponificava-se	saponificar+V.ele.REFL+IMPF+1+SG
saponificava-se	saponificar+V.ele.REFL+IMPF+3+SG
saponificavas-lhe	saponificar+V.ele.DAT.3.SG+IMPF+2+SG
saponificavas-lhes	saponificar+V.ele.DAT.3.PL+IMPF+2+SG
saponificavas-me	saponificar+V.eu.AD.1.SG+IMPF+2+SG
saponificavas-te	saponificar+V.tu.AD.2.SG+IMPF+2+SG
saponificavas-vos	saponificar+V.vós.AD.2.PL+IMPF+2+SG
saponificava-te	saponificar+V.tu.AD.2.SG+IMPF+1+SG
saponificava-te	saponificar+V.tu.AD.2.SG+IMPF+3+SG
saponificava-vos	saponificar+V.vós.AD.2.PL+IMPF+1+SG
saponificava-vos	saponificar+V.vós.AD.2.PL+IMPF+3+SG
saponificávei-la	saponificar+V.ele.ACC.3.F.SG+IMPF+2+PL
saponificávei-las	saponificar+V.ele.ACC.3.F.PL+IMPF+2+PL
saponificávei-lo	saponificar+V.ele.ACC.3.M.SG+IMPF+2+PL
saponificávei-los	saponificar+V.ele.ACC.3.M.PL+IMPF+2+PL
saponificávei-nos	saponificar+nós.AD.1.PL+IMPF+2+PL
saponificáveis-lhe	saponificar+V.ele.DAT.3.SG+IMPF+2+PL
saponificáveis-lhes	saponificar+V.ele.DAT.3.PL+IMPF+2+PL
saponificáveis-me	saponificar+V.eu.AD.1.SG+IMPF+2+PL
saponificáveis-te	saponificar+V.tu.AD.2.SG+IMPF+2+PL
saponificáveis-vos	saponificar+V.vós.AD.2.PL+IMPF+2+PL
saponifica-vos	saponificar+V.vós.AD.2.PL+PRS+3+SG
saponifico-a	saponificar+V.ele.ACC.3.F.SG+PRS+1+SG
saponifico-as	saponificar+V.ele.ACC.3.F.PL+PRS+1+SG
saponifico-lhe	saponificar+V.ele.DAT.3.SG+PRS+1+SG
saponifico-lhes	saponificar+V.ele.DAT.3.PL+PRS+1+SG
saponifico-me	saponificar+V.eu.AD.1.SG+PRS+1+SG
saponifico-nos	saponificar+nós.AD.1.PL+PRS+1+SG
saponifico-o	saponificar+V.ele.ACC.3.M.SG+PRS+1+SG
saponifico-os	saponificar+V.ele.ACC.3.M.PL+PRS+1+SG
saponifico-te	saponificar+V.tu.AD.2.SG+PRS+1+SG
saponificou-a	saponificar+V.ele.ACC.3.F.SG+PRF+3+SG
saponificou-as	saponificar+V.ele.ACC.3.F.PL+PRF+3+SG
saponificou-lhe	saponificar+V.ele.DAT.3.SG+PRF+3+SG
saponificou-lhes	saponificar+V.ele.DAT.3.PL+PRF+3+SG
saponificou-me	saponificar+V.eu.AD.1.SG+PRF+3+SG
saponificou-nos	saponificar+nós.AD.1.PL+PRF+3+SG
saponificou-o	saponificar+V.ele.ACC.3.M.SG+PRF+3+SG
saponificou-os	saponificar+V.ele.ACC.3.M.PL+PRF+3+SG
saponificou-se	saponificar+V.ele.REFL+PRF+3+SG
saponificou-te	saponificar+V.tu.AD.2.SG+PRF+3+SG
saponificou-vos	saponificar+V.vós.AD.2.PL+PRF+3+SG
saponifico-vos	saponificar+V.vós.AD.2.PL+PRS+1+SG
saponifique-a	saponificar+V.ele.ACC.3.F.SG+IMP+3+SG
saponifique-as	saponificar+V.ele.ACC.3.F.PL+IMP+3+SG
saponifiquei-a	saponificar+V.ele.ACC.3.F.SG+PRF+1+SG
saponifiquei-as	saponificar+V.ele.ACC.3.F.PL+PRF+1+SG
saponifiquei-lhe	saponificar+V.ele.DAT.3.SG+PRF+1+SG
saponifiquei-lhes	saponificar+V.ele.DAT.3.PL+PRF+1+SG
saponifiquei-me	saponificar+V.eu.AD.1.SG+PRF+1+SG
saponifiquei-nos	saponificar+nós.AD.1.PL+PRF+1+SG
saponifiquei-o	saponificar+V.ele.ACC.3.M.SG+PRF+1+SG
saponifiquei-os	saponificar+V.ele.ACC.3.M.PL+PRF+1+SG
saponifiquei-te	saponificar+V.tu.AD.2.SG+PRF+1+SG
saponifiquei-vos	saponificar+V.vós.AD.2.PL+PRF+1+SG
saponifique-lhe	saponificar+V.ele.DAT.3.SG+IMP+3+SG
saponifique-lhes	saponificar+V.ele.DAT.3.PL+IMP+3+SG
saponifique-me	saponificar+V.eu.AD.1.SG+IMP+3+SG
saponifiquem-lhe	saponificar+V.ele.DAT.3.SG+IMP+3+PL
saponifiquem-lhes	saponificar+V.ele.DAT.3.PL+IMP+3+PL
saponifiquem-me	saponificar+V.eu.AD.1.SG+IMP+3+PL
saponifiquem-na	saponificar+V.ele.ACC.3.F.SG+IMP+3+PL
saponifiquem-nas	saponificar+V.ele.ACC.3.F.PL+IMP+3+PL
saponifiquem-no	saponificar+V.ele.ACC.3.M.SG+IMP+3+PL
saponifiquem-nos	saponificar+V.ele.ACC.3.M.PL+IMP+3+PL
saponifiquem-nos	saponificar+V.nós.AD.1.PL+IMP+3+PL
saponifiquemo-la	saponificar+V.ele.ACC.3.F.SG+IMP+1+PL
saponifiquemo-las	saponificar+V.ele.ACC.3.F.PL+IMP+1+PL
saponifiquemo-lo	saponificar+V.ele.ACC.3.M.SG+IMP+1+PL
saponifiquemo-los	saponificar+V.ele.ACC.3.M.PL+IMP+1+PL
saponifiquemo-nos	saponificar+nós.AD.1.PL+IMP+1+PL
saponifiquemos-lhe	saponificar+V.ele.DAT.3.SG+IMP+1+PL
saponifiquemos-lhes	saponificar+V.ele.DAT.3.PL+IMP+1+PL
saponifiquemos-me	saponificar+V.eu.AD.1.SG+IMP+1+PL
saponifiquemos-te	saponificar+V.tu.AD.2.SG+IMP+1+PL
saponifiquemos-vos	saponificar+V.vós.AD.2.PL+IMP+1+PL
saponifiquem-se	saponificar+V.ele.REFL+IMP+3+PL
saponifiquem-te	saponificar+V.tu.AD.2.SG+IMP+3+PL
saponifiquem-vos	saponificar+V.vós.AD.2.PL+IMP+3+PL
saponifique-nos	saponificar+nós.AD.1.PL+IMP+3+SG
saponifique-o	saponificar+V.ele.ACC.3.M.SG+IMP+3+SG
saponifique-os	saponificar+V.ele.ACC.3.M.PL+IMP+3+SG
saponifique-se	saponificar+V.ele.REFL+IMP+3+SG
saponifique-te	saponificar+V.tu.AD.2.SG+IMP+3+SG
saponifique-vos	saponificar+V.vós.AD.2.PL+IMP+3+SG
sapo-nos	sapar+nós.AD.1.PL+PRS+1+SG
sapo-o	sapar+V.ele.ACC.3.M.SG+PRS+1+SG
sapo-os	sapar+V.ele.ACC.3.M.PL+PRS+1+SG
sapo-te	sapar+V.tu.AD.2.SG+PRS+1+SG
sapou-a	sapar+V.ele.ACC.3.F.SG+PRF+3+SG
sapou-as	sapar+V.ele.ACC.3.F.PL+PRF+3+SG
sapou-lhe	sapar+V.ele.DAT.3.SG+PRF+3+SG
sapou-lhes	sapar+V.ele.DAT.3.PL+PRF+3+SG
sapou-me	sapar+V.eu.AD.1.SG+PRF+3+SG
sapou-nos	sapar+nós.AD.1.PL+PRF+3+SG
sapou-o	sapar+V.ele.ACC.3.M.SG+PRF+3+SG
sapou-os	sapar+V.ele.ACC.3.M.PL+PRF+3+SG
sapou-se	sapar+V.ele.REFL+PRF+3+SG
sapou-te	sapar+V.tu.AD.2.SG+PRF+3+SG
sapou-vos	sapar+V.vós.AD.2.PL+PRF+3+SG
sapo-vos	sapar+V.vós.AD.2.PL+PRS+1+SG
saprema-a	sapremar+V.ele.ACC.3.F.SG+PRS+3+SG
saprema-as	sapremar+V.ele.ACC.3.F.PL+PRS+3+SG
sapremai-la	sapremar+V.ele.ACC.3.F.SG+PRS+2+PL
sapremai-las	sapremar+V.ele.ACC.3.F.PL+PRS+2+PL
sapremai-lo	sapremar+V.ele.ACC.3.M.SG+PRS+2+PL
sapremai-los	sapremar+V.ele.ACC.3.M.PL+PRS+2+PL
sapremai-nos	sapremar+nós.AD.1.PL+PRS+2+PL
sapremais-lhe	sapremar+V.ele.DAT.3.SG+PRS+2+PL
sapremais-lhes	sapremar+V.ele.DAT.3.PL+PRS+2+PL
sapremais-me	sapremar+V.eu.AD.1.SG+PRS+2+PL
sapremais-te	sapremar+V.tu.AD.2.SG+PRS+2+PL
sapremais-vos	sapremar+V.vós.AD.2.PL+PRS+2+PL
sapremá-la-ão	sapremar+V.ele.ACC.3.F.SG+FUT+3+PL
sapremá-la-á	sapremar+V.ele.ACC.3.F.SG+FUT+3+SG
sapremá-la-ás	sapremar+V.ele.ACC.3.F.SG+FUT+2+SG
sapremá-la-ei	sapremar+V.ele.ACC.3.F.SG+FUT+1+SG
sapremá-la-eis	sapremar+V.ele.ACC.3.F.SG+FUT+2+PL
sapremá-la-emos	sapremar+V.ele.ACC.3.F.SG+FUT+1+PL
sapremá-la-íamos	sapremar+V.ele.ACC.3.F.SG+COND+1+PL
sapremá-la-iam	sapremar+V.ele.ACC.3.F.SG+COND+3+PL
sapremá-la-ia	sapremar+V.ele.ACC.3.F.SG+COND+1+SG
sapremá-la-ia	sapremar+V.ele.ACC.3.F.SG+COND+3+SG
sapremá-la-ias	sapremar+V.ele.ACC.3.F.SG+COND+2+SG
sapremá-la-íeis	sapremar+V.ele.ACC.3.F.SG+COND+2+PL
sapremá-las-ão	sapremar+V.ele.ACC.3.F.PL+FUT+3+PL
sapremá-la	sapremar+V.ele.ACC.3.F.SG+INF+1+SG
sapremá-la	sapremar+V.ele.ACC.3.F.SG+INF+3+SG
saprema-la	sapremar+V.ele.ACC.3.F.SG+PRS+2+SG
sapremá-la	sapremar+V.ele.ACC.3.F.SG+SBJF+1+SG
sapremá-la	sapremar+V.ele.ACC.3.F.SG+SBJF+3+SG
sapremá-las-á	sapremar+V.ele.ACC.3.F.PL+FUT+3+SG
sapremá-las-ás	sapremar+V.ele.ACC.3.F.PL+FUT+2+SG
sapremá-las-ei	sapremar+V.ele.ACC.3.F.PL+FUT+1+SG
sapremá-las-eis	sapremar+V.ele.ACC.3.F.PL+FUT+2+PL
sapremá-las-emos	sapremar+V.ele.ACC.3.F.PL+FUT+1+PL
sapremá-las-íamos	sapremar+V.ele.ACC.3.F.PL+COND+1+PL
sapremá-las-iam	sapremar+V.ele.ACC.3.F.PL+COND+3+PL
sapremá-las-ia	sapremar+V.ele.ACC.3.F.PL+COND+1+SG
sapremá-las-ia	sapremar+V.ele.ACC.3.F.PL+COND+3+SG
sapremá-las-ias	sapremar+V.ele.ACC.3.F.PL+COND+2+SG
sapremá-las-íeis	sapremar+V.ele.ACC.3.F.PL+COND+2+PL
sapremá-las	sapremar+V.ele.ACC.3.F.PL+INF+1+SG
sapremá-las	sapremar+V.ele.ACC.3.F.PL+INF+3+SG
saprema-las	sapremar+V.ele.ACC.3.F.PL+PRS+2+SG
sapremá-las	sapremar+V.ele.ACC.3.F.PL+SBJF+1+SG
sapremá-las	sapremar+V.ele.ACC.3.F.PL+SBJF+3+SG
saprema-lhe	sapremar+V.ele.DAT.3.SG+PRS+3+SG
saprema-lhes	sapremar+V.ele.DAT.3.PL+PRS+3+SG
sapremá-lo-ão	sapremar+V.ele.ACC.3.M.SG+FUT+3+PL
sapremá-lo-á	sapremar+V.ele.ACC.3.M.SG+FUT+3+SG
sapremá-lo-ás	sapremar+V.ele.ACC.3.M.SG+FUT+2+SG
sapremá-lo-ei	sapremar+V.ele.ACC.3.M.SG+FUT+1+SG
sapremá-lo-eis	sapremar+V.ele.ACC.3.M.SG+FUT+2+PL
sapremá-lo-emos	sapremar+V.ele.ACC.3.M.SG+FUT+1+PL
sapremá-lo-íamos	sapremar+V.ele.ACC.3.M.SG+COND+1+PL
sapremá-lo-iam	sapremar+V.ele.ACC.3.M.SG+COND+3+PL
sapremá-lo-ia	sapremar+V.ele.ACC.3.M.SG+COND+1+SG
sapremá-lo-ia	sapremar+V.ele.ACC.3.M.SG+COND+3+SG
sapremá-lo-ias	sapremar+V.ele.ACC.3.M.SG+COND+2+SG
sapremá-lo-íeis	sapremar+V.ele.ACC.3.M.SG+COND+2+PL
sapremá-los-ão	sapremar+V.ele.ACC.3.M.PL+FUT+3+PL
sapremá-lo	sapremar+V.ele.ACC.3.M.SG+INF+1+SG
sapremá-lo	sapremar+V.ele.ACC.3.M.SG+INF+3+SG
saprema-lo	sapremar+V.ele.ACC.3.M.SG+PRS+2+SG
sapremá-lo	sapremar+V.ele.ACC.3.M.SG+SBJF+1+SG
sapremá-lo	sapremar+V.ele.ACC.3.M.SG+SBJF+3+SG
sapremá-los-á	sapremar+V.ele.ACC.3.M.PL+FUT+3+SG
sapremá-los-ás	sapremar+V.ele.ACC.3.M.PL+FUT+2+SG
sapremá-los-ei	sapremar+V.ele.ACC.3.M.PL+FUT+1+SG
sapremá-los-eis	sapremar+V.ele.ACC.3.M.PL+FUT+2+PL
sapremá-los-emos	sapremar+V.ele.ACC.3.M.PL+FUT+1+PL
sapremá-los-íamos	sapremar+V.ele.ACC.3.M.PL+COND+1+PL
sapremá-los-iam	sapremar+V.ele.ACC.3.M.PL+COND+3+PL
sapremá-los-ia	sapremar+V.ele.ACC.3.M.PL+COND+1+SG
sapremá-los-ia	sapremar+V.ele.ACC.3.M.PL+COND+3+SG
sapremá-los-ias	sapremar+V.ele.ACC.3.M.PL+COND+2+SG
sapremá-los-íeis	sapremar+V.ele.ACC.3.M.PL+COND+2+PL
sapremá-los	sapremar+V.ele.ACC.3.M.PL+INF+1+SG
sapremá-los	sapremar+V.ele.ACC.3.M.PL+INF+3+SG
saprema-los	sapremar+V.ele.ACC.3.M.PL+PRS+2+SG
sapremá-los	sapremar+V.ele.ACC.3.M.PL+SBJF+1+SG
sapremá-los	sapremar+V.ele.ACC.3.M.PL+SBJF+3+SG
saprema-me	sapremar+V.eu.AD.1.SG+PRS+3+SG
sapremam-lhe	sapremar+V.ele.DAT.3.SG+PRS+3+PL
sapremam-lhes	sapremar+V.ele.DAT.3.PL+PRS+3+PL
sapremam-me	sapremar+V.eu.AD.1.SG+PRS+3+PL
sapremam-na	sapremar+V.ele.ACC.3.F.SG+PRS+3+PL
sapremam-nas	sapremar+V.ele.ACC.3.F.PL+PRS+3+PL
sapremam-no	sapremar+V.ele.ACC.3.M.SG+PRS+3+PL
sapremam-nos	sapremar+V.ele.ACC.3.M.PL+PRS+3+PL
sapremam-nos	sapremar+V.nós.AD.1.PL+PRS+3+PL
sapremamo-la	sapremar+V.ele.ACC.3.F.SG+PRF+1+PL
sapremamo-la	sapremar+V.ele.ACC.3.F.SG+PRS+1+PL
sapremamo-las	sapremar+V.ele.ACC.3.F.PL+PRF+1+PL
sapremamo-las	sapremar+V.ele.ACC.3.F.PL+PRS+1+PL
sapremamo-lo	sapremar+V.ele.ACC.3.M.SG+PRF+1+PL
sapremamo-lo	sapremar+V.ele.ACC.3.M.SG+PRS+1+PL
sapremamo-los	sapremar+V.ele.ACC.3.M.PL+PRF+1+PL
sapremamo-los	sapremar+V.ele.ACC.3.M.PL+PRS+1+PL
sapremamo-nos	sapremar+nós.AD.1.PL+PRF+1+PL
sapremamo-nos	sapremar+nós.AD.1.PL+PRS+1+PL
sapremamos-lhe	sapremar+V.ele.DAT.3.SG+PRF+1+PL
sapremamos-lhe	sapremar+V.ele.DAT.3.SG+PRS+1+PL
sapremamos-lhes	sapremar+V.ele.DAT.3.PL+PRF+1+PL
sapremamos-lhes	sapremar+V.ele.DAT.3.PL+PRS+1+PL
sapremamos-me	sapremar+V.eu.AD.1.SG+PRF+1+PL
sapremamos-me	sapremar+V.eu.AD.1.SG+PRS+1+PL
sapremamos-te	sapremar+V.tu.AD.2.SG+PRF+1+PL
sapremamos-te	sapremar+V.tu.AD.2.SG+PRS+1+PL
sapremamos-vos	sapremar+V.vós.AD.2.PL+PRF+1+PL
sapremamos-vos	sapremar+V.vós.AD.2.PL+PRS+1+PL
sapremam-se	sapremar+V.ele.REFL+PRS+3+PL
sapremam-te	sapremar+V.tu.AD.2.SG+PRS+3+PL
sapremam-vos	sapremar+V.vós.AD.2.PL+PRS+3+PL
sapremando-a	sapremar+V.ele.ACC.3.F.SG+GRD
sapremando-as	sapremar+V.ele.ACC.3.F.PL+GRD
sapremando-lhe	sapremar+V.ele.DAT.3.SG+GRD
sapremando-lhes	sapremar+V.ele.DAT.3.PL+GRD
sapremando-me	sapremar+V.eu.AD.1.SG+GRD
sapremando-nos	sapremar+nós.AD.1.PL+GRD
sapremando-o	sapremar+V.ele.ACC.3.M.SG+GRD
sapremando-os	sapremar+V.ele.ACC.3.M.PL+GRD
sapremando-se	sapremar+V.ele.REFL+GRD
sapremando-te	sapremar+V.tu.AD.2.SG+GRD
sapremando-vos	sapremar+V.vós.AD.2.PL+GRD
saprema-nos	sapremar+nós.AD.1.PL+PRS+2+SG
saprema-nos	sapremar+nós.AD.1.PL+PRS+3+SG
saprema-o	sapremar+V.ele.ACC.3.M.SG+PRS+3+SG
saprema-os	sapremar+V.ele.ACC.3.M.PL+PRS+3+SG
sapremara-a	sapremar+V.ele.ACC.3.F.SG+PQP+1+SG
sapremara-a	sapremar+V.ele.ACC.3.F.SG+PQP+3+SG
sapremara-as	sapremar+V.ele.ACC.3.F.PL+PQP+1+SG
sapremara-as	sapremar+V.ele.ACC.3.F.PL+PQP+3+SG
sapremara-la	sapremar+V.ele.ACC.3.F.SG+PQP+2+SG
sapremara-las	sapremar+V.ele.ACC.3.F.PL+PQP+2+SG
sapremara-lhe	sapremar+V.ele.DAT.3.SG+PQP+1+SG
sapremara-lhe	sapremar+V.ele.DAT.3.SG+PQP+3+SG
sapremara-lhes	sapremar+V.ele.DAT.3.PL+PQP+1+SG
sapremara-lhes	sapremar+V.ele.DAT.3.PL+PQP+3+SG
sapremara-lo	sapremar+V.ele.ACC.3.M.SG+PQP+2+SG
sapremara-los	sapremar+V.ele.ACC.3.M.PL+PQP+2+SG
sapremara-me	sapremar+V.eu.AD.1.SG+PQP+1+SG
sapremara-me	sapremar+V.eu.AD.1.SG+PQP+3+SG
sapremaram-lhe	sapremar+V.ele.DAT.3.SG+PQP+3+PL
sapremaram-lhe	sapremar+V.ele.DAT.3.SG+PRF+3+PL
sapremaram-lhes	sapremar+V.ele.DAT.3.PL+PQP+3+PL
sapremaram-lhes	sapremar+V.ele.DAT.3.PL+PRF+3+PL
sapremaram-me	sapremar+V.eu.AD.1.SG+PQP+3+PL
sapremaram-me	sapremar+V.eu.AD.1.SG+PRF+3+PL
sapremaram-na	sapremar+V.ele.ACC.3.F.SG+PQP+3+PL
sapremaram-na	sapremar+V.ele.ACC.3.F.SG+PRF+3+PL
sapremaram-nas	sapremar+V.ele.ACC.3.F.PL+PQP+3+PL
sapremaram-nas	sapremar+V.ele.ACC.3.F.PL+PRF+3+PL
sapremaram-no	sapremar+V.ele.ACC.3.M.SG+PQP+3+PL
sapremaram-no	sapremar+V.ele.ACC.3.M.SG+PRF+3+PL
sapremaram-nos	sapremar+V.ele.ACC.3.M.PL+PQP+3+PL
sapremaram-nos	sapremar+V.ele.ACC.3.M.PL+PRF+3+PL
sapremaram-nos	sapremar+V.nós.AD.1.PL+PQP+3+PL
sapremaram-nos	sapremar+V.nós.AD.1.PL+PRF+3+PL
sapremáramo-la	sapremar+V.ele.ACC.3.F.SG+PQP+1+PL
sapremáramo-las	sapremar+V.ele.ACC.3.F.PL+PQP+1+PL
sapremáramo-lo	sapremar+V.ele.ACC.3.M.SG+PQP+1+PL
sapremáramo-los	sapremar+V.ele.ACC.3.M.PL+PQP+1+PL
sapremáramo-nos	sapremar+V.ele.ACC.3.M.PL+PQP+1+PL
sapremáramo-nos	sapremar+V.nós.AD.1.PL+PQP+1+PL
sapremáramos-lhe	sapremar+V.ele.DAT.3.SG+PQP+1+PL
sapremáramos-lhes	sapremar+V.ele.DAT.3.PL+PQP+1+PL
sapremáramos-me	sapremar+V.eu.AD.1.SG+PQP+1+PL
sapremáramos-te	sapremar+V.tu.AD.2.SG+PQP+1+PL
sapremáramos-vos	sapremar+V.vós.AD.2.PL+PQP+1+PL
sapremaram-se	sapremar+V.ele.REFL+PQP+3+PL
sapremaram-se	sapremar+V.ele.REFL+PRF+3+PL
sapremaram-te	sapremar+V.tu.AD.2.SG+PQP+3+PL
sapremaram-te	sapremar+V.tu.AD.2.SG+PRF+3+PL
sapremaram-vos	sapremar+V.vós.AD.2.PL+PQP+3+PL
sapremaram-vos	sapremar+V.vós.AD.2.PL+PRF+3+PL
sapremara-nos	sapremar+nós.AD.1.PL+PQP+1+SG
sapremara-nos	sapremar+nós.AD.1.PL+PQP+2+SG
sapremara-nos	sapremar+nós.AD.1.PL+PQP+3+SG
sapremara-o	sapremar+V.ele.ACC.3.M.SG+PQP+1+SG
sapremara-o	sapremar+V.ele.ACC.3.M.SG+PQP+3+SG
sapremara-os	sapremar+V.ele.ACC.3.M.PL+PQP+1+SG
sapremara-os	sapremar+V.ele.ACC.3.M.PL+PQP+3+SG
sapremara-se	sapremar+V.ele.REFL+PQP+1+SG
sapremara-se	sapremar+V.ele.REFL+PQP+3+SG
sapremaras-lhe	sapremar+V.ele.DAT.3.SG+PQP+2+SG
sapremaras-lhes	sapremar+V.ele.DAT.3.PL+PQP+2+SG
sapremaras-me	sapremar+V.eu.AD.1.SG+PQP+2+SG
sapremaras-te	sapremar+V.tu.AD.2.SG+PQP+2+SG
sapremaras-vos	sapremar+V.vós.AD.2.PL+PQP+2+SG
sapremara-te	sapremar+V.tu.AD.2.SG+PQP+1+SG
sapremara-te	sapremar+V.tu.AD.2.SG+PQP+3+SG
sapremara-vos	sapremar+V.vós.AD.2.PL+PQP+1+SG
sapremara-vos	sapremar+V.vós.AD.2.PL+PQP+3+SG
sapremarde-la	sapremar+V.ele.ACC.3.F.SG+INF+2+PL
sapremarde-la	sapremar+V.ele.ACC.3.F.SG+SBJF+2+PL
sapremarde-las	sapremar+V.ele.ACC.3.F.PL+INF+2+PL
sapremarde-las	sapremar+V.ele.ACC.3.F.PL+SBJF+2+PL
sapremarde-lo	sapremar+V.ele.ACC.3.M.SG+INF+2+PL
sapremarde-lo	sapremar+V.ele.ACC.3.M.SG+SBJF+2+PL
sapremarde-los	sapremar+V.ele.ACC.3.M.PL+INF+2+PL
sapremarde-los	sapremar+V.ele.ACC.3.M.PL+SBJF+2+PL
sapremarde-nos	sapremar+nós.AD.1.PL+INF+2+PL
sapremarde-nos	sapremar+nós.AD.1.PL+SBJF+2+PL
sapremardes-lhe	sapremar+V.ele.DAT.3.SG+INF+2+PL
sapremardes-lhe	sapremar+V.ele.DAT.3.SG+SBJF+2+PL
sapremardes-lhes	sapremar+V.ele.DAT.3.PL+INF+2+PL
sapremardes-lhes	sapremar+V.ele.DAT.3.PL+SBJF+2+PL
sapremardes-me	sapremar+V.eu.AD.1.SG+INF+2+PL
sapremardes-me	sapremar+V.eu.AD.1.SG+SBJF+2+PL
sapremardes-te	sapremar+V.tu.AD.2.SG+INF+2+PL
sapremardes-te	sapremar+V.tu.AD.2.SG+SBJF+2+PL
sapremardes-vos	sapremar+V.vós.AD.2.PL+INF+2+PL
sapremardes-vos	sapremar+V.vós.AD.2.PL+SBJF+2+PL
sapremárei-la	sapremar+V.ele.ACC.3.F.SG+PQP+2+PL
sapremárei-las	sapremar+V.ele.ACC.3.F.PL+PQP+2+PL
sapremárei-lo	sapremar+V.ele.ACC.3.M.SG+PQP+2+PL
sapremárei-los	sapremar+V.ele.ACC.3.M.PL+PQP+2+PL
sapremárei-nos	sapremar+V.ele.ACC.3.M.PL+PQP+2+PL
sapremárei-nos	sapremar+V.nós.AD.1.PL+PQP+2+PL
sapremáreis-lhe	sapremar+V.ele.DAT.3.SG+PQP+2+PL
sapremáreis-lhes	sapremar+V.ele.DAT.3.PL+PQP+2+PL
sapremáreis-me	sapremar+V.eu.AD.1.SG+PQP+2+PL
sapremáreis-te	sapremar+V.tu.AD.2.SG+PQP+2+PL
sapremáreis-vos	sapremar+V.vós.AD.2.PL+PQP+2+PL
sapremare-la	sapremar+V.ele.ACC.3.F.SG+INF+2+SG
sapremare-la	sapremar+V.ele.ACC.3.F.SG+SBJF+2+SG
sapremare-las	sapremar+V.ele.ACC.3.F.PL+INF+2+SG
sapremare-las	sapremar+V.ele.ACC.3.F.PL+SBJF+2+SG
sapremare-lo	sapremar+V.ele.ACC.3.M.SG+INF+2+SG
sapremare-lo	sapremar+V.ele.ACC.3.M.SG+SBJF+2+SG
sapremare-los	sapremar+V.ele.ACC.3.M.PL+INF+2+SG
sapremare-los	sapremar+V.ele.ACC.3.M.PL+SBJF+2+SG
sapremarem-lhe	sapremar+V.ele.DAT.3.SG+INF+3+PL
sapremarem-lhe	sapremar+V.ele.DAT.3.SG+SBJF+3+PL
sapremarem-lhes	sapremar+V.ele.DAT.3.PL+INF+3+PL
sapremarem-lhes	sapremar+V.ele.DAT.3.PL+SBJF+3+PL
sapremarem-me	sapremar+V.eu.AD.1.SG+INF+3+PL
sapremarem-me	sapremar+V.eu.AD.1.SG+SBJF+3+PL
