sobressolar-nos	sobressolar+nós.AD.1.PL+INF+1+SG
sobressolar-nos	sobressolar+nós.AD.1.PL+INF+3+SG
sobressolar-nos	sobressolar+nós.AD.1.PL+SBJF+1+SG
sobressolar-nos	sobressolar+nós.AD.1.PL+SBJF+3+SG
sobressolar-se-ão	sobressolar+V.ele.REFL+FUT+3+PL
sobressolar-se-á	sobressolar+V.ele.REFL+FUT+3+SG
sobressolar-se-iam	sobressolar+V.ele.REFL+COND+3+PL
sobressolar-se-ia	sobressolar+V.ele.REFL+COND+3+SG
sobressolar-se	sobressolar+V.ele.REFL+INF
sobressolar-se	sobressolar+V.ele.REFL+INF+3+SG
sobressolar-se	sobressolar+V.ele.REFL+SBJF+3+SG
sobressolar-te-ão	sobressolar+V.tu.AD.2.SG+FUT+3+PL
sobressolar-te-á	sobressolar+V.tu.AD.2.SG+FUT+3+SG
sobressolar-te-ás	sobressolar+V.tu.AD.2.SG+FUT+2+SG
sobressolar-te-ei	sobressolar+V.tu.AD.2.SG+FUT+1+SG
sobressolar-te-eis	sobressolar+V.tu.AD.2.SG+FUT+2+PL
sobressolar-te-emos	sobressolar+V.tu.AD.2.SG+FUT+1+PL
sobressolar-te-íamos	sobressolar+V.tu.AD.2.SG+COND+1+PL
sobressolar-te-iam	sobressolar+V.tu.AD.2.SG+COND+3+PL
sobressolar-te-ia	sobressolar+V.tu.AD.2.SG+COND+1+SG
sobressolar-te-ia	sobressolar+V.tu.AD.2.SG+COND+3+SG
sobressolar-te-ias	sobressolar+V.tu.AD.2.SG+COND+2+SG
sobressolar-te-íeis	sobressolar+V.tu.AD.2.SG+COND+2+PL
sobressolar-te	sobressolar+V.tu.AD.2.SG+INF
sobressolar-te	sobressolar+V.tu.AD.2.SG+INF+1+SG
sobressolar-te	sobressolar+V.tu.AD.2.SG+INF+3+SG
sobressolar-te	sobressolar+V.tu.AD.2.SG+SBJF+1+SG
sobressolar-te	sobressolar+V.tu.AD.2.SG+SBJF+3+SG
sobressolar-vos-ão	sobressolar+V.vós.AD.2.PL+FUT+3+PL
sobressolar-vos-á	sobressolar+V.vós.AD.2.PL+FUT+3+SG
sobressolar-vos-ás	sobressolar+V.vós.AD.2.PL+FUT+2+SG
sobressolar-vos-ei	sobressolar+V.vós.AD.2.PL+FUT+1+SG
sobressolar-vos-eis	sobressolar+V.vós.AD.2.PL+FUT+2+PL
sobressolar-vos-emos	sobressolar+V.vós.AD.2.PL+FUT+1+PL
sobressolar-vos-íamos	sobressolar+V.vós.AD.2.PL+COND+1+PL
sobressolar-vos-iam	sobressolar+V.vós.AD.2.PL+COND+3+PL
sobressolar-vos-ia	sobressolar+V.vós.AD.2.PL+COND+1+SG
sobressolar-vos-ia	sobressolar+V.vós.AD.2.PL+COND+3+SG
sobressolar-vos-ias	sobressolar+V.vós.AD.2.PL+COND+2+SG
sobressolar-vos-íeis	sobressolar+V.vós.AD.2.PL+COND+2+PL
sobressolar-vos	sobressolar+V.vós.AD.2.PL+INF
sobressolar-vos	sobressolar+V.vós.AD.2.PL+INF+1+SG
sobressolar-vos	sobressolar+V.vós.AD.2.PL+INF+3+SG
sobressolar-vos	sobressolar+V.vós.AD.2.PL+SBJF+1+SG
sobressolar-vos	sobressolar+V.vós.AD.2.PL+SBJF+3+SG
sobressola-se	sobressolar+V.ele.REFL+PRS+3+SG
sobressolas-lhe	sobressolar+V.ele.DAT.3.SG+PRS+2+SG
sobressolas-lhes	sobressolar+V.ele.DAT.3.PL+PRS+2+SG
sobressolas-me	sobressolar+V.eu.AD.1.SG+PRS+2+SG
sobressolaste-a	sobressolar+V.ele.ACC.3.F.SG+PRF+2+SG
sobressolaste-as	sobressolar+V.ele.ACC.3.F.PL+PRF+2+SG
sobressolaste-la	sobressolar+V.ele.ACC.3.F.SG+PRF+2+PL
sobressolaste-las	sobressolar+V.ele.ACC.3.F.PL+PRF+2+PL
sobressolaste-lhe	sobressolar+V.ele.DAT.3.SG+PRF+2+SG
sobressolaste-lhes	sobressolar+V.ele.DAT.3.PL+PRF+2+SG
sobressolaste-lo	sobressolar+V.ele.ACC.3.M.SG+PRF+2+PL
sobressolaste-los	sobressolar+V.ele.ACC.3.M.PL+PRF+2+PL
sobressolaste-me	sobressolar+V.eu.AD.1.SG+PRF+2+SG
sobressolaste-nos	sobressolar+nós.AD.1.PL+PRF+2+PL
sobressolaste-nos	sobressolar+nós.AD.1.PL+PRF+2+SG
sobressolaste-o	sobressolar+V.ele.ACC.3.M.SG+PRF+2+SG
sobressolaste-os	sobressolar+V.ele.ACC.3.M.PL+PRF+2+SG
sobressolastes-lhe	sobressolar+V.ele.DAT.3.SG+PRF+2+PL
sobressolastes-lhes	sobressolar+V.ele.DAT.3.PL+PRF+2+PL
sobressolastes-me	sobressolar+V.eu.AD.1.SG+PRF+2+PL
sobressolas-te	sobressolar+V.tu.AD.2.SG+PRS+2+SG
sobressolastes-te	sobressolar+V.tu.AD.2.SG+PRF+2+PL
sobressolastes-vos	sobressolar+V.vós.AD.2.PL+PRF+2+PL
sobressolaste-te	sobressolar+V.tu.AD.2.SG+PRF+2+SG
sobressolaste-vos	sobressolar+V.vós.AD.2.PL+PRF+2+SG
sobressolas-vos	sobressolar+V.vós.AD.2.PL+PRS+2+SG
sobressola-te	sobressolar+V.tu.AD.2.SG+PRS+3+SG
sobressolava-a	sobressolar+V.ele.ACC.3.F.SG+IMPF+1+SG
sobressolava-a	sobressolar+V.ele.ACC.3.F.SG+IMPF+3+SG
sobressolava-as	sobressolar+V.ele.ACC.3.F.PL+IMPF+1+SG
sobressolava-as	sobressolar+V.ele.ACC.3.F.PL+IMPF+3+SG
sobressolava-la	sobressolar+V.ele.ACC.3.F.SG+IMPF+2+SG
sobressolava-las	sobressolar+V.ele.ACC.3.F.PL+IMPF+2+SG
sobressolava-lhe	sobressolar+V.ele.DAT.3.SG+IMPF+1+SG
sobressolava-lhe	sobressolar+V.ele.DAT.3.SG+IMPF+3+SG
sobressolava-lhes	sobressolar+V.ele.DAT.3.PL+IMPF+1+SG
sobressolava-lhes	sobressolar+V.ele.DAT.3.PL+IMPF+3+SG
sobressolava-lo	sobressolar+V.ele.ACC.3.M.SG+IMPF+2+SG
sobressolava-los	sobressolar+V.ele.ACC.3.M.PL+IMPF+2+SG
sobressolava-me	sobressolar+V.eu.AD.1.SG+IMPF+1+SG
sobressolava-me	sobressolar+V.eu.AD.1.SG+IMPF+3+SG
sobressolavam-lhe	sobressolar+V.ele.DAT.3.SG+IMPF+3+PL
sobressolavam-lhes	sobressolar+V.ele.DAT.3.PL+IMPF+3+PL
sobressolavam-me	sobressolar+V.eu.AD.1.SG+IMPF+3+PL
sobressolavam-na	sobressolar+V.ele.ACC.3.F.SG+IMPF+3+PL
sobressolavam-nas	sobressolar+V.ele.ACC.3.F.PL+IMPF+3+PL
sobressolavam-no	sobressolar+V.ele.ACC.3.M.SG+IMPF+3+PL
sobressolavam-nos	sobressolar+V.ele.ACC.3.M.PL+IMPF+3+PL
sobressolavam-nos	sobressolar+V.nós.AD.1.PL+IMPF+3+PL
sobressolávamo-la	sobressolar+V.ele.ACC.3.F.SG+IMPF+1+PL
sobressolávamo-las	sobressolar+V.ele.ACC.3.F.PL+IMPF+1+PL
sobressolávamo-lo	sobressolar+V.ele.ACC.3.M.SG+IMPF+1+PL
sobressolávamo-los	sobressolar+V.ele.ACC.3.M.PL+IMPF+1+PL
sobressolávamo-nos	sobressolar+nós.AD.1.PL+IMPF+1+PL
sobressolávamos-lhe	sobressolar+V.ele.DAT.3.SG+IMPF+1+PL
sobressolávamos-lhes	sobressolar+V.ele.DAT.3.PL+IMPF+1+PL
sobressolávamos-me	sobressolar+V.eu.AD.1.SG+IMPF+1+PL
sobressolávamos-te	sobressolar+V.tu.AD.2.SG+IMPF+1+PL
sobressolávamos-vos	sobressolar+V.vós.AD.2.PL+IMPF+1+PL
sobressolavam-se	sobressolar+V.ele.REFL+IMPF+3+PL
sobressolavam-te	sobressolar+V.tu.AD.2.SG+IMPF+3+PL
sobressolavam-vos	sobressolar+V.vós.AD.2.PL+IMPF+3+PL
sobressolava-nos	sobressolar+nós.AD.1.PL+IMPF+1+SG
sobressolava-nos	sobressolar+nós.AD.1.PL+IMPF+2+SG
sobressolava-nos	sobressolar+nós.AD.1.PL+IMPF+3+SG
sobressolava-o	sobressolar+V.ele.ACC.3.M.SG+IMPF+1+SG
sobressolava-o	sobressolar+V.ele.ACC.3.M.SG+IMPF+3+SG
sobressolava-os	sobressolar+V.ele.ACC.3.M.PL+IMPF+1+SG
sobressolava-os	sobressolar+V.ele.ACC.3.M.PL+IMPF+3+SG
sobressolava-se	sobressolar+V.ele.REFL+IMPF+1+SG
sobressolava-se	sobressolar+V.ele.REFL+IMPF+3+SG
sobressolavas-lhe	sobressolar+V.ele.DAT.3.SG+IMPF+2+SG
sobressolavas-lhes	sobressolar+V.ele.DAT.3.PL+IMPF+2+SG
sobressolavas-me	sobressolar+V.eu.AD.1.SG+IMPF+2+SG
sobressolavas-te	sobressolar+V.tu.AD.2.SG+IMPF+2+SG
sobressolavas-vos	sobressolar+V.vós.AD.2.PL+IMPF+2+SG
sobressolava-te	sobressolar+V.tu.AD.2.SG+IMPF+1+SG
sobressolava-te	sobressolar+V.tu.AD.2.SG+IMPF+3+SG
sobressolava-vos	sobressolar+V.vós.AD.2.PL+IMPF+1+SG
sobressolava-vos	sobressolar+V.vós.AD.2.PL+IMPF+3+SG
sobressolávei-la	sobressolar+V.ele.ACC.3.F.SG+IMPF+2+PL
sobressolávei-las	sobressolar+V.ele.ACC.3.F.PL+IMPF+2+PL
sobressolávei-lo	sobressolar+V.ele.ACC.3.M.SG+IMPF+2+PL
sobressolávei-los	sobressolar+V.ele.ACC.3.M.PL+IMPF+2+PL
sobressolávei-nos	sobressolar+nós.AD.1.PL+IMPF+2+PL
sobressoláveis-lhe	sobressolar+V.ele.DAT.3.SG+IMPF+2+PL
sobressoláveis-lhes	sobressolar+V.ele.DAT.3.PL+IMPF+2+PL
sobressoláveis-me	sobressolar+V.eu.AD.1.SG+IMPF+2+PL
sobressoláveis-te	sobressolar+V.tu.AD.2.SG+IMPF+2+PL
sobressoláveis-vos	sobressolar+V.vós.AD.2.PL+IMPF+2+PL
sobressola-vos	sobressolar+V.vós.AD.2.PL+PRS+3+SG
sobressole-a	sobressolar+V.ele.ACC.3.F.SG+IMP+3+SG
sobressole-as	sobressolar+V.ele.ACC.3.F.PL+IMP+3+SG
sobressolei-a	sobressolar+V.ele.ACC.3.F.SG+PRF+1+SG
sobressolei-as	sobressolar+V.ele.ACC.3.F.PL+PRF+1+SG
sobressolei-lhe	sobressolar+V.ele.DAT.3.SG+PRF+1+SG
sobressolei-lhes	sobressolar+V.ele.DAT.3.PL+PRF+1+SG
sobressolei-me	sobressolar+V.eu.AD.1.SG+PRF+1+SG
sobressolei-nos	sobressolar+nós.AD.1.PL+PRF+1+SG
sobressolei-o	sobressolar+V.ele.ACC.3.M.SG+PRF+1+SG
sobressolei-os	sobressolar+V.ele.ACC.3.M.PL+PRF+1+SG
sobressolei-te	sobressolar+V.tu.AD.2.SG+PRF+1+SG
sobressolei-vos	sobressolar+V.vós.AD.2.PL+PRF+1+SG
sobressole-lhe	sobressolar+V.ele.DAT.3.SG+IMP+3+SG
sobressole-lhes	sobressolar+V.ele.DAT.3.PL+IMP+3+SG
sobressole-me	sobressolar+V.eu.AD.1.SG+IMP+3+SG
sobressolem-lhe	sobressolar+V.ele.DAT.3.SG+IMP+3+PL
sobressolem-lhes	sobressolar+V.ele.DAT.3.PL+IMP+3+PL
sobressolem-me	sobressolar+V.eu.AD.1.SG+IMP+3+PL
sobressolem-na	sobressolar+V.ele.ACC.3.F.SG+IMP+3+PL
sobressolem-nas	sobressolar+V.ele.ACC.3.F.PL+IMP+3+PL
sobressolem-no	sobressolar+V.ele.ACC.3.M.SG+IMP+3+PL
sobressolem-nos	sobressolar+V.ele.ACC.3.M.PL+IMP+3+PL
sobressolem-nos	sobressolar+V.nós.AD.1.PL+IMP+3+PL
sobressolemo-la	sobressolar+V.ele.ACC.3.F.SG+IMP+1+PL
sobressolemo-las	sobressolar+V.ele.ACC.3.F.PL+IMP+1+PL
sobressolemo-lo	sobressolar+V.ele.ACC.3.M.SG+IMP+1+PL
sobressolemo-los	sobressolar+V.ele.ACC.3.M.PL+IMP+1+PL
sobressolemo-nos	sobressolar+nós.AD.1.PL+IMP+1+PL
sobressolemos-lhe	sobressolar+V.ele.DAT.3.SG+IMP+1+PL
sobressolemos-lhes	sobressolar+V.ele.DAT.3.PL+IMP+1+PL
sobressolemos-me	sobressolar+V.eu.AD.1.SG+IMP+1+PL
sobressolemos-te	sobressolar+V.tu.AD.2.SG+IMP+1+PL
sobressolemos-vos	sobressolar+V.vós.AD.2.PL+IMP+1+PL
sobressolem-se	sobressolar+V.ele.REFL+IMP+3+PL
sobressolem-te	sobressolar+V.tu.AD.2.SG+IMP+3+PL
sobressolem-vos	sobressolar+V.vós.AD.2.PL+IMP+3+PL
sobressole-nos	sobressolar+nós.AD.1.PL+IMP+3+SG
sobressole-o	sobressolar+V.ele.ACC.3.M.SG+IMP+3+SG
sobressole-os	sobressolar+V.ele.ACC.3.M.PL+IMP+3+SG
sobressole-se	sobressolar+V.ele.REFL+IMP+3+SG
sobressole-te	sobressolar+V.tu.AD.2.SG+IMP+3+SG
sobressole-vos	sobressolar+V.vós.AD.2.PL+IMP+3+SG
sobressolo-a	sobressolar+V.ele.ACC.3.F.SG+PRS+1+SG
sobressolo-as	sobressolar+V.ele.ACC.3.F.PL+PRS+1+SG
sobressolo-lhe	sobressolar+V.ele.DAT.3.SG+PRS+1+SG
sobressolo-lhes	sobressolar+V.ele.DAT.3.PL+PRS+1+SG
sobressolo-me	sobressolar+V.eu.AD.1.SG+PRS+1+SG
sobressolo-nos	sobressolar+nós.AD.1.PL+PRS+1+SG
sobressolo-o	sobressolar+V.ele.ACC.3.M.SG+PRS+1+SG
sobressolo-os	sobressolar+V.ele.ACC.3.M.PL+PRS+1+SG
sobressolo-te	sobressolar+V.tu.AD.2.SG+PRS+1+SG
sobressolou-a	sobressolar+V.ele.ACC.3.F.SG+PRF+3+SG
sobressolou-as	sobressolar+V.ele.ACC.3.F.PL+PRF+3+SG
sobressolou-lhe	sobressolar+V.ele.DAT.3.SG+PRF+3+SG
sobressolou-lhes	sobressolar+V.ele.DAT.3.PL+PRF+3+SG
sobressolou-me	sobressolar+V.eu.AD.1.SG+PRF+3+SG
sobressolou-nos	sobressolar+nós.AD.1.PL+PRF+3+SG
sobressolou-o	sobressolar+V.ele.ACC.3.M.SG+PRF+3+SG
sobressolou-os	sobressolar+V.ele.ACC.3.M.PL+PRF+3+SG
sobressolou-se	sobressolar+V.ele.REFL+PRF+3+SG
sobressolou-te	sobressolar+V.tu.AD.2.SG+PRF+3+SG
sobressolou-vos	sobressolar+V.vós.AD.2.PL+PRF+3+SG
sobressolo-vos	sobressolar+V.vós.AD.2.PL+PRS+1+SG
sobrestá-la-ão	sobrestar+V.ele.ACC.3.F.SG+FUT+3+PL
sobrestá-la-á	sobrestar+V.ele.ACC.3.F.SG+FUT+3+SG
sobrestá-la-ás	sobrestar+V.ele.ACC.3.F.SG+FUT+2+SG
sobrestá-la-ei	sobrestar+V.ele.ACC.3.F.SG+FUT+1+SG
sobrestá-la-eis	sobrestar+V.ele.ACC.3.F.SG+FUT+2+PL
sobrestá-la-emos	sobrestar+V.ele.ACC.3.F.SG+FUT+1+PL
sobrestá-la-íamos	sobrestar+V.ele.ACC.3.F.SG+COND+1+PL
sobrestá-la-iam	sobrestar+V.ele.ACC.3.F.SG+COND+3+PL
sobrestá-la-ia	sobrestar+V.ele.ACC.3.F.SG+COND+1+SG
sobrestá-la-ia	sobrestar+V.ele.ACC.3.F.SG+COND+3+SG
sobrestá-la-ias	sobrestar+V.ele.ACC.3.F.SG+COND+2+SG
sobrestá-la-íeis	sobrestar+V.ele.ACC.3.F.SG+COND+2+PL
sobrestá-las-ão	sobrestar+V.ele.ACC.3.F.PL+FUT+3+PL
sobrestá-las-á	sobrestar+V.ele.ACC.3.F.PL+FUT+3+SG
sobrestá-las-ás	sobrestar+V.ele.ACC.3.F.PL+FUT+2+SG
sobrestá-las-ei	sobrestar+V.ele.ACC.3.F.PL+FUT+1+SG
sobrestá-las-eis	sobrestar+V.ele.ACC.3.F.PL+FUT+2+PL
sobrestá-las-emos	sobrestar+V.ele.ACC.3.F.PL+FUT+1+PL
sobrestá-las-íamos	sobrestar+V.ele.ACC.3.F.PL+COND+1+PL
sobrestá-las-iam	sobrestar+V.ele.ACC.3.F.PL+COND+3+PL
sobrestá-las-ia	sobrestar+V.ele.ACC.3.F.PL+COND+1+SG
sobrestá-las-ia	sobrestar+V.ele.ACC.3.F.PL+COND+3+SG
sobrestá-las-ias	sobrestar+V.ele.ACC.3.F.PL+COND+2+SG
sobrestá-las-íeis	sobrestar+V.ele.ACC.3.F.PL+COND+2+PL
sobrestá-la	sobrestar+V.ele.ACC.3.F.SG+INF+1+SG
sobrestá-la	sobrestar+V.ele.ACC.3.F.SG+INF+3+SG
sobrestá-las	sobrestar+V.ele.ACC.3.F.PL+INF+1+SG
sobrestá-las	sobrestar+V.ele.ACC.3.F.PL+INF+3+SG
sobrestá-lo-ão	sobrestar+V.ele.ACC.3.M.SG+FUT+3+PL
sobrestá-lo-á	sobrestar+V.ele.ACC.3.M.SG+FUT+3+SG
sobrestá-lo-ás	sobrestar+V.ele.ACC.3.M.SG+FUT+2+SG
sobrestá-lo-ei	sobrestar+V.ele.ACC.3.M.SG+FUT+1+SG
sobrestá-lo-eis	sobrestar+V.ele.ACC.3.M.SG+FUT+2+PL
sobrestá-lo-emos	sobrestar+V.ele.ACC.3.M.SG+FUT+1+PL
sobrestá-lo-íamos	sobrestar+V.ele.ACC.3.M.SG+COND+1+PL
sobrestá-lo-iam	sobrestar+V.ele.ACC.3.M.SG+COND+3+PL
sobrestá-lo-ia	sobrestar+V.ele.ACC.3.M.SG+COND+1+SG
sobrestá-lo-ia	sobrestar+V.ele.ACC.3.M.SG+COND+3+SG
sobrestá-lo-ias	sobrestar+V.ele.ACC.3.M.SG+COND+2+SG
sobrestá-lo-íeis	sobrestar+V.ele.ACC.3.M.SG+COND+2+PL
sobrestá-los-ão	sobrestar+V.ele.ACC.3.M.PL+FUT+3+PL
sobrestá-los-á	sobrestar+V.ele.ACC.3.M.PL+FUT+3+SG
sobrestá-los-ás	sobrestar+V.ele.ACC.3.M.PL+FUT+2+SG
sobrestá-los-ei	sobrestar+V.ele.ACC.3.M.PL+FUT+1+SG
sobrestá-los-eis	sobrestar+V.ele.ACC.3.M.PL+FUT+2+PL
sobrestá-los-emos	sobrestar+V.ele.ACC.3.M.PL+FUT+1+PL
sobrestá-los-íamos	sobrestar+V.ele.ACC.3.M.PL+COND+1+PL
sobrestá-los-iam	sobrestar+V.ele.ACC.3.M.PL+COND+3+PL
sobrestá-los-ia	sobrestar+V.ele.ACC.3.M.PL+COND+1+SG
sobrestá-los-ia	sobrestar+V.ele.ACC.3.M.PL+COND+3+SG
sobrestá-los-ias	sobrestar+V.ele.ACC.3.M.PL+COND+2+SG
sobrestá-los-íeis	sobrestar+V.ele.ACC.3.M.PL+COND+2+PL
sobrestá-lo	sobrestar+V.ele.ACC.3.M.SG+INF+1+SG
sobrestá-lo	sobrestar+V.ele.ACC.3.M.SG+INF+3+SG
sobrestá-los	sobrestar+V.ele.ACC.3.M.PL+INF+1+SG
sobrestá-los	sobrestar+V.ele.ACC.3.M.PL+INF+3+SG
sobrestarde-la	sobrestar+V.ele.ACC.3.F.SG+INF+2+PL
sobrestarde-las	sobrestar+V.ele.ACC.3.F.PL+INF+2+PL
sobrestarde-lo	sobrestar+V.ele.ACC.3.M.SG+INF+2+PL
sobrestarde-los	sobrestar+V.ele.ACC.3.M.PL+INF+2+PL
sobrestarde-nos	sobrestar+nós.AD.1.PL+INF+2+PL
sobrestardes-lhe	sobrestar+V.ele.DAT.3.SG+INF+2+PL
sobrestardes-lhes	sobrestar+V.ele.DAT.3.PL+INF+2+PL
sobrestardes-me	sobrestar+V.eu.AD.1.SG+INF+2+PL
sobrestardes-te	sobrestar+V.tu.AD.2.SG+INF+2+PL
sobrestardes-vos	sobrestar+V.vós.AD.2.PL+INF+2+PL
sobrestare-la	sobrestar+V.ele.ACC.3.F.SG+INF+2+SG
sobrestare-las	sobrestar+V.ele.ACC.3.F.PL+INF+2+SG
sobrestare-lo	sobrestar+V.ele.ACC.3.M.SG+INF+2+SG
sobrestare-los	sobrestar+V.ele.ACC.3.M.PL+INF+2+SG
sobrestarem-lhe	sobrestar+V.ele.DAT.3.SG+INF+3+PL
sobrestarem-lhes	sobrestar+V.ele.DAT.3.PL+INF+3+PL
sobrestarem-me	sobrestar+V.eu.AD.1.SG+INF+3+PL
sobrestarem-na	sobrestar+V.ele.ACC.3.F.SG+INF+3+PL
sobrestarem-nas	sobrestar+V.ele.ACC.3.F.PL+INF+3+PL
sobrestarem-no	sobrestar+V.ele.ACC.3.M.SG+INF+3+PL
sobrestarem-nos	sobrestar+V.ele.ACC.3.M.PL+INF+3+PL
sobrestarem-nos	sobrestar+V.nós.AD.1.PL+INF+3+PL
sobrestarem-se	sobrestar+V.ele.REFL+INF+3+PL
sobrestarem-te	sobrestar+V.tu.AD.2.SG+INF+3+PL
sobrestarem-vos	sobrestar+V.vós.AD.2.PL+INF+3+PL
sobrestare-nos	sobrestar+nós.AD.1.PL+INF+2+SG
sobrestares-lhe	sobrestar+V.ele.DAT.3.SG+INF+2+SG
sobrestares-lhes	sobrestar+V.ele.DAT.3.PL+INF+2+SG
sobrestares-me	sobrestar+V.eu.AD.1.SG+INF+2+SG
sobrestares-te	sobrestar+V.tu.AD.2.SG+INF+2+SG
sobrestares-vos	sobrestar+V.vós.AD.2.PL+INF+2+SG
sobrestar-lhe-ão	sobrestar+V.ele.DAT.3.SG+FUT+3+PL
sobrestar-lhe-á	sobrestar+V.ele.DAT.3.SG+FUT+3+SG
sobrestar-lhe-ás	sobrestar+V.ele.DAT.3.SG+FUT+2+SG
sobrestar-lhe-ei	sobrestar+V.ele.DAT.3.SG+FUT+1+SG
sobrestar-lhe-eis	sobrestar+V.ele.DAT.3.SG+FUT+2+PL
sobrestar-lhe-emos	sobrestar+V.ele.DAT.3.SG+FUT+1+PL
sobrestar-lhe-íamos	sobrestar+V.ele.DAT.3.SG+COND+1+PL
sobrestar-lhe-iam	sobrestar+V.ele.DAT.3.SG+COND+3+PL
sobrestar-lhe-ia	sobrestar+V.ele.DAT.3.SG+COND+1+SG
sobrestar-lhe-ia	sobrestar+V.ele.DAT.3.SG+COND+3+SG
sobrestar-lhe-ias	sobrestar+V.ele.DAT.3.SG+COND+2+SG
sobrestar-lhe-íeis	sobrestar+V.ele.DAT.3.SG+COND+2+PL
sobrestar-lhes-ão	sobrestar+V.ele.DAT.3.PL+FUT+3+PL
sobrestar-lhes-á	sobrestar+V.ele.DAT.3.PL+FUT+3+SG
sobrestar-lhes-ás	sobrestar+V.ele.DAT.3.PL+FUT+2+SG
sobrestar-lhes-ei	sobrestar+V.ele.DAT.3.PL+FUT+1+SG
sobrestar-lhes-eis	sobrestar+V.ele.DAT.3.PL+FUT+2+PL
sobrestar-lhes-emos	sobrestar+V.ele.DAT.3.PL+FUT+1+PL
sobrestar-lhes-íamos	sobrestar+V.ele.DAT.3.PL+COND+1+PL
sobrestar-lhes-iam	sobrestar+V.ele.DAT.3.PL+COND+3+PL
sobrestar-lhes-ia	sobrestar+V.ele.DAT.3.PL+COND+1+SG
sobrestar-lhes-ia	sobrestar+V.ele.DAT.3.PL+COND+3+SG
sobrestar-lhes-ias	sobrestar+V.ele.DAT.3.PL+COND+2+SG
sobrestar-lhes-íeis	sobrestar+V.ele.DAT.3.PL+COND+2+PL
sobrestar-lhe	sobrestar+V.ele.DAT.3.SG+INF
sobrestar-lhe	sobrestar+V.ele.DAT.3.SG+INF+1+SG
sobrestar-lhe	sobrestar+V.ele.DAT.3.SG+INF+3+SG
sobrestar-lhes	sobrestar+V.ele.DAT.3.PL+INF
sobrestar-lhes	sobrestar+V.ele.DAT.3.PL+INF+1+SG
sobrestar-lhes	sobrestar+V.ele.DAT.3.PL+INF+3+SG
sobrestar-me-ão	sobrestar+V.eu.AD.1.SG+FUT+3+PL
sobrestar-me-á	sobrestar+V.eu.AD.1.SG+FUT+3+SG
sobrestar-me-ás	sobrestar+V.eu.AD.1.SG+FUT+2+SG
sobrestar-me-ei	sobrestar+V.eu.AD.1.SG+FUT+1+SG
sobrestar-me-eis	sobrestar+V.eu.AD.1.SG+FUT+2+PL
sobrestar-me-emos	sobrestar+V.eu.AD.1.SG+FUT+1+PL
sobrestar-me-íamos	sobrestar+V.eu.AD.1.SG+COND+1+PL
sobrestar-me-iam	sobrestar+V.eu.AD.1.SG+COND+3+PL
sobrestar-me-ia	sobrestar+V.eu.AD.1.SG+COND+1+SG
sobrestar-me-ia	sobrestar+V.eu.AD.1.SG+COND+3+SG
sobrestar-me-ias	sobrestar+V.eu.AD.1.SG+COND+2+SG
sobrestar-me-íeis	sobrestar+V.eu.AD.1.SG+COND+2+PL
sobrestar-me	sobrestar+V.eu.AD.1.SG+INF
sobrestar-me	sobrestar+V.eu.AD.1.SG+INF+1+SG
sobrestar-me	sobrestar+V.eu.AD.1.SG+INF+3+SG
sobrestarmo-la	sobrestar+V.ele.ACC.3.F.SG+INF+1+PL
sobrestarmo-las	sobrestar+V.ele.ACC.3.F.PL+INF+1+PL
sobrestarmo-lo	sobrestar+V.ele.ACC.3.M.SG+INF+1+PL
sobrestarmo-los	sobrestar+V.ele.ACC.3.M.PL+INF+1+PL
sobrestarmo-nos	sobrestar+nós.AD.1.PL+INF+1+PL
sobrestarmos-lhe	sobrestar+V.ele.DAT.3.SG+INF+1+PL
sobrestarmos-lhes	sobrestar+V.ele.DAT.3.PL+INF+1+PL
sobrestarmos-me	sobrestar+V.eu.AD.1.SG+INF+1+PL
sobrestarmos-te	sobrestar+V.tu.AD.2.SG+INF+1+PL
sobrestarmos-vos	sobrestar+V.vós.AD.2.PL+INF+1+PL
sobrestar-nos-ão	sobrestar+nós.AD.1.PL+FUT+3+PL
sobrestar-nos-á	sobrestar+nós.AD.1.PL+FUT+3+SG
sobrestar-nos-ás	sobrestar+nós.AD.1.PL+FUT+2+SG
sobrestar-nos-ei	sobrestar+nós.AD.1.PL+FUT+1+SG
sobrestar-nos-eis	sobrestar+nós.AD.1.PL+FUT+2+PL
sobrestar-nos-emos	sobrestar+nós.AD.1.PL+FUT+1+PL
sobrestar-nos-íamos	sobrestar+nós.AD.1.PL+COND+1+PL
sobrestar-nos-iam	sobrestar+nós.AD.1.PL+COND+3+PL
sobrestar-nos-ia	sobrestar+nós.AD.1.PL+COND+1+SG
sobrestar-nos-ia	sobrestar+nós.AD.1.PL+COND+3+SG
sobrestar-nos-ias	sobrestar+nós.AD.1.PL+COND+2+SG
sobrestar-nos-íeis	sobrestar+nós.AD.1.PL+COND+2+PL
sobrestar-nos	sobrestar+nós.AD.1.PL+INF
sobrestar-nos	sobrestar+nós.AD.1.PL+INF+1+SG
sobrestar-nos	sobrestar+nós.AD.1.PL+INF+3+SG
sobrestar-se-ão	sobrestar+V.ele.REFL+FUT+3+PL
sobrestar-se-á	sobrestar+V.ele.REFL+FUT+3+SG
sobrestar-se-iam	sobrestar+V.ele.REFL+COND+3+PL
sobrestar-se-ia	sobrestar+V.ele.REFL+COND+3+SG
sobrestar-se	sobrestar+V.ele.REFL+INF
sobrestar-se	sobrestar+V.ele.REFL+INF+3+SG
sobrestar-te-ão	sobrestar+V.tu.AD.2.SG+FUT+3+PL
sobrestar-te-á	sobrestar+V.tu.AD.2.SG+FUT+3+SG
sobrestar-te-ás	sobrestar+V.tu.AD.2.SG+FUT+2+SG
sobrestar-te-ei	sobrestar+V.tu.AD.2.SG+FUT+1+SG
sobrestar-te-eis	sobrestar+V.tu.AD.2.SG+FUT+2+PL
sobrestar-te-emos	sobrestar+V.tu.AD.2.SG+FUT+1+PL
sobrestar-te-íamos	sobrestar+V.tu.AD.2.SG+COND+1+PL
sobrestar-te-iam	sobrestar+V.tu.AD.2.SG+COND+3+PL
sobrestar-te-ia	sobrestar+V.tu.AD.2.SG+COND+1+SG
sobrestar-te-ia	sobrestar+V.tu.AD.2.SG+COND+3+SG
sobrestar-te-ias	sobrestar+V.tu.AD.2.SG+COND+2+SG
sobrestar-te-íeis	sobrestar+V.tu.AD.2.SG+COND+2+PL
sobrestar-te	sobrestar+V.tu.AD.2.SG+INF
sobrestar-te	sobrestar+V.tu.AD.2.SG+INF+1+SG
sobrestar-te	sobrestar+V.tu.AD.2.SG+INF+3+SG
sobrestar-vos-ão	sobrestar+V.vós.AD.2.PL+FUT+3+PL
sobrestar-vos-á	sobrestar+V.vós.AD.2.PL+FUT+3+SG
sobrestar-vos-ás	sobrestar+V.vós.AD.2.PL+FUT+2+SG
sobrestar-vos-ei	sobrestar+V.vós.AD.2.PL+FUT+1+SG
sobrestar-vos-eis	sobrestar+V.vós.AD.2.PL+FUT+2+PL
sobrestar-vos-emos	sobrestar+V.vós.AD.2.PL+FUT+1+PL
sobrestar-vos-íamos	sobrestar+V.vós.AD.2.PL+COND+1+PL
sobrestar-vos-iam	sobrestar+V.vós.AD.2.PL+COND+3+PL
sobrestar-vos-ia	sobrestar+V.vós.AD.2.PL+COND+1+SG
sobrestar-vos-ia	sobrestar+V.vós.AD.2.PL+COND+3+SG
sobrestar-vos-ias	sobrestar+V.vós.AD.2.PL+COND+2+SG
sobrestar-vos-íeis	sobrestar+V.vós.AD.2.PL+COND+2+PL
sobrestar-vos	sobrestar+V.vós.AD.2.PL+INF
sobrestar-vos	sobrestar+V.vós.AD.2.PL+INF+1+SG
sobrestar-vos	sobrestar+V.vós.AD.2.PL+INF+3+SG
sobrestava-a	sobrestar+V.ele.ACC.3.F.SG+IMPF+1+SG
sobrestava-a	sobrestar+V.ele.ACC.3.F.SG+IMPF+3+SG
sobrestava-as	sobrestar+V.ele.ACC.3.F.PL+IMPF+1+SG
sobrestava-as	sobrestar+V.ele.ACC.3.F.PL+IMPF+3+SG
sobrestava-la	sobrestar+V.ele.ACC.3.F.SG+IMPF+2+SG
sobrestava-las	sobrestar+V.ele.ACC.3.F.PL+IMPF+2+SG
sobrestava-lhe	sobrestar+V.ele.DAT.3.SG+IMPF+1+SG
sobrestava-lhe	sobrestar+V.ele.DAT.3.SG+IMPF+3+SG
sobrestava-lhes	sobrestar+V.ele.DAT.3.PL+IMPF+1+SG
sobrestava-lhes	sobrestar+V.ele.DAT.3.PL+IMPF+3+SG
sobrestava-lo	sobrestar+V.ele.ACC.3.M.SG+IMPF+2+SG
sobrestava-los	sobrestar+V.ele.ACC.3.M.PL+IMPF+2+SG
sobrestava-me	sobrestar+V.eu.AD.1.SG+IMPF+1+SG
sobrestava-me	sobrestar+V.eu.AD.1.SG+IMPF+3+SG
sobrestavam-lhe	sobrestar+V.ele.DAT.3.SG+IMPF+3+PL
sobrestavam-lhes	sobrestar+V.ele.DAT.3.PL+IMPF+3+PL
sobrestavam-me	sobrestar+V.eu.AD.1.SG+IMPF+3+PL
sobrestavam-na	sobrestar+V.ele.ACC.3.F.SG+IMPF+3+PL
sobrestavam-nas	sobrestar+V.ele.ACC.3.F.PL+IMPF+3+PL
sobrestavam-no	sobrestar+V.ele.ACC.3.M.SG+IMPF+3+PL
sobrestavam-nos	sobrestar+V.ele.ACC.3.M.PL+IMPF+3+PL
sobrestavam-nos	sobrestar+V.nós.AD.1.PL+IMPF+3+PL
sobrestávamo-la	sobrestar+V.ele.ACC.3.F.SG+IMPF+1+PL
sobrestávamo-las	sobrestar+V.ele.ACC.3.F.PL+IMPF+1+PL
sobrestávamo-lo	sobrestar+V.ele.ACC.3.M.SG+IMPF+1+PL
sobrestávamo-los	sobrestar+V.ele.ACC.3.M.PL+IMPF+1+PL
sobrestávamo-nos	sobrestar+nós.AD.1.PL+IMPF+1+PL
sobrestávamos-lhe	sobrestar+V.ele.DAT.3.SG+IMPF+1+PL
sobrestávamos-lhes	sobrestar+V.ele.DAT.3.PL+IMPF+1+PL
sobrestávamos-me	sobrestar+V.eu.AD.1.SG+IMPF+1+PL
sobrestávamos-te	sobrestar+V.tu.AD.2.SG+IMPF+1+PL
sobrestávamos-vos	sobrestar+V.vós.AD.2.PL+IMPF+1+PL
sobrestavam-se	sobrestar+V.ele.REFL+IMPF+3+PL
sobrestavam-te	sobrestar+V.tu.AD.2.SG+IMPF+3+PL
sobrestavam-vos	sobrestar+V.vós.AD.2.PL+IMPF+3+PL
sobrestava-nos	sobrestar+nós.AD.1.PL+IMPF+1+SG
sobrestava-nos	sobrestar+nós.AD.1.PL+IMPF+2+SG
sobrestava-nos	sobrestar+nós.AD.1.PL+IMPF+3+SG
sobrestava-o	sobrestar+V.ele.ACC.3.M.SG+IMPF+1+SG
sobrestava-o	sobrestar+V.ele.ACC.3.M.SG+IMPF+3+SG
sobrestava-os	sobrestar+V.ele.ACC.3.M.PL+IMPF+1+SG
sobrestava-os	sobrestar+V.ele.ACC.3.M.PL+IMPF+3+SG
sobrestava-se	sobrestar+V.ele.REFL+IMPF+1+SG
sobrestava-se	sobrestar+V.ele.REFL+IMPF+3+SG
sobrestavas-lhe	sobrestar+V.ele.DAT.3.SG+IMPF+2+SG
sobrestavas-lhes	sobrestar+V.ele.DAT.3.PL+IMPF+2+SG
sobrestavas-me	sobrestar+V.eu.AD.1.SG+IMPF+2+SG
sobrestavas-te	sobrestar+V.tu.AD.2.SG+IMPF+2+SG
sobrestavas-vos	sobrestar+V.vós.AD.2.PL+IMPF+2+SG
sobrestava-te	sobrestar+V.tu.AD.2.SG+IMPF+1+SG
sobrestava-te	sobrestar+V.tu.AD.2.SG+IMPF+3+SG
sobrestava-vos	sobrestar+V.vós.AD.2.PL+IMPF+1+SG
sobrestava-vos	sobrestar+V.vós.AD.2.PL+IMPF+3+SG
sobrestávei-la	sobrestar+V.ele.ACC.3.F.SG+IMPF+2+PL
sobrestávei-las	sobrestar+V.ele.ACC.3.F.PL+IMPF+2+PL
sobrestávei-lo	sobrestar+V.ele.ACC.3.M.SG+IMPF+2+PL
sobrestávei-los	sobrestar+V.ele.ACC.3.M.PL+IMPF+2+PL
sobrestávei-nos	sobrestar+nós.AD.1.PL+IMPF+2+PL
sobrestáveis-lhe	sobrestar+V.ele.DAT.3.SG+IMPF+2+PL
sobrestáveis-lhes	sobrestar+V.ele.DAT.3.PL+IMPF+2+PL
sobrestáveis-me	sobrestar+V.eu.AD.1.SG+IMPF+2+PL
sobrestáveis-te	sobrestar+V.tu.AD.2.SG+IMPF+2+PL
sobrestáveis-vos	sobrestar+V.vós.AD.2.PL+IMPF+2+PL
sobresteve-a	sobrestar+V.ele.ACC.3.F.SG+PRF+3+SG
sobresteve-as	sobrestar+V.ele.ACC.3.F.PL+PRF+3+SG
sobresteve-lhe	sobrestar+V.ele.DAT.3.SG+PRF+3+SG
sobresteve-lhes	sobrestar+V.ele.DAT.3.PL+PRF+3+SG
sobresteve-me	sobrestar+V.eu.AD.1.SG+PRF+3+SG
sobresteve-nos	sobrestar+nós.AD.1.PL+PRF+3+SG
sobresteve-o	sobrestar+V.ele.ACC.3.M.SG+PRF+3+SG
sobresteve-os	sobrestar+V.ele.ACC.3.M.PL+PRF+3+SG
sobresteve-se	sobrestar+V.ele.REFL+PRF+3+SG
sobresteve-te	sobrestar+V.tu.AD.2.SG+PRF+3+SG
sobresteve-vos	sobrestar+V.vós.AD.2.PL+PRF+3+SG
sobrestive-a	sobrestar+V.ele.ACC.3.F.SG+PRF+1+SG
sobrestive-as	sobrestar+V.ele.ACC.3.F.PL+PRF+1+SG
sobrestivé-la	sobrestar+V.ele.ACC.3.F.SG+SBJF+1+SG
sobrestivé-la	sobrestar+V.ele.ACC.3.F.SG+SBJF+3+SG
sobrestivé-las	sobrestar+V.ele.ACC.3.F.PL+SBJF+1+SG
sobrestivé-las	sobrestar+V.ele.ACC.3.F.PL+SBJF+3+SG
sobrestive-lhe	sobrestar+V.ele.DAT.3.SG+PRF+1+SG
sobrestive-lhes	sobrestar+V.ele.DAT.3.PL+PRF+1+SG
sobrestivé-lo	sobrestar+V.ele.ACC.3.M.SG+SBJF+1+SG
sobrestivé-lo	sobrestar+V.ele.ACC.3.M.SG+SBJF+3+SG
sobrestivé-los	sobrestar+V.ele.ACC.3.M.PL+SBJF+1+SG
sobrestivé-los	sobrestar+V.ele.ACC.3.M.PL+SBJF+3+SG
sobrestive-me	sobrestar+V.eu.AD.1.SG+PRF+1+SG
sobrestivemo-la	sobrestar+V.ele.ACC.3.F.SG+PRF+1+PL
sobrestivemo-las	sobrestar+V.ele.ACC.3.F.PL+PRF+1+PL
sobrestivemo-lo	sobrestar+V.ele.ACC.3.M.SG+PRF+1+PL
sobrestivemo-los	sobrestar+V.ele.ACC.3.M.PL+PRF+1+PL
sobrestivemo-nos	sobrestar+nós.AD.1.PL+PRF+1+PL
sobrestivemos-lhe	sobrestar+V.ele.DAT.3.SG+PRF+1+PL
sobrestivemos-lhes	sobrestar+V.ele.DAT.3.PL+PRF+1+PL
sobrestivemos-me	sobrestar+V.eu.AD.1.SG+PRF+1+PL
sobrestivemos-te	sobrestar+V.tu.AD.2.SG+PRF+1+PL
sobrestivemos-vos	sobrestar+V.vós.AD.2.PL+PRF+1+PL
sobrestive-nos	sobrestar+nós.AD.1.PL+PRF+1+SG
sobrestive-o	sobrestar+V.ele.ACC.3.M.SG+PRF+1+SG
sobrestive-os	sobrestar+V.ele.ACC.3.M.PL+PRF+1+SG
sobrestiveram-lhe	sobrestar+V.ele.DAT.3.SG+PRF+3+PL
sobrestiveram-lhes	sobrestar+V.ele.DAT.3.PL+PRF+3+PL
sobrestiveram-me	sobrestar+V.eu.AD.1.SG+PRF+3+PL
sobrestiveram-na	sobrestar+V.ele.ACC.3.F.SG+PRF+3+PL
sobrestiveram-nas	sobrestar+V.ele.ACC.3.F.PL+PRF+3+PL
sobrestiveram-no	sobrestar+V.ele.ACC.3.M.SG+PRF+3+PL
sobrestiveram-nos	sobrestar+V.ele.ACC.3.M.PL+PRF+3+PL
sobrestiveram-nos	sobrestar+V.nós.AD.1.PL+PRF+3+PL
sobrestiveram-se	sobrestar+V.ele.REFL+PRF+3+PL
sobrestiveram-te	sobrestar+V.tu.AD.2.SG+PRF+3+PL
sobrestiveram-vos	sobrestar+V.vós.AD.2.PL+PRF+3+PL
sobrestiverde-la	sobrestar+V.ele.ACC.3.F.SG+SBJF+2+PL
sobrestiverde-las	sobrestar+V.ele.ACC.3.F.PL+SBJF+2+PL
sobrestiverde-lo	sobrestar+V.ele.ACC.3.M.SG+SBJF+2+PL
sobrestiverde-los	sobrestar+V.ele.ACC.3.M.PL+SBJF+2+PL
sobrestiverde-nos	sobrestar+nós.AD.1.PL+SBJF+2+PL
sobrestiverdes-lhe	sobrestar+V.ele.DAT.3.SG+SBJF+2+PL
sobrestiverdes-lhes	sobrestar+V.ele.DAT.3.PL+SBJF+2+PL
sobrestiverdes-me	sobrestar+V.eu.AD.1.SG+SBJF+2+PL
sobrestiverdes-te	sobrestar+V.tu.AD.2.SG+SBJF+2+PL
sobrestiverdes-vos	sobrestar+V.vós.AD.2.PL+SBJF+2+PL
sobrestivere-la	sobrestar+V.ele.ACC.3.F.SG+SBJF+2+SG
sobrestivere-las	sobrestar+V.ele.ACC.3.F.PL+SBJF+2+SG
sobrestivere-lo	sobrestar+V.ele.ACC.3.M.SG+SBJF+2+SG
sobrestivere-los	sobrestar+V.ele.ACC.3.M.PL+SBJF+2+SG
sobrestiverem-lhe	sobrestar+V.ele.DAT.3.SG+SBJF+3+PL
sobrestiverem-lhes	sobrestar+V.ele.DAT.3.PL+SBJF+3+PL
sobrestiverem-me	sobrestar+V.eu.AD.1.SG+SBJF+3+PL
sobrestiverem-na	sobrestar+V.ele.ACC.3.F.SG+SBJF+3+PL
sobrestiverem-nas	sobrestar+V.ele.ACC.3.F.PL+SBJF+3+PL
sobrestiverem-no	sobrestar+V.ele.ACC.3.M.SG+SBJF+3+PL
sobrestiverem-nos	sobrestar+V.ele.ACC.3.M.PL+SBJF+3+PL
sobrestiverem-nos	sobrestar+V.nós.AD.1.PL+SBJF+3+PL
sobrestiverem-se	sobrestar+V.ele.REFL+SBJF+3+PL
sobrestiverem-te	sobrestar+V.tu.AD.2.SG+SBJF+3+PL
sobrestiverem-vos	sobrestar+V.vós.AD.2.PL+SBJF+3+PL
sobrestivere-nos	sobrestar+nós.AD.1.PL+SBJF+2+SG
sobrestiveres-lhe	sobrestar+V.ele.DAT.3.SG+SBJF+2+SG
sobrestiveres-lhes	sobrestar+V.ele.DAT.3.PL+SBJF+2+SG
sobrestiveres-me	sobrestar+V.eu.AD.1.SG+SBJF+2+SG
sobrestiveres-te	sobrestar+V.tu.AD.2.SG+SBJF+2+SG
sobrestiveres-vos	sobrestar+V.vós.AD.2.PL+SBJF+2+SG
sobrestivermo-la	sobrestar+V.ele.ACC.3.F.SG+SBJF+1+PL
sobrestivermo-las	sobrestar+V.ele.ACC.3.F.PL+SBJF+1+PL
sobrestivermo-lo	sobrestar+V.ele.ACC.3.M.SG+SBJF+1+PL
sobrestivermo-los	sobrestar+V.ele.ACC.3.M.PL+SBJF+1+PL
sobrestivermo-nos	sobrestar+nós.AD.1.PL+SBJF+1+PL
sobrestivermos-lhe	sobrestar+V.ele.DAT.3.SG+SBJF+1+PL
sobrestivermos-lhes	sobrestar+V.ele.DAT.3.PL+SBJF+1+PL
sobrestivermos-me	sobrestar+V.eu.AD.1.SG+SBJF+1+PL
sobrestivermos-te	sobrestar+V.tu.AD.2.SG+SBJF+1+PL
sobrestivermos-vos	sobrestar+V.vós.AD.2.PL+SBJF+1+PL
sobrestiveste-a	sobrestar+V.ele.ACC.3.F.SG+PRF+2+SG
sobrestiveste-as	sobrestar+V.ele.ACC.3.F.PL+PRF+2+SG
sobrestiveste-la	sobrestar+V.ele.ACC.3.F.SG+PRF+2+PL
sobrestiveste-las	sobrestar+V.ele.ACC.3.F.PL+PRF+2+PL
sobrestiveste-lhe	sobrestar+V.ele.DAT.3.SG+PRF+2+SG
sobrestiveste-lhes	sobrestar+V.ele.DAT.3.PL+PRF+2+SG
sobrestiveste-lo	sobrestar+V.ele.ACC.3.M.SG+PRF+2+PL
sobrestiveste-los	sobrestar+V.ele.ACC.3.M.PL+PRF+2+PL
sobrestiveste-me	sobrestar+V.eu.AD.1.SG+PRF+2+SG
sobrestiveste-nos	sobrestar+nós.AD.1.PL+PRF+2+PL
sobrestiveste-nos	sobrestar+nós.AD.1.PL+PRF+2+SG
sobrestiveste-o	sobrestar+V.ele.ACC.3.M.SG+PRF+2+SG
sobrestiveste-os	sobrestar+V.ele.ACC.3.M.PL+PRF+2+SG
sobrestivestes-lhe	sobrestar+V.ele.DAT.3.SG+PRF+2+PL
sobrestivestes-lhes	sobrestar+V.ele.DAT.3.PL+PRF+2+PL
sobrestivestes-me	sobrestar+V.eu.AD.1.SG+PRF+2+PL
sobrestivestes-te	sobrestar+V.tu.AD.2.SG+PRF+2+PL
sobrestivestes-vos	sobrestar+V.vós.AD.2.PL+PRF+2+PL
sobrestiveste-te	sobrestar+V.tu.AD.2.SG+PRF+2+SG
sobrestiveste-vos	sobrestar+V.vós.AD.2.PL+PRF+2+SG
sobrestive-te	sobrestar+V.tu.AD.2.SG+PRF+1+SG
sobrestive-vos	sobrestar+V.vós.AD.2.PL+PRF+1+SG
sobreteça-a	sobretecer+V.ele.ACC.3.F.SG+IMP+3+SG
sobreteça-as	sobretecer+V.ele.ACC.3.F.PL+IMP+3+SG
sobreteça-lhe	sobretecer+V.ele.DAT.3.SG+IMP+3+SG
sobreteça-lhes	sobretecer+V.ele.DAT.3.PL+IMP+3+SG
sobreteça-me	sobretecer+V.eu.AD.1.SG+IMP+3+SG
sobreteçam-lhe	sobretecer+V.ele.DAT.3.SG+IMP+3+PL
sobreteçam-lhes	sobretecer+V.ele.DAT.3.PL+IMP+3+PL
sobreteçam-me	sobretecer+V.eu.AD.1.SG+IMP+3+PL
sobreteçam-na	sobretecer+V.ele.ACC.3.F.SG+IMP+3+PL
sobreteçam-nas	sobretecer+V.ele.ACC.3.F.PL+IMP+3+PL
sobreteçam-no	sobretecer+V.ele.ACC.3.M.SG+IMP+3+PL
sobreteçam-nos	sobretecer+nós.AD.1.PL+IMP+3+PL
sobreteçamo-la	sobretecer+V.ele.ACC.3.F.SG+IMP+1+PL
sobreteçamo-las	sobretecer+V.ele.ACC.3.F.PL+IMP+1+PL
sobreteçamo-lo	sobretecer+V.ele.ACC.3.M.SG+IMP+1+PL
sobreteçamo-los	sobretecer+V.ele.ACC.3.M.PL+IMP+1+PL
sobreteçamo-nos	sobretecer+nós.AD.1.PL+IMP+1+PL
sobreteçamos-lhe	sobretecer+V.ele.DAT.3.SG+IMP+1+PL
sobreteçamos-lhes	sobretecer+V.ele.DAT.3.PL+IMP+1+PL
sobreteçamos-me	sobretecer+V.eu.AD.1.SG+IMP+1+PL
sobreteçamos-te	sobretecer+V.tu.AD.2.SG+IMP+1+PL
sobreteçamos-vos	sobretecer+V.vós.AD.2.PL+IMP+1+PL
sobreteçam-se	sobretecer+V.ele.REFL+IMP+3+PL
sobreteçam-te	sobretecer+V.tu.AD.2.SG+IMP+3+PL
sobreteçam-vos	sobretecer+V.vós.AD.2.PL+IMP+3+PL
sobreteça-nos	sobretecer+nós.AD.1.PL+IMP+3+SG
sobreteça-o	sobretecer+V.ele.ACC.3.M.SG+IMP+3+SG
sobreteça-os	sobretecer+V.ele.ACC.3.M.PL+IMP+3+SG
sobreteça-se	sobretecer+V.ele.REFL+IMP+3+SG
sobreteça-te	sobretecer+V.tu.AD.2.SG+IMP+3+SG
sobreteça-vos	sobretecer+V.vós.AD.2.PL+IMP+3+SG
sobretecei-la	sobretecer+V.ele.ACC.3.F.SG+PRS+2+PL
sobretecei-las	sobretecer+V.ele.ACC.3.F.PL+PRS+2+PL
sobretecei-lo	sobretecer+V.ele.ACC.3.M.SG+PRS+2+PL
sobretecei-los	sobretecer+V.ele.ACC.3.M.PL+PRS+2+PL
sobretecei-nos	sobretecer+nós.AD.1.PL+PRS+2+PL
sobreteceis-lhe	sobretecer+V.ele.DAT.3.SG+PRS+2+PL
sobreteceis-lhes	sobretecer+V.ele.DAT.3.PL+PRS+2+PL
sobreteceis-me	sobretecer+V.eu.AD.1.SG+PRS+2+PL
sobreteceis-te	sobretecer+V.tu.AD.2.SG+PRS+2+PL
sobreteceis-vos	sobretecer+V.vós.AD.2.PL+PRS+2+PL
sobretecê-la-ão	sobretecer+V.ele.ACC.3.F.SG+FUT+3+PL
sobretecê-la-á	sobretecer+V.ele.ACC.3.F.SG+FUT+3+SG
sobretecê-la-ás	sobretecer+V.ele.ACC.3.F.SG+FUT+2+SG
sobretecê-la-ei	sobretecer+V.ele.ACC.3.F.SG+FUT+1+SG
sobretecê-la-eis	sobretecer+V.ele.ACC.3.F.SG+FUT+2+PL
sobretecê-la-emos	sobretecer+V.ele.ACC.3.F.SG+FUT+1+PL
sobretecê-la-íamos	sobretecer+V.ele.ACC.3.F.SG+COND+1+PL
sobretecê-la-iam	sobretecer+V.ele.ACC.3.F.SG+COND+3+PL
sobretecê-la-ia	sobretecer+V.ele.ACC.3.F.SG+COND+1+SG
sobretecê-la-ia	sobretecer+V.ele.ACC.3.F.SG+COND+3+SG
sobretecê-la-ias	sobretecer+V.ele.ACC.3.F.SG+COND+2+SG
sobretecê-la-íeis	sobretecer+V.ele.ACC.3.F.SG+COND+2+PL
sobretecê-las-ão	sobretecer+V.ele.ACC.3.F.PL+FUT+3+PL
sobretecê-las-á	sobretecer+V.ele.ACC.3.F.PL+FUT+3+SG
sobretecê-las-ás	sobretecer+V.ele.ACC.3.F.PL+FUT+2+SG
sobretecê-las-ei	sobretecer+V.ele.ACC.3.F.PL+FUT+1+SG
sobretecê-las-eis	sobretecer+V.ele.ACC.3.F.PL+FUT+2+PL
sobretecê-las-emos	sobretecer+V.ele.ACC.3.F.PL+FUT+1+PL
sobretecê-las-íamos	sobretecer+V.ele.ACC.3.F.PL+COND+1+PL
sobretecê-las-iam	sobretecer+V.ele.ACC.3.F.PL+COND+3+PL
sobretecê-las-ia	sobretecer+V.ele.ACC.3.F.PL+COND+1+SG
sobretecê-las-ia	sobretecer+V.ele.ACC.3.F.PL+COND+3+SG
sobretecê-las-ias	sobretecer+V.ele.ACC.3.F.PL+COND+2+SG
sobretecê-las-íeis	sobretecer+V.ele.ACC.3.F.PL+COND+2+PL
sobretecê-la	sobretecer+V.ele.ACC.3.F.SG+INF
sobretecê-la	sobretecer+V.ele.ACC.3.F.SG+INF+1+SG
sobretecê-la	sobretecer+V.ele.ACC.3.F.SG+INF+3+SG
sobretece-la	sobretecer+V.ele.ACC.3.F.SG+PRS+2+SG
sobretecê-la	sobretecer+V.ele.ACC.3.F.SG+SBJF+1+SG
sobretecê-la	sobretecer+V.ele.ACC.3.F.SG+SBJF+3+SG
sobretecê-las	sobretecer+V.ele.ACC.3.F.PL+INF
sobretecê-las	sobretecer+V.ele.ACC.3.F.PL+INF+1+SG
sobretecê-las	sobretecer+V.ele.ACC.3.F.PL+INF+3+SG
sobretece-las	sobretecer+V.ele.ACC.3.F.PL+PRS+2+SG
sobretecê-las	sobretecer+V.ele.ACC.3.F.PL+SBJF+1+SG
sobretecê-las	sobretecer+V.ele.ACC.3.F.PL+SBJF+3+SG
sobretecê-lo-ão	sobretecer+V.ele.ACC.3.M.SG+FUT+3+PL
sobretecê-lo-á	sobretecer+V.ele.ACC.3.M.SG+FUT+3+SG
sobretecê-lo-ás	sobretecer+V.ele.ACC.3.M.SG+FUT+2+SG
sobretecê-lo-ei	sobretecer+V.ele.ACC.3.M.SG+FUT+1+SG
sobretecê-lo-eis	sobretecer+V.ele.ACC.3.M.SG+FUT+2+PL
sobretecê-lo-emos	sobretecer+V.ele.ACC.3.M.SG+FUT+1+PL
sobretecê-lo-íamos	sobretecer+V.ele.ACC.3.M.SG+COND+1+PL
sobretecê-lo-iam	sobretecer+V.ele.ACC.3.M.SG+COND+3+PL
sobretecê-lo-ia	sobretecer+V.ele.ACC.3.M.SG+COND+1+SG
sobretecê-lo-ia	sobretecer+V.ele.ACC.3.M.SG+COND+3+SG
sobretecê-lo-ias	sobretecer+V.ele.ACC.3.M.SG+COND+2+SG
sobretecê-lo-íeis	sobretecer+V.ele.ACC.3.M.SG+COND+2+PL
sobretecê-los-ão	sobretecer+V.ele.ACC.3.M.PL+FUT+3+PL
sobretecê-los-á	sobretecer+V.ele.ACC.3.M.PL+FUT+3+SG
sobretecê-los-ás	sobretecer+V.ele.ACC.3.M.PL+FUT+2+SG
sobretecê-los-ei	sobretecer+V.ele.ACC.3.M.PL+FUT+1+SG
sobretecê-los-eis	sobretecer+V.ele.ACC.3.M.PL+FUT+2+PL
sobretecê-los-emos	sobretecer+V.ele.ACC.3.M.PL+FUT+1+PL
sobretecê-los-íamos	sobretecer+V.ele.ACC.3.M.PL+COND+1+PL
sobretecê-los-iam	sobretecer+V.ele.ACC.3.M.PL+COND+3+PL
sobretecê-los-ia	sobretecer+V.ele.ACC.3.M.PL+COND+1+SG
sobretecê-los-ia	sobretecer+V.ele.ACC.3.M.PL+COND+3+SG
sobretecê-los-ias	sobretecer+V.ele.ACC.3.M.PL+COND+2+SG
sobretecê-los-íeis	sobretecer+V.ele.ACC.3.M.PL+COND+2+PL
sobretecê-lo	sobretecer+V.ele.ACC.3.M.SG+INF
sobretecê-lo	sobretecer+V.ele.ACC.3.M.SG+INF+1+SG
sobretecê-lo	sobretecer+V.ele.ACC.3.M.SG+INF+3+SG
sobretece-lo	sobretecer+V.ele.ACC.3.M.SG+PRS+2+SG
sobretecê-lo	sobretecer+V.ele.ACC.3.M.SG+SBJF+1+SG
sobretecê-lo	sobretecer+V.ele.ACC.3.M.SG+SBJF+3+SG
sobretecê-los	sobretecer+V.ele.ACC.3.M.PL+INF
sobretecê-los	sobretecer+V.ele.ACC.3.M.PL+INF+1+SG
sobretecê-los	sobretecer+V.ele.ACC.3.M.PL+INF+3+SG
sobretece-los	sobretecer+V.ele.ACC.3.M.PL+PRS+2+SG
sobretecê-los	sobretecer+V.ele.ACC.3.M.PL+SBJF+1+SG
sobretecê-los	sobretecer+V.ele.ACC.3.M.PL+SBJF+3+SG
sobretecem-lhe	sobretecer+V.ele.DAT.3.SG+PRS+3+PL
sobretecem-lhes	sobretecer+V.ele.DAT.3.PL+PRS+3+PL
sobretecem-me	sobretecer+V.eu.AD.1.SG+PRS+3+PL
sobretecem-na	sobretecer+V.ele.ACC.3.F.SG+PRS+3+PL
sobretecem-nas	sobretecer+V.ele.ACC.3.F.PL+PRS+3+PL
sobretecem-no	sobretecer+V.ele.ACC.3.M.SG+PRS+3+PL
sobretecem-nos	sobretecer+V.ele.ACC.3.M.PL+PRS+3+PL
sobretecem-nos	sobretecer+V.nós.AD.1.PL+PRS+3+PL
sobretecemo-la	sobretecer+V.ele.ACC.3.F.SG+PRF+1+PL
sobretecemo-la	sobretecer+V.ele.ACC.3.F.SG+PRS+1+PL
sobretecemo-las	sobretecer+V.ele.ACC.3.F.PL+PRF+1+PL
sobretecemo-las	sobretecer+V.ele.ACC.3.F.PL+PRS+1+PL
sobretecemo-lo	sobretecer+V.ele.ACC.3.M.SG+PRF+1+PL
sobretecemo-lo	sobretecer+V.ele.ACC.3.M.SG+PRS+1+PL
sobretecemo-los	sobretecer+V.ele.ACC.3.M.PL+PRF+1+PL
sobretecemo-los	sobretecer+V.ele.ACC.3.M.PL+PRS+1+PL
sobretecemo-nos	sobretecer+nós.AD.1.PL+PRF+1+PL
sobretecemo-nos	sobretecer+nós.AD.1.PL+PRS+1+PL
sobretecemos-lhe	sobretecer+V.ele.DAT.3.SG+PRF+1+PL
sobretecemos-lhe	sobretecer+V.ele.DAT.3.SG+PRS+1+PL
sobretecemos-lhes	sobretecer+V.ele.DAT.3.PL+PRF+1+PL
sobretecemos-lhes	sobretecer+V.ele.DAT.3.PL+PRS+1+PL
sobretecemos-me	sobretecer+V.eu.AD.1.SG+PRF+1+PL
sobretecemos-me	sobretecer+V.eu.AD.1.SG+PRS+1+PL
sobretecemos-te	sobretecer+V.tu.AD.2.SG+PRF+1+PL
sobretecemos-te	sobretecer+V.tu.AD.2.SG+PRS+1+PL
sobretecemos-vos	sobretecer+V.vós.AD.2.PL+PRF+1+PL
sobretecemos-vos	sobretecer+V.vós.AD.2.PL+PRS+1+PL
sobretecem-se	sobretecer+V.ele.REFL+PRS+3+PL
sobretecem-te	sobretecer+V.tu.AD.2.SG+PRS+3+PL
sobretecem-vos	sobretecer+V.vós.AD.2.PL+PRS+3+PL
sobretecendo-a	sobretecer+V.ele.ACC.3.F.SG+GRD
sobretecendo-as	sobretecer+V.ele.ACC.3.F.PL+GRD
sobretecendo-lhe	sobretecer+V.ele.DAT.3.SG+GRD
sobretecendo-lhes	sobretecer+V.ele.DAT.3.PL+GRD
sobretecendo-me	sobretecer+V.eu.AD.1.SG+GRD
sobretecendo-nos	sobretecer+nós.AD.1.PL+GRD
sobretecendo-o	sobretecer+V.ele.ACC.3.M.SG+GRD
sobretecendo-os	sobretecer+V.ele.ACC.3.M.PL+GRD
sobretecendo-se	sobretecer+V.ele.REFL+GRD
sobretecendo-te	sobretecer+V.tu.AD.2.SG+GRD
sobretecendo-vos	sobretecer+V.vós.AD.2.PL+GRD
sobretece-nos	sobretecer+nós.AD.1.PL+PRS+2+SG
sobretecera-a	sobretecer+V.ele.ACC.3.F.SG+PQP+1+SG
sobretecera-a	sobretecer+V.ele.ACC.3.F.SG+PQP+3+SG
sobretecera-as	sobretecer+V.ele.ACC.3.F.PL+PQP+1+SG
sobretecera-as	sobretecer+V.ele.ACC.3.F.PL+PQP+3+SG
sobretecera-la	sobretecer+V.ele.ACC.3.F.SG+PQP+2+SG
sobretecera-las	sobretecer+V.ele.ACC.3.F.PL+PQP+2+SG
sobretecera-lhe	sobretecer+V.ele.DAT.3.SG+PQP+1+SG
sobretecera-lhe	sobretecer+V.ele.DAT.3.SG+PQP+3+SG
sobretecera-lhes	sobretecer+V.ele.DAT.3.PL+PQP+1+SG
sobretecera-lhes	sobretecer+V.ele.DAT.3.PL+PQP+3+SG
sobretecera-lo	sobretecer+V.ele.ACC.3.M.SG+PQP+2+SG
sobretecera-los	sobretecer+V.ele.ACC.3.M.PL+PQP+2+SG
sobretecera-me	sobretecer+V.eu.AD.1.SG+PQP+1+SG
sobretecera-me	sobretecer+V.eu.AD.1.SG+PQP+3+SG
sobreteceram-lhe	sobretecer+V.ele.DAT.3.SG+PQP+3+PL
sobreteceram-lhe	sobretecer+V.ele.DAT.3.SG+PRF+3+PL
sobreteceram-lhes	sobretecer+V.ele.DAT.3.PL+PQP+3+PL
sobreteceram-lhes	sobretecer+V.ele.DAT.3.PL+PRF+3+PL
sobreteceram-me	sobretecer+V.eu.AD.1.SG+PQP+3+PL
sobreteceram-me	sobretecer+V.eu.AD.1.SG+PRF+3+PL
sobreteceram-na	sobretecer+V.ele.ACC.3.F.SG+PQP+3+PL
sobreteceram-na	sobretecer+V.ele.ACC.3.F.SG+PRF+3+PL
sobreteceram-nas	sobretecer+V.ele.ACC.3.F.PL+PQP+3+PL
sobreteceram-nas	sobretecer+V.ele.ACC.3.F.PL+PRF+3+PL
sobreteceram-no	sobretecer+V.ele.ACC.3.M.SG+PQP+3+PL
sobreteceram-no	sobretecer+V.ele.ACC.3.M.SG+PRF+3+PL
sobreteceram-nos	sobretecer+V.ele.ACC.3.M.PL+PQP+3+PL
sobreteceram-nos	sobretecer+V.ele.ACC.3.M.PL+PRF+3+PL
sobreteceram-nos	sobretecer+V.nós.AD.1.PL+PQP+3+PL
sobreteceram-nos	sobretecer+V.nós.AD.1.PL+PRF+3+PL
sobretecêramo-la	sobretecer+V.ele.ACC.3.F.SG+PQP+1+PL
sobretecêramo-las	sobretecer+V.ele.ACC.3.F.PL+PQP+1+PL
sobretecêramo-lo	sobretecer+V.ele.ACC.3.M.SG+PQP+1+PL
sobretecêramo-los	sobretecer+V.ele.ACC.3.M.PL+PQP+1+PL
sobretecêramo-nos	sobretecer+nós.AD.1.PL+PQP+1+PL
sobretecêramos-lhe	sobretecer+V.ele.DAT.3.SG+PQP+1+PL
sobretecêramos-lhes	sobretecer+V.ele.DAT.3.PL+PQP+1+PL
sobretecêramos-me	sobretecer+V.eu.AD.1.SG+PQP+1+PL
sobretecêramos-te	sobretecer+V.tu.AD.2.SG+PQP+1+PL
sobretecêramos-vos	sobretecer+V.vós.AD.2.PL+PQP+1+PL
sobreteceram-se	sobretecer+V.ele.REFL+PQP+3+PL
sobreteceram-se	sobretecer+V.ele.REFL+PRF+3+PL
sobreteceram-te	sobretecer+V.tu.AD.2.SG+PQP+3+PL
sobreteceram-te	sobretecer+V.tu.AD.2.SG+PRF+3+PL
sobreteceram-vos	sobretecer+V.vós.AD.2.PL+PQP+3+PL
sobreteceram-vos	sobretecer+V.vós.AD.2.PL+PRF+3+PL
sobretecera-nos	sobretecer+nós.AD.1.PL+PQP+1+SG
sobretecera-nos	sobretecer+nós.AD.1.PL+PQP+2+SG
sobretecera-nos	sobretecer+nós.AD.1.PL+PQP+3+SG
sobretecera-o	sobretecer+V.ele.ACC.3.M.SG+PQP+1+SG
sobretecera-o	sobretecer+V.ele.ACC.3.M.SG+PQP+3+SG
sobretecera-os	sobretecer+V.ele.ACC.3.M.PL+PQP+1+SG
sobretecera-os	sobretecer+V.ele.ACC.3.M.PL+PQP+3+SG
sobretecera-se	sobretecer+V.ele.REFL+PQP+3+SG
sobreteceras-lhe	sobretecer+V.ele.DAT.3.SG+PQP+2+SG
sobreteceras-lhes	sobretecer+V.ele.DAT.3.PL+PQP+2+SG
sobreteceras-me	sobretecer+V.eu.AD.1.SG+PQP+2+SG
sobreteceras-te	sobretecer+V.tu.AD.2.SG+PQP+2+SG
sobreteceras-vos	sobretecer+V.vós.AD.2.PL+PQP+2+SG
sobretecera-te	sobretecer+V.tu.AD.2.SG+PQP+1+SG
sobretecera-te	sobretecer+V.tu.AD.2.SG+PQP+3+SG
sobretecera-vos	sobretecer+V.vós.AD.2.PL+PQP+1+SG
sobretecera-vos	sobretecer+V.vós.AD.2.PL+PQP+3+SG
sobretecerde-la	sobretecer+V.ele.ACC.3.F.SG+INF+2+PL
sobretecerde-la	sobretecer+V.ele.ACC.3.F.SG+SBJF+2+PL
sobretecerde-las	sobretecer+V.ele.ACC.3.F.PL+INF+2+PL
sobretecerde-las	sobretecer+V.ele.ACC.3.F.PL+SBJF+2+PL
sobretecerde-lo	sobretecer+V.ele.ACC.3.M.SG+INF+2+PL
sobretecerde-lo	sobretecer+V.ele.ACC.3.M.SG+SBJF+2+PL
sobretecerde-los	sobretecer+V.ele.ACC.3.M.PL+INF+2+PL
sobretecerde-los	sobretecer+V.ele.ACC.3.M.PL+SBJF+2+PL
sobretecerde-nos	sobretecer+nós.AD.1.PL+INF+2+PL
sobretecerde-nos	sobretecer+nós.AD.1.PL+SBJF+2+PL
sobretecerdes-lhe	sobretecer+V.ele.DAT.3.SG+INF+2+PL
sobretecerdes-lhe	sobretecer+V.ele.DAT.3.SG+SBJF+2+PL
sobretecerdes-lhes	sobretecer+V.ele.DAT.3.PL+INF+2+PL
sobretecerdes-lhes	sobretecer+V.ele.DAT.3.PL+SBJF+2+PL
sobretecerdes-me	sobretecer+V.eu.AD.1.SG+INF+2+PL
sobretecerdes-me	sobretecer+V.eu.AD.1.SG+SBJF+2+PL
sobretecerdes-te	sobretecer+V.tu.AD.2.SG+INF+2+PL
sobretecerdes-te	sobretecer+V.tu.AD.2.SG+SBJF+2+PL
sobretecerdes-vos	sobretecer+V.vós.AD.2.PL+INF+2+PL
sobretecerdes-vos	sobretecer+V.vós.AD.2.PL+SBJF+2+PL
sobretecêrei-la	sobretecer+V.ele.ACC.3.F.SG+PQP+2+PL
sobretecêrei-las	sobretecer+V.ele.ACC.3.F.PL+PQP+2+PL
sobretecêrei-lo	sobretecer+V.ele.ACC.3.M.SG+PQP+2+PL
sobretecêrei-los	sobretecer+V.ele.ACC.3.M.PL+PQP+2+PL
sobretecêrei-nos	sobretecer+nós.AD.1.PL+PQP+2+PL
sobretecêreis-lhe	sobretecer+V.ele.DAT.3.SG+PQP+2+PL
sobretecêreis-lhes	sobretecer+V.ele.DAT.3.PL+PQP+2+PL
sobretecêreis-me	sobretecer+V.eu.AD.1.SG+PQP+2+PL
sobretecêreis-te	sobretecer+V.tu.AD.2.SG+PQP+2+PL
sobretecêreis-vos	sobretecer+V.vós.AD.2.PL+PQP+2+PL
sobretecere-la	sobretecer+V.ele.ACC.3.F.SG+INF+2+SG
sobretecere-la	sobretecer+V.ele.ACC.3.F.SG+SBJF+2+SG
sobretecere-las	sobretecer+V.ele.ACC.3.F.PL+INF+2+SG
sobretecere-las	sobretecer+V.ele.ACC.3.F.PL+SBJF+2+SG
sobretecere-lo	sobretecer+V.ele.ACC.3.M.SG+INF+2+SG
sobretecere-lo	sobretecer+V.ele.ACC.3.M.SG+SBJF+2+SG
sobretecere-los	sobretecer+V.ele.ACC.3.M.PL+INF+2+SG
sobretecere-los	sobretecer+V.ele.ACC.3.M.PL+SBJF+2+SG
sobretecerem-lhe	sobretecer+V.ele.DAT.3.SG+INF+3+PL
sobretecerem-lhe	sobretecer+V.ele.DAT.3.SG+SBJF+3+PL
sobretecerem-lhes	sobretecer+V.ele.DAT.3.PL+INF+3+PL
sobretecerem-lhes	sobretecer+V.ele.DAT.3.PL+SBJF+3+PL
sobretecerem-me	sobretecer+V.eu.AD.1.SG+INF+3+PL
sobretecerem-me	sobretecer+V.eu.AD.1.SG+SBJF+3+PL
sobretecerem-na	sobretecer+V.ele.ACC.3.F.SG+INF+3+PL
sobretecerem-na	sobretecer+V.ele.ACC.3.F.SG+SBJF+3+PL
sobretecerem-nas	sobretecer+V.ele.ACC.3.F.PL+INF+3+PL
sobretecerem-nas	sobretecer+V.ele.ACC.3.F.PL+SBJF+3+PL
sobretecerem-no	sobretecer+V.ele.ACC.3.M.SG+INF+3+PL
sobretecerem-no	sobretecer+V.ele.ACC.3.M.SG+SBJF+3+PL
sobretecerem-nos	sobretecer+V.ele.ACC.3.M.PL+INF+3+PL
sobretecerem-nos	sobretecer+V.ele.ACC.3.M.PL+SBJF+3+PL
sobretecerem-nos	sobretecer+V.nós.AD.1.PL+INF+3+PL
sobretecerem-nos	sobretecer+V.nós.AD.1.PL+SBJF+3+PL
sobretecerem-se	sobretecer+V.ele.REFL+INF+3+PL
sobretecerem-se	sobretecer+V.ele.REFL+SBJF+3+PL
sobretecerem-te	sobretecer+V.tu.AD.2.SG+INF+3+PL
sobretecerem-te	sobretecer+V.tu.AD.2.SG+SBJF+3+PL
sobretecerem-vos	sobretecer+V.vós.AD.2.PL+INF+3+PL
sobretecerem-vos	sobretecer+V.vós.AD.2.PL+SBJF+3+PL
sobretecere-nos	sobretecer+nós.AD.1.PL+INF+2+SG
sobretecere-nos	sobretecer+nós.AD.1.PL+SBJF+2+SG
sobreteceres-lhe	sobretecer+V.ele.DAT.3.SG+INF+2+SG
sobreteceres-lhe	sobretecer+V.ele.DAT.3.SG+SBJF+2+SG
sobreteceres-lhes	sobretecer+V.ele.DAT.3.PL+INF+2+SG
sobreteceres-lhes	sobretecer+V.ele.DAT.3.PL+SBJF+2+SG
sobreteceres-me	sobretecer+V.eu.AD.1.SG+INF+2+SG
sobreteceres-me	sobretecer+V.eu.AD.1.SG+SBJF+2+SG
sobreteceres-te	sobretecer+V.tu.AD.2.SG+INF+2+SG
sobreteceres-te	sobretecer+V.tu.AD.2.SG+SBJF+2+SG
sobreteceres-vos	sobretecer+V.vós.AD.2.PL+INF+2+SG
sobreteceres-vos	sobretecer+V.vós.AD.2.PL+SBJF+2+SG
sobretecer-lhe-ão	sobretecer+V.ele.DAT.3.SG+FUT+3+PL
sobretecer-lhe-á	sobretecer+V.ele.DAT.3.SG+FUT+3+SG
sobretecer-lhe-ás	sobretecer+V.ele.DAT.3.SG+FUT+2+SG
sobretecer-lhe-ei	sobretecer+V.ele.DAT.3.SG+FUT+1+SG
sobretecer-lhe-eis	sobretecer+V.ele.DAT.3.SG+FUT+2+PL
sobretecer-lhe-emos	sobretecer+V.ele.DAT.3.SG+FUT+1+PL
sobretecer-lhe-íamos	sobretecer+V.ele.DAT.3.SG+COND+1+PL
sobretecer-lhe-iam	sobretecer+V.ele.DAT.3.SG+COND+3+PL
sobretecer-lhe-ia	sobretecer+V.ele.DAT.3.SG+COND+1+SG
sobretecer-lhe-ia	sobretecer+V.ele.DAT.3.SG+COND+3+SG
sobretecer-lhe-ias	sobretecer+V.ele.DAT.3.SG+COND+2+SG
sobretecer-lhe-íeis	sobretecer+V.ele.DAT.3.SG+COND+2+PL
sobretecer-lhes-ão	sobretecer+V.ele.DAT.3.PL+FUT+3+PL
sobretecer-lhes-á	sobretecer+V.ele.DAT.3.PL+FUT+3+SG
sobretecer-lhes-ás	sobretecer+V.ele.DAT.3.PL+FUT+2+SG
sobretecer-lhes-ei	sobretecer+V.ele.DAT.3.PL+FUT+1+SG
sobretecer-lhes-eis	sobretecer+V.ele.DAT.3.PL+FUT+2+PL
sobretecer-lhes-emos	sobretecer+V.ele.DAT.3.PL+FUT+1+PL
sobretecer-lhes-íamos	sobretecer+V.ele.DAT.3.PL+COND+1+PL
sobretecer-lhes-iam	sobretecer+V.ele.DAT.3.PL+COND+3+PL
sobretecer-lhes-ia	sobretecer+V.ele.DAT.3.PL+COND+1+SG
sobretecer-lhes-ia	sobretecer+V.ele.DAT.3.PL+COND+3+SG
sobretecer-lhes-ias	sobretecer+V.ele.DAT.3.PL+COND+2+SG
sobretecer-lhes-íeis	sobretecer+V.ele.DAT.3.PL+COND+2+PL
sobretecer-lhe	sobretecer+V.ele.DAT.3.SG+INF
sobretecer-lhe	sobretecer+V.ele.DAT.3.SG+INF+1+SG
sobretecer-lhe	sobretecer+V.ele.DAT.3.SG+INF+3+SG
sobretecer-lhe	sobretecer+V.ele.DAT.3.SG+SBJF+1+SG
sobretecer-lhe	sobretecer+V.ele.DAT.3.SG+SBJF+3+SG
sobretecer-lhes	sobretecer+V.ele.DAT.3.PL+INF
sobretecer-lhes	sobretecer+V.ele.DAT.3.PL+INF+1+SG
sobretecer-lhes	sobretecer+V.ele.DAT.3.PL+INF+3+SG
sobretecer-lhes	sobretecer+V.ele.DAT.3.PL+SBJF+1+SG
sobretecer-lhes	sobretecer+V.ele.DAT.3.PL+SBJF+3+SG
sobretecer-me-ão	sobretecer+V.eu.AD.1.SG+FUT+3+PL
sobretecer-me-á	sobretecer+V.eu.AD.1.SG+FUT+3+SG
sobretecer-me-ás	sobretecer+V.eu.AD.1.SG+FUT+2+SG
sobretecer-me-ei	sobretecer+V.eu.AD.1.SG+FUT+1+SG
sobretecer-me-eis	sobretecer+V.eu.AD.1.SG+FUT+2+PL
sobretecer-me-emos	sobretecer+V.eu.AD.1.SG+FUT+1+PL
sobretecer-me-íamos	sobretecer+V.eu.AD.1.SG+COND+1+PL
sobretecer-me-iam	sobretecer+V.eu.AD.1.SG+COND+3+PL
sobretecer-me-ia	sobretecer+V.eu.AD.1.SG+COND+1+SG
sobretecer-me-ia	sobretecer+V.eu.AD.1.SG+COND+3+SG
sobretecer-me-ias	sobretecer+V.eu.AD.1.SG+COND+2+SG
sobretecer-me-íeis	sobretecer+V.eu.AD.1.SG+COND+2+PL
sobretecer-me	sobretecer+V.eu.AD.1.SG+INF
sobretecer-me	sobretecer+V.eu.AD.1.SG+INF+1+SG
sobretecer-me	sobretecer+V.eu.AD.1.SG+INF+3+SG
sobretecer-me	sobretecer+V.eu.AD.1.SG+SBJF+1+SG
sobretecer-me	sobretecer+V.eu.AD.1.SG+SBJF+3+SG
sobretecermo-la	sobretecer+V.ele.ACC.3.F.SG+INF+1+PL
sobretecermo-la	sobretecer+V.ele.ACC.3.F.SG+SBJF+1+PL
sobretecermo-las	sobretecer+V.ele.ACC.3.F.PL+INF+1+PL
sobretecermo-las	sobretecer+V.ele.ACC.3.F.PL+SBJF+1+PL
sobretecermo-lo	sobretecer+V.ele.ACC.3.M.SG+INF+1+PL
sobretecermo-lo	sobretecer+V.ele.ACC.3.M.SG+SBJF+1+PL
sobretecermo-los	sobretecer+V.ele.ACC.3.M.PL+INF+1+PL
sobretecermo-los	sobretecer+V.ele.ACC.3.M.PL+SBJF+1+PL
sobretecermo-nos	sobretecer+nós.AD.1.PL+INF+1+PL
sobretecermo-nos	sobretecer+nós.AD.1.PL+SBJF+1+PL
sobretecermos-lhe	sobretecer+V.ele.DAT.3.SG+INF+1+PL
sobretecermos-lhe	sobretecer+V.ele.DAT.3.SG+SBJF+1+PL
sobretecermos-lhes	sobretecer+V.ele.DAT.3.PL+INF+1+PL
sobretecermos-lhes	sobretecer+V.ele.DAT.3.PL+SBJF+1+PL
sobretecermos-me	sobretecer+V.eu.AD.1.SG+INF+1+PL
sobretecermos-me	sobretecer+V.eu.AD.1.SG+SBJF+1+PL
sobretecermos-te	sobretecer+V.tu.AD.2.SG+INF+1+PL
sobretecermos-te	sobretecer+V.tu.AD.2.SG+SBJF+1+PL
sobretecermos-vos	sobretecer+V.vós.AD.2.PL+INF+1+PL
sobretecermos-vos	sobretecer+V.vós.AD.2.PL+SBJF+1+PL
sobretecer-nos-ão	sobretecer+nós.AD.1.PL+FUT+3+PL
sobretecer-nos-á	sobretecer+nós.AD.1.PL+FUT+3+SG
sobretecer-nos-ás	sobretecer+nós.AD.1.PL+FUT+2+SG
sobretecer-nos-ei	sobretecer+nós.AD.1.PL+FUT+1+SG
sobretecer-nos-eis	sobretecer+nós.AD.1.PL+FUT+2+PL
sobretecer-nos-emos	sobretecer+nós.AD.1.PL+FUT+1+PL
sobretecer-nos-íamos	sobretecer+nós.AD.1.PL+COND+1+PL
sobretecer-nos-iam	sobretecer+nós.AD.1.PL+COND+3+PL
sobretecer-nos-ia	sobretecer+nós.AD.1.PL+COND+1+SG
sobretecer-nos-ia	sobretecer+nós.AD.1.PL+COND+3+SG
sobretecer-nos-ias	sobretecer+nós.AD.1.PL+COND+2+SG
sobretecer-nos-íeis	sobretecer+nós.AD.1.PL+COND+2+PL
sobretecer-nos	sobretecer+nós.AD.1.PL+INF
sobretecer-nos	sobretecer+nós.AD.1.PL+INF+1+SG
sobretecer-nos	sobretecer+nós.AD.1.PL+INF+3+SG
sobretecer-nos	sobretecer+nós.AD.1.PL+SBJF+1+SG
sobretecer-nos	sobretecer+nós.AD.1.PL+SBJF+3+SG
sobretecer-se-ão	sobretecer+V.ele.REFL+FUT+3+PL
sobretecer-se-á	sobretecer+V.ele.REFL+FUT+3+SG
sobretecer-se-iam	sobretecer+V.ele.REFL+COND+3+PL
sobretecer-se-ia	sobretecer+V.ele.REFL+COND+3+SG
sobretecer-se	sobretecer+V.ele.REFL+INF
sobretecer-se	sobretecer+V.ele.REFL+INF+3+SG
sobretecer-se	sobretecer+V.ele.REFL+SBJF+3+SG
sobretecer-te-ão	sobretecer+V.tu.AD.2.SG+FUT+3+PL
sobretecer-te-á	sobretecer+V.tu.AD.2.SG+FUT+3+SG
sobretecer-te-ás	sobretecer+V.tu.AD.2.SG+FUT+2+SG
sobretecer-te-ei	sobretecer+V.tu.AD.2.SG+FUT+1+SG
sobretecer-te-eis	sobretecer+V.tu.AD.2.SG+FUT+2+PL
sobretecer-te-emos	sobretecer+V.tu.AD.2.SG+FUT+1+PL
sobretecer-te-íamos	sobretecer+V.tu.AD.2.SG+COND+1+PL
sobretecer-te-iam	sobretecer+V.tu.AD.2.SG+COND+3+PL
sobretecer-te-ia	sobretecer+V.tu.AD.2.SG+COND+1+SG
sobretecer-te-ia	sobretecer+V.tu.AD.2.SG+COND+3+SG
sobretecer-te-ias	sobretecer+V.tu.AD.2.SG+COND+2+SG
sobretecer-te-íeis	sobretecer+V.tu.AD.2.SG+COND+2+PL
sobretecer-te	sobretecer+V.tu.AD.2.SG+INF
sobretecer-te	sobretecer+V.tu.AD.2.SG+INF+1+SG
sobretecer-te	sobretecer+V.tu.AD.2.SG+INF+3+SG
sobretecer-te	sobretecer+V.tu.AD.2.SG+SBJF+1+SG
sobretecer-te	sobretecer+V.tu.AD.2.SG+SBJF+3+SG
sobretecer-vos-ão	sobretecer+V.vós.AD.2.PL+FUT+3+PL
sobretecer-vos-á	sobretecer+V.vós.AD.2.PL+FUT+3+SG
sobretecer-vos-ás	sobretecer+V.vós.AD.2.PL+FUT+2+SG
sobretecer-vos-ei	sobretecer+V.vós.AD.2.PL+FUT+1+SG
sobretecer-vos-eis	sobretecer+V.vós.AD.2.PL+FUT+2+PL
sobretecer-vos-emos	sobretecer+V.vós.AD.2.PL+FUT+1+PL
sobretecer-vos-íamos	sobretecer+V.vós.AD.2.PL+COND+1+PL
sobretecer-vos-iam	sobretecer+V.vós.AD.2.PL+COND+3+PL
sobretecer-vos-ia	sobretecer+V.vós.AD.2.PL+COND+1+SG
sobretecer-vos-ia	sobretecer+V.vós.AD.2.PL+COND+3+SG
sobretecer-vos-ias	sobretecer+V.vós.AD.2.PL+COND+2+SG
sobretecer-vos-íeis	sobretecer+V.vós.AD.2.PL+COND+2+PL
sobretecer-vos	sobretecer+V.vós.AD.2.PL+INF
sobretecer-vos	sobretecer+V.vós.AD.2.PL+INF+1+SG
sobretecer-vos	sobretecer+V.vós.AD.2.PL+INF+3+SG
sobretecer-vos	sobretecer+V.vós.AD.2.PL+SBJF+1+SG
sobretecer-vos	sobretecer+V.vós.AD.2.PL+SBJF+3+SG
sobretece-se	sobretecer+V.ele.REFL+PRS+3+SG
sobreteces-lhe	sobretecer+V.ele.DAT.3.SG+PRS+2+SG
sobreteces-lhes	sobretecer+V.ele.DAT.3.PL+PRS+2+SG
sobreteces-me	sobretecer+V.eu.AD.1.SG+PRS+2+SG
sobreteceste-a	sobretecer+V.ele.ACC.3.F.SG+PRF+2+SG
sobreteceste-as	sobretecer+V.ele.ACC.3.F.PL+PRF+2+SG
sobreteceste-la	sobretecer+V.ele.ACC.3.F.SG+PRF+2+PL
sobreteceste-las	sobretecer+V.ele.ACC.3.F.PL+PRF+2+PL
sobreteceste-lhe	sobretecer+V.ele.DAT.3.SG+PRF+2+SG
sobreteceste-lhes	sobretecer+V.ele.DAT.3.PL+PRF+2+SG
sobreteceste-lo	sobretecer+V.ele.ACC.3.M.SG+PRF+2+PL
sobreteceste-los	sobretecer+V.ele.ACC.3.M.PL+PRF+2+PL
sobreteceste-me	sobretecer+V.eu.AD.1.SG+PRF+2+SG
sobreteceste-nos	sobretecer+nós.AD.1.PL+PRF+2+PL
