tartameleares-vos	tartamelear+V.vós.AD.2.PL+SBJF+2+SG
tartamelear-lhe-ão	tartamelear+V.ele.DAT.3.SG+FUT+3+PL
tartamelear-lhe-ás	tartamelear+V.ele.DAT.3.SG+FUT+2+SG
tartamelear-lhe-á	tartamelear+V.ele.DAT.3.SG+FUT+3+SG
tartamelear-lhe-eis	tartamelear+V.ele.DAT.3.SG+FUT+2+PL
tartamelear-lhe-ei	tartamelear+V.ele.DAT.3.SG+FUT+1+SG
tartamelear-lhe-emos	tartamelear+V.ele.DAT.3.SG+FUT+1+PL
tartamelear-lhe-íamos	tartamelear+V.ele.DAT.3.SG+COND+1+PL
tartamelear-lhe-iam	tartamelear+V.ele.DAT.3.SG+COND+3+PL
tartamelear-lhe-ias	tartamelear+V.ele.DAT.3.SG+COND+2+SG
tartamelear-lhe-ia	tartamelear+V.ele.DAT.3.SG+COND+1+SG
tartamelear-lhe-ia	tartamelear+V.ele.DAT.3.SG+COND+3+SG
tartamelear-lhe-íeis	tartamelear+V.ele.DAT.3.SG+COND+2+PL
tartamelear-lhes-ão	tartamelear+V.ele.DAT.3.PL+FUT+3+PL
tartamelear-lhes-ás	tartamelear+V.ele.DAT.3.PL+FUT+2+SG
tartamelear-lhes-á	tartamelear+V.ele.DAT.3.PL+FUT+3+SG
tartamelear-lhes-eis	tartamelear+V.ele.DAT.3.PL+FUT+2+PL
tartamelear-lhes-ei	tartamelear+V.ele.DAT.3.PL+FUT+1+SG
tartamelear-lhes-emos	tartamelear+V.ele.DAT.3.PL+FUT+1+PL
tartamelear-lhes-íamos	tartamelear+V.ele.DAT.3.PL+COND+1+PL
tartamelear-lhes-iam	tartamelear+V.ele.DAT.3.PL+COND+3+PL
tartamelear-lhes-ias	tartamelear+V.ele.DAT.3.PL+COND+2+SG
tartamelear-lhes-ia	tartamelear+V.ele.DAT.3.PL+COND+1+SG
tartamelear-lhes-ia	tartamelear+V.ele.DAT.3.PL+COND+3+SG
tartamelear-lhes-íeis	tartamelear+V.ele.DAT.3.PL+COND+2+PL
tartamelear-lhes	tartamelear+V.ele.DAT.3.PL+INF
tartamelear-lhes	tartamelear+V.ele.DAT.3.PL+INF+1+SG
tartamelear-lhes	tartamelear+V.ele.DAT.3.PL+INF+3+SG
tartamelear-lhes	tartamelear+V.ele.DAT.3.PL+SBJF+1+SG
tartamelear-lhes	tartamelear+V.ele.DAT.3.PL+SBJF+3+SG
tartamelear-lhe	tartamelear+V.ele.DAT.3.SG+INF
tartamelear-lhe	tartamelear+V.ele.DAT.3.SG+INF+1+SG
tartamelear-lhe	tartamelear+V.ele.DAT.3.SG+INF+3+SG
tartamelear-lhe	tartamelear+V.ele.DAT.3.SG+SBJF+1+SG
tartamelear-lhe	tartamelear+V.ele.DAT.3.SG+SBJF+3+SG
tartamelear-me-ão	tartamelear+V.eu.AD.1.SG+FUT+3+PL
tartamelear-me-ás	tartamelear+V.eu.AD.1.SG+FUT+2+SG
tartamelear-me-á	tartamelear+V.eu.AD.1.SG+FUT+3+SG
tartamelear-me-eis	tartamelear+V.eu.AD.1.SG+FUT+2+PL
tartamelear-me-ei	tartamelear+V.eu.AD.1.SG+FUT+1+SG
tartamelear-me-emos	tartamelear+V.eu.AD.1.SG+FUT+1+PL
tartamelear-me-íamos	tartamelear+V.eu.AD.1.SG+COND+1+PL
tartamelear-me-iam	tartamelear+V.eu.AD.1.SG+COND+3+PL
tartamelear-me-ias	tartamelear+V.eu.AD.1.SG+COND+2+SG
tartamelear-me-ia	tartamelear+V.eu.AD.1.SG+COND+1+SG
tartamelear-me-ia	tartamelear+V.eu.AD.1.SG+COND+3+SG
tartamelear-me-íeis	tartamelear+V.eu.AD.1.SG+COND+2+PL
tartamelear-me	tartamelear+V.eu.AD.1.SG+INF
tartamelear-me	tartamelear+V.eu.AD.1.SG+INF+1+SG
tartamelear-me	tartamelear+V.eu.AD.1.SG+INF+3+SG
tartamelear-me	tartamelear+V.eu.AD.1.SG+SBJF+1+SG
tartamelear-me	tartamelear+V.eu.AD.1.SG+SBJF+3+SG
tartamelearmo-las	tartamelear+V.ele.ACC.3.F.PL+INF+1+PL
tartamelearmo-las	tartamelear+V.ele.ACC.3.F.PL+SBJF+1+PL
tartamelearmo-la	tartamelear+V.ele.ACC.3.F.SG+INF+1+PL
tartamelearmo-la	tartamelear+V.ele.ACC.3.F.SG+SBJF+1+PL
tartamelearmo-los	tartamelear+V.ele.ACC.3.M.PL+INF+1+PL
tartamelearmo-los	tartamelear+V.ele.ACC.3.M.PL+SBJF+1+PL
tartamelearmo-lo	tartamelear+V.ele.ACC.3.M.SG+INF+1+PL
tartamelearmo-lo	tartamelear+V.ele.ACC.3.M.SG+SBJF+1+PL
tartamelearmo-nos	tartamelear+nós.AD.1.PL+INF+1+PL
tartamelearmo-nos	tartamelear+nós.AD.1.PL+SBJF+1+PL
tartamelearmos-lhes	tartamelear+V.ele.DAT.3.PL+INF+1+PL
tartamelearmos-lhes	tartamelear+V.ele.DAT.3.PL+SBJF+1+PL
tartamelearmos-lhe	tartamelear+V.ele.DAT.3.SG+INF+1+PL
tartamelearmos-lhe	tartamelear+V.ele.DAT.3.SG+SBJF+1+PL
tartamelearmos-me	tartamelear+V.eu.AD.1.SG+INF+1+PL
tartamelearmos-me	tartamelear+V.eu.AD.1.SG+SBJF+1+PL
tartamelearmos-te	tartamelear+V.tu.AD.2.SG+INF+1+PL
tartamelearmos-te	tartamelear+V.tu.AD.2.SG+SBJF+1+PL
tartamelearmos-vos	tartamelear+V.vós.AD.2.PL+INF+1+PL
tartamelearmos-vos	tartamelear+V.vós.AD.2.PL+SBJF+1+PL
tartamelear-nos-ão	tartamelear+nós.AD.1.PL+FUT+3+PL
tartamelear-nos-ás	tartamelear+nós.AD.1.PL+FUT+2+SG
tartamelear-nos-á	tartamelear+nós.AD.1.PL+FUT+3+SG
tartamelear-nos-eis	tartamelear+nós.AD.1.PL+FUT+2+PL
tartamelear-nos-ei	tartamelear+nós.AD.1.PL+FUT+1+SG
tartamelear-nos-emos	tartamelear+nós.AD.1.PL+FUT+1+PL
tartamelear-nos-íamos	tartamelear+nós.AD.1.PL+COND+1+PL
tartamelear-nos-iam	tartamelear+nós.AD.1.PL+COND+3+PL
tartamelear-nos-ias	tartamelear+nós.AD.1.PL+COND+2+SG
tartamelear-nos-ia	tartamelear+nós.AD.1.PL+COND+1+SG
tartamelear-nos-ia	tartamelear+nós.AD.1.PL+COND+3+SG
tartamelear-nos-íeis	tartamelear+nós.AD.1.PL+COND+2+PL
tartamelear-nos	tartamelear+nós.AD.1.PL+INF
tartamelear-nos	tartamelear+nós.AD.1.PL+INF+1+SG
tartamelear-nos	tartamelear+nós.AD.1.PL+INF+3+SG
tartamelear-nos	tartamelear+nós.AD.1.PL+SBJF+1+SG
tartamelear-nos	tartamelear+nós.AD.1.PL+SBJF+3+SG
tartamelear-se-ão	tartamelear+V.ele.REFL+FUT+3+PL
tartamelear-se-á	tartamelear+V.ele.REFL+FUT+3+SG
tartamelear-se-iam	tartamelear+V.ele.REFL+COND+3+PL
tartamelear-se-ia	tartamelear+V.ele.REFL+COND+3+SG
tartamelear-se	tartamelear+V.ele.REFL+INF
tartamelear-se	tartamelear+V.ele.REFL+INF+3+SG
tartamelear-se	tartamelear+V.ele.REFL+SBJF+3+SG
tartamelear-te-ão	tartamelear+V.tu.AD.2.SG+FUT+3+PL
tartamelear-te-ás	tartamelear+V.tu.AD.2.SG+FUT+2+SG
tartamelear-te-á	tartamelear+V.tu.AD.2.SG+FUT+3+SG
tartamelear-te-eis	tartamelear+V.tu.AD.2.SG+FUT+2+PL
tartamelear-te-ei	tartamelear+V.tu.AD.2.SG+FUT+1+SG
tartamelear-te-emos	tartamelear+V.tu.AD.2.SG+FUT+1+PL
tartamelear-te-íamos	tartamelear+V.tu.AD.2.SG+COND+1+PL
tartamelear-te-iam	tartamelear+V.tu.AD.2.SG+COND+3+PL
tartamelear-te-ias	tartamelear+V.tu.AD.2.SG+COND+2+SG
tartamelear-te-ia	tartamelear+V.tu.AD.2.SG+COND+1+SG
tartamelear-te-ia	tartamelear+V.tu.AD.2.SG+COND+3+SG
tartamelear-te-íeis	tartamelear+V.tu.AD.2.SG+COND+2+PL
tartamelear-te	tartamelear+V.tu.AD.2.SG+INF
tartamelear-te	tartamelear+V.tu.AD.2.SG+INF+1+SG
tartamelear-te	tartamelear+V.tu.AD.2.SG+INF+3+SG
tartamelear-te	tartamelear+V.tu.AD.2.SG+SBJF+1+SG
tartamelear-te	tartamelear+V.tu.AD.2.SG+SBJF+3+SG
tartamelear-vos-ão	tartamelear+V.vós.AD.2.PL+FUT+3+PL
tartamelear-vos-ás	tartamelear+V.vós.AD.2.PL+FUT+2+SG
tartamelear-vos-á	tartamelear+V.vós.AD.2.PL+FUT+3+SG
tartamelear-vos-eis	tartamelear+V.vós.AD.2.PL+FUT+2+PL
tartamelear-vos-ei	tartamelear+V.vós.AD.2.PL+FUT+1+SG
tartamelear-vos-emos	tartamelear+V.vós.AD.2.PL+FUT+1+PL
tartamelear-vos-íamos	tartamelear+V.vós.AD.2.PL+COND+1+PL
tartamelear-vos-iam	tartamelear+V.vós.AD.2.PL+COND+3+PL
tartamelear-vos-ias	tartamelear+V.vós.AD.2.PL+COND+2+SG
tartamelear-vos-ia	tartamelear+V.vós.AD.2.PL+COND+1+SG
tartamelear-vos-ia	tartamelear+V.vós.AD.2.PL+COND+3+SG
tartamelear-vos-íeis	tartamelear+V.vós.AD.2.PL+COND+2+PL
tartamelear-vos	tartamelear+V.vós.AD.2.PL+INF
tartamelear-vos	tartamelear+V.vós.AD.2.PL+INF+1+SG
tartamelear-vos	tartamelear+V.vós.AD.2.PL+INF+3+SG
tartamelear-vos	tartamelear+V.vós.AD.2.PL+SBJF+1+SG
tartamelear-vos	tartamelear+V.vós.AD.2.PL+SBJF+3+SG
tartamele-as	tartamelar+V.ele.ACC.3.F.PL+IMP+3+SG
tartameleaste-as	tartamelear+V.ele.ACC.3.F.PL+PRF+2+SG
tartameleaste-a	tartamelear+V.ele.ACC.3.F.SG+PRF+2+SG
tartameleaste-las	tartamelear+V.ele.ACC.3.F.PL+PRF+2+PL
tartameleaste-la	tartamelear+V.ele.ACC.3.F.SG+PRF+2+PL
tartameleaste-lhes	tartamelear+V.ele.DAT.3.PL+PRF+2+SG
tartameleaste-lhe	tartamelear+V.ele.DAT.3.SG+PRF+2+SG
tartameleaste-los	tartamelear+V.ele.ACC.3.M.PL+PRF+2+PL
tartameleaste-lo	tartamelear+V.ele.ACC.3.M.SG+PRF+2+PL
tartameleaste-me	tartamelear+V.eu.AD.1.SG+PRF+2+SG
tartameleaste-nos	tartamelear+nós.AD.1.PL+PRF+2+PL
tartameleaste-nos	tartamelear+nós.AD.1.PL+PRF+2+SG
tartameleaste-os	tartamelear+V.ele.ACC.3.M.PL+PRF+2+SG
tartameleaste-o	tartamelear+V.ele.ACC.3.M.SG+PRF+2+SG
tartameleastes-lhes	tartamelear+V.ele.DAT.3.PL+PRF+2+PL
tartameleastes-lhe	tartamelear+V.ele.DAT.3.SG+PRF+2+PL
tartameleastes-me	tartamelear+V.eu.AD.1.SG+PRF+2+PL
tartameleastes-te	tartamelear+V.tu.AD.2.SG+PRF+2+PL
tartameleastes-vos	tartamelear+V.vós.AD.2.PL+PRF+2+PL
tartameleaste-te	tartamelear+V.tu.AD.2.SG+PRF+2+SG
tartameleaste-vos	tartamelear+V.vós.AD.2.PL+PRF+2+SG
tartamele-a	tartamelar+V.ele.ACC.3.F.SG+IMP+3+SG
tartameleava-as	tartamelear+V.ele.ACC.3.F.PL+IMPF+1+SG
tartameleava-as	tartamelear+V.ele.ACC.3.F.PL+IMPF+3+SG
tartameleava-a	tartamelear+V.ele.ACC.3.F.SG+IMPF+1+SG
tartameleava-a	tartamelear+V.ele.ACC.3.F.SG+IMPF+3+SG
tartameleava-las	tartamelear+V.ele.ACC.3.F.PL+IMPF+2+SG
tartameleava-la	tartamelear+V.ele.ACC.3.F.SG+IMPF+2+SG
tartameleava-lhes	tartamelear+V.ele.DAT.3.PL+IMPF+1+SG
tartameleava-lhes	tartamelear+V.ele.DAT.3.PL+IMPF+3+SG
tartameleava-lhe	tartamelear+V.ele.DAT.3.SG+IMPF+1+SG
tartameleava-lhe	tartamelear+V.ele.DAT.3.SG+IMPF+3+SG
tartameleava-los	tartamelear+V.ele.ACC.3.M.PL+IMPF+2+SG
tartameleava-lo	tartamelear+V.ele.ACC.3.M.SG+IMPF+2+SG
tartameleava-me	tartamelear+V.eu.AD.1.SG+IMPF+1+SG
tartameleava-me	tartamelear+V.eu.AD.1.SG+IMPF+3+SG
tartameleavam-lhes	tartamelear+V.ele.DAT.3.PL+IMPF+3+PL
tartameleavam-lhe	tartamelear+V.ele.DAT.3.SG+IMPF+3+PL
tartameleavam-me	tartamelear+V.eu.AD.1.SG+IMPF+3+PL
tartameleavam-nas	tartamelear+V.ele.ACC.3.F.PL+IMPF+3+PL
tartameleavam-na	tartamelear+V.ele.ACC.3.F.SG+IMPF+3+PL
tartameleavam-nos	tartamelear+V.ele.ACC.3.M.PL+IMPF+3+PL
tartameleavam-nos	tartamelear+V.nós.AD.1.PL+IMPF+3+PL
tartameleavam-no	tartamelear+V.ele.ACC.3.M.SG+IMPF+3+PL
tartameleávamo-las	tartamelear+V.ele.ACC.3.F.PL+IMPF+1+PL
tartameleávamo-la	tartamelear+V.ele.ACC.3.F.SG+IMPF+1+PL
tartameleávamo-los	tartamelear+V.ele.ACC.3.M.PL+IMPF+1+PL
tartameleávamo-lo	tartamelear+V.ele.ACC.3.M.SG+IMPF+1+PL
tartameleávamo-nos	tartamelear+nós.AD.1.PL+IMPF+1+PL
tartameleávamos-lhes	tartamelear+V.ele.DAT.3.PL+IMPF+1+PL
tartameleávamos-lhe	tartamelear+V.ele.DAT.3.SG+IMPF+1+PL
tartameleávamos-me	tartamelear+V.eu.AD.1.SG+IMPF+1+PL
tartameleávamos-te	tartamelear+V.tu.AD.2.SG+IMPF+1+PL
tartameleávamos-vos	tartamelear+V.vós.AD.2.PL+IMPF+1+PL
tartameleavam-se	tartamelear+V.ele.REFL+IMPF+3+PL
tartameleavam-te	tartamelear+V.tu.AD.2.SG+IMPF+3+PL
tartameleavam-vos	tartamelear+V.vós.AD.2.PL+IMPF+3+PL
tartameleava-nos	tartamelear+nós.AD.1.PL+IMPF+1+SG
tartameleava-nos	tartamelear+nós.AD.1.PL+IMPF+2+SG
tartameleava-nos	tartamelear+nós.AD.1.PL+IMPF+3+SG
tartameleava-os	tartamelear+V.ele.ACC.3.M.PL+IMPF+1+SG
tartameleava-os	tartamelear+V.ele.ACC.3.M.PL+IMPF+3+SG
tartameleava-o	tartamelear+V.ele.ACC.3.M.SG+IMPF+1+SG
tartameleava-o	tartamelear+V.ele.ACC.3.M.SG+IMPF+3+SG
tartameleava-se	tartamelear+V.ele.REFL+IMPF+1+SG
tartameleava-se	tartamelear+V.ele.REFL+IMPF+3+SG
tartameleavas-lhes	tartamelear+V.ele.DAT.3.PL+IMPF+2+SG
tartameleavas-lhe	tartamelear+V.ele.DAT.3.SG+IMPF+2+SG
tartameleavas-me	tartamelear+V.eu.AD.1.SG+IMPF+2+SG
tartameleavas-te	tartamelear+V.tu.AD.2.SG+IMPF+2+SG
tartameleavas-vos	tartamelear+V.vós.AD.2.PL+IMPF+2+SG
tartameleava-te	tartamelear+V.tu.AD.2.SG+IMPF+1+SG
tartameleava-te	tartamelear+V.tu.AD.2.SG+IMPF+3+SG
tartameleava-vos	tartamelear+V.vós.AD.2.PL+IMPF+1+SG
tartameleava-vos	tartamelear+V.vós.AD.2.PL+IMPF+3+SG
tartameleávei-las	tartamelear+V.ele.ACC.3.F.PL+IMPF+2+PL
tartameleávei-la	tartamelear+V.ele.ACC.3.F.SG+IMPF+2+PL
tartameleávei-los	tartamelear+V.ele.ACC.3.M.PL+IMPF+2+PL
tartameleávei-lo	tartamelear+V.ele.ACC.3.M.SG+IMPF+2+PL
tartameleávei-nos	tartamelear+nós.AD.1.PL+IMPF+2+PL
tartameleáveis-lhes	tartamelear+V.ele.DAT.3.PL+IMPF+2+PL
tartameleáveis-lhe	tartamelear+V.ele.DAT.3.SG+IMPF+2+PL
tartameleáveis-me	tartamelear+V.eu.AD.1.SG+IMPF+2+PL
tartameleáveis-te	tartamelear+V.tu.AD.2.SG+IMPF+2+PL
tartameleáveis-vos	tartamelear+V.vós.AD.2.PL+IMPF+2+PL
tartameleei-as	tartamelear+V.ele.ACC.3.F.PL+PRF+1+SG
tartameleei-a	tartamelear+V.ele.ACC.3.F.SG+PRF+1+SG
tartameleei-lhes	tartamelear+V.ele.DAT.3.PL+PRF+1+SG
tartameleei-lhe	tartamelear+V.ele.DAT.3.SG+PRF+1+SG
tartameleei-me	tartamelear+V.eu.AD.1.SG+PRF+1+SG
tartameleei-nos	tartamelear+nós.AD.1.PL+PRF+1+SG
tartameleei-os	tartamelear+V.ele.ACC.3.M.PL+PRF+1+SG
tartameleei-o	tartamelear+V.ele.ACC.3.M.SG+PRF+1+SG
tartameleei-te	tartamelear+V.tu.AD.2.SG+PRF+1+SG
tartameleei-vos	tartamelear+V.vós.AD.2.PL+PRF+1+SG
tartameleia-as	tartamelear+V.ele.ACC.3.F.PL+PRS+3+SG
tartameleia-a	tartamelear+V.ele.ACC.3.F.SG+PRS+3+SG
tartameleia-las	tartamelear+V.ele.ACC.3.F.PL+PRS+2+SG
tartameleia-la	tartamelear+V.ele.ACC.3.F.SG+PRS+2+SG
tartameleia-lhes	tartamelear+V.ele.DAT.3.PL+PRS+3+SG
tartameleia-lhe	tartamelear+V.ele.DAT.3.SG+PRS+3+SG
tartameleia-los	tartamelear+V.ele.ACC.3.M.PL+PRS+2+SG
tartameleia-lo	tartamelear+V.ele.ACC.3.M.SG+PRS+2+SG
tartameleia-me	tartamelear+V.eu.AD.1.SG+PRS+3+SG
tartameleiam-lhes	tartamelear+V.ele.DAT.3.PL+PRS+3+PL
tartameleiam-lhe	tartamelear+V.ele.DAT.3.SG+PRS+3+PL
tartameleiam-me	tartamelear+V.eu.AD.1.SG+PRS+3+PL
tartameleiam-nas	tartamelear+V.ele.ACC.3.F.PL+PRS+3+PL
tartameleiam-na	tartamelear+V.ele.ACC.3.F.SG+PRS+3+PL
tartameleiam-nos	tartamelear+V.ele.ACC.3.M.PL+PRS+3+PL
tartameleiam-nos	tartamelear+V.nós.AD.1.PL+PRS+3+PL
tartameleiam-no	tartamelear+V.ele.ACC.3.M.SG+PRS+3+PL
tartameleiam-se	tartamelear+V.ele.REFL+PRS+3+PL
tartameleiam-te	tartamelear+V.tu.AD.2.SG+PRS+3+PL
tartameleiam-vos	tartamelear+V.vós.AD.2.PL+PRS+3+PL
tartameleia-nos	tartamelear+nós.AD.1.PL+PRS+2+SG
tartameleia-nos	tartamelear+nós.AD.1.PL+PRS+3+SG
tartameleia-os	tartamelear+V.ele.ACC.3.M.PL+PRS+3+SG
tartameleia-o	tartamelear+V.ele.ACC.3.M.SG+PRS+3+SG
tartameleia-se	tartamelear+V.ele.REFL+PRS+3+SG
tartameleias-lhes	tartamelear+V.ele.DAT.3.PL+PRS+2+SG
tartameleias-lhe	tartamelear+V.ele.DAT.3.SG+PRS+2+SG
tartameleias-me	tartamelear+V.eu.AD.1.SG+PRS+2+SG
tartamelei-as	tartamelar+V.ele.ACC.3.F.PL+PRF+1+SG
tartameleias-te	tartamelear+V.tu.AD.2.SG+PRS+2+SG
tartameleias-vos	tartamelear+V.vós.AD.2.PL+PRS+2+SG
tartamelei-a	tartamelar+V.ele.ACC.3.F.SG+PRF+1+SG
tartameleia-te	tartamelear+V.tu.AD.2.SG+PRS+3+SG
tartameleia-vos	tartamelear+V.vós.AD.2.PL+PRS+3+SG
tartamelei-lhes	tartamelar+V.ele.DAT.3.PL+PRF+1+SG
tartamelei-lhe	tartamelar+V.ele.DAT.3.SG+PRF+1+SG
tartamelei-me	tartamelar+V.eu.AD.1.SG+PRF+1+SG
tartamelei-nos	tartamelar+nós.AD.1.PL+PRF+1+SG
tartameleio-as	tartamelear+V.ele.ACC.3.F.PL+PRS+1+SG
tartameleio-a	tartamelear+V.ele.ACC.3.F.SG+PRS+1+SG
tartameleio-lhes	tartamelear+V.ele.DAT.3.PL+PRS+1+SG
tartameleio-lhe	tartamelear+V.ele.DAT.3.SG+PRS+1+SG
tartameleio-me	tartamelear+V.eu.AD.1.SG+PRS+1+SG
tartameleio-nos	tartamelear+nós.AD.1.PL+PRS+1+SG
tartameleio-os	tartamelear+V.ele.ACC.3.M.PL+PRS+1+SG
tartameleio-o	tartamelear+V.ele.ACC.3.M.SG+PRS+1+SG
tartamelei-os	tartamelar+V.ele.ACC.3.M.PL+PRF+1+SG
tartamelei-o	tartamelar+V.ele.ACC.3.M.SG+PRF+1+SG
tartameleio-te	tartamelear+V.tu.AD.2.SG+PRS+1+SG
tartameleio-vos	tartamelear+V.vós.AD.2.PL+PRS+1+SG
tartamelei-te	tartamelar+V.tu.AD.2.SG+PRF+1+SG
tartamelei-vos	tartamelar+V.vós.AD.2.PL+PRF+1+SG
tartamele-lhes	tartamelar+V.ele.DAT.3.PL+IMP+3+SG
tartamele-lhe	tartamelar+V.ele.DAT.3.SG+IMP+3+SG
tartamele-me	tartamelar+V.eu.AD.1.SG+IMP+3+SG
tartamelem-lhes	tartamelar+V.ele.DAT.3.PL+IMP+3+PL
tartamelem-lhe	tartamelar+V.ele.DAT.3.SG+IMP+3+PL
tartamelem-me	tartamelar+V.eu.AD.1.SG+IMP+3+PL
tartamelem-nas	tartamelar+V.ele.ACC.3.F.PL+IMP+3+PL
tartamelem-na	tartamelar+V.ele.ACC.3.F.SG+IMP+3+PL
tartamelem-nos	tartamelar+V.ele.ACC.3.M.PL+IMP+3+PL
tartamelem-nos	tartamelar+V.nós.AD.1.PL+IMP+3+PL
tartamelem-no	tartamelar+V.ele.ACC.3.M.SG+IMP+3+PL
tartamelemo-las	tartamelar+V.ele.ACC.3.F.PL+IMP+1+PL
tartamelemo-la	tartamelar+V.ele.ACC.3.F.SG+IMP+1+PL
tartamelemo-los	tartamelar+V.ele.ACC.3.M.PL+IMP+1+PL
tartamelemo-lo	tartamelar+V.ele.ACC.3.M.SG+IMP+1+PL
tartamelemo-nos	tartamelar+nós.AD.1.PL+IMP+1+PL
tartamelemos-lhes	tartamelar+V.ele.DAT.3.PL+IMP+1+PL
tartamelemos-lhe	tartamelar+V.ele.DAT.3.SG+IMP+1+PL
tartamelemos-me	tartamelar+V.eu.AD.1.SG+IMP+1+PL
tartamelemos-te	tartamelar+V.tu.AD.2.SG+IMP+1+PL
tartamelemos-vos	tartamelar+V.vós.AD.2.PL+IMP+1+PL
tartamelem-se	tartamelar+V.ele.REFL+IMP+3+PL
tartamelem-te	tartamelar+V.tu.AD.2.SG+IMP+3+PL
tartamelem-vos	tartamelar+V.vós.AD.2.PL+IMP+3+PL
tartamele-nos	tartamelar+nós.AD.1.PL+IMP+3+SG
tartamele-os	tartamelar+V.ele.ACC.3.M.PL+IMP+3+SG
tartamele-o	tartamelar+V.ele.ACC.3.M.SG+IMP+3+SG
tartameleou-as	tartamelear+V.ele.ACC.3.F.PL+PRF+3+SG
tartameleou-a	tartamelear+V.ele.ACC.3.F.SG+PRF+3+SG
tartameleou-lhes	tartamelear+V.ele.DAT.3.PL+PRF+3+SG
tartameleou-lhe	tartamelear+V.ele.DAT.3.SG+PRF+3+SG
tartameleou-me	tartamelear+V.eu.AD.1.SG+PRF+3+SG
tartameleou-nos	tartamelear+nós.AD.1.PL+PRF+3+SG
tartameleou-os	tartamelear+V.ele.ACC.3.M.PL+PRF+3+SG
tartameleou-o	tartamelear+V.ele.ACC.3.M.SG+PRF+3+SG
tartameleou-se	tartamelear+V.ele.REFL+PRF+3+SG
tartameleou-te	tartamelear+V.tu.AD.2.SG+PRF+3+SG
tartameleou-vos	tartamelear+V.vós.AD.2.PL+PRF+3+SG
tartamele-se	tartamelar+V.ele.REFL+IMP+3+SG
tartamele-te	tartamelar+V.tu.AD.2.SG+IMP+3+SG
tartamele-vos	tartamelar+V.vós.AD.2.PL+IMP+3+SG
tartamelo-as	tartamelar+V.ele.ACC.3.F.PL+PRS+1+SG
tartamelo-a	tartamelar+V.ele.ACC.3.F.SG+PRS+1+SG
tartamelo-lhes	tartamelar+V.ele.DAT.3.PL+PRS+1+SG
tartamelo-lhe	tartamelar+V.ele.DAT.3.SG+PRS+1+SG
tartamelo-me	tartamelar+V.eu.AD.1.SG+PRS+1+SG
tartamelo-nos	tartamelar+nós.AD.1.PL+PRS+1+SG
tartamelo-os	tartamelar+V.ele.ACC.3.M.PL+PRS+1+SG
tartamelo-o	tartamelar+V.ele.ACC.3.M.SG+PRS+1+SG
tartamelo-te	tartamelar+V.tu.AD.2.SG+PRS+1+SG
tartamelou-as	tartamelar+V.ele.ACC.3.F.PL+PRF+3+SG
tartamelou-a	tartamelar+V.ele.ACC.3.F.SG+PRF+3+SG
tartamelou-lhes	tartamelar+V.ele.DAT.3.PL+PRF+3+SG
tartamelou-lhe	tartamelar+V.ele.DAT.3.SG+PRF+3+SG
tartamelou-me	tartamelar+V.eu.AD.1.SG+PRF+3+SG
tartamelou-nos	tartamelar+nós.AD.1.PL+PRF+3+SG
tartamelou-os	tartamelar+V.ele.ACC.3.M.PL+PRF+3+SG
tartamelou-o	tartamelar+V.ele.ACC.3.M.SG+PRF+3+SG
tartamelou-se	tartamelar+V.ele.REFL+PRF+3+SG
tartamelou-te	tartamelar+V.tu.AD.2.SG+PRF+3+SG
tartamelou-vos	tartamelar+V.vós.AD.2.PL+PRF+3+SG
tartamelo-vos	tartamelar+V.vós.AD.2.PL+PRS+1+SG
tartamudeai-las	tartamudear+V.ele.ACC.3.F.PL+PRS+2+PL
tartamudeai-la	tartamudear+V.ele.ACC.3.F.SG+PRS+2+PL
tartamudeai-los	tartamudear+V.ele.ACC.3.M.PL+PRS+2+PL
tartamudeai-lo	tartamudear+V.ele.ACC.3.M.SG+PRS+2+PL
tartamudeai-nos	tartamudear+nós.AD.1.PL+PRS+2+PL
tartamudeais-lhes	tartamudear+V.ele.DAT.3.PL+PRS+2+PL
tartamudeais-lhe	tartamudear+V.ele.DAT.3.SG+PRS+2+PL
tartamudeais-me	tartamudear+V.eu.AD.1.SG+PRS+2+PL
tartamudeais-te	tartamudear+V.tu.AD.2.SG+PRS+2+PL
tartamudeais-vos	tartamudear+V.vós.AD.2.PL+PRS+2+PL
tartamudeá-la-ão	tartamudear+V.ele.ACC.3.F.SG+FUT+3+PL
tartamudeá-la-ás	tartamudear+V.ele.ACC.3.F.SG+FUT+2+SG
tartamudeá-la-á	tartamudear+V.ele.ACC.3.F.SG+FUT+3+SG
tartamudeá-la-eis	tartamudear+V.ele.ACC.3.F.SG+FUT+2+PL
tartamudeá-la-ei	tartamudear+V.ele.ACC.3.F.SG+FUT+1+SG
tartamudeá-la-emos	tartamudear+V.ele.ACC.3.F.SG+FUT+1+PL
tartamudeá-la-íamos	tartamudear+V.ele.ACC.3.F.SG+COND+1+PL
tartamudeá-la-iam	tartamudear+V.ele.ACC.3.F.SG+COND+3+PL
tartamudeá-la-ias	tartamudear+V.ele.ACC.3.F.SG+COND+2+SG
tartamudeá-la-ia	tartamudear+V.ele.ACC.3.F.SG+COND+1+SG
tartamudeá-la-ia	tartamudear+V.ele.ACC.3.F.SG+COND+3+SG
tartamudeá-la-íeis	tartamudear+V.ele.ACC.3.F.SG+COND+2+PL
tartamudeá-las-ão	tartamudear+V.ele.ACC.3.F.PL+FUT+3+PL
tartamudeá-las-ás	tartamudear+V.ele.ACC.3.F.PL+FUT+2+SG
tartamudeá-las-á	tartamudear+V.ele.ACC.3.F.PL+FUT+3+SG
tartamudeá-las-eis	tartamudear+V.ele.ACC.3.F.PL+FUT+2+PL
tartamudeá-las-ei	tartamudear+V.ele.ACC.3.F.PL+FUT+1+SG
tartamudeá-las-emos	tartamudear+V.ele.ACC.3.F.PL+FUT+1+PL
tartamudeá-las-íamos	tartamudear+V.ele.ACC.3.F.PL+COND+1+PL
tartamudeá-las-iam	tartamudear+V.ele.ACC.3.F.PL+COND+3+PL
tartamudeá-las-ias	tartamudear+V.ele.ACC.3.F.PL+COND+2+SG
tartamudeá-las-ia	tartamudear+V.ele.ACC.3.F.PL+COND+1+SG
tartamudeá-las-ia	tartamudear+V.ele.ACC.3.F.PL+COND+3+SG
tartamudeá-las-íeis	tartamudear+V.ele.ACC.3.F.PL+COND+2+PL
tartamudeá-las	tartamudear+V.ele.ACC.3.F.PL+INF+1+SG
tartamudeá-las	tartamudear+V.ele.ACC.3.F.PL+INF+3+SG
tartamudeá-las	tartamudear+V.ele.ACC.3.F.PL+SBJF+1+SG
tartamudeá-las	tartamudear+V.ele.ACC.3.F.PL+SBJF+3+SG
tartamudeá-la	tartamudear+V.ele.ACC.3.F.SG+INF+1+SG
tartamudeá-la	tartamudear+V.ele.ACC.3.F.SG+INF+3+SG
tartamudeá-la	tartamudear+V.ele.ACC.3.F.SG+SBJF+1+SG
tartamudeá-la	tartamudear+V.ele.ACC.3.F.SG+SBJF+3+SG
tartamudeá-lo-ão	tartamudear+V.ele.ACC.3.M.SG+FUT+3+PL
tartamudeá-lo-ás	tartamudear+V.ele.ACC.3.M.SG+FUT+2+SG
tartamudeá-lo-á	tartamudear+V.ele.ACC.3.M.SG+FUT+3+SG
tartamudeá-lo-eis	tartamudear+V.ele.ACC.3.M.SG+FUT+2+PL
tartamudeá-lo-ei	tartamudear+V.ele.ACC.3.M.SG+FUT+1+SG
tartamudeá-lo-emos	tartamudear+V.ele.ACC.3.M.SG+FUT+1+PL
tartamudeá-lo-íamos	tartamudear+V.ele.ACC.3.M.SG+COND+1+PL
tartamudeá-lo-iam	tartamudear+V.ele.ACC.3.M.SG+COND+3+PL
tartamudeá-lo-ias	tartamudear+V.ele.ACC.3.M.SG+COND+2+SG
tartamudeá-lo-ia	tartamudear+V.ele.ACC.3.M.SG+COND+1+SG
tartamudeá-lo-ia	tartamudear+V.ele.ACC.3.M.SG+COND+3+SG
tartamudeá-lo-íeis	tartamudear+V.ele.ACC.3.M.SG+COND+2+PL
tartamudeá-los-ão	tartamudear+V.ele.ACC.3.M.PL+FUT+3+PL
tartamudeá-los-ás	tartamudear+V.ele.ACC.3.M.PL+FUT+2+SG
tartamudeá-los-á	tartamudear+V.ele.ACC.3.M.PL+FUT+3+SG
tartamudeá-los-eis	tartamudear+V.ele.ACC.3.M.PL+FUT+2+PL
tartamudeá-los-ei	tartamudear+V.ele.ACC.3.M.PL+FUT+1+SG
tartamudeá-los-emos	tartamudear+V.ele.ACC.3.M.PL+FUT+1+PL
tartamudeá-los-íamos	tartamudear+V.ele.ACC.3.M.PL+COND+1+PL
tartamudeá-los-iam	tartamudear+V.ele.ACC.3.M.PL+COND+3+PL
tartamudeá-los-ias	tartamudear+V.ele.ACC.3.M.PL+COND+2+SG
tartamudeá-los-ia	tartamudear+V.ele.ACC.3.M.PL+COND+1+SG
tartamudeá-los-ia	tartamudear+V.ele.ACC.3.M.PL+COND+3+SG
tartamudeá-los-íeis	tartamudear+V.ele.ACC.3.M.PL+COND+2+PL
tartamudeá-los	tartamudear+V.ele.ACC.3.M.PL+INF+1+SG
tartamudeá-los	tartamudear+V.ele.ACC.3.M.PL+INF+3+SG
tartamudeá-los	tartamudear+V.ele.ACC.3.M.PL+SBJF+1+SG
tartamudeá-los	tartamudear+V.ele.ACC.3.M.PL+SBJF+3+SG
tartamudeá-lo	tartamudear+V.ele.ACC.3.M.SG+INF+1+SG
tartamudeá-lo	tartamudear+V.ele.ACC.3.M.SG+INF+3+SG
tartamudeá-lo	tartamudear+V.ele.ACC.3.M.SG+SBJF+1+SG
tartamudeá-lo	tartamudear+V.ele.ACC.3.M.SG+SBJF+3+SG
tartamudeamo-las	tartamudear+V.ele.ACC.3.F.PL+PRF+1+PL
tartamudeamo-las	tartamudear+V.ele.ACC.3.F.PL+PRS+1+PL
tartamudeamo-la	tartamudear+V.ele.ACC.3.F.SG+PRF+1+PL
tartamudeamo-la	tartamudear+V.ele.ACC.3.F.SG+PRS+1+PL
tartamudeamo-los	tartamudear+V.ele.ACC.3.M.PL+PRF+1+PL
tartamudeamo-los	tartamudear+V.ele.ACC.3.M.PL+PRS+1+PL
tartamudeamo-lo	tartamudear+V.ele.ACC.3.M.SG+PRF+1+PL
tartamudeamo-lo	tartamudear+V.ele.ACC.3.M.SG+PRS+1+PL
tartamudeamo-nos	tartamudear+nós.AD.1.PL+PRF+1+PL
tartamudeamo-nos	tartamudear+nós.AD.1.PL+PRS+1+PL
tartamudeamos-lhes	tartamudear+V.ele.DAT.3.PL+PRF+1+PL
tartamudeamos-lhes	tartamudear+V.ele.DAT.3.PL+PRS+1+PL
tartamudeamos-lhe	tartamudear+V.ele.DAT.3.SG+PRF+1+PL
tartamudeamos-lhe	tartamudear+V.ele.DAT.3.SG+PRS+1+PL
tartamudeamos-me	tartamudear+V.eu.AD.1.SG+PRF+1+PL
tartamudeamos-me	tartamudear+V.eu.AD.1.SG+PRS+1+PL
tartamudeamos-te	tartamudear+V.tu.AD.2.SG+PRF+1+PL
tartamudeamos-te	tartamudear+V.tu.AD.2.SG+PRS+1+PL
tartamudeamos-vos	tartamudear+V.vós.AD.2.PL+PRF+1+PL
tartamudeamos-vos	tartamudear+V.vós.AD.2.PL+PRS+1+PL
tartamudeando-as	tartamudear+V.ele.ACC.3.F.PL+GRD
tartamudeando-a	tartamudear+V.ele.ACC.3.F.SG+GRD
tartamudeando-lhes	tartamudear+V.ele.DAT.3.PL+GRD
tartamudeando-lhe	tartamudear+V.ele.DAT.3.SG+GRD
tartamudeando-me	tartamudear+V.eu.AD.1.SG+GRD
tartamudeando-nos	tartamudear+nós.AD.1.PL+GRD
tartamudeando-os	tartamudear+V.ele.ACC.3.M.PL+GRD
tartamudeando-o	tartamudear+V.ele.ACC.3.M.SG+GRD
tartamudeando-se	tartamudear+V.ele.REFL+GRD
tartamudeando-te	tartamudear+V.tu.AD.2.SG+GRD
tartamudeando-vos	tartamudear+V.vós.AD.2.PL+GRD
tartamudeara-as	tartamudear+V.ele.ACC.3.F.PL+PQP+1+SG
tartamudeara-as	tartamudear+V.ele.ACC.3.F.PL+PQP+3+SG
tartamudeara-a	tartamudear+V.ele.ACC.3.F.SG+PQP+1+SG
tartamudeara-a	tartamudear+V.ele.ACC.3.F.SG+PQP+3+SG
tartamudeara-las	tartamudear+V.ele.ACC.3.F.PL+PQP+2+SG
tartamudeara-la	tartamudear+V.ele.ACC.3.F.SG+PQP+2+SG
tartamudeara-lhes	tartamudear+V.ele.DAT.3.PL+PQP+1+SG
tartamudeara-lhes	tartamudear+V.ele.DAT.3.PL+PQP+3+SG
tartamudeara-lhe	tartamudear+V.ele.DAT.3.SG+PQP+1+SG
tartamudeara-lhe	tartamudear+V.ele.DAT.3.SG+PQP+3+SG
tartamudeara-los	tartamudear+V.ele.ACC.3.M.PL+PQP+2+SG
tartamudeara-lo	tartamudear+V.ele.ACC.3.M.SG+PQP+2+SG
tartamudeara-me	tartamudear+V.eu.AD.1.SG+PQP+1+SG
tartamudeara-me	tartamudear+V.eu.AD.1.SG+PQP+3+SG
tartamudearam-lhes	tartamudear+V.ele.DAT.3.PL+PQP+3+PL
tartamudearam-lhes	tartamudear+V.ele.DAT.3.PL+PRF+3+PL
tartamudearam-lhe	tartamudear+V.ele.DAT.3.SG+PQP+3+PL
tartamudearam-lhe	tartamudear+V.ele.DAT.3.SG+PRF+3+PL
tartamudearam-me	tartamudear+V.eu.AD.1.SG+PQP+3+PL
tartamudearam-me	tartamudear+V.eu.AD.1.SG+PRF+3+PL
tartamudearam-nas	tartamudear+V.ele.ACC.3.F.PL+PQP+3+PL
tartamudearam-nas	tartamudear+V.ele.ACC.3.F.PL+PRF+3+PL
tartamudearam-na	tartamudear+V.ele.ACC.3.F.SG+PQP+3+PL
tartamudearam-na	tartamudear+V.ele.ACC.3.F.SG+PRF+3+PL
tartamudearam-nos	tartamudear+V.ele.ACC.3.M.PL+PQP+3+PL
tartamudearam-nos	tartamudear+V.ele.ACC.3.M.PL+PRF+3+PL
tartamudearam-nos	tartamudear+V.nós.AD.1.PL+PQP+3+PL
tartamudearam-nos	tartamudear+V.nós.AD.1.PL+PRF+3+PL
tartamudearam-no	tartamudear+V.ele.ACC.3.M.SG+PQP+3+PL
tartamudearam-no	tartamudear+V.ele.ACC.3.M.SG+PRF+3+PL
tartamudeáramo-las	tartamudear+V.ele.ACC.3.F.PL+PQP+1+PL
tartamudeáramo-la	tartamudear+V.ele.ACC.3.F.SG+PQP+1+PL
tartamudeáramo-los	tartamudear+V.ele.ACC.3.M.PL+PQP+1+PL
tartamudeáramo-lo	tartamudear+V.ele.ACC.3.M.SG+PQP+1+PL
tartamudeáramo-nos	tartamudear+nós.AD.1.PL+PQP+1+PL
tartamudeáramos-lhes	tartamudear+V.ele.DAT.3.PL+PQP+1+PL
tartamudeáramos-lhe	tartamudear+V.ele.DAT.3.SG+PQP+1+PL
tartamudeáramos-me	tartamudear+V.eu.AD.1.SG+PQP+1+PL
tartamudeáramos-te	tartamudear+V.tu.AD.2.SG+PQP+1+PL
tartamudeáramos-vos	tartamudear+V.vós.AD.2.PL+PQP+1+PL
tartamudearam-se	tartamudear+V.ele.REFL+PQP+3+PL
tartamudearam-se	tartamudear+V.ele.REFL+PRF+3+PL
tartamudearam-te	tartamudear+V.tu.AD.2.SG+PQP+3+PL
tartamudearam-te	tartamudear+V.tu.AD.2.SG+PRF+3+PL
tartamudearam-vos	tartamudear+V.vós.AD.2.PL+PQP+3+PL
tartamudearam-vos	tartamudear+V.vós.AD.2.PL+PRF+3+PL
tartamudeara-nos	tartamudear+nós.AD.1.PL+PQP+1+SG
tartamudeara-nos	tartamudear+nós.AD.1.PL+PQP+2+SG
tartamudeara-nos	tartamudear+nós.AD.1.PL+PQP+3+SG
tartamudeara-os	tartamudear+V.ele.ACC.3.M.PL+PQP+1+SG
tartamudeara-os	tartamudear+V.ele.ACC.3.M.PL+PQP+3+SG
tartamudeara-o	tartamudear+V.ele.ACC.3.M.SG+PQP+1+SG
tartamudeara-o	tartamudear+V.ele.ACC.3.M.SG+PQP+3+SG
tartamudeara-se	tartamudear+V.ele.REFL+PQP+1+SG
tartamudeara-se	tartamudear+V.ele.REFL+PQP+3+SG
tartamudearas-lhes	tartamudear+V.ele.DAT.3.PL+PQP+2+SG
tartamudearas-lhe	tartamudear+V.ele.DAT.3.SG+PQP+2+SG
tartamudearas-me	tartamudear+V.eu.AD.1.SG+PQP+2+SG
tartamudearas-te	tartamudear+V.tu.AD.2.SG+PQP+2+SG
tartamudearas-vos	tartamudear+V.vós.AD.2.PL+PQP+2+SG
tartamudeara-te	tartamudear+V.tu.AD.2.SG+PQP+1+SG
tartamudeara-te	tartamudear+V.tu.AD.2.SG+PQP+3+SG
tartamudeara-vos	tartamudear+V.vós.AD.2.PL+PQP+1+SG
tartamudeara-vos	tartamudear+V.vós.AD.2.PL+PQP+3+SG
tartamudearde-las	tartamudear+V.ele.ACC.3.F.PL+INF+2+PL
tartamudearde-las	tartamudear+V.ele.ACC.3.F.PL+SBJF+2+PL
tartamudearde-la	tartamudear+V.ele.ACC.3.F.SG+INF+2+PL
tartamudearde-la	tartamudear+V.ele.ACC.3.F.SG+SBJF+2+PL
tartamudearde-los	tartamudear+V.ele.ACC.3.M.PL+INF+2+PL
tartamudearde-los	tartamudear+V.ele.ACC.3.M.PL+SBJF+2+PL
tartamudearde-lo	tartamudear+V.ele.ACC.3.M.SG+INF+2+PL
tartamudearde-lo	tartamudear+V.ele.ACC.3.M.SG+SBJF+2+PL
tartamudearde-nos	tartamudear+nós.AD.1.PL+INF+2+PL
tartamudearde-nos	tartamudear+nós.AD.1.PL+SBJF+2+PL
tartamudeardes-lhes	tartamudear+V.ele.DAT.3.PL+INF+2+PL
tartamudeardes-lhes	tartamudear+V.ele.DAT.3.PL+SBJF+2+PL
tartamudeardes-lhe	tartamudear+V.ele.DAT.3.SG+INF+2+PL
tartamudeardes-lhe	tartamudear+V.ele.DAT.3.SG+SBJF+2+PL
tartamudeardes-me	tartamudear+V.eu.AD.1.SG+INF+2+PL
tartamudeardes-me	tartamudear+V.eu.AD.1.SG+SBJF+2+PL
tartamudeardes-te	tartamudear+V.tu.AD.2.SG+INF+2+PL
tartamudeardes-te	tartamudear+V.tu.AD.2.SG+SBJF+2+PL
tartamudeardes-vos	tartamudear+V.vós.AD.2.PL+INF+2+PL
tartamudeardes-vos	tartamudear+V.vós.AD.2.PL+SBJF+2+PL
tartamudeárei-las	tartamudear+V.ele.ACC.3.F.PL+PQP+2+PL
tartamudeárei-la	tartamudear+V.ele.ACC.3.F.SG+PQP+2+PL
tartamudeárei-los	tartamudear+V.ele.ACC.3.M.PL+PQP+2+PL
tartamudeárei-lo	tartamudear+V.ele.ACC.3.M.SG+PQP+2+PL
tartamudeárei-nos	tartamudear+nós.AD.1.PL+PQP+2+PL
tartamudeáreis-lhes	tartamudear+V.ele.DAT.3.PL+PQP+2+PL
tartamudeáreis-lhe	tartamudear+V.ele.DAT.3.SG+PQP+2+PL
tartamudeáreis-me	tartamudear+V.eu.AD.1.SG+PQP+2+PL
tartamudeáreis-te	tartamudear+V.tu.AD.2.SG+PQP+2+PL
tartamudeáreis-vos	tartamudear+V.vós.AD.2.PL+PQP+2+PL
tartamudeare-las	tartamudear+V.ele.ACC.3.F.PL+INF+2+SG
tartamudeare-las	tartamudear+V.ele.ACC.3.F.PL+SBJF+2+SG
tartamudeare-la	tartamudear+V.ele.ACC.3.F.SG+INF+2+SG
tartamudeare-la	tartamudear+V.ele.ACC.3.F.SG+SBJF+2+SG
tartamudeare-los	tartamudear+V.ele.ACC.3.M.PL+INF+2+SG
tartamudeare-los	tartamudear+V.ele.ACC.3.M.PL+SBJF+2+SG
tartamudeare-lo	tartamudear+V.ele.ACC.3.M.SG+INF+2+SG
tartamudeare-lo	tartamudear+V.ele.ACC.3.M.SG+SBJF+2+SG
tartamudearem-lhes	tartamudear+V.ele.DAT.3.PL+INF+3+PL
tartamudearem-lhes	tartamudear+V.ele.DAT.3.PL+SBJF+3+PL
tartamudearem-lhe	tartamudear+V.ele.DAT.3.SG+INF+3+PL
tartamudearem-lhe	tartamudear+V.ele.DAT.3.SG+SBJF+3+PL
tartamudearem-me	tartamudear+V.eu.AD.1.SG+INF+3+PL
tartamudearem-me	tartamudear+V.eu.AD.1.SG+SBJF+3+PL
tartamudearem-nas	tartamudear+V.ele.ACC.3.F.PL+INF+3+PL
tartamudearem-nas	tartamudear+V.ele.ACC.3.F.PL+SBJF+3+PL
tartamudearem-na	tartamudear+V.ele.ACC.3.F.SG+INF+3+PL
tartamudearem-na	tartamudear+V.ele.ACC.3.F.SG+SBJF+3+PL
tartamudearem-nos	tartamudear+V.ele.ACC.3.M.PL+INF+3+PL
tartamudearem-nos	tartamudear+V.ele.ACC.3.M.PL+SBJF+3+PL
tartamudearem-nos	tartamudear+V.nós.AD.1.PL+INF+3+PL
tartamudearem-nos	tartamudear+V.nós.AD.1.PL+SBJF+3+PL
tartamudearem-no	tartamudear+V.ele.ACC.3.M.SG+INF+3+PL
tartamudearem-no	tartamudear+V.ele.ACC.3.M.SG+SBJF+3+PL
tartamudearem-se	tartamudear+V.ele.REFL+INF+3+PL
tartamudearem-se	tartamudear+V.ele.REFL+SBJF+3+PL
tartamudearem-te	tartamudear+V.tu.AD.2.SG+INF+3+PL
tartamudearem-te	tartamudear+V.tu.AD.2.SG+SBJF+3+PL
tartamudearem-vos	tartamudear+V.vós.AD.2.PL+INF+3+PL
tartamudearem-vos	tartamudear+V.vós.AD.2.PL+SBJF+3+PL
tartamudeare-nos	tartamudear+nós.AD.1.PL+INF+2+SG
tartamudeare-nos	tartamudear+nós.AD.1.PL+SBJF+2+SG
tartamudeares-lhes	tartamudear+V.ele.DAT.3.PL+INF+2+SG
tartamudeares-lhes	tartamudear+V.ele.DAT.3.PL+SBJF+2+SG
tartamudeares-lhe	tartamudear+V.ele.DAT.3.SG+INF+2+SG
tartamudeares-lhe	tartamudear+V.ele.DAT.3.SG+SBJF+2+SG
tartamudeares-me	tartamudear+V.eu.AD.1.SG+INF+2+SG
tartamudeares-me	tartamudear+V.eu.AD.1.SG+SBJF+2+SG
tartamudeares-te	tartamudear+V.tu.AD.2.SG+INF+2+SG
tartamudeares-te	tartamudear+V.tu.AD.2.SG+SBJF+2+SG
tartamudeares-vos	tartamudear+V.vós.AD.2.PL+INF+2+SG
tartamudeares-vos	tartamudear+V.vós.AD.2.PL+SBJF+2+SG
tartamudear-lhe-ão	tartamudear+V.ele.DAT.3.SG+FUT+3+PL
tartamudear-lhe-ás	tartamudear+V.ele.DAT.3.SG+FUT+2+SG
tartamudear-lhe-á	tartamudear+V.ele.DAT.3.SG+FUT+3+SG
tartamudear-lhe-eis	tartamudear+V.ele.DAT.3.SG+FUT+2+PL
tartamudear-lhe-ei	tartamudear+V.ele.DAT.3.SG+FUT+1+SG
tartamudear-lhe-emos	tartamudear+V.ele.DAT.3.SG+FUT+1+PL
tartamudear-lhe-íamos	tartamudear+V.ele.DAT.3.SG+COND+1+PL
tartamudear-lhe-iam	tartamudear+V.ele.DAT.3.SG+COND+3+PL
tartamudear-lhe-ias	tartamudear+V.ele.DAT.3.SG+COND+2+SG
tartamudear-lhe-ia	tartamudear+V.ele.DAT.3.SG+COND+1+SG
tartamudear-lhe-ia	tartamudear+V.ele.DAT.3.SG+COND+3+SG
tartamudear-lhe-íeis	tartamudear+V.ele.DAT.3.SG+COND+2+PL
tartamudear-lhes-ão	tartamudear+V.ele.DAT.3.PL+FUT+3+PL
tartamudear-lhes-ás	tartamudear+V.ele.DAT.3.PL+FUT+2+SG
tartamudear-lhes-á	tartamudear+V.ele.DAT.3.PL+FUT+3+SG
tartamudear-lhes-eis	tartamudear+V.ele.DAT.3.PL+FUT+2+PL
tartamudear-lhes-ei	tartamudear+V.ele.DAT.3.PL+FUT+1+SG
tartamudear-lhes-emos	tartamudear+V.ele.DAT.3.PL+FUT+1+PL
tartamudear-lhes-íamos	tartamudear+V.ele.DAT.3.PL+COND+1+PL
tartamudear-lhes-iam	tartamudear+V.ele.DAT.3.PL+COND+3+PL
tartamudear-lhes-ias	tartamudear+V.ele.DAT.3.PL+COND+2+SG
tartamudear-lhes-ia	tartamudear+V.ele.DAT.3.PL+COND+1+SG
tartamudear-lhes-ia	tartamudear+V.ele.DAT.3.PL+COND+3+SG
tartamudear-lhes-íeis	tartamudear+V.ele.DAT.3.PL+COND+2+PL
tartamudear-lhes	tartamudear+V.ele.DAT.3.PL+INF
tartamudear-lhes	tartamudear+V.ele.DAT.3.PL+INF+1+SG
tartamudear-lhes	tartamudear+V.ele.DAT.3.PL+INF+3+SG
tartamudear-lhes	tartamudear+V.ele.DAT.3.PL+SBJF+1+SG
tartamudear-lhes	tartamudear+V.ele.DAT.3.PL+SBJF+3+SG
tartamudear-lhe	tartamudear+V.ele.DAT.3.SG+INF
tartamudear-lhe	tartamudear+V.ele.DAT.3.SG+INF+1+SG
tartamudear-lhe	tartamudear+V.ele.DAT.3.SG+INF+3+SG
tartamudear-lhe	tartamudear+V.ele.DAT.3.SG+SBJF+1+SG
tartamudear-lhe	tartamudear+V.ele.DAT.3.SG+SBJF+3+SG
tartamudear-me-ão	tartamudear+V.eu.AD.1.SG+FUT+3+PL
tartamudear-me-ás	tartamudear+V.eu.AD.1.SG+FUT+2+SG
tartamudear-me-á	tartamudear+V.eu.AD.1.SG+FUT+3+SG
tartamudear-me-eis	tartamudear+V.eu.AD.1.SG+FUT+2+PL
tartamudear-me-ei	tartamudear+V.eu.AD.1.SG+FUT+1+SG
tartamudear-me-emos	tartamudear+V.eu.AD.1.SG+FUT+1+PL
tartamudear-me-íamos	tartamudear+V.eu.AD.1.SG+COND+1+PL
tartamudear-me-iam	tartamudear+V.eu.AD.1.SG+COND+3+PL
tartamudear-me-ias	tartamudear+V.eu.AD.1.SG+COND+2+SG
tartamudear-me-ia	tartamudear+V.eu.AD.1.SG+COND+1+SG
tartamudear-me-ia	tartamudear+V.eu.AD.1.SG+COND+3+SG
tartamudear-me-íeis	tartamudear+V.eu.AD.1.SG+COND+2+PL
tartamudear-me	tartamudear+V.eu.AD.1.SG+INF
tartamudear-me	tartamudear+V.eu.AD.1.SG+INF+1+SG
tartamudear-me	tartamudear+V.eu.AD.1.SG+INF+3+SG
tartamudear-me	tartamudear+V.eu.AD.1.SG+SBJF+1+SG
tartamudear-me	tartamudear+V.eu.AD.1.SG+SBJF+3+SG
tartamudearmo-las	tartamudear+V.ele.ACC.3.F.PL+INF+1+PL
tartamudearmo-las	tartamudear+V.ele.ACC.3.F.PL+SBJF+1+PL
tartamudearmo-la	tartamudear+V.ele.ACC.3.F.SG+INF+1+PL
tartamudearmo-la	tartamudear+V.ele.ACC.3.F.SG+SBJF+1+PL
tartamudearmo-los	tartamudear+V.ele.ACC.3.M.PL+INF+1+PL
tartamudearmo-los	tartamudear+V.ele.ACC.3.M.PL+SBJF+1+PL
tartamudearmo-lo	tartamudear+V.ele.ACC.3.M.SG+INF+1+PL
tartamudearmo-lo	tartamudear+V.ele.ACC.3.M.SG+SBJF+1+PL
tartamudearmo-nos	tartamudear+nós.AD.1.PL+INF+1+PL
tartamudearmo-nos	tartamudear+nós.AD.1.PL+SBJF+1+PL
tartamudearmos-lhes	tartamudear+V.ele.DAT.3.PL+INF+1+PL
tartamudearmos-lhes	tartamudear+V.ele.DAT.3.PL+SBJF+1+PL
tartamudearmos-lhe	tartamudear+V.ele.DAT.3.SG+INF+1+PL
tartamudearmos-lhe	tartamudear+V.ele.DAT.3.SG+SBJF+1+PL
tartamudearmos-me	tartamudear+V.eu.AD.1.SG+INF+1+PL
tartamudearmos-me	tartamudear+V.eu.AD.1.SG+SBJF+1+PL
tartamudearmos-te	tartamudear+V.tu.AD.2.SG+INF+1+PL
tartamudearmos-te	tartamudear+V.tu.AD.2.SG+SBJF+1+PL
tartamudearmos-vos	tartamudear+V.vós.AD.2.PL+INF+1+PL
tartamudearmos-vos	tartamudear+V.vós.AD.2.PL+SBJF+1+PL
tartamudear-nos-ão	tartamudear+nós.AD.1.PL+FUT+3+PL
tartamudear-nos-ás	tartamudear+nós.AD.1.PL+FUT+2+SG
tartamudear-nos-á	tartamudear+nós.AD.1.PL+FUT+3+SG
tartamudear-nos-eis	tartamudear+nós.AD.1.PL+FUT+2+PL
tartamudear-nos-ei	tartamudear+nós.AD.1.PL+FUT+1+SG
tartamudear-nos-emos	tartamudear+nós.AD.1.PL+FUT+1+PL
tartamudear-nos-íamos	tartamudear+nós.AD.1.PL+COND+1+PL
tartamudear-nos-iam	tartamudear+nós.AD.1.PL+COND+3+PL
tartamudear-nos-ias	tartamudear+nós.AD.1.PL+COND+2+SG
tartamudear-nos-ia	tartamudear+nós.AD.1.PL+COND+1+SG
tartamudear-nos-ia	tartamudear+nós.AD.1.PL+COND+3+SG
tartamudear-nos-íeis	tartamudear+nós.AD.1.PL+COND+2+PL
tartamudear-nos	tartamudear+nós.AD.1.PL+INF
tartamudear-nos	tartamudear+nós.AD.1.PL+INF+1+SG
tartamudear-nos	tartamudear+nós.AD.1.PL+INF+3+SG
tartamudear-nos	tartamudear+nós.AD.1.PL+SBJF+1+SG
tartamudear-nos	tartamudear+nós.AD.1.PL+SBJF+3+SG
tartamudear-se-ão	tartamudear+V.ele.REFL+FUT+3+PL
tartamudear-se-á	tartamudear+V.ele.REFL+FUT+3+SG
tartamudear-se-iam	tartamudear+V.ele.REFL+COND+3+PL
tartamudear-se-ia	tartamudear+V.ele.REFL+COND+3+SG
tartamudear-se	tartamudear+V.ele.REFL+INF
tartamudear-se	tartamudear+V.ele.REFL+INF+3+SG
tartamudear-se	tartamudear+V.ele.REFL+SBJF+3+SG
tartamudear-te-ão	tartamudear+V.tu.AD.2.SG+FUT+3+PL
tartamudear-te-ás	tartamudear+V.tu.AD.2.SG+FUT+2+SG
tartamudear-te-á	tartamudear+V.tu.AD.2.SG+FUT+3+SG
tartamudear-te-eis	tartamudear+V.tu.AD.2.SG+FUT+2+PL
tartamudear-te-ei	tartamudear+V.tu.AD.2.SG+FUT+1+SG
tartamudear-te-emos	tartamudear+V.tu.AD.2.SG+FUT+1+PL
tartamudear-te-íamos	tartamudear+V.tu.AD.2.SG+COND+1+PL
tartamudear-te-iam	tartamudear+V.tu.AD.2.SG+COND+3+PL
tartamudear-te-ias	tartamudear+V.tu.AD.2.SG+COND+2+SG
tartamudear-te-ia	tartamudear+V.tu.AD.2.SG+COND+1+SG
tartamudear-te-ia	tartamudear+V.tu.AD.2.SG+COND+3+SG
tartamudear-te-íeis	tartamudear+V.tu.AD.2.SG+COND+2+PL
tartamudear-te	tartamudear+V.tu.AD.2.SG+INF
tartamudear-te	tartamudear+V.tu.AD.2.SG+INF+1+SG
tartamudear-te	tartamudear+V.tu.AD.2.SG+INF+3+SG
tartamudear-te	tartamudear+V.tu.AD.2.SG+SBJF+1+SG
tartamudear-te	tartamudear+V.tu.AD.2.SG+SBJF+3+SG
tartamudear-vos-ão	tartamudear+V.vós.AD.2.PL+FUT+3+PL
tartamudear-vos-ás	tartamudear+V.vós.AD.2.PL+FUT+2+SG
tartamudear-vos-á	tartamudear+V.vós.AD.2.PL+FUT+3+SG
tartamudear-vos-eis	tartamudear+V.vós.AD.2.PL+FUT+2+PL
tartamudear-vos-ei	tartamudear+V.vós.AD.2.PL+FUT+1+SG
tartamudear-vos-emos	tartamudear+V.vós.AD.2.PL+FUT+1+PL
tartamudear-vos-íamos	tartamudear+V.vós.AD.2.PL+COND+1+PL
tartamudear-vos-iam	tartamudear+V.vós.AD.2.PL+COND+3+PL
tartamudear-vos-ias	tartamudear+V.vós.AD.2.PL+COND+2+SG
tartamudear-vos-ia	tartamudear+V.vós.AD.2.PL+COND+1+SG
tartamudear-vos-ia	tartamudear+V.vós.AD.2.PL+COND+3+SG
tartamudear-vos-íeis	tartamudear+V.vós.AD.2.PL+COND+2+PL
tartamudear-vos	tartamudear+V.vós.AD.2.PL+INF
tartamudear-vos	tartamudear+V.vós.AD.2.PL+INF+1+SG
tartamudear-vos	tartamudear+V.vós.AD.2.PL+INF+3+SG
tartamudear-vos	tartamudear+V.vós.AD.2.PL+SBJF+1+SG
tartamudear-vos	tartamudear+V.vós.AD.2.PL+SBJF+3+SG
tartamudeaste-as	tartamudear+V.ele.ACC.3.F.PL+PRF+2+SG
tartamudeaste-a	tartamudear+V.ele.ACC.3.F.SG+PRF+2+SG
tartamudeaste-las	tartamudear+V.ele.ACC.3.F.PL+PRF+2+PL
tartamudeaste-la	tartamudear+V.ele.ACC.3.F.SG+PRF+2+PL
tartamudeaste-lhes	tartamudear+V.ele.DAT.3.PL+PRF+2+SG
tartamudeaste-lhe	tartamudear+V.ele.DAT.3.SG+PRF+2+SG
tartamudeaste-los	tartamudear+V.ele.ACC.3.M.PL+PRF+2+PL
tartamudeaste-lo	tartamudear+V.ele.ACC.3.M.SG+PRF+2+PL
tartamudeaste-me	tartamudear+V.eu.AD.1.SG+PRF+2+SG
tartamudeaste-nos	tartamudear+nós.AD.1.PL+PRF+2+PL
tartamudeaste-nos	tartamudear+nós.AD.1.PL+PRF+2+SG
tartamudeaste-os	tartamudear+V.ele.ACC.3.M.PL+PRF+2+SG
tartamudeaste-o	tartamudear+V.ele.ACC.3.M.SG+PRF+2+SG
tartamudeastes-lhes	tartamudear+V.ele.DAT.3.PL+PRF+2+PL
tartamudeastes-lhe	tartamudear+V.ele.DAT.3.SG+PRF+2+PL
tartamudeastes-me	tartamudear+V.eu.AD.1.SG+PRF+2+PL
tartamudeastes-te	tartamudear+V.tu.AD.2.SG+PRF+2+PL
tartamudeastes-vos	tartamudear+V.vós.AD.2.PL+PRF+2+PL
tartamudeaste-te	tartamudear+V.tu.AD.2.SG+PRF+2+SG
tartamudeaste-vos	tartamudear+V.vós.AD.2.PL+PRF+2+SG
tartamudeava-as	tartamudear+V.ele.ACC.3.F.PL+IMPF+1+SG
tartamudeava-as	tartamudear+V.ele.ACC.3.F.PL+IMPF+3+SG
tartamudeava-a	tartamudear+V.ele.ACC.3.F.SG+IMPF+1+SG
tartamudeava-a	tartamudear+V.ele.ACC.3.F.SG+IMPF+3+SG
tartamudeava-las	tartamudear+V.ele.ACC.3.F.PL+IMPF+2+SG
tartamudeava-la	tartamudear+V.ele.ACC.3.F.SG+IMPF+2+SG
tartamudeava-lhes	tartamudear+V.ele.DAT.3.PL+IMPF+1+SG
tartamudeava-lhes	tartamudear+V.ele.DAT.3.PL+IMPF+3+SG
tartamudeava-lhe	tartamudear+V.ele.DAT.3.SG+IMPF+1+SG
tartamudeava-lhe	tartamudear+V.ele.DAT.3.SG+IMPF+3+SG
tartamudeava-los	tartamudear+V.ele.ACC.3.M.PL+IMPF+2+SG
tartamudeava-lo	tartamudear+V.ele.ACC.3.M.SG+IMPF+2+SG
tartamudeava-me	tartamudear+V.eu.AD.1.SG+IMPF+1+SG
tartamudeava-me	tartamudear+V.eu.AD.1.SG+IMPF+3+SG
tartamudeavam-lhes	tartamudear+V.ele.DAT.3.PL+IMPF+3+PL
tartamudeavam-lhe	tartamudear+V.ele.DAT.3.SG+IMPF+3+PL
tartamudeavam-me	tartamudear+V.eu.AD.1.SG+IMPF+3+PL
tartamudeavam-nas	tartamudear+V.ele.ACC.3.F.PL+IMPF+3+PL
tartamudeavam-na	tartamudear+V.ele.ACC.3.F.SG+IMPF+3+PL
tartamudeavam-nos	tartamudear+V.ele.ACC.3.M.PL+IMPF+3+PL
tartamudeavam-nos	tartamudear+V.nós.AD.1.PL+IMPF+3+PL
tartamudeavam-no	tartamudear+V.ele.ACC.3.M.SG+IMPF+3+PL
tartamudeávamo-las	tartamudear+V.ele.ACC.3.F.PL+IMPF+1+PL
tartamudeávamo-la	tartamudear+V.ele.ACC.3.F.SG+IMPF+1+PL
tartamudeávamo-los	tartamudear+V.ele.ACC.3.M.PL+IMPF+1+PL
tartamudeávamo-lo	tartamudear+V.ele.ACC.3.M.SG+IMPF+1+PL
tartamudeávamo-nos	tartamudear+nós.AD.1.PL+IMPF+1+PL
tartamudeávamos-lhes	tartamudear+V.ele.DAT.3.PL+IMPF+1+PL
tartamudeávamos-lhe	tartamudear+V.ele.DAT.3.SG+IMPF+1+PL
tartamudeávamos-me	tartamudear+V.eu.AD.1.SG+IMPF+1+PL
tartamudeávamos-te	tartamudear+V.tu.AD.2.SG+IMPF+1+PL
tartamudeávamos-vos	tartamudear+V.vós.AD.2.PL+IMPF+1+PL
tartamudeavam-se	tartamudear+V.ele.REFL+IMPF+3+PL
tartamudeavam-te	tartamudear+V.tu.AD.2.SG+IMPF+3+PL
tartamudeavam-vos	tartamudear+V.vós.AD.2.PL+IMPF+3+PL
tartamudeava-nos	tartamudear+nós.AD.1.PL+IMPF+1+SG
tartamudeava-nos	tartamudear+nós.AD.1.PL+IMPF+2+SG
tartamudeava-nos	tartamudear+nós.AD.1.PL+IMPF+3+SG
tartamudeava-os	tartamudear+V.ele.ACC.3.M.PL+IMPF+1+SG
tartamudeava-os	tartamudear+V.ele.ACC.3.M.PL+IMPF+3+SG
tartamudeava-o	tartamudear+V.ele.ACC.3.M.SG+IMPF+1+SG
tartamudeava-o	tartamudear+V.ele.ACC.3.M.SG+IMPF+3+SG
tartamudeava-se	tartamudear+V.ele.REFL+IMPF+1+SG
tartamudeava-se	tartamudear+V.ele.REFL+IMPF+3+SG
tartamudeavas-lhes	tartamudear+V.ele.DAT.3.PL+IMPF+2+SG
tartamudeavas-lhe	tartamudear+V.ele.DAT.3.SG+IMPF+2+SG
tartamudeavas-me	tartamudear+V.eu.AD.1.SG+IMPF+2+SG
tartamudeavas-te	tartamudear+V.tu.AD.2.SG+IMPF+2+SG
tartamudeavas-vos	tartamudear+V.vós.AD.2.PL+IMPF+2+SG
tartamudeava-te	tartamudear+V.tu.AD.2.SG+IMPF+1+SG
tartamudeava-te	tartamudear+V.tu.AD.2.SG+IMPF+3+SG
tartamudeava-vos	tartamudear+V.vós.AD.2.PL+IMPF+1+SG
tartamudeava-vos	tartamudear+V.vós.AD.2.PL+IMPF+3+SG
tartamudeávei-las	tartamudear+V.ele.ACC.3.F.PL+IMPF+2+PL
tartamudeávei-la	tartamudear+V.ele.ACC.3.F.SG+IMPF+2+PL
tartamudeávei-los	tartamudear+V.ele.ACC.3.M.PL+IMPF+2+PL
tartamudeávei-lo	tartamudear+V.ele.ACC.3.M.SG+IMPF+2+PL
tartamudeávei-nos	tartamudear+nós.AD.1.PL+IMPF+2+PL
tartamudeáveis-lhes	tartamudear+V.ele.DAT.3.PL+IMPF+2+PL
tartamudeáveis-lhe	tartamudear+V.ele.DAT.3.SG+IMPF+2+PL
tartamudeáveis-me	tartamudear+V.eu.AD.1.SG+IMPF+2+PL
tartamudeáveis-te	tartamudear+V.tu.AD.2.SG+IMPF+2+PL
tartamudeáveis-vos	tartamudear+V.vós.AD.2.PL+IMPF+2+PL
tartamudeei-as	tartamudear+V.ele.ACC.3.F.PL+PRF+1+SG
tartamudeei-a	tartamudear+V.ele.ACC.3.F.SG+PRF+1+SG
tartamudeei-lhes	tartamudear+V.ele.DAT.3.PL+PRF+1+SG
tartamudeei-lhe	tartamudear+V.ele.DAT.3.SG+PRF+1+SG
tartamudeei-me	tartamudear+V.eu.AD.1.SG+PRF+1+SG
tartamudeei-nos	tartamudear+nós.AD.1.PL+PRF+1+SG
tartamudeei-os	tartamudear+V.ele.ACC.3.M.PL+PRF+1+SG
tartamudeei-o	tartamudear+V.ele.ACC.3.M.SG+PRF+1+SG
tartamudeei-te	tartamudear+V.tu.AD.2.SG+PRF+1+SG
tartamudeei-vos	tartamudear+V.vós.AD.2.PL+PRF+1+SG
tartamudeia-as	tartamudear+V.ele.ACC.3.F.PL+PRS+3+SG
tartamudeia-a	tartamudear+V.ele.ACC.3.F.SG+PRS+3+SG
tartamudeia-las	tartamudear+V.ele.ACC.3.F.PL+PRS+2+SG
tartamudeia-la	tartamudear+V.ele.ACC.3.F.SG+PRS+2+SG
tartamudeia-lhes	tartamudear+V.ele.DAT.3.PL+PRS+3+SG
tartamudeia-lhe	tartamudear+V.ele.DAT.3.SG+PRS+3+SG
tartamudeia-los	tartamudear+V.ele.ACC.3.M.PL+PRS+2+SG
tartamudeia-lo	tartamudear+V.ele.ACC.3.M.SG+PRS+2+SG
tartamudeia-me	tartamudear+V.eu.AD.1.SG+PRS+3+SG
tartamudeiam-lhes	tartamudear+V.ele.DAT.3.PL+PRS+3+PL
tartamudeiam-lhe	tartamudear+V.ele.DAT.3.SG+PRS+3+PL
tartamudeiam-me	tartamudear+V.eu.AD.1.SG+PRS+3+PL
tartamudeiam-nas	tartamudear+V.ele.ACC.3.F.PL+PRS+3+PL
tartamudeiam-na	tartamudear+V.ele.ACC.3.F.SG+PRS+3+PL
tartamudeiam-nos	tartamudear+V.ele.ACC.3.M.PL+PRS+3+PL
tartamudeiam-nos	tartamudear+V.nós.AD.1.PL+PRS+3+PL
tartamudeiam-no	tartamudear+V.ele.ACC.3.M.SG+PRS+3+PL
tartamudeiam-se	tartamudear+V.ele.REFL+PRS+3+PL
tartamudeiam-te	tartamudear+V.tu.AD.2.SG+PRS+3+PL
tartamudeiam-vos	tartamudear+V.vós.AD.2.PL+PRS+3+PL
tartamudeia-nos	tartamudear+nós.AD.1.PL+PRS+2+SG
tartamudeia-nos	tartamudear+nós.AD.1.PL+PRS+3+SG
tartamudeia-os	tartamudear+V.ele.ACC.3.M.PL+PRS+3+SG
tartamudeia-o	tartamudear+V.ele.ACC.3.M.SG+PRS+3+SG
tartamudeia-se	tartamudear+V.ele.REFL+PRS+3+SG
tartamudeias-lhes	tartamudear+V.ele.DAT.3.PL+PRS+2+SG
tartamudeias-lhe	tartamudear+V.ele.DAT.3.SG+PRS+2+SG
tartamudeias-me	tartamudear+V.eu.AD.1.SG+PRS+2+SG
tartamudeias-te	tartamudear+V.tu.AD.2.SG+PRS+2+SG
tartamudeias-vos	tartamudear+V.vós.AD.2.PL+PRS+2+SG
tartamudeia-te	tartamudear+V.tu.AD.2.SG+PRS+3+SG
tartamudeia-vos	tartamudear+V.vós.AD.2.PL+PRS+3+SG
tartamudeio-as	tartamudear+V.ele.ACC.3.F.PL+PRS+1+SG
tartamudeio-a	tartamudear+V.ele.ACC.3.F.SG+PRS+1+SG
tartamudeio-lhes	tartamudear+V.ele.DAT.3.PL+PRS+1+SG
tartamudeio-lhe	tartamudear+V.ele.DAT.3.SG+PRS+1+SG
tartamudeio-me	tartamudear+V.eu.AD.1.SG+PRS+1+SG
tartamudeio-nos	tartamudear+nós.AD.1.PL+PRS+1+SG
tartamudeio-os	tartamudear+V.ele.ACC.3.M.PL+PRS+1+SG
tartamudeio-o	tartamudear+V.ele.ACC.3.M.SG+PRS+1+SG
tartamudeio-te	tartamudear+V.tu.AD.2.SG+PRS+1+SG
tartamudeio-vos	tartamudear+V.vós.AD.2.PL+PRS+1+SG
tartamudeou-as	tartamudear+V.ele.ACC.3.F.PL+PRF+3+SG
tartamudeou-a	tartamudear+V.ele.ACC.3.F.SG+PRF+3+SG
tartamudeou-lhes	tartamudear+V.ele.DAT.3.PL+PRF+3+SG
tartamudeou-lhe	tartamudear+V.ele.DAT.3.SG+PRF+3+SG
tartamudeou-me	tartamudear+V.eu.AD.1.SG+PRF+3+SG
tartamudeou-nos	tartamudear+nós.AD.1.PL+PRF+3+SG
tartamudeou-os	tartamudear+V.ele.ACC.3.M.PL+PRF+3+SG
tartamudeou-o	tartamudear+V.ele.ACC.3.M.SG+PRF+3+SG
tartamudeou-se	tartamudear+V.ele.REFL+PRF+3+SG
tartamudeou-te	tartamudear+V.tu.AD.2.SG+PRF+3+SG
tartamudeou-vos	tartamudear+V.vós.AD.2.PL+PRF+3+SG
tartaranha-as	tartaranhar+V.ele.ACC.3.F.PL+PRS+3+SG
tartaranha-a	tartaranhar+V.ele.ACC.3.F.SG+PRS+3+SG
tartaranhai-las	tartaranhar+V.ele.ACC.3.F.PL+PRS+2+PL
tartaranhai-la	tartaranhar+V.ele.ACC.3.F.SG+PRS+2+PL
tartaranhai-los	tartaranhar+V.ele.ACC.3.M.PL+PRS+2+PL
tartaranhai-lo	tartaranhar+V.ele.ACC.3.M.SG+PRS+2+PL
tartaranhai-nos	tartaranhar+nós.AD.1.PL+PRS+2+PL
tartaranhais-lhes	tartaranhar+V.ele.DAT.3.PL+PRS+2+PL
tartaranhais-lhe	tartaranhar+V.ele.DAT.3.SG+PRS+2+PL
tartaranhais-me	tartaranhar+V.eu.AD.1.SG+PRS+2+PL
tartaranhais-te	tartaranhar+V.tu.AD.2.SG+PRS+2+PL
tartaranhais-vos	tartaranhar+V.vós.AD.2.PL+PRS+2+PL
tartaranhá-la-ão	tartaranhar+V.ele.ACC.3.F.SG+FUT+3+PL
tartaranhá-la-ás	tartaranhar+V.ele.ACC.3.F.SG+FUT+2+SG
tartaranhá-la-á	tartaranhar+V.ele.ACC.3.F.SG+FUT+3+SG
tartaranhá-la-eis	tartaranhar+V.ele.ACC.3.F.SG+FUT+2+PL
tartaranhá-la-ei	tartaranhar+V.ele.ACC.3.F.SG+FUT+1+SG
tartaranhá-la-emos	tartaranhar+V.ele.ACC.3.F.SG+FUT+1+PL
tartaranhá-la-íamos	tartaranhar+V.ele.ACC.3.F.SG+COND+1+PL
tartaranhá-la-iam	tartaranhar+V.ele.ACC.3.F.SG+COND+3+PL
tartaranhá-la-ias	tartaranhar+V.ele.ACC.3.F.SG+COND+2+SG
tartaranhá-la-ia	tartaranhar+V.ele.ACC.3.F.SG+COND+1+SG
tartaranhá-la-ia	tartaranhar+V.ele.ACC.3.F.SG+COND+3+SG
tartaranhá-la-íeis	tartaranhar+V.ele.ACC.3.F.SG+COND+2+PL
tartaranhá-las-ão	tartaranhar+V.ele.ACC.3.F.PL+FUT+3+PL
tartaranhá-las-ás	tartaranhar+V.ele.ACC.3.F.PL+FUT+2+SG
tartaranhá-las-á	tartaranhar+V.ele.ACC.3.F.PL+FUT+3+SG
tartaranhá-las-eis	tartaranhar+V.ele.ACC.3.F.PL+FUT+2+PL
tartaranhá-las-ei	tartaranhar+V.ele.ACC.3.F.PL+FUT+1+SG
tartaranhá-las-emos	tartaranhar+V.ele.ACC.3.F.PL+FUT+1+PL
tartaranhá-las-íamos	tartaranhar+V.ele.ACC.3.F.PL+COND+1+PL
tartaranhá-las-iam	tartaranhar+V.ele.ACC.3.F.PL+COND+3+PL
tartaranhá-las-ias	tartaranhar+V.ele.ACC.3.F.PL+COND+2+SG
tartaranhá-las-ia	tartaranhar+V.ele.ACC.3.F.PL+COND+1+SG
tartaranhá-las-ia	tartaranhar+V.ele.ACC.3.F.PL+COND+3+SG
tartaranhá-las-íeis	tartaranhar+V.ele.ACC.3.F.PL+COND+2+PL
tartaranhá-las	tartaranhar+V.ele.ACC.3.F.PL+INF+1+SG
tartaranhá-las	tartaranhar+V.ele.ACC.3.F.PL+INF+3+SG
tartaranha-las	tartaranhar+V.ele.ACC.3.F.PL+PRS+2+SG
tartaranhá-las	tartaranhar+V.ele.ACC.3.F.PL+SBJF+1+SG
tartaranhá-las	tartaranhar+V.ele.ACC.3.F.PL+SBJF+3+SG
tartaranhá-la	tartaranhar+V.ele.ACC.3.F.SG+INF+1+SG
tartaranhá-la	tartaranhar+V.ele.ACC.3.F.SG+INF+3+SG
tartaranha-la	tartaranhar+V.ele.ACC.3.F.SG+PRS+2+SG
tartaranhá-la	tartaranhar+V.ele.ACC.3.F.SG+SBJF+1+SG
tartaranhá-la	tartaranhar+V.ele.ACC.3.F.SG+SBJF+3+SG
tartaranha-lhes	tartaranhar+V.ele.DAT.3.PL+PRS+3+SG
tartaranha-lhe	tartaranhar+V.ele.DAT.3.SG+PRS+3+SG
tartaranhá-lo-ão	tartaranhar+V.ele.ACC.3.M.SG+FUT+3+PL
tartaranhá-lo-ás	tartaranhar+V.ele.ACC.3.M.SG+FUT+2+SG
tartaranhá-lo-á	tartaranhar+V.ele.ACC.3.M.SG+FUT+3+SG
tartaranhá-lo-eis	tartaranhar+V.ele.ACC.3.M.SG+FUT+2+PL
tartaranhá-lo-ei	tartaranhar+V.ele.ACC.3.M.SG+FUT+1+SG
tartaranhá-lo-emos	tartaranhar+V.ele.ACC.3.M.SG+FUT+1+PL
tartaranhá-lo-íamos	tartaranhar+V.ele.ACC.3.M.SG+COND+1+PL
tartaranhá-lo-iam	tartaranhar+V.ele.ACC.3.M.SG+COND+3+PL
tartaranhá-lo-ias	tartaranhar+V.ele.ACC.3.M.SG+COND+2+SG
tartaranhá-lo-ia	tartaranhar+V.ele.ACC.3.M.SG+COND+1+SG
tartaranhá-lo-ia	tartaranhar+V.ele.ACC.3.M.SG+COND+3+SG
tartaranhá-lo-íeis	tartaranhar+V.ele.ACC.3.M.SG+COND+2+PL
tartaranhá-los-ão	tartaranhar+V.ele.ACC.3.M.PL+FUT+3+PL
tartaranhá-los-ás	tartaranhar+V.ele.ACC.3.M.PL+FUT+2+SG
tartaranhá-los-á	tartaranhar+V.ele.ACC.3.M.PL+FUT+3+SG
tartaranhá-los-eis	tartaranhar+V.ele.ACC.3.M.PL+FUT+2+PL
tartaranhá-los-ei	tartaranhar+V.ele.ACC.3.M.PL+FUT+1+SG
tartaranhá-los-emos	tartaranhar+V.ele.ACC.3.M.PL+FUT+1+PL
tartaranhá-los-íamos	tartaranhar+V.ele.ACC.3.M.PL+COND+1+PL
tartaranhá-los-iam	tartaranhar+V.ele.ACC.3.M.PL+COND+3+PL
tartaranhá-los-ias	tartaranhar+V.ele.ACC.3.M.PL+COND+2+SG
tartaranhá-los-ia	tartaranhar+V.ele.ACC.3.M.PL+COND+1+SG
tartaranhá-los-ia	tartaranhar+V.ele.ACC.3.M.PL+COND+3+SG
tartaranhá-los-íeis	tartaranhar+V.ele.ACC.3.M.PL+COND+2+PL
tartaranhá-los	tartaranhar+V.ele.ACC.3.M.PL+INF+1+SG
tartaranhá-los	tartaranhar+V.ele.ACC.3.M.PL+INF+3+SG
tartaranha-los	tartaranhar+V.ele.ACC.3.M.PL+PRS+2+SG
tartaranhá-los	tartaranhar+V.ele.ACC.3.M.PL+SBJF+1+SG
tartaranhá-los	tartaranhar+V.ele.ACC.3.M.PL+SBJF+3+SG
tartaranhá-lo	tartaranhar+V.ele.ACC.3.M.SG+INF+1+SG
tartaranhá-lo	tartaranhar+V.ele.ACC.3.M.SG+INF+3+SG
tartaranha-lo	tartaranhar+V.ele.ACC.3.M.SG+PRS+2+SG
tartaranhá-lo	tartaranhar+V.ele.ACC.3.M.SG+SBJF+1+SG
tartaranhá-lo	tartaranhar+V.ele.ACC.3.M.SG+SBJF+3+SG
tartaranha-me	tartaranhar+V.eu.AD.1.SG+PRS+3+SG
tartaranham-lhes	tartaranhar+V.ele.DAT.3.PL+PRS+3+PL
tartaranham-lhe	tartaranhar+V.ele.DAT.3.SG+PRS+3+PL
tartaranham-me	tartaranhar+V.eu.AD.1.SG+PRS+3+PL
tartaranham-nas	tartaranhar+V.ele.ACC.3.F.PL+PRS+3+PL
tartaranham-na	tartaranhar+V.ele.ACC.3.F.SG+PRS+3+PL
tartaranham-nos	tartaranhar+V.ele.ACC.3.M.PL+PRS+3+PL
tartaranham-nos	tartaranhar+V.nós.AD.1.PL+PRS+3+PL
tartaranham-no	tartaranhar+V.ele.ACC.3.M.SG+PRS+3+PL
tartaranhamo-las	tartaranhar+V.ele.ACC.3.F.PL+PRF+1+PL
tartaranhamo-las	tartaranhar+V.ele.ACC.3.F.PL+PRS+1+PL
tartaranhamo-la	tartaranhar+V.ele.ACC.3.F.SG+PRF+1+PL
tartaranhamo-la	tartaranhar+V.ele.ACC.3.F.SG+PRS+1+PL
tartaranhamo-los	tartaranhar+V.ele.ACC.3.M.PL+PRF+1+PL
tartaranhamo-los	tartaranhar+V.ele.ACC.3.M.PL+PRS+1+PL
tartaranhamo-lo	tartaranhar+V.ele.ACC.3.M.SG+PRF+1+PL
tartaranhamo-lo	tartaranhar+V.ele.ACC.3.M.SG+PRS+1+PL
tartaranhamo-nos	tartaranhar+nós.AD.1.PL+PRF+1+PL
tartaranhamo-nos	tartaranhar+nós.AD.1.PL+PRS+1+PL
tartaranhamos-lhes	tartaranhar+V.ele.DAT.3.PL+PRF+1+PL
tartaranhamos-lhes	tartaranhar+V.ele.DAT.3.PL+PRS+1+PL
tartaranhamos-lhe	tartaranhar+V.ele.DAT.3.SG+PRF+1+PL
tartaranhamos-lhe	tartaranhar+V.ele.DAT.3.SG+PRS+1+PL
tartaranhamos-me	tartaranhar+V.eu.AD.1.SG+PRF+1+PL
tartaranhamos-me	tartaranhar+V.eu.AD.1.SG+PRS+1+PL
tartaranhamos-te	tartaranhar+V.tu.AD.2.SG+PRF+1+PL
tartaranhamos-te	tartaranhar+V.tu.AD.2.SG+PRS+1+PL
tartaranhamos-vos	tartaranhar+V.vós.AD.2.PL+PRF+1+PL
tartaranhamos-vos	tartaranhar+V.vós.AD.2.PL+PRS+1+PL
tartaranham-se	tartaranhar+V.ele.REFL+PRS+3+PL
tartaranham-te	tartaranhar+V.tu.AD.2.SG+PRS+3+PL
tartaranham-vos	tartaranhar+V.vós.AD.2.PL+PRS+3+PL
tartaranhando-as	tartaranhar+V.ele.ACC.3.F.PL+GRD
tartaranhando-a	tartaranhar+V.ele.ACC.3.F.SG+GRD
tartaranhando-lhes	tartaranhar+V.ele.DAT.3.PL+GRD
tartaranhando-lhe	tartaranhar+V.ele.DAT.3.SG+GRD
tartaranhando-me	tartaranhar+V.eu.AD.1.SG+GRD
tartaranhando-nos	tartaranhar+nós.AD.1.PL+GRD
tartaranhando-os	tartaranhar+V.ele.ACC.3.M.PL+GRD
tartaranhando-o	tartaranhar+V.ele.ACC.3.M.SG+GRD
tartaranhando-se	tartaranhar+V.ele.REFL+GRD
tartaranhando-te	tartaranhar+V.tu.AD.2.SG+GRD
tartaranhando-vos	tartaranhar+V.vós.AD.2.PL+GRD
tartaranha-nos	tartaranhar+nós.AD.1.PL+PRS+2+SG
tartaranha-nos	tartaranhar+nós.AD.1.PL+PRS+3+SG
tartaranha-os	tartaranhar+V.ele.ACC.3.M.PL+PRS+3+SG
tartaranha-o	tartaranhar+V.ele.ACC.3.M.SG+PRS+3+SG
tartaranhara-as	tartaranhar+V.ele.ACC.3.F.PL+PQP+1+SG
tartaranhara-as	tartaranhar+V.ele.ACC.3.F.PL+PQP+3+SG
tartaranhara-a	tartaranhar+V.ele.ACC.3.F.SG+PQP+1+SG
tartaranhara-a	tartaranhar+V.ele.ACC.3.F.SG+PQP+3+SG
tartaranhara-las	tartaranhar+V.ele.ACC.3.F.PL+PQP+2+SG
tartaranhara-la	tartaranhar+V.ele.ACC.3.F.SG+PQP+2+SG
tartaranhara-lhes	tartaranhar+V.ele.DAT.3.PL+PQP+1+SG
tartaranhara-lhes	tartaranhar+V.ele.DAT.3.PL+PQP+3+SG
tartaranhara-lhe	tartaranhar+V.ele.DAT.3.SG+PQP+1+SG
tartaranhara-lhe	tartaranhar+V.ele.DAT.3.SG+PQP+3+SG
tartaranhara-los	tartaranhar+V.ele.ACC.3.M.PL+PQP+2+SG
tartaranhara-lo	tartaranhar+V.ele.ACC.3.M.SG+PQP+2+SG
tartaranhara-me	tartaranhar+V.eu.AD.1.SG+PQP+1+SG
tartaranhara-me	tartaranhar+V.eu.AD.1.SG+PQP+3+SG
tartaranharam-lhes	tartaranhar+V.ele.DAT.3.PL+PQP+3+PL
tartaranharam-lhes	tartaranhar+V.ele.DAT.3.PL+PRF+3+PL
