venerar-lhes-íamos	venerar+V.ele.DAT.3.PL+COND+1+PL
venerar-lhes-iam	venerar+V.ele.DAT.3.PL+COND+3+PL
venerar-lhes-ias	venerar+V.ele.DAT.3.PL+COND+2+SG
venerar-lhes-ia	venerar+V.ele.DAT.3.PL+COND+1+SG
venerar-lhes-ia	venerar+V.ele.DAT.3.PL+COND+3+SG
venerar-lhes-íeis	venerar+V.ele.DAT.3.PL+COND+2+PL
venerar-lhes	venerar+V.ele.DAT.3.PL+INF
venerar-lhes	venerar+V.ele.DAT.3.PL+INF+1+SG
venerar-lhes	venerar+V.ele.DAT.3.PL+INF+3+SG
venerar-lhes	venerar+V.ele.DAT.3.PL+SBJF+1+SG
venerar-lhes	venerar+V.ele.DAT.3.PL+SBJF+3+SG
venerar-lhe	venerar+V.ele.DAT.3.SG+INF
venerar-lhe	venerar+V.ele.DAT.3.SG+INF+1+SG
venerar-lhe	venerar+V.ele.DAT.3.SG+INF+3+SG
venerar-lhe	venerar+V.ele.DAT.3.SG+SBJF+1+SG
venerar-lhe	venerar+V.ele.DAT.3.SG+SBJF+3+SG
venerar-me-ão	venerar+V.eu.AD.1.SG+FUT+3+PL
venerar-me-ás	venerar+V.eu.AD.1.SG+FUT+2+SG
venerar-me-á	venerar+V.eu.AD.1.SG+FUT+3+SG
venerar-me-eis	venerar+V.eu.AD.1.SG+FUT+2+PL
venerar-me-ei	venerar+V.eu.AD.1.SG+FUT+1+SG
venerar-me-emos	venerar+V.eu.AD.1.SG+FUT+1+PL
venerar-me-íamos	venerar+V.eu.AD.1.SG+COND+1+PL
venerar-me-iam	venerar+V.eu.AD.1.SG+COND+3+PL
venerar-me-ias	venerar+V.eu.AD.1.SG+COND+2+SG
venerar-me-ia	venerar+V.eu.AD.1.SG+COND+1+SG
venerar-me-ia	venerar+V.eu.AD.1.SG+COND+3+SG
venerar-me-íeis	venerar+V.eu.AD.1.SG+COND+2+PL
venerar-me	venerar+V.eu.AD.1.SG+INF
venerar-me	venerar+V.eu.AD.1.SG+INF+1+SG
venerar-me	venerar+V.eu.AD.1.SG+INF+3+SG
venerar-me	venerar+V.eu.AD.1.SG+SBJF+1+SG
venerar-me	venerar+V.eu.AD.1.SG+SBJF+3+SG
venerarmo-las	venerar+V.ele.ACC.3.F.PL+INF+1+PL
venerarmo-las	venerar+V.ele.ACC.3.F.PL+SBJF+1+PL
venerarmo-la	venerar+V.ele.ACC.3.F.SG+INF+1+PL
venerarmo-la	venerar+V.ele.ACC.3.F.SG+SBJF+1+PL
venerarmo-los	venerar+V.ele.ACC.3.M.PL+INF+1+PL
venerarmo-los	venerar+V.ele.ACC.3.M.PL+SBJF+1+PL
venerarmo-lo	venerar+V.ele.ACC.3.M.SG+INF+1+PL
venerarmo-lo	venerar+V.ele.ACC.3.M.SG+SBJF+1+PL
venerarmo-nos	venerar+nós.AD.1.PL+INF+1+PL
venerarmo-nos	venerar+nós.AD.1.PL+SBJF+1+PL
venerarmos-lhes	venerar+V.ele.DAT.3.PL+INF+1+PL
venerarmos-lhes	venerar+V.ele.DAT.3.PL+SBJF+1+PL
venerarmos-lhe	venerar+V.ele.DAT.3.SG+INF+1+PL
venerarmos-lhe	venerar+V.ele.DAT.3.SG+SBJF+1+PL
venerarmos-me	venerar+V.eu.AD.1.SG+INF+1+PL
venerarmos-me	venerar+V.eu.AD.1.SG+SBJF+1+PL
venerarmos-te	venerar+V.tu.AD.2.SG+INF+1+PL
venerarmos-te	venerar+V.tu.AD.2.SG+SBJF+1+PL
venerarmos-vos	venerar+V.vós.AD.2.PL+INF+1+PL
venerarmos-vos	venerar+V.vós.AD.2.PL+SBJF+1+PL
venerar-nos-ão	venerar+nós.AD.1.PL+FUT+3+PL
venerar-nos-ás	venerar+nós.AD.1.PL+FUT+2+SG
venerar-nos-á	venerar+nós.AD.1.PL+FUT+3+SG
venerar-nos-eis	venerar+nós.AD.1.PL+FUT+2+PL
venerar-nos-ei	venerar+nós.AD.1.PL+FUT+1+SG
venerar-nos-emos	venerar+nós.AD.1.PL+FUT+1+PL
venerar-nos-íamos	venerar+nós.AD.1.PL+COND+1+PL
venerar-nos-iam	venerar+nós.AD.1.PL+COND+3+PL
venerar-nos-ias	venerar+nós.AD.1.PL+COND+2+SG
venerar-nos-ia	venerar+nós.AD.1.PL+COND+1+SG
venerar-nos-ia	venerar+nós.AD.1.PL+COND+3+SG
venerar-nos-íeis	venerar+nós.AD.1.PL+COND+2+PL
venerar-nos	venerar+nós.AD.1.PL+INF
venerar-nos	venerar+nós.AD.1.PL+INF+1+SG
venerar-nos	venerar+nós.AD.1.PL+INF+3+SG
venerar-nos	venerar+nós.AD.1.PL+SBJF+1+SG
venerar-nos	venerar+nós.AD.1.PL+SBJF+3+SG
venerar-se-ão	venerar+V.ele.REFL+FUT+3+PL
venerar-se-á	venerar+V.ele.REFL+FUT+3+SG
venerar-se-iam	venerar+V.ele.REFL+COND+3+PL
venerar-se-ia	venerar+V.ele.REFL+COND+3+SG
venerar-se	venerar+V.ele.REFL+INF
venerar-se	venerar+V.ele.REFL+INF+3+SG
venerar-se	venerar+V.ele.REFL+SBJF+3+SG
venerar-te-ão	venerar+V.tu.AD.2.SG+FUT+3+PL
venerar-te-ás	venerar+V.tu.AD.2.SG+FUT+2+SG
venerar-te-á	venerar+V.tu.AD.2.SG+FUT+3+SG
venerar-te-eis	venerar+V.tu.AD.2.SG+FUT+2+PL
venerar-te-ei	venerar+V.tu.AD.2.SG+FUT+1+SG
venerar-te-emos	venerar+V.tu.AD.2.SG+FUT+1+PL
venerar-te-íamos	venerar+V.tu.AD.2.SG+COND+1+PL
venerar-te-iam	venerar+V.tu.AD.2.SG+COND+3+PL
venerar-te-ias	venerar+V.tu.AD.2.SG+COND+2+SG
venerar-te-ia	venerar+V.tu.AD.2.SG+COND+1+SG
venerar-te-ia	venerar+V.tu.AD.2.SG+COND+3+SG
venerar-te-íeis	venerar+V.tu.AD.2.SG+COND+2+PL
venerar-te	venerar+V.tu.AD.2.SG+INF
venerar-te	venerar+V.tu.AD.2.SG+INF+1+SG
venerar-te	venerar+V.tu.AD.2.SG+INF+3+SG
venerar-te	venerar+V.tu.AD.2.SG+SBJF+1+SG
venerar-te	venerar+V.tu.AD.2.SG+SBJF+3+SG
venerar-vos-ão	venerar+V.vós.AD.2.PL+FUT+3+PL
venerar-vos-ás	venerar+V.vós.AD.2.PL+FUT+2+SG
venerar-vos-á	venerar+V.vós.AD.2.PL+FUT+3+SG
venerar-vos-eis	venerar+V.vós.AD.2.PL+FUT+2+PL
venerar-vos-ei	venerar+V.vós.AD.2.PL+FUT+1+SG
venerar-vos-emos	venerar+V.vós.AD.2.PL+FUT+1+PL
venerar-vos-íamos	venerar+V.vós.AD.2.PL+COND+1+PL
venerar-vos-iam	venerar+V.vós.AD.2.PL+COND+3+PL
venerar-vos-ias	venerar+V.vós.AD.2.PL+COND+2+SG
venerar-vos-ia	venerar+V.vós.AD.2.PL+COND+1+SG
venerar-vos-ia	venerar+V.vós.AD.2.PL+COND+3+SG
venerar-vos-íeis	venerar+V.vós.AD.2.PL+COND+2+PL
venerar-vos	venerar+V.vós.AD.2.PL+INF
venerar-vos	venerar+V.vós.AD.2.PL+INF+1+SG
venerar-vos	venerar+V.vós.AD.2.PL+INF+3+SG
venerar-vos	venerar+V.vós.AD.2.PL+SBJF+1+SG
venerar-vos	venerar+V.vós.AD.2.PL+SBJF+3+SG
venera-se	venerar+V.ele.REFL+PRS+3+SG
veneras-lhes	venerar+V.ele.DAT.3.PL+PRS+2+SG
veneras-lhe	venerar+V.ele.DAT.3.SG+PRS+2+SG
veneras-me	venerar+V.eu.AD.1.SG+PRS+2+SG
veneraste-as	venerar+V.ele.ACC.3.F.PL+PRF+2+SG
veneraste-a	venerar+V.ele.ACC.3.F.SG+PRF+2+SG
veneraste-las	venerar+V.ele.ACC.3.F.PL+PRF+2+PL
veneraste-la	venerar+V.ele.ACC.3.F.SG+PRF+2+PL
veneraste-lhes	venerar+V.ele.DAT.3.PL+PRF+2+SG
veneraste-lhe	venerar+V.ele.DAT.3.SG+PRF+2+SG
veneraste-los	venerar+V.ele.ACC.3.M.PL+PRF+2+PL
veneraste-lo	venerar+V.ele.ACC.3.M.SG+PRF+2+PL
veneraste-me	venerar+V.eu.AD.1.SG+PRF+2+SG
veneraste-nos	venerar+nós.AD.1.PL+PRF+2+PL
veneraste-nos	venerar+nós.AD.1.PL+PRF+2+SG
veneraste-os	venerar+V.ele.ACC.3.M.PL+PRF+2+SG
veneraste-o	venerar+V.ele.ACC.3.M.SG+PRF+2+SG
venerastes-lhes	venerar+V.ele.DAT.3.PL+PRF+2+PL
venerastes-lhe	venerar+V.ele.DAT.3.SG+PRF+2+PL
venerastes-me	venerar+V.eu.AD.1.SG+PRF+2+PL
venerastes-te	venerar+V.tu.AD.2.SG+PRF+2+PL
venerastes-vos	venerar+V.vós.AD.2.PL+PRF+2+PL
veneraste-te	venerar+V.tu.AD.2.SG+PRF+2+SG
veneras-te	venerar+V.tu.AD.2.SG+PRS+2+SG
veneraste-vos	venerar+V.vós.AD.2.PL+PRF+2+SG
veneras-vos	venerar+V.vós.AD.2.PL+PRS+2+SG
venera-te	venerar+V.tu.AD.2.SG+PRS+3+SG
venerava-as	venerar+V.ele.ACC.3.F.PL+IMPF+1+SG
venerava-as	venerar+V.ele.ACC.3.F.PL+IMPF+3+SG
venerava-a	venerar+V.ele.ACC.3.F.SG+IMPF+1+SG
venerava-a	venerar+V.ele.ACC.3.F.SG+IMPF+3+SG
venerava-las	venerar+V.ele.ACC.3.F.PL+IMPF+2+SG
venerava-la	venerar+V.ele.ACC.3.F.SG+IMPF+2+SG
venerava-lhes	venerar+V.ele.DAT.3.PL+IMPF+1+SG
venerava-lhes	venerar+V.ele.DAT.3.PL+IMPF+3+SG
venerava-lhe	venerar+V.ele.DAT.3.SG+IMPF+1+SG
venerava-lhe	venerar+V.ele.DAT.3.SG+IMPF+3+SG
venerava-los	venerar+V.ele.ACC.3.M.PL+IMPF+2+SG
venerava-lo	venerar+V.ele.ACC.3.M.SG+IMPF+2+SG
venerava-me	venerar+V.eu.AD.1.SG+IMPF+1+SG
venerava-me	venerar+V.eu.AD.1.SG+IMPF+3+SG
veneravam-lhes	venerar+V.ele.DAT.3.PL+IMPF+3+PL
veneravam-lhe	venerar+V.ele.DAT.3.SG+IMPF+3+PL
veneravam-me	venerar+V.eu.AD.1.SG+IMPF+3+PL
veneravam-nas	venerar+V.ele.ACC.3.F.PL+IMPF+3+PL
veneravam-na	venerar+V.ele.ACC.3.F.SG+IMPF+3+PL
veneravam-nos	venerar+V.ele.ACC.3.M.PL+IMPF+3+PL
veneravam-nos	venerar+V.nós.AD.1.PL+IMPF+3+PL
veneravam-no	venerar+V.ele.ACC.3.M.SG+IMPF+3+PL
venerávamo-las	venerar+V.ele.ACC.3.F.PL+IMPF+1+PL
venerávamo-la	venerar+V.ele.ACC.3.F.SG+IMPF+1+PL
venerávamo-los	venerar+V.ele.ACC.3.M.PL+IMPF+1+PL
venerávamo-lo	venerar+V.ele.ACC.3.M.SG+IMPF+1+PL
venerávamo-nos	venerar+nós.AD.1.PL+IMPF+1+PL
venerávamos-lhes	venerar+V.ele.DAT.3.PL+IMPF+1+PL
venerávamos-lhe	venerar+V.ele.DAT.3.SG+IMPF+1+PL
venerávamos-me	venerar+V.eu.AD.1.SG+IMPF+1+PL
venerávamos-te	venerar+V.tu.AD.2.SG+IMPF+1+PL
venerávamos-vos	venerar+V.vós.AD.2.PL+IMPF+1+PL
veneravam-se	venerar+V.ele.REFL+IMPF+3+PL
veneravam-te	venerar+V.tu.AD.2.SG+IMPF+3+PL
veneravam-vos	venerar+V.vós.AD.2.PL+IMPF+3+PL
venerava-nos	venerar+nós.AD.1.PL+IMPF+1+SG
venerava-nos	venerar+nós.AD.1.PL+IMPF+2+SG
venerava-nos	venerar+nós.AD.1.PL+IMPF+3+SG
venerava-os	venerar+V.ele.ACC.3.M.PL+IMPF+1+SG
venerava-os	venerar+V.ele.ACC.3.M.PL+IMPF+3+SG
venerava-o	venerar+V.ele.ACC.3.M.SG+IMPF+1+SG
venerava-o	venerar+V.ele.ACC.3.M.SG+IMPF+3+SG
venerava-se	venerar+V.ele.REFL+IMPF+1+SG
venerava-se	venerar+V.ele.REFL+IMPF+3+SG
veneravas-lhes	venerar+V.ele.DAT.3.PL+IMPF+2+SG
veneravas-lhe	venerar+V.ele.DAT.3.SG+IMPF+2+SG
veneravas-me	venerar+V.eu.AD.1.SG+IMPF+2+SG
veneravas-te	venerar+V.tu.AD.2.SG+IMPF+2+SG
veneravas-vos	venerar+V.vós.AD.2.PL+IMPF+2+SG
venerava-te	venerar+V.tu.AD.2.SG+IMPF+1+SG
venerava-te	venerar+V.tu.AD.2.SG+IMPF+3+SG
venerava-vos	venerar+V.vós.AD.2.PL+IMPF+1+SG
venerava-vos	venerar+V.vós.AD.2.PL+IMPF+3+SG
venerávei-las	venerar+V.ele.ACC.3.F.PL+IMPF+2+PL
venerávei-la	venerar+V.ele.ACC.3.F.SG+IMPF+2+PL
venerávei-los	venerar+V.ele.ACC.3.M.PL+IMPF+2+PL
venerávei-lo	venerar+V.ele.ACC.3.M.SG+IMPF+2+PL
venerávei-nos	venerar+nós.AD.1.PL+IMPF+2+PL
veneráveis-lhes	venerar+V.ele.DAT.3.PL+IMPF+2+PL
veneráveis-lhe	venerar+V.ele.DAT.3.SG+IMPF+2+PL
veneráveis-me	venerar+V.eu.AD.1.SG+IMPF+2+PL
veneráveis-te	venerar+V.tu.AD.2.SG+IMPF+2+PL
veneráveis-vos	venerar+V.vós.AD.2.PL+IMPF+2+PL
venera-vos	venerar+V.vós.AD.2.PL+PRS+3+SG
venere-as	venerar+V.ele.ACC.3.F.PL+IMP+3+SG
venere-a	venerar+V.ele.ACC.3.F.SG+IMP+3+SG
venerei-as	venerar+V.ele.ACC.3.F.PL+PRF+1+SG
venerei-a	venerar+V.ele.ACC.3.F.SG+PRF+1+SG
venerei-lhes	venerar+V.ele.DAT.3.PL+PRF+1+SG
venerei-lhe	venerar+V.ele.DAT.3.SG+PRF+1+SG
venerei-me	venerar+V.eu.AD.1.SG+PRF+1+SG
venerei-nos	venerar+nós.AD.1.PL+PRF+1+SG
venerei-os	venerar+V.ele.ACC.3.M.PL+PRF+1+SG
venerei-o	venerar+V.ele.ACC.3.M.SG+PRF+1+SG
venerei-te	venerar+V.tu.AD.2.SG+PRF+1+SG
venerei-vos	venerar+V.vós.AD.2.PL+PRF+1+SG
venere-lhes	venerar+V.ele.DAT.3.PL+IMP+3+SG
venere-lhe	venerar+V.ele.DAT.3.SG+IMP+3+SG
venere-me	venerar+V.eu.AD.1.SG+IMP+3+SG
venerem-lhes	venerar+V.ele.DAT.3.PL+IMP+3+PL
venerem-lhe	venerar+V.ele.DAT.3.SG+IMP+3+PL
venerem-me	venerar+V.eu.AD.1.SG+IMP+3+PL
venerem-nas	venerar+V.ele.ACC.3.F.PL+IMP+3+PL
venerem-na	venerar+V.ele.ACC.3.F.SG+IMP+3+PL
venerem-nos	venerar+V.ele.ACC.3.M.PL+IMP+3+PL
venerem-nos	venerar+V.nós.AD.1.PL+IMP+3+PL
venerem-no	venerar+V.ele.ACC.3.M.SG+IMP+3+PL
veneremo-las	venerar+V.ele.ACC.3.F.PL+IMP+1+PL
veneremo-la	venerar+V.ele.ACC.3.F.SG+IMP+1+PL
veneremo-los	venerar+V.ele.ACC.3.M.PL+IMP+1+PL
veneremo-lo	venerar+V.ele.ACC.3.M.SG+IMP+1+PL
veneremo-nos	venerar+nós.AD.1.PL+IMP+1+PL
veneremos-lhes	venerar+V.ele.DAT.3.PL+IMP+1+PL
veneremos-lhe	venerar+V.ele.DAT.3.SG+IMP+1+PL
veneremos-me	venerar+V.eu.AD.1.SG+IMP+1+PL
veneremos-te	venerar+V.tu.AD.2.SG+IMP+1+PL
veneremos-vos	venerar+V.vós.AD.2.PL+IMP+1+PL
venerem-se	venerar+V.ele.REFL+IMP+3+PL
venerem-te	venerar+V.tu.AD.2.SG+IMP+3+PL
venerem-vos	venerar+V.vós.AD.2.PL+IMP+3+PL
venere-nos	venerar+nós.AD.1.PL+IMP+3+SG
venere-os	venerar+V.ele.ACC.3.M.PL+IMP+3+SG
venere-o	venerar+V.ele.ACC.3.M.SG+IMP+3+SG
venere-se	venerar+V.ele.REFL+IMP+3+SG
venere-te	venerar+V.tu.AD.2.SG+IMP+3+SG
venere-vos	venerar+V.vós.AD.2.PL+IMP+3+SG
venero-as	venerar+V.ele.ACC.3.F.PL+PRS+1+SG
venero-a	venerar+V.ele.ACC.3.F.SG+PRS+1+SG
venero-lhes	venerar+V.ele.DAT.3.PL+PRS+1+SG
venero-lhe	venerar+V.ele.DAT.3.SG+PRS+1+SG
venero-me	venerar+V.eu.AD.1.SG+PRS+1+SG
venero-nos	venerar+nós.AD.1.PL+PRS+1+SG
venero-os	venerar+V.ele.ACC.3.M.PL+PRS+1+SG
venero-o	venerar+V.ele.ACC.3.M.SG+PRS+1+SG
venero-te	venerar+V.tu.AD.2.SG+PRS+1+SG
venerou-as	venerar+V.ele.ACC.3.F.PL+PRF+3+SG
venerou-a	venerar+V.ele.ACC.3.F.SG+PRF+3+SG
venerou-lhes	venerar+V.ele.DAT.3.PL+PRF+3+SG
venerou-lhe	venerar+V.ele.DAT.3.SG+PRF+3+SG
venerou-me	venerar+V.eu.AD.1.SG+PRF+3+SG
venerou-nos	venerar+nós.AD.1.PL+PRF+3+SG
venerou-os	venerar+V.ele.ACC.3.M.PL+PRF+3+SG
venerou-o	venerar+V.ele.ACC.3.M.SG+PRF+3+SG
venerou-se	venerar+V.ele.REFL+PRF+3+SG
venerou-te	venerar+V.tu.AD.2.SG+PRF+3+SG
venerou-vos	venerar+V.vós.AD.2.PL+PRF+3+SG
venero-vos	venerar+V.vós.AD.2.PL+PRS+1+SG
venha-as	vir+V.ele.ACC.3.F.PL+IMP+3+SG
venha-a	vir+V.ele.ACC.3.F.SG+IMP+3+SG
venha-lhes	vir+V.ele.DAT.3.PL+IMP+3+SG
venha-lhe	vir+V.ele.DAT.3.SG+IMP+3+SG
venha-me	vir+V.eu.AD.1.SG+IMP+3+SG
venham-lhes	vir+V.ele.DAT.3.PL+IMP+3+PL
venham-lhe	vir+V.ele.DAT.3.SG+IMP+3+PL
venham-me	vir+V.eu.AD.1.SG+IMP+3+PL
venham-nas	vir+V.ele.ACC.3.F.PL+IMP+3+PL
venham-na	vir+V.ele.ACC.3.F.SG+IMP+3+PL
venham-nos	vir+V.ele.ACC.3.M.PL+IMP+3+PL
venham-nos	vir+V.nós.AD.1.PL+IMP+3+PL
venham-no	vir+V.ele.ACC.3.M.SG+IMP+3+PL
venhamo-las	vir+V.ele.ACC.3.F.PL+IMP+1+PL
venhamo-la	vir+V.ele.ACC.3.F.SG+IMP+1+PL
venhamo-los	vir+V.ele.ACC.3.M.PL+IMP+1+PL
venhamo-lo	vir+V.ele.ACC.3.M.SG+IMP+1+PL
venhamo-nos	vir+nós.AD.1.PL+IMP+1+PL
venhamos-lhes	vir+V.ele.DAT.3.PL+IMP+1+PL
venhamos-lhe	vir+V.ele.DAT.3.SG+IMP+1+PL
venhamos-me	vir+V.eu.AD.1.SG+IMP+1+PL
venhamos-te	vir+V.tu.AD.2.SG+IMP+1+PL
venhamos-vos	vir+V.vós.AD.2.PL+IMP+1+PL
venham-se	vir+V.ele.REFL+IMP+3+PL
venham-te	vir+V.tu.AD.2.SG+IMP+3+PL
venham-vos	vir+V.vós.AD.2.PL+IMP+3+PL
venha-nos	vir+nós.AD.1.PL+IMP+3+SG
venha-os	vir+V.ele.ACC.3.M.PL+IMP+3+SG
venha-o	vir+V.ele.ACC.3.M.SG+IMP+3+SG
venha-se	vir+V.ele.REFL+IMP+3+SG
venha-te	vir+V.tu.AD.2.SG+IMP+3+SG
venha-vos	vir+V.vós.AD.2.PL+IMP+3+SG
venho-as	vir+V.ele.ACC.3.F.PL+PRS+1+SG
venho-a	vir+V.ele.ACC.3.F.SG+PRS+1+SG
venho-lhes	vir+V.ele.DAT.3.PL+PRS+1+SG
venho-lhe	vir+V.ele.DAT.3.SG+PRS+1+SG
venho-me	vir+V.eu.AD.1.SG+PRS+1+SG
venho-nos	vir+nós.AD.1.PL+PRS+1+SG
venho-os	vir+V.ele.ACC.3.M.PL+PRS+1+SG
venho-o	vir+V.ele.ACC.3.M.SG+PRS+1+SG
venho-te	vir+V.tu.AD.2.SG+PRS+1+SG
venho-vos	vir+V.vós.AD.2.PL+PRS+1+SG
veniaga-as	veniagar+V.ele.ACC.3.F.PL+PRS+3+SG
veniaga-a	veniagar+V.ele.ACC.3.F.SG+PRS+3+SG
veniagai-las	veniagar+V.ele.ACC.3.F.PL+PRS+2+PL
veniagai-la	veniagar+V.ele.ACC.3.F.SG+PRS+2+PL
veniagai-los	veniagar+V.ele.ACC.3.M.PL+PRS+2+PL
veniagai-lo	veniagar+V.ele.ACC.3.M.SG+PRS+2+PL
veniagai-nos	veniagar+nós.AD.1.PL+PRS+2+PL
veniagais-lhes	veniagar+V.ele.DAT.3.PL+PRS+2+PL
veniagais-lhe	veniagar+V.ele.DAT.3.SG+PRS+2+PL
veniagais-me	veniagar+V.eu.AD.1.SG+PRS+2+PL
veniagais-te	veniagar+V.tu.AD.2.SG+PRS+2+PL
veniagais-vos	veniagar+V.vós.AD.2.PL+PRS+2+PL
veniagá-la-ão	veniagar+V.ele.ACC.3.F.SG+FUT+3+PL
veniagá-la-ás	veniagar+V.ele.ACC.3.F.SG+FUT+2+SG
veniagá-la-á	veniagar+V.ele.ACC.3.F.SG+FUT+3+SG
veniagá-la-eis	veniagar+V.ele.ACC.3.F.SG+FUT+2+PL
veniagá-la-ei	veniagar+V.ele.ACC.3.F.SG+FUT+1+SG
veniagá-la-emos	veniagar+V.ele.ACC.3.F.SG+FUT+1+PL
veniagá-la-íamos	veniagar+V.ele.ACC.3.F.SG+COND+1+PL
veniagá-la-iam	veniagar+V.ele.ACC.3.F.SG+COND+3+PL
veniagá-la-ias	veniagar+V.ele.ACC.3.F.SG+COND+2+SG
veniagá-la-ia	veniagar+V.ele.ACC.3.F.SG+COND+1+SG
veniagá-la-ia	veniagar+V.ele.ACC.3.F.SG+COND+3+SG
veniagá-la-íeis	veniagar+V.ele.ACC.3.F.SG+COND+2+PL
veniagá-las-ão	veniagar+V.ele.ACC.3.F.PL+FUT+3+PL
veniagá-las-ás	veniagar+V.ele.ACC.3.F.PL+FUT+2+SG
veniagá-las-á	veniagar+V.ele.ACC.3.F.PL+FUT+3+SG
veniagá-las-eis	veniagar+V.ele.ACC.3.F.PL+FUT+2+PL
veniagá-las-ei	veniagar+V.ele.ACC.3.F.PL+FUT+1+SG
veniagá-las-emos	veniagar+V.ele.ACC.3.F.PL+FUT+1+PL
veniagá-las-íamos	veniagar+V.ele.ACC.3.F.PL+COND+1+PL
veniagá-las-iam	veniagar+V.ele.ACC.3.F.PL+COND+3+PL
veniagá-las-ias	veniagar+V.ele.ACC.3.F.PL+COND+2+SG
veniagá-las-ia	veniagar+V.ele.ACC.3.F.PL+COND+1+SG
veniagá-las-ia	veniagar+V.ele.ACC.3.F.PL+COND+3+SG
veniagá-las-íeis	veniagar+V.ele.ACC.3.F.PL+COND+2+PL
veniagá-las	veniagar+V.ele.ACC.3.F.PL+INF+1+SG
veniagá-las	veniagar+V.ele.ACC.3.F.PL+INF+3+SG
veniaga-las	veniagar+V.ele.ACC.3.F.PL+PRS+2+SG
veniagá-las	veniagar+V.ele.ACC.3.F.PL+SBJF+1+SG
veniagá-las	veniagar+V.ele.ACC.3.F.PL+SBJF+3+SG
veniagá-la	veniagar+V.ele.ACC.3.F.SG+INF+1+SG
veniagá-la	veniagar+V.ele.ACC.3.F.SG+INF+3+SG
veniaga-la	veniagar+V.ele.ACC.3.F.SG+PRS+2+SG
veniagá-la	veniagar+V.ele.ACC.3.F.SG+SBJF+1+SG
veniagá-la	veniagar+V.ele.ACC.3.F.SG+SBJF+3+SG
veniaga-lhes	veniagar+V.ele.DAT.3.PL+PRS+3+SG
veniaga-lhe	veniagar+V.ele.DAT.3.SG+PRS+3+SG
veniagá-lo-ão	veniagar+V.ele.ACC.3.M.SG+FUT+3+PL
veniagá-lo-ás	veniagar+V.ele.ACC.3.M.SG+FUT+2+SG
veniagá-lo-á	veniagar+V.ele.ACC.3.M.SG+FUT+3+SG
veniagá-lo-eis	veniagar+V.ele.ACC.3.M.SG+FUT+2+PL
veniagá-lo-ei	veniagar+V.ele.ACC.3.M.SG+FUT+1+SG
veniagá-lo-emos	veniagar+V.ele.ACC.3.M.SG+FUT+1+PL
veniagá-lo-íamos	veniagar+V.ele.ACC.3.M.SG+COND+1+PL
veniagá-lo-iam	veniagar+V.ele.ACC.3.M.SG+COND+3+PL
veniagá-lo-ias	veniagar+V.ele.ACC.3.M.SG+COND+2+SG
veniagá-lo-ia	veniagar+V.ele.ACC.3.M.SG+COND+1+SG
veniagá-lo-ia	veniagar+V.ele.ACC.3.M.SG+COND+3+SG
veniagá-lo-íeis	veniagar+V.ele.ACC.3.M.SG+COND+2+PL
veniagá-los-ão	veniagar+V.ele.ACC.3.M.PL+FUT+3+PL
veniagá-los-ás	veniagar+V.ele.ACC.3.M.PL+FUT+2+SG
veniagá-los-á	veniagar+V.ele.ACC.3.M.PL+FUT+3+SG
veniagá-los-eis	veniagar+V.ele.ACC.3.M.PL+FUT+2+PL
veniagá-los-ei	veniagar+V.ele.ACC.3.M.PL+FUT+1+SG
veniagá-los-emos	veniagar+V.ele.ACC.3.M.PL+FUT+1+PL
veniagá-los-íamos	veniagar+V.ele.ACC.3.M.PL+COND+1+PL
veniagá-los-iam	veniagar+V.ele.ACC.3.M.PL+COND+3+PL
veniagá-los-ias	veniagar+V.ele.ACC.3.M.PL+COND+2+SG
veniagá-los-ia	veniagar+V.ele.ACC.3.M.PL+COND+1+SG
veniagá-los-ia	veniagar+V.ele.ACC.3.M.PL+COND+3+SG
veniagá-los-íeis	veniagar+V.ele.ACC.3.M.PL+COND+2+PL
veniagá-los	veniagar+V.ele.ACC.3.M.PL+INF+1+SG
veniagá-los	veniagar+V.ele.ACC.3.M.PL+INF+3+SG
veniaga-los	veniagar+V.ele.ACC.3.M.PL+PRS+2+SG
veniagá-los	veniagar+V.ele.ACC.3.M.PL+SBJF+1+SG
veniagá-los	veniagar+V.ele.ACC.3.M.PL+SBJF+3+SG
veniagá-lo	veniagar+V.ele.ACC.3.M.SG+INF+1+SG
veniagá-lo	veniagar+V.ele.ACC.3.M.SG+INF+3+SG
veniaga-lo	veniagar+V.ele.ACC.3.M.SG+PRS+2+SG
veniagá-lo	veniagar+V.ele.ACC.3.M.SG+SBJF+1+SG
veniagá-lo	veniagar+V.ele.ACC.3.M.SG+SBJF+3+SG
veniaga-me	veniagar+V.eu.AD.1.SG+PRS+3+SG
veniagam-lhes	veniagar+V.ele.DAT.3.PL+PRS+3+PL
veniagam-lhe	veniagar+V.ele.DAT.3.SG+PRS+3+PL
veniagam-me	veniagar+V.eu.AD.1.SG+PRS+3+PL
veniagam-nas	veniagar+V.ele.ACC.3.F.PL+PRS+3+PL
veniagam-na	veniagar+V.ele.ACC.3.F.SG+PRS+3+PL
veniagam-nos	veniagar+V.ele.ACC.3.M.PL+PRS+3+PL
veniagam-nos	veniagar+V.nós.AD.1.PL+PRS+3+PL
veniagam-no	veniagar+V.ele.ACC.3.M.SG+PRS+3+PL
veniagamo-las	veniagar+V.ele.ACC.3.F.PL+PRF+1+PL
veniagamo-las	veniagar+V.ele.ACC.3.F.PL+PRS+1+PL
veniagamo-la	veniagar+V.ele.ACC.3.F.SG+PRF+1+PL
veniagamo-la	veniagar+V.ele.ACC.3.F.SG+PRS+1+PL
veniagamo-los	veniagar+V.ele.ACC.3.M.PL+PRF+1+PL
veniagamo-los	veniagar+V.ele.ACC.3.M.PL+PRS+1+PL
veniagamo-lo	veniagar+V.ele.ACC.3.M.SG+PRF+1+PL
veniagamo-lo	veniagar+V.ele.ACC.3.M.SG+PRS+1+PL
veniagamo-nos	veniagar+nós.AD.1.PL+PRF+1+PL
veniagamo-nos	veniagar+nós.AD.1.PL+PRS+1+PL
veniagamos-lhes	veniagar+V.ele.DAT.3.PL+PRF+1+PL
veniagamos-lhes	veniagar+V.ele.DAT.3.PL+PRS+1+PL
veniagamos-lhe	veniagar+V.ele.DAT.3.SG+PRF+1+PL
veniagamos-lhe	veniagar+V.ele.DAT.3.SG+PRS+1+PL
veniagamos-me	veniagar+V.eu.AD.1.SG+PRF+1+PL
veniagamos-me	veniagar+V.eu.AD.1.SG+PRS+1+PL
veniagamos-te	veniagar+V.tu.AD.2.SG+PRF+1+PL
veniagamos-te	veniagar+V.tu.AD.2.SG+PRS+1+PL
veniagamos-vos	veniagar+V.vós.AD.2.PL+PRF+1+PL
veniagamos-vos	veniagar+V.vós.AD.2.PL+PRS+1+PL
veniagam-se	veniagar+V.ele.REFL+PRS+3+PL
veniagam-te	veniagar+V.tu.AD.2.SG+PRS+3+PL
veniagam-vos	veniagar+V.vós.AD.2.PL+PRS+3+PL
veniagando-as	veniagar+V.ele.ACC.3.F.PL+GRD
veniagando-a	veniagar+V.ele.ACC.3.F.SG+GRD
veniagando-lhes	veniagar+V.ele.DAT.3.PL+GRD
veniagando-lhe	veniagar+V.ele.DAT.3.SG+GRD
veniagando-me	veniagar+V.eu.AD.1.SG+GRD
veniagando-nos	veniagar+nós.AD.1.PL+GRD
veniagando-os	veniagar+V.ele.ACC.3.M.PL+GRD
veniagando-o	veniagar+V.ele.ACC.3.M.SG+GRD
veniagando-se	veniagar+V.ele.REFL+GRD
veniagando-te	veniagar+V.tu.AD.2.SG+GRD
veniagando-vos	veniagar+V.vós.AD.2.PL+GRD
veniaga-nos	veniagar+nós.AD.1.PL+PRS+2+SG
veniaga-nos	veniagar+nós.AD.1.PL+PRS+3+SG
veniaga-os	veniagar+V.ele.ACC.3.M.PL+PRS+3+SG
veniaga-o	veniagar+V.ele.ACC.3.M.SG+PRS+3+SG
veniagara-as	veniagar+V.ele.ACC.3.F.PL+PQP+1+SG
veniagara-as	veniagar+V.ele.ACC.3.F.PL+PQP+3+SG
veniagara-a	veniagar+V.ele.ACC.3.F.SG+PQP+1+SG
veniagara-a	veniagar+V.ele.ACC.3.F.SG+PQP+3+SG
veniagara-las	veniagar+V.ele.ACC.3.F.PL+PQP+2+SG
veniagara-la	veniagar+V.ele.ACC.3.F.SG+PQP+2+SG
veniagara-lhes	veniagar+V.ele.DAT.3.PL+PQP+1+SG
veniagara-lhes	veniagar+V.ele.DAT.3.PL+PQP+3+SG
veniagara-lhe	veniagar+V.ele.DAT.3.SG+PQP+1+SG
veniagara-lhe	veniagar+V.ele.DAT.3.SG+PQP+3+SG
veniagara-los	veniagar+V.ele.ACC.3.M.PL+PQP+2+SG
veniagara-lo	veniagar+V.ele.ACC.3.M.SG+PQP+2+SG
veniagara-me	veniagar+V.eu.AD.1.SG+PQP+1+SG
veniagara-me	veniagar+V.eu.AD.1.SG+PQP+3+SG
veniagaram-lhes	veniagar+V.ele.DAT.3.PL+PQP+3+PL
veniagaram-lhes	veniagar+V.ele.DAT.3.PL+PRF+3+PL
veniagaram-lhe	veniagar+V.ele.DAT.3.SG+PQP+3+PL
veniagaram-lhe	veniagar+V.ele.DAT.3.SG+PRF+3+PL
veniagaram-me	veniagar+V.eu.AD.1.SG+PQP+3+PL
veniagaram-me	veniagar+V.eu.AD.1.SG+PRF+3+PL
veniagaram-nas	veniagar+V.ele.ACC.3.F.PL+PQP+3+PL
veniagaram-nas	veniagar+V.ele.ACC.3.F.PL+PRF+3+PL
veniagaram-na	veniagar+V.ele.ACC.3.F.SG+PQP+3+PL
veniagaram-na	veniagar+V.ele.ACC.3.F.SG+PRF+3+PL
veniagaram-nos	veniagar+V.ele.ACC.3.M.PL+PQP+3+PL
veniagaram-nos	veniagar+V.ele.ACC.3.M.PL+PRF+3+PL
veniagaram-nos	veniagar+V.nós.AD.1.PL+PQP+3+PL
veniagaram-nos	veniagar+V.nós.AD.1.PL+PRF+3+PL
veniagaram-no	veniagar+V.ele.ACC.3.M.SG+PQP+3+PL
veniagaram-no	veniagar+V.ele.ACC.3.M.SG+PRF+3+PL
veniagáramo-las	veniagar+V.ele.ACC.3.F.PL+PQP+1+PL
veniagáramo-la	veniagar+V.ele.ACC.3.F.SG+PQP+1+PL
veniagáramo-los	veniagar+V.ele.ACC.3.M.PL+PQP+1+PL
veniagáramo-lo	veniagar+V.ele.ACC.3.M.SG+PQP+1+PL
veniagáramo-nos	veniagar+nós.AD.1.PL+PQP+1+PL
veniagáramos-lhes	veniagar+V.ele.DAT.3.PL+PQP+1+PL
veniagáramos-lhe	veniagar+V.ele.DAT.3.SG+PQP+1+PL
veniagáramos-me	veniagar+V.eu.AD.1.SG+PQP+1+PL
veniagáramos-te	veniagar+V.tu.AD.2.SG+PQP+1+PL
veniagáramos-vos	veniagar+V.vós.AD.2.PL+PQP+1+PL
veniagaram-se	veniagar+V.ele.REFL+PQP+3+PL
veniagaram-se	veniagar+V.ele.REFL+PRF+3+PL
veniagaram-te	veniagar+V.tu.AD.2.SG+PQP+3+PL
veniagaram-te	veniagar+V.tu.AD.2.SG+PRF+3+PL
veniagaram-vos	veniagar+V.vós.AD.2.PL+PQP+3+PL
veniagaram-vos	veniagar+V.vós.AD.2.PL+PRF+3+PL
veniagara-nos	veniagar+nós.AD.1.PL+PQP+1+SG
veniagara-nos	veniagar+nós.AD.1.PL+PQP+2+SG
veniagara-nos	veniagar+nós.AD.1.PL+PQP+3+SG
veniagara-os	veniagar+V.ele.ACC.3.M.PL+PQP+1+SG
veniagara-os	veniagar+V.ele.ACC.3.M.PL+PQP+3+SG
veniagara-o	veniagar+V.ele.ACC.3.M.SG+PQP+1+SG
veniagara-o	veniagar+V.ele.ACC.3.M.SG+PQP+3+SG
veniagara-se	veniagar+V.ele.REFL+PQP+1+SG
veniagara-se	veniagar+V.ele.REFL+PQP+3+SG
veniagaras-lhes	veniagar+V.ele.DAT.3.PL+PQP+2+SG
veniagaras-lhe	veniagar+V.ele.DAT.3.SG+PQP+2+SG
veniagaras-me	veniagar+V.eu.AD.1.SG+PQP+2+SG
veniagaras-te	veniagar+V.tu.AD.2.SG+PQP+2+SG
veniagaras-vos	veniagar+V.vós.AD.2.PL+PQP+2+SG
veniagara-te	veniagar+V.tu.AD.2.SG+PQP+1+SG
veniagara-te	veniagar+V.tu.AD.2.SG+PQP+3+SG
veniagara-vos	veniagar+V.vós.AD.2.PL+PQP+1+SG
veniagara-vos	veniagar+V.vós.AD.2.PL+PQP+3+SG
veniagarde-las	veniagar+V.ele.ACC.3.F.PL+INF+2+PL
veniagarde-las	veniagar+V.ele.ACC.3.F.PL+SBJF+2+PL
veniagarde-la	veniagar+V.ele.ACC.3.F.SG+INF+2+PL
veniagarde-la	veniagar+V.ele.ACC.3.F.SG+SBJF+2+PL
veniagarde-los	veniagar+V.ele.ACC.3.M.PL+INF+2+PL
veniagarde-los	veniagar+V.ele.ACC.3.M.PL+SBJF+2+PL
veniagarde-lo	veniagar+V.ele.ACC.3.M.SG+INF+2+PL
veniagarde-lo	veniagar+V.ele.ACC.3.M.SG+SBJF+2+PL
veniagarde-nos	veniagar+nós.AD.1.PL+INF+2+PL
veniagarde-nos	veniagar+nós.AD.1.PL+SBJF+2+PL
veniagardes-lhes	veniagar+V.ele.DAT.3.PL+INF+2+PL
veniagardes-lhes	veniagar+V.ele.DAT.3.PL+SBJF+2+PL
veniagardes-lhe	veniagar+V.ele.DAT.3.SG+INF+2+PL
veniagardes-lhe	veniagar+V.ele.DAT.3.SG+SBJF+2+PL
veniagardes-me	veniagar+V.eu.AD.1.SG+INF+2+PL
veniagardes-me	veniagar+V.eu.AD.1.SG+SBJF+2+PL
veniagardes-te	veniagar+V.tu.AD.2.SG+INF+2+PL
veniagardes-te	veniagar+V.tu.AD.2.SG+SBJF+2+PL
veniagardes-vos	veniagar+V.vós.AD.2.PL+INF+2+PL
veniagardes-vos	veniagar+V.vós.AD.2.PL+SBJF+2+PL
veniagárei-las	veniagar+V.ele.ACC.3.F.PL+PQP+2+PL
veniagárei-la	veniagar+V.ele.ACC.3.F.SG+PQP+2+PL
veniagárei-los	veniagar+V.ele.ACC.3.M.PL+PQP+2+PL
veniagárei-lo	veniagar+V.ele.ACC.3.M.SG+PQP+2+PL
veniagárei-nos	veniagar+nós.AD.1.PL+PQP+2+PL
veniagáreis-lhes	veniagar+V.ele.DAT.3.PL+PQP+2+PL
veniagáreis-lhe	veniagar+V.ele.DAT.3.SG+PQP+2+PL
veniagáreis-me	veniagar+V.eu.AD.1.SG+PQP+2+PL
veniagáreis-te	veniagar+V.tu.AD.2.SG+PQP+2+PL
veniagáreis-vos	veniagar+V.vós.AD.2.PL+PQP+2+PL
veniagare-las	veniagar+V.ele.ACC.3.F.PL+INF+2+SG
veniagare-las	veniagar+V.ele.ACC.3.F.PL+SBJF+2+SG
veniagare-la	veniagar+V.ele.ACC.3.F.SG+INF+2+SG
veniagare-la	veniagar+V.ele.ACC.3.F.SG+SBJF+2+SG
veniagare-los	veniagar+V.ele.ACC.3.M.PL+INF+2+SG
veniagare-los	veniagar+V.ele.ACC.3.M.PL+SBJF+2+SG
veniagare-lo	veniagar+V.ele.ACC.3.M.SG+INF+2+SG
veniagare-lo	veniagar+V.ele.ACC.3.M.SG+SBJF+2+SG
veniagarem-lhes	veniagar+V.ele.DAT.3.PL+INF+3+PL
veniagarem-lhes	veniagar+V.ele.DAT.3.PL+SBJF+3+PL
veniagarem-lhe	veniagar+V.ele.DAT.3.SG+INF+3+PL
veniagarem-lhe	veniagar+V.ele.DAT.3.SG+SBJF+3+PL
veniagarem-me	veniagar+V.eu.AD.1.SG+INF+3+PL
veniagarem-me	veniagar+V.eu.AD.1.SG+SBJF+3+PL
veniagarem-nas	veniagar+V.ele.ACC.3.F.PL+INF+3+PL
veniagarem-nas	veniagar+V.ele.ACC.3.F.PL+SBJF+3+PL
veniagarem-na	veniagar+V.ele.ACC.3.F.SG+INF+3+PL
veniagarem-na	veniagar+V.ele.ACC.3.F.SG+SBJF+3+PL
veniagarem-nos	veniagar+V.ele.ACC.3.M.PL+INF+3+PL
veniagarem-nos	veniagar+V.ele.ACC.3.M.PL+SBJF+3+PL
veniagarem-nos	veniagar+V.nós.AD.1.PL+INF+3+PL
veniagarem-nos	veniagar+V.nós.AD.1.PL+SBJF+3+PL
veniagarem-no	veniagar+V.ele.ACC.3.M.SG+INF+3+PL
veniagarem-no	veniagar+V.ele.ACC.3.M.SG+SBJF+3+PL
veniagarem-se	veniagar+V.ele.REFL+INF+3+PL
veniagarem-se	veniagar+V.ele.REFL+SBJF+3+PL
veniagarem-te	veniagar+V.tu.AD.2.SG+INF+3+PL
veniagarem-te	veniagar+V.tu.AD.2.SG+SBJF+3+PL
veniagarem-vos	veniagar+V.vós.AD.2.PL+INF+3+PL
veniagarem-vos	veniagar+V.vós.AD.2.PL+SBJF+3+PL
veniagare-nos	veniagar+nós.AD.1.PL+INF+2+SG
veniagare-nos	veniagar+nós.AD.1.PL+SBJF+2+SG
veniagares-lhes	veniagar+V.ele.DAT.3.PL+INF+2+SG
veniagares-lhes	veniagar+V.ele.DAT.3.PL+SBJF+2+SG
veniagares-lhe	veniagar+V.ele.DAT.3.SG+INF+2+SG
veniagares-lhe	veniagar+V.ele.DAT.3.SG+SBJF+2+SG
veniagares-me	veniagar+V.eu.AD.1.SG+INF+2+SG
veniagares-me	veniagar+V.eu.AD.1.SG+SBJF+2+SG
veniagares-te	veniagar+V.tu.AD.2.SG+INF+2+SG
veniagares-te	veniagar+V.tu.AD.2.SG+SBJF+2+SG
veniagares-vos	veniagar+V.vós.AD.2.PL+INF+2+SG
veniagares-vos	veniagar+V.vós.AD.2.PL+SBJF+2+SG
veniagar-lhe-ão	veniagar+V.ele.DAT.3.SG+FUT+3+PL
veniagar-lhe-ás	veniagar+V.ele.DAT.3.SG+FUT+2+SG
veniagar-lhe-á	veniagar+V.ele.DAT.3.SG+FUT+3+SG
veniagar-lhe-eis	veniagar+V.ele.DAT.3.SG+FUT+2+PL
veniagar-lhe-ei	veniagar+V.ele.DAT.3.SG+FUT+1+SG
veniagar-lhe-emos	veniagar+V.ele.DAT.3.SG+FUT+1+PL
veniagar-lhe-íamos	veniagar+V.ele.DAT.3.SG+COND+1+PL
veniagar-lhe-iam	veniagar+V.ele.DAT.3.SG+COND+3+PL
veniagar-lhe-ias	veniagar+V.ele.DAT.3.SG+COND+2+SG
veniagar-lhe-ia	veniagar+V.ele.DAT.3.SG+COND+1+SG
veniagar-lhe-ia	veniagar+V.ele.DAT.3.SG+COND+3+SG
veniagar-lhe-íeis	veniagar+V.ele.DAT.3.SG+COND+2+PL
veniagar-lhes-ão	veniagar+V.ele.DAT.3.PL+FUT+3+PL
veniagar-lhes-ás	veniagar+V.ele.DAT.3.PL+FUT+2+SG
veniagar-lhes-á	veniagar+V.ele.DAT.3.PL+FUT+3+SG
veniagar-lhes-eis	veniagar+V.ele.DAT.3.PL+FUT+2+PL
veniagar-lhes-ei	veniagar+V.ele.DAT.3.PL+FUT+1+SG
veniagar-lhes-emos	veniagar+V.ele.DAT.3.PL+FUT+1+PL
veniagar-lhes-íamos	veniagar+V.ele.DAT.3.PL+COND+1+PL
veniagar-lhes-iam	veniagar+V.ele.DAT.3.PL+COND+3+PL
veniagar-lhes-ias	veniagar+V.ele.DAT.3.PL+COND+2+SG
veniagar-lhes-ia	veniagar+V.ele.DAT.3.PL+COND+1+SG
veniagar-lhes-ia	veniagar+V.ele.DAT.3.PL+COND+3+SG
veniagar-lhes-íeis	veniagar+V.ele.DAT.3.PL+COND+2+PL
veniagar-lhes	veniagar+V.ele.DAT.3.PL+INF
veniagar-lhes	veniagar+V.ele.DAT.3.PL+INF+1+SG
veniagar-lhes	veniagar+V.ele.DAT.3.PL+INF+3+SG
veniagar-lhes	veniagar+V.ele.DAT.3.PL+SBJF+1+SG
veniagar-lhes	veniagar+V.ele.DAT.3.PL+SBJF+3+SG
veniagar-lhe	veniagar+V.ele.DAT.3.SG+INF
veniagar-lhe	veniagar+V.ele.DAT.3.SG+INF+1+SG
veniagar-lhe	veniagar+V.ele.DAT.3.SG+INF+3+SG
veniagar-lhe	veniagar+V.ele.DAT.3.SG+SBJF+1+SG
veniagar-lhe	veniagar+V.ele.DAT.3.SG+SBJF+3+SG
veniagar-me-ão	veniagar+V.eu.AD.1.SG+FUT+3+PL
veniagar-me-ás	veniagar+V.eu.AD.1.SG+FUT+2+SG
veniagar-me-á	veniagar+V.eu.AD.1.SG+FUT+3+SG
veniagar-me-eis	veniagar+V.eu.AD.1.SG+FUT+2+PL
veniagar-me-ei	veniagar+V.eu.AD.1.SG+FUT+1+SG
veniagar-me-emos	veniagar+V.eu.AD.1.SG+FUT+1+PL
veniagar-me-íamos	veniagar+V.eu.AD.1.SG+COND+1+PL
veniagar-me-iam	veniagar+V.eu.AD.1.SG+COND+3+PL
veniagar-me-ias	veniagar+V.eu.AD.1.SG+COND+2+SG
veniagar-me-ia	veniagar+V.eu.AD.1.SG+COND+1+SG
veniagar-me-ia	veniagar+V.eu.AD.1.SG+COND+3+SG
veniagar-me-íeis	veniagar+V.eu.AD.1.SG+COND+2+PL
veniagar-me	veniagar+V.eu.AD.1.SG+INF
veniagar-me	veniagar+V.eu.AD.1.SG+INF+1+SG
veniagar-me	veniagar+V.eu.AD.1.SG+INF+3+SG
veniagar-me	veniagar+V.eu.AD.1.SG+SBJF+1+SG
veniagar-me	veniagar+V.eu.AD.1.SG+SBJF+3+SG
veniagarmo-las	veniagar+V.ele.ACC.3.F.PL+INF+1+PL
veniagarmo-las	veniagar+V.ele.ACC.3.F.PL+SBJF+1+PL
veniagarmo-la	veniagar+V.ele.ACC.3.F.SG+INF+1+PL
veniagarmo-la	veniagar+V.ele.ACC.3.F.SG+SBJF+1+PL
veniagarmo-los	veniagar+V.ele.ACC.3.M.PL+INF+1+PL
veniagarmo-los	veniagar+V.ele.ACC.3.M.PL+SBJF+1+PL
veniagarmo-lo	veniagar+V.ele.ACC.3.M.SG+INF+1+PL
veniagarmo-lo	veniagar+V.ele.ACC.3.M.SG+SBJF+1+PL
veniagarmo-nos	veniagar+nós.AD.1.PL+INF+1+PL
veniagarmo-nos	veniagar+nós.AD.1.PL+SBJF+1+PL
veniagarmos-lhes	veniagar+V.ele.DAT.3.PL+INF+1+PL
veniagarmos-lhes	veniagar+V.ele.DAT.3.PL+SBJF+1+PL
veniagarmos-lhe	veniagar+V.ele.DAT.3.SG+INF+1+PL
veniagarmos-lhe	veniagar+V.ele.DAT.3.SG+SBJF+1+PL
veniagarmos-me	veniagar+V.eu.AD.1.SG+INF+1+PL
veniagarmos-me	veniagar+V.eu.AD.1.SG+SBJF+1+PL
veniagarmos-te	veniagar+V.tu.AD.2.SG+INF+1+PL
veniagarmos-te	veniagar+V.tu.AD.2.SG+SBJF+1+PL
veniagarmos-vos	veniagar+V.vós.AD.2.PL+INF+1+PL
veniagarmos-vos	veniagar+V.vós.AD.2.PL+SBJF+1+PL
veniagar-nos-ão	veniagar+nós.AD.1.PL+FUT+3+PL
veniagar-nos-ás	veniagar+nós.AD.1.PL+FUT+2+SG
veniagar-nos-á	veniagar+nós.AD.1.PL+FUT+3+SG
veniagar-nos-eis	veniagar+nós.AD.1.PL+FUT+2+PL
veniagar-nos-ei	veniagar+nós.AD.1.PL+FUT+1+SG
veniagar-nos-emos	veniagar+nós.AD.1.PL+FUT+1+PL
veniagar-nos-íamos	veniagar+nós.AD.1.PL+COND+1+PL
veniagar-nos-iam	veniagar+nós.AD.1.PL+COND+3+PL
veniagar-nos-ias	veniagar+nós.AD.1.PL+COND+2+SG
veniagar-nos-ia	veniagar+nós.AD.1.PL+COND+1+SG
veniagar-nos-ia	veniagar+nós.AD.1.PL+COND+3+SG
veniagar-nos-íeis	veniagar+nós.AD.1.PL+COND+2+PL
veniagar-nos	veniagar+nós.AD.1.PL+INF
veniagar-nos	veniagar+nós.AD.1.PL+INF+1+SG
veniagar-nos	veniagar+nós.AD.1.PL+INF+3+SG
veniagar-nos	veniagar+nós.AD.1.PL+SBJF+1+SG
veniagar-nos	veniagar+nós.AD.1.PL+SBJF+3+SG
veniagar-se-ão	veniagar+V.ele.REFL+FUT+3+PL
veniagar-se-á	veniagar+V.ele.REFL+FUT+3+SG
veniagar-se-iam	veniagar+V.ele.REFL+COND+3+PL
veniagar-se-ia	veniagar+V.ele.REFL+COND+3+SG
veniagar-se	veniagar+V.ele.REFL+INF
veniagar-se	veniagar+V.ele.REFL+INF+3+SG
veniagar-se	veniagar+V.ele.REFL+SBJF+3+SG
veniagar-te-ão	veniagar+V.tu.AD.2.SG+FUT+3+PL
veniagar-te-ás	veniagar+V.tu.AD.2.SG+FUT+2+SG
veniagar-te-á	veniagar+V.tu.AD.2.SG+FUT+3+SG
veniagar-te-eis	veniagar+V.tu.AD.2.SG+FUT+2+PL
veniagar-te-ei	veniagar+V.tu.AD.2.SG+FUT+1+SG
veniagar-te-emos	veniagar+V.tu.AD.2.SG+FUT+1+PL
veniagar-te-íamos	veniagar+V.tu.AD.2.SG+COND+1+PL
veniagar-te-iam	veniagar+V.tu.AD.2.SG+COND+3+PL
veniagar-te-ias	veniagar+V.tu.AD.2.SG+COND+2+SG
veniagar-te-ia	veniagar+V.tu.AD.2.SG+COND+1+SG
veniagar-te-ia	veniagar+V.tu.AD.2.SG+COND+3+SG
veniagar-te-íeis	veniagar+V.tu.AD.2.SG+COND+2+PL
veniagar-te	veniagar+V.tu.AD.2.SG+INF
veniagar-te	veniagar+V.tu.AD.2.SG+INF+1+SG
veniagar-te	veniagar+V.tu.AD.2.SG+INF+3+SG
veniagar-te	veniagar+V.tu.AD.2.SG+SBJF+1+SG
veniagar-te	veniagar+V.tu.AD.2.SG+SBJF+3+SG
veniagar-vos-ão	veniagar+V.vós.AD.2.PL+FUT+3+PL
veniagar-vos-ás	veniagar+V.vós.AD.2.PL+FUT+2+SG
veniagar-vos-á	veniagar+V.vós.AD.2.PL+FUT+3+SG
veniagar-vos-eis	veniagar+V.vós.AD.2.PL+FUT+2+PL
veniagar-vos-ei	veniagar+V.vós.AD.2.PL+FUT+1+SG
veniagar-vos-emos	veniagar+V.vós.AD.2.PL+FUT+1+PL
veniagar-vos-íamos	veniagar+V.vós.AD.2.PL+COND+1+PL
veniagar-vos-iam	veniagar+V.vós.AD.2.PL+COND+3+PL
veniagar-vos-ias	veniagar+V.vós.AD.2.PL+COND+2+SG
veniagar-vos-ia	veniagar+V.vós.AD.2.PL+COND+1+SG
veniagar-vos-ia	veniagar+V.vós.AD.2.PL+COND+3+SG
veniagar-vos-íeis	veniagar+V.vós.AD.2.PL+COND+2+PL
veniagar-vos	veniagar+V.vós.AD.2.PL+INF
veniagar-vos	veniagar+V.vós.AD.2.PL+INF+1+SG
veniagar-vos	veniagar+V.vós.AD.2.PL+INF+3+SG
veniagar-vos	veniagar+V.vós.AD.2.PL+SBJF+1+SG
veniagar-vos	veniagar+V.vós.AD.2.PL+SBJF+3+SG
veniaga-se	veniagar+V.ele.REFL+PRS+3+SG
veniagas-lhes	veniagar+V.ele.DAT.3.PL+PRS+2+SG
veniagas-lhe	veniagar+V.ele.DAT.3.SG+PRS+2+SG
veniagas-me	veniagar+V.eu.AD.1.SG+PRS+2+SG
veniagaste-as	veniagar+V.ele.ACC.3.F.PL+PRF+2+SG
veniagaste-a	veniagar+V.ele.ACC.3.F.SG+PRF+2+SG
veniagaste-las	veniagar+V.ele.ACC.3.F.PL+PRF+2+PL
veniagaste-la	veniagar+V.ele.ACC.3.F.SG+PRF+2+PL
veniagaste-lhes	veniagar+V.ele.DAT.3.PL+PRF+2+SG
veniagaste-lhe	veniagar+V.ele.DAT.3.SG+PRF+2+SG
veniagaste-los	veniagar+V.ele.ACC.3.M.PL+PRF+2+PL
veniagaste-lo	veniagar+V.ele.ACC.3.M.SG+PRF+2+PL
veniagaste-me	veniagar+V.eu.AD.1.SG+PRF+2+SG
veniagaste-nos	veniagar+nós.AD.1.PL+PRF+2+PL
veniagaste-nos	veniagar+nós.AD.1.PL+PRF+2+SG
veniagaste-os	veniagar+V.ele.ACC.3.M.PL+PRF+2+SG
veniagaste-o	veniagar+V.ele.ACC.3.M.SG+PRF+2+SG
veniagastes-lhes	veniagar+V.ele.DAT.3.PL+PRF+2+PL
veniagastes-lhe	veniagar+V.ele.DAT.3.SG+PRF+2+PL
veniagastes-me	veniagar+V.eu.AD.1.SG+PRF+2+PL
veniagastes-te	veniagar+V.tu.AD.2.SG+PRF+2+PL
veniagastes-vos	veniagar+V.vós.AD.2.PL+PRF+2+PL
veniagaste-te	veniagar+V.tu.AD.2.SG+PRF+2+SG
veniagas-te	veniagar+V.tu.AD.2.SG+PRS+2+SG
veniagaste-vos	veniagar+V.vós.AD.2.PL+PRF+2+SG
veniagas-vos	veniagar+V.vós.AD.2.PL+PRS+2+SG
veniaga-te	veniagar+V.tu.AD.2.SG+PRS+3+SG
veniagava-as	veniagar+V.ele.ACC.3.F.PL+IMPF+1+SG
veniagava-as	veniagar+V.ele.ACC.3.F.PL+IMPF+3+SG
veniagava-a	veniagar+V.ele.ACC.3.F.SG+IMPF+1+SG
veniagava-a	veniagar+V.ele.ACC.3.F.SG+IMPF+3+SG
veniagava-las	veniagar+V.ele.ACC.3.F.PL+IMPF+2+SG
veniagava-la	veniagar+V.ele.ACC.3.F.SG+IMPF+2+SG
veniagava-lhes	veniagar+V.ele.DAT.3.PL+IMPF+1+SG
veniagava-lhes	veniagar+V.ele.DAT.3.PL+IMPF+3+SG
veniagava-lhe	veniagar+V.ele.DAT.3.SG+IMPF+1+SG
veniagava-lhe	veniagar+V.ele.DAT.3.SG+IMPF+3+SG
veniagava-los	veniagar+V.ele.ACC.3.M.PL+IMPF+2+SG
veniagava-lo	veniagar+V.ele.ACC.3.M.SG+IMPF+2+SG
veniagava-me	veniagar+V.eu.AD.1.SG+IMPF+1+SG
veniagava-me	veniagar+V.eu.AD.1.SG+IMPF+3+SG
veniagavam-lhes	veniagar+V.ele.DAT.3.PL+IMPF+3+PL
veniagavam-lhe	veniagar+V.ele.DAT.3.SG+IMPF+3+PL
veniagavam-me	veniagar+V.eu.AD.1.SG+IMPF+3+PL
veniagavam-nas	veniagar+V.ele.ACC.3.F.PL+IMPF+3+PL
veniagavam-na	veniagar+V.ele.ACC.3.F.SG+IMPF+3+PL
veniagavam-nos	veniagar+V.ele.ACC.3.M.PL+IMPF+3+PL
veniagavam-nos	veniagar+V.nós.AD.1.PL+IMPF+3+PL
veniagavam-no	veniagar+V.ele.ACC.3.M.SG+IMPF+3+PL
veniagávamo-las	veniagar+V.ele.ACC.3.F.PL+IMPF+1+PL
veniagávamo-la	veniagar+V.ele.ACC.3.F.SG+IMPF+1+PL
veniagávamo-los	veniagar+V.ele.ACC.3.M.PL+IMPF+1+PL
veniagávamo-lo	veniagar+V.ele.ACC.3.M.SG+IMPF+1+PL
veniagávamo-nos	veniagar+nós.AD.1.PL+IMPF+1+PL
veniagávamos-lhes	veniagar+V.ele.DAT.3.PL+IMPF+1+PL
veniagávamos-lhe	veniagar+V.ele.DAT.3.SG+IMPF+1+PL
veniagávamos-me	veniagar+V.eu.AD.1.SG+IMPF+1+PL
veniagávamos-te	veniagar+V.tu.AD.2.SG+IMPF+1+PL
veniagávamos-vos	veniagar+V.vós.AD.2.PL+IMPF+1+PL
veniagavam-se	veniagar+V.ele.REFL+IMPF+3+PL
veniagavam-te	veniagar+V.tu.AD.2.SG+IMPF+3+PL
veniagavam-vos	veniagar+V.vós.AD.2.PL+IMPF+3+PL
veniagava-nos	veniagar+nós.AD.1.PL+IMPF+1+SG
veniagava-nos	veniagar+nós.AD.1.PL+IMPF+2+SG
veniagava-nos	veniagar+nós.AD.1.PL+IMPF+3+SG
veniagava-os	veniagar+V.ele.ACC.3.M.PL+IMPF+1+SG
veniagava-os	veniagar+V.ele.ACC.3.M.PL+IMPF+3+SG
veniagava-o	veniagar+V.ele.ACC.3.M.SG+IMPF+1+SG
veniagava-o	veniagar+V.ele.ACC.3.M.SG+IMPF+3+SG
veniagava-se	veniagar+V.ele.REFL+IMPF+1+SG
veniagava-se	veniagar+V.ele.REFL+IMPF+3+SG
veniagavas-lhes	veniagar+V.ele.DAT.3.PL+IMPF+2+SG
veniagavas-lhe	veniagar+V.ele.DAT.3.SG+IMPF+2+SG
veniagavas-me	veniagar+V.eu.AD.1.SG+IMPF+2+SG
veniagavas-te	veniagar+V.tu.AD.2.SG+IMPF+2+SG
veniagavas-vos	veniagar+V.vós.AD.2.PL+IMPF+2+SG
veniagava-te	veniagar+V.tu.AD.2.SG+IMPF+1+SG
veniagava-te	veniagar+V.tu.AD.2.SG+IMPF+3+SG
veniagava-vos	veniagar+V.vós.AD.2.PL+IMPF+1+SG
veniagava-vos	veniagar+V.vós.AD.2.PL+IMPF+3+SG
veniagávei-las	veniagar+V.ele.ACC.3.F.PL+IMPF+2+PL
veniagávei-la	veniagar+V.ele.ACC.3.F.SG+IMPF+2+PL
veniagávei-los	veniagar+V.ele.ACC.3.M.PL+IMPF+2+PL
veniagávei-lo	veniagar+V.ele.ACC.3.M.SG+IMPF+2+PL
veniagávei-nos	veniagar+nós.AD.1.PL+IMPF+2+PL
veniagáveis-lhes	veniagar+V.ele.DAT.3.PL+IMPF+2+PL
veniagáveis-lhe	veniagar+V.ele.DAT.3.SG+IMPF+2+PL
veniagáveis-me	veniagar+V.eu.AD.1.SG+IMPF+2+PL
veniagáveis-te	veniagar+V.tu.AD.2.SG+IMPF+2+PL
veniagáveis-vos	veniagar+V.vós.AD.2.PL+IMPF+2+PL
veniaga-vos	veniagar+V.vós.AD.2.PL+PRS+3+SG
veniago-as	veniagar+V.ele.ACC.3.F.PL+PRS+1+SG
veniago-a	veniagar+V.ele.ACC.3.F.SG+PRS+1+SG
veniago-lhes	veniagar+V.ele.DAT.3.PL+PRS+1+SG
veniago-lhe	veniagar+V.ele.DAT.3.SG+PRS+1+SG
veniago-me	veniagar+V.eu.AD.1.SG+PRS+1+SG
veniago-nos	veniagar+nós.AD.1.PL+PRS+1+SG
veniago-os	veniagar+V.ele.ACC.3.M.PL+PRS+1+SG
veniago-o	veniagar+V.ele.ACC.3.M.SG+PRS+1+SG
veniago-te	veniagar+V.tu.AD.2.SG+PRS+1+SG
veniagou-as	veniagar+V.ele.ACC.3.F.PL+PRF+3+SG
veniagou-a	veniagar+V.ele.ACC.3.F.SG+PRF+3+SG
veniagou-lhes	veniagar+V.ele.DAT.3.PL+PRF+3+SG
veniagou-lhe	veniagar+V.ele.DAT.3.SG+PRF+3+SG
veniagou-me	veniagar+V.eu.AD.1.SG+PRF+3+SG
veniagou-nos	veniagar+nós.AD.1.PL+PRF+3+SG
veniagou-os	veniagar+V.ele.ACC.3.M.PL+PRF+3+SG
veniagou-o	veniagar+V.ele.ACC.3.M.SG+PRF+3+SG
veniagou-se	veniagar+V.ele.REFL+PRF+3+SG
veniagou-te	veniagar+V.tu.AD.2.SG+PRF+3+SG
veniagou-vos	veniagar+V.vós.AD.2.PL+PRF+3+SG
veniago-vos	veniagar+V.vós.AD.2.PL+PRS+1+SG
veniague-as	veniagar+V.ele.ACC.3.F.PL+IMP+3+SG
veniague-a	veniagar+V.ele.ACC.3.F.SG+IMP+3+SG
veniaguei-as	veniagar+V.ele.ACC.3.F.PL+PRF+1+SG
veniaguei-a	veniagar+V.ele.ACC.3.F.SG+PRF+1+SG
veniaguei-lhes	veniagar+V.ele.DAT.3.PL+PRF+1+SG
veniaguei-lhe	veniagar+V.ele.DAT.3.SG+PRF+1+SG
veniaguei-me	veniagar+V.eu.AD.1.SG+PRF+1+SG
veniaguei-nos	veniagar+nós.AD.1.PL+PRF+1+SG
veniaguei-os	veniagar+V.ele.ACC.3.M.PL+PRF+1+SG
veniaguei-o	veniagar+V.ele.ACC.3.M.SG+PRF+1+SG
veniaguei-te	veniagar+V.tu.AD.2.SG+PRF+1+SG
veniaguei-vos	veniagar+V.vós.AD.2.PL+PRF+1+SG
veniague-lhes	veniagar+V.ele.DAT.3.PL+IMP+3+SG
veniague-lhe	veniagar+V.ele.DAT.3.SG+IMP+3+SG
veniague-me	veniagar+V.eu.AD.1.SG+IMP+3+SG
veniaguem-lhes	veniagar+V.ele.DAT.3.PL+IMP+3+PL
veniaguem-lhe	veniagar+V.ele.DAT.3.SG+IMP+3+PL
veniaguem-me	veniagar+V.eu.AD.1.SG+IMP+3+PL
veniaguem-nas	veniagar+V.ele.ACC.3.F.PL+IMP+3+PL
veniaguem-na	veniagar+V.ele.ACC.3.F.SG+IMP+3+PL
veniaguem-nos	veniagar+V.ele.ACC.3.M.PL+IMP+3+PL
veniaguem-nos	veniagar+V.nós.AD.1.PL+IMP+3+PL
veniaguem-no	veniagar+V.ele.ACC.3.M.SG+IMP+3+PL
veniaguemo-las	veniagar+V.ele.ACC.3.F.PL+IMP+1+PL
veniaguemo-la	veniagar+V.ele.ACC.3.F.SG+IMP+1+PL
veniaguemo-los	veniagar+V.ele.ACC.3.M.PL+IMP+1+PL
veniaguemo-lo	veniagar+V.ele.ACC.3.M.SG+IMP+1+PL
veniaguemo-nos	veniagar+nós.AD.1.PL+IMP+1+PL
veniaguemos-lhes	veniagar+V.ele.DAT.3.PL+IMP+1+PL
veniaguemos-lhe	veniagar+V.ele.DAT.3.SG+IMP+1+PL
veniaguemos-me	veniagar+V.eu.AD.1.SG+IMP+1+PL
veniaguemos-te	veniagar+V.tu.AD.2.SG+IMP+1+PL
veniaguemos-vos	veniagar+V.vós.AD.2.PL+IMP+1+PL
veniaguem-se	veniagar+V.ele.REFL+IMP+3+PL
veniaguem-te	veniagar+V.tu.AD.2.SG+IMP+3+PL
veniaguem-vos	veniagar+V.vós.AD.2.PL+IMP+3+PL
veniague-nos	veniagar+nós.AD.1.PL+IMP+3+SG
veniague-os	veniagar+V.ele.ACC.3.M.PL+IMP+3+SG
veniague-o	veniagar+V.ele.ACC.3.M.SG+IMP+3+SG
veniague-se	veniagar+V.ele.REFL+IMP+3+SG
veniague-te	veniagar+V.tu.AD.2.SG+IMP+3+SG
veniague-vos	veniagar+V.vós.AD.2.PL+IMP+3+SG
venializa-as	venializar+V.ele.ACC.3.F.PL+PRS+3+SG
venializa-a	venializar+V.ele.ACC.3.F.SG+PRS+3+SG
venializai-las	venializar+V.ele.ACC.3.F.PL+PRS+2+PL
venializai-la	venializar+V.ele.ACC.3.F.SG+PRS+2+PL
venializai-los	venializar+V.ele.ACC.3.M.PL+PRS+2+PL
venializai-lo	venializar+V.ele.ACC.3.M.SG+PRS+2+PL
venializai-nos	venializar+nós.AD.1.PL+PRS+2+PL
venializais-lhes	venializar+V.ele.DAT.3.PL+PRS+2+PL
venializais-lhe	venializar+V.ele.DAT.3.SG+PRS+2+PL
venializais-me	venializar+V.eu.AD.1.SG+PRS+2+PL
venializais-te	venializar+V.tu.AD.2.SG+PRS+2+PL
venializais-vos	venializar+V.vós.AD.2.PL+PRS+2+PL
venializá-la-ão	venializar+V.ele.ACC.3.F.SG+FUT+3+PL
venializá-la-ás	venializar+V.ele.ACC.3.F.SG+FUT+2+SG
venializá-la-á	venializar+V.ele.ACC.3.F.SG+FUT+3+SG
venializá-la-eis	venializar+V.ele.ACC.3.F.SG+FUT+2+PL
venializá-la-ei	venializar+V.ele.ACC.3.F.SG+FUT+1+SG
venializá-la-emos	venializar+V.ele.ACC.3.F.SG+FUT+1+PL
venializá-la-íamos	venializar+V.ele.ACC.3.F.SG+COND+1+PL
venializá-la-iam	venializar+V.ele.ACC.3.F.SG+COND+3+PL
venializá-la-ias	venializar+V.ele.ACC.3.F.SG+COND+2+SG
venializá-la-ia	venializar+V.ele.ACC.3.F.SG+COND+1+SG
venializá-la-ia	venializar+V.ele.ACC.3.F.SG+COND+3+SG
venializá-la-íeis	venializar+V.ele.ACC.3.F.SG+COND+2+PL
venializá-las-ão	venializar+V.ele.ACC.3.F.PL+FUT+3+PL
venializá-las-ás	venializar+V.ele.ACC.3.F.PL+FUT+2+SG
venializá-las-á	venializar+V.ele.ACC.3.F.PL+FUT+3+SG
venializá-las-eis	venializar+V.ele.ACC.3.F.PL+FUT+2+PL
venializá-las-ei	venializar+V.ele.ACC.3.F.PL+FUT+1+SG
venializá-las-emos	venializar+V.ele.ACC.3.F.PL+FUT+1+PL
venializá-las-íamos	venializar+V.ele.ACC.3.F.PL+COND+1+PL
venializá-las-iam	venializar+V.ele.ACC.3.F.PL+COND+3+PL
venializá-las-ias	venializar+V.ele.ACC.3.F.PL+COND+2+SG
venializá-las-ia	venializar+V.ele.ACC.3.F.PL+COND+1+SG
venializá-las-ia	venializar+V.ele.ACC.3.F.PL+COND+3+SG
venializá-las-íeis	venializar+V.ele.ACC.3.F.PL+COND+2+PL
venializá-las	venializar+V.ele.ACC.3.F.PL+INF+1+SG
venializá-las	venializar+V.ele.ACC.3.F.PL+INF+3+SG
venializa-las	venializar+V.ele.ACC.3.F.PL+PRS+2+SG
venializá-las	venializar+V.ele.ACC.3.F.PL+SBJF+1+SG
venializá-las	venializar+V.ele.ACC.3.F.PL+SBJF+3+SG
venializá-la	venializar+V.ele.ACC.3.F.SG+INF+1+SG
venializá-la	venializar+V.ele.ACC.3.F.SG+INF+3+SG
venializa-la	venializar+V.ele.ACC.3.F.SG+PRS+2+SG
venializá-la	venializar+V.ele.ACC.3.F.SG+SBJF+1+SG
venializá-la	venializar+V.ele.ACC.3.F.SG+SBJF+3+SG
venializa-lhes	venializar+V.ele.DAT.3.PL+PRS+3+SG
venializa-lhe	venializar+V.ele.DAT.3.SG+PRS+3+SG
venializá-lo-ão	venializar+V.ele.ACC.3.M.SG+FUT+3+PL
venializá-lo-ás	venializar+V.ele.ACC.3.M.SG+FUT+2+SG
venializá-lo-á	venializar+V.ele.ACC.3.M.SG+FUT+3+SG
venializá-lo-eis	venializar+V.ele.ACC.3.M.SG+FUT+2+PL
venializá-lo-ei	venializar+V.ele.ACC.3.M.SG+FUT+1+SG
venializá-lo-emos	venializar+V.ele.ACC.3.M.SG+FUT+1+PL
venializá-lo-íamos	venializar+V.ele.ACC.3.M.SG+COND+1+PL
venializá-lo-iam	venializar+V.ele.ACC.3.M.SG+COND+3+PL
venializá-lo-ias	venializar+V.ele.ACC.3.M.SG+COND+2+SG
venializá-lo-ia	venializar+V.ele.ACC.3.M.SG+COND+1+SG
venializá-lo-ia	venializar+V.ele.ACC.3.M.SG+COND+3+SG
venializá-lo-íeis	venializar+V.ele.ACC.3.M.SG+COND+2+PL
venializá-los-ão	venializar+V.ele.ACC.3.M.PL+FUT+3+PL
venializá-los-ás	venializar+V.ele.ACC.3.M.PL+FUT+2+SG
venializá-los-á	venializar+V.ele.ACC.3.M.PL+FUT+3+SG
venializá-los-eis	venializar+V.ele.ACC.3.M.PL+FUT+2+PL
venializá-los-ei	venializar+V.ele.ACC.3.M.PL+FUT+1+SG
venializá-los-emos	venializar+V.ele.ACC.3.M.PL+FUT+1+PL
venializá-los-íamos	venializar+V.ele.ACC.3.M.PL+COND+1+PL
venializá-los-iam	venializar+V.ele.ACC.3.M.PL+COND+3+PL
venializá-los-ias	venializar+V.ele.ACC.3.M.PL+COND+2+SG
venializá-los-ia	venializar+V.ele.ACC.3.M.PL+COND+1+SG
venializá-los-ia	venializar+V.ele.ACC.3.M.PL+COND+3+SG
venializá-los-íeis	venializar+V.ele.ACC.3.M.PL+COND+2+PL
venializá-los	venializar+V.ele.ACC.3.M.PL+INF+1+SG
venializá-los	venializar+V.ele.ACC.3.M.PL+INF+3+SG
venializa-los	venializar+V.ele.ACC.3.M.PL+PRS+2+SG
venializá-los	venializar+V.ele.ACC.3.M.PL+SBJF+1+SG
venializá-los	venializar+V.ele.ACC.3.M.PL+SBJF+3+SG
venializá-lo	venializar+V.ele.ACC.3.M.SG+INF+1+SG
venializá-lo	venializar+V.ele.ACC.3.M.SG+INF+3+SG
venializa-lo	venializar+V.ele.ACC.3.M.SG+PRS+2+SG
venializá-lo	venializar+V.ele.ACC.3.M.SG+SBJF+1+SG
venializá-lo	venializar+V.ele.ACC.3.M.SG+SBJF+3+SG
venializa-me	venializar+V.eu.AD.1.SG+PRS+3+SG
venializam-lhes	venializar+V.ele.DAT.3.PL+PRS+3+PL
venializam-lhe	venializar+V.ele.DAT.3.SG+PRS+3+PL
venializam-me	venializar+V.eu.AD.1.SG+PRS+3+PL
venializam-nas	venializar+V.ele.ACC.3.F.PL+PRS+3+PL
venializam-na	venializar+V.ele.ACC.3.F.SG+PRS+3+PL
venializam-nos	venializar+V.ele.ACC.3.M.PL+PRS+3+PL
venializam-nos	venializar+V.nós.AD.1.PL+PRS+3+PL
venializam-no	venializar+V.ele.ACC.3.M.SG+PRS+3+PL
venializamo-las	venializar+V.ele.ACC.3.F.PL+PRF+1+PL
venializamo-las	venializar+V.ele.ACC.3.F.PL+PRS+1+PL
venializamo-la	venializar+V.ele.ACC.3.F.SG+PRF+1+PL
venializamo-la	venializar+V.ele.ACC.3.F.SG+PRS+1+PL
venializamo-los	venializar+V.ele.ACC.3.M.PL+PRF+1+PL
venializamo-los	venializar+V.ele.ACC.3.M.PL+PRS+1+PL
venializamo-lo	venializar+V.ele.ACC.3.M.SG+PRF+1+PL
venializamo-lo	venializar+V.ele.ACC.3.M.SG+PRS+1+PL
venializamo-nos	venializar+nós.AD.1.PL+PRF+1+PL
venializamo-nos	venializar+nós.AD.1.PL+PRS+1+PL
venializamos-lhes	venializar+V.ele.DAT.3.PL+PRF+1+PL
venializamos-lhes	venializar+V.ele.DAT.3.PL+PRS+1+PL
venializamos-lhe	venializar+V.ele.DAT.3.SG+PRF+1+PL
venializamos-lhe	venializar+V.ele.DAT.3.SG+PRS+1+PL
venializamos-me	venializar+V.eu.AD.1.SG+PRF+1+PL
venializamos-me	venializar+V.eu.AD.1.SG+PRS+1+PL
venializamos-te	venializar+V.tu.AD.2.SG+PRF+1+PL
venializamos-te	venializar+V.tu.AD.2.SG+PRS+1+PL
venializamos-vos	venializar+V.vós.AD.2.PL+PRF+1+PL
venializamos-vos	venializar+V.vós.AD.2.PL+PRS+1+PL
venializam-se	venializar+V.ele.REFL+PRS+3+PL
venializam-te	venializar+V.tu.AD.2.SG+PRS+3+PL
venializam-vos	venializar+V.vós.AD.2.PL+PRS+3+PL
venializando-as	venializar+V.ele.ACC.3.F.PL+GRD
venializando-a	venializar+V.ele.ACC.3.F.SG+GRD
venializando-lhes	venializar+V.ele.DAT.3.PL+GRD
venializando-lhe	venializar+V.ele.DAT.3.SG+GRD
venializando-me	venializar+V.eu.AD.1.SG+GRD
venializando-nos	venializar+nós.AD.1.PL+GRD
venializando-os	venializar+V.ele.ACC.3.M.PL+GRD
venializando-o	venializar+V.ele.ACC.3.M.SG+GRD
venializando-se	venializar+V.ele.REFL+GRD
venializando-te	venializar+V.tu.AD.2.SG+GRD
venializando-vos	venializar+V.vós.AD.2.PL+GRD
venializa-nos	venializar+nós.AD.1.PL+PRS+2+SG
venializa-nos	venializar+nós.AD.1.PL+PRS+3+SG
venializa-os	venializar+V.ele.ACC.3.M.PL+PRS+3+SG
venializa-o	venializar+V.ele.ACC.3.M.SG+PRS+3+SG
venializara-as	venializar+V.ele.ACC.3.F.PL+PQP+1+SG
venializara-as	venializar+V.ele.ACC.3.F.PL+PQP+3+SG
venializara-a	venializar+V.ele.ACC.3.F.SG+PQP+1+SG
venializara-a	venializar+V.ele.ACC.3.F.SG+PQP+3+SG
venializara-las	venializar+V.ele.ACC.3.F.PL+PQP+2+SG
venializara-la	venializar+V.ele.ACC.3.F.SG+PQP+2+SG
venializara-lhes	venializar+V.ele.DAT.3.PL+PQP+1+SG
venializara-lhes	venializar+V.ele.DAT.3.PL+PQP+3+SG
venializara-lhe	venializar+V.ele.DAT.3.SG+PQP+1+SG
venializara-lhe	venializar+V.ele.DAT.3.SG+PQP+3+SG
venializara-los	venializar+V.ele.ACC.3.M.PL+PQP+2+SG
venializara-lo	venializar+V.ele.ACC.3.M.SG+PQP+2+SG
venializara-me	venializar+V.eu.AD.1.SG+PQP+1+SG
venializara-me	venializar+V.eu.AD.1.SG+PQP+3+SG
venializaram-lhes	venializar+V.ele.DAT.3.PL+PQP+3+PL
venializaram-lhes	venializar+V.ele.DAT.3.PL+PRF+3+PL
